transaction_hash,status,gas_used,cumulative_gas_used,contract_address,block_number,timestamp,transaction_index
0x569c5b35f203ca6db6e2cec44bceba756fad513384e2bd79c06a8c0181273379,t,21000,21000,,5000000,2018-01-30 13:41:33,0
0x696a35492b283624ccf4ae9438ae2d5d5e84a4a00798155b568d1eb52606d829,t,39835,60835,,5000000,2018-01-30 13:41:33,1
0xb4de9f39cf7b6218d51ded0174007d4f9344ddfa690f9c94af00b4d18b7d3bb0,t,55843,116678,,5000000,2018-01-30 13:41:33,2
0x889750534901fa3db4e044786097d275b56eefb091e40c45241892bce03729da,t,21000,137678,,5000000,2018-01-30 13:41:33,3
0x1c947c0b8f087171a4e54bcbdae169aee4e740ee09e997be0820fb3d58bd49f6,t,21000,158678,,5000000,2018-01-30 13:41:33,4
0xf29819bc5b114851494262c25728e697bd1b679646be9a5e4d12431868057b39,t,24090,182768,,5000000,2018-01-30 13:41:33,5
0x3709cb1903e26cbbb1d44af0c41e126f5cc718f5343daabbfa31b956a7395eae,t,21000,203768,,5000000,2018-01-30 13:41:33,6
0x5b252a6c4c6c4348c6c35a85df7d432ceea0b71459d9980755d8e906e0ab57b1,t,38690,242458,,5000000,2018-01-30 13:41:33,7
0xe76a14cd47adad50687565f75c41223bbafd786890076c024f4ae8addea7635b,t,21000,263458,,5000000,2018-01-30 13:41:33,8
0x3b5f0b05cf51bfd65c509c1e4adca86e50622f193abd92fb84b050e548d0f3a9,t,21000,284458,,5000000,2018-01-30 13:41:33,9
0xc3ef85864e9dd0b65c822416dc882da379cebb947deb3f01ca950a1d737d1317,t,21000,305458,,5000000,2018-01-30 13:41:33,10
0xded2f1d126b873f8fe60e128ff0f39e9f3fc7fe516345c1832ae016035a96d78,t,34725,340183,,5000000,2018-01-30 13:41:33,11
0x3cd56c08d3af62c4533dbd18c62b252287a9d87468cc802f010d29adc7c9ac0b,t,53318,393501,,5000000,2018-01-30 13:41:33,12
0x2f70fa29730249f10a7a64d3dfa426cb4e44e3edad8ea0ecae56b687e7b7bbc1,t,52948,446449,,5000000,2018-01-30 13:41:33,13
0x50bd1efb30794dda13bd67a7d6f5ea358fb2cf6ccfaa6a178baf2216849ba4d6,t,30611,477060,,5000000,2018-01-30 13:41:33,14
0xd69c3c8b4b8b09fed0e8a3586583ead35ff104a7abec17def79a7556acd9f0b9,t,51916,528976,,5000000,2018-01-30 13:41:33,15
0xa7812aaf1bf042b5276ee3bef7b4fdafd8b667815a79751134577e94193d63a0,t,21000,549976,,5000000,2018-01-30 13:41:33,16
0x5d23d932b844aae22653903e47bfdf20ae3da3d570df6da31be0fe45d9f1cb7b,t,21000,570976,,5000000,2018-01-30 13:41:33,17
0xa4ddd7ae5775b57993e77bf77d08edadc0f609d4d4e3170fe0a1a636dd5efc3b,t,45738,616714,,5000000,2018-01-30 13:41:33,18
0x74f7fff70e21e3cdb9386868ebe718770ae4a5c67945ff2f5a658f996b3ec88f,t,78798,695512,,5000000,2018-01-30 13:41:33,19
0x4ebf7f5d5673b06abf1f69c1c28285c44d70b6b4536ee6fc96c3a5f4ac18b643,t,21000,716512,,5000000,2018-01-30 13:41:33,20
0x3460455198a751a72cf49e17ced434852ee1ee94ac81d5508f4ae3a44d64cb99,t,102934,819446,,5000000,2018-01-30 13:41:33,21
0x26c4afdb927218a37fe04a1557c7bdcacf77494ea1414f32a1c537b694f6cfd2,t,21000,840446,,5000000,2018-01-30 13:41:33,22
0xa6a786e5461b78700da1d1580cad4b8b56470f215aae6f575919f344de77b148,t,21000,861446,,5000000,2018-01-30 13:41:33,23
0xa401a57d82f6de33cd4796ae8336bccac903d8fa65a76cc06ac2e80b89c3bb50,t,21000,882446,,5000000,2018-01-30 13:41:33,24
0x8ff0f68fed41bce9b91687616fb68989708167c6ec07910492aa6848c80989bd,t,21000,903446,,5000000,2018-01-30 13:41:33,25
0x058ddeab6f98df3661ad8b90e8ba5541342c8bf7194eace86b3206e96b377cb3,t,21000,924446,,5000000,2018-01-30 13:41:33,26
0x24a6295d33508c73455f0b2c54020ac0d6251b9c4a10602154d6412ba08e9e85,t,21000,945446,,5000000,2018-01-30 13:41:33,27
0x3ac6132405fb6fce3cf04f947ac8e91da92b48a2ae4666e377535eaf1f2c7d48,t,67597,1013043,,5000000,2018-01-30 13:41:33,28
0xd7c4e7c61f2db278ddd0c70e3bae372a8d91ea909871c57b197e203aa03555e2,t,21000,1034043,,5000000,2018-01-30 13:41:33,29
0x33e3a6780eab07586bd3951e5c44fdfabfe7efcf1b22833da2ec2acf7a11ccbe,t,253854,1287897,0x832ad0f69B7aB16d896fD547Fa306Ab2BD2b87C6,5000000,2018-01-30 13:41:33,30
0xc274f066f7179e13160df4fcea3622f62901dd84d664f221c874d899c1df4799,t,21000,1308897,,5000000,2018-01-30 13:41:33,31
0x613fd4a2e884ad9949ad42076e6d480e0621e1ea27b5559cc64aadc052a73bd5,t,21000,1329897,,5000000,2018-01-30 13:41:33,32
0xd464bca4552371be4aa96a74370dafa9d3efa4f7196e21444644c852d44f79ca,t,36792,1366689,,5000000,2018-01-30 13:41:33,33
0xcc9aa0df9dbfbff85e5caf968887fe6e575a0e12788515d13e124b9c7e91d6f3,t,21000,1387689,,5000000,2018-01-30 13:41:33,34
0xbf1530a1bc3c2c5c9452f683bf0391424d73fef3e8cc81c3b74d4ac6bc6dba65,t,21000,1408689,,5000000,2018-01-30 13:41:33,35
0xe0aeba3ffdead78551361c59c8d8583f750a94c1982e96e6f5de84902835e56b,t,44493,1453182,,5000000,2018-01-30 13:41:33,36
0x104f8b11d1d9583640330d05daa87110386d6798c2b6cd8f1b5e9549ebef3472,t,57694,1510876,,5000000,2018-01-30 13:41:33,37
0x879f8791a0994d393e81e948818a278aa0d85b62662a3c5d146c506a2021b690,t,92986,1603862,,5000000,2018-01-30 13:41:33,38
0x9f72a886fba356af05a5effb99693dc90d1424be0c9756d4ec80ef68aa557d17,t,41872,1645734,,5000000,2018-01-30 13:41:33,39
0xaa33979e331940a0b8cd9069ab3ef0f8788f9a956e916da10ce87e3a99cbf512,t,23316,1669050,,5000000,2018-01-30 13:41:33,40
0xdecbdac6695845d5399e6f62b5182bbdff641aadf687c4d5d7601a76b22fa918,t,21000,1690050,,5000000,2018-01-30 13:41:33,41
0xba996e8d2feab66b165e23feaa56939c6ddfbf21ff5a38a9c00f7010ba2bc7cf,t,52776,1742826,,5000000,2018-01-30 13:41:33,42
0x65784cc03a18fa4ba92c5ebd7d3d3827da2109345d317456d33fd8f293dfffc1,t,26937,1769763,,5000000,2018-01-30 13:41:33,43
0xd56ec0c74c0272c7e71ca65c944c70d8d4160e570692609e22a4b1022babcbf1,t,23551,1793314,,5000000,2018-01-30 13:41:33,44
0x04dceef18be4620144be14f27abc733c0b2178f39a66c1135ae75a6bace46659,t,37950,1831264,,5000000,2018-01-30 13:41:33,45
0xc3e1a6b35abd7fd26fc72ef4f2c9fdfe67c5bde78f3ddd847a83760c76f88405,t,22206,1853470,,5000000,2018-01-30 13:41:33,46
0xf7c221cad993e24c8cc447e51bbb870799195d0647cac006efc47a7a665e5db5,t,52848,1906318,,5000000,2018-01-30 13:41:33,47
0xfe6e82694b66115db9fc00db5e90a8eb50409fce896bd21d3ff9ba6abbef489f,t,36685,1943003,,5000000,2018-01-30 13:41:33,48
0x72d0f4f165169cde7181cfd44b592d761f13d22f00c9fd0f2f63116ea8f5beb8,t,21000,1964003,,5000000,2018-01-30 13:41:33,49
0xb1dc11691eb8285ab2d9f0910b47eb4379604cefcc51cbd1b5e3182e3c773e3d,t,37132,2001135,,5000000,2018-01-30 13:41:33,50
0x9909f21e7327d03167c56b2820494a0b134794c4c20c2ac97b82747163a91949,t,21000,2022135,,5000000,2018-01-30 13:41:33,51
0xd67e95d3ba6ba09164492396a07c7537a8cb1c58a1b975a806a385d16e448c2e,t,21000,2043135,,5000000,2018-01-30 13:41:33,52
0x20098b8adfbaa2c67b1c6f50f9fb138816c45b459a4116563d82eb9c006a0a1d,t,21000,2064135,,5000000,2018-01-30 13:41:33,53
0x8db11b2db8dd39e6f82360fd7aa9111102feccf054b2e4047e833ea269b7d833,t,21000,2085135,,5000000,2018-01-30 13:41:33,54
0x7595469b9ec9464a848b990df95fa373a5a55dd0f7793179a0f21603bd008298,t,21000,2106135,,5000000,2018-01-30 13:41:33,55
0xa38801dad0671afb53aa398a83ee45f4c700edc78ae825e02f51906da43c51e7,t,93114,2199249,,5000000,2018-01-30 13:41:33,56
0x0cc22c7f31c2b5db63ce26b01bfe78af8ad2e632c2fd4e7e3a04ab9b0a610a6f,t,41186,2240435,,5000000,2018-01-30 13:41:33,57
0x06953ff02055e3f42f73359f0aac4d95e8a859d21db012970ccf07c8226224bf,t,21000,2261435,,5000000,2018-01-30 13:41:33,58
0x85c7463f907da4ef530105260ba23a57c13c62ae055ff71a5fc8e893abc90d69,t,37170,2298605,,5000000,2018-01-30 13:41:33,59
0x0cde97b11cc71cc78ccbca607bf35f04e8f8b04dcbef698e2c5e52fc07d4c6a1,t,59354,2357959,,5000000,2018-01-30 13:41:33,60
0x641f5f823f06882c709d2a22f2058a440fae0845b85a279fd3e86c9317ff9ed4,f,250000,2607959,,5000000,2018-01-30 13:41:33,61
0x0384367ab330552f4bc127a809069b711d9c4e05582ddcc4d1c461a84ce4b14d,t,69504,2677463,,5000000,2018-01-30 13:41:33,62
0x56ee7a0f1705e1d2138e0c12ebd47225882bf1e62ef4028e44ba1a6c5730a2cc,t,21000,2698463,,5000000,2018-01-30 13:41:33,63
0x8dc6793a0dacf72ecb8e8121443bddb5d18cdeeac1d11e680dde2430b1d8064a,t,140212,2838675,,5000000,2018-01-30 13:41:33,64
0x139e7e0c329c458f5cbc9ec9418ca19df59cbf619f1ede2c1d210930b819ffe6,t,51708,2890383,,5000000,2018-01-30 13:41:33,65
0x427c27e37a46ffaf398d03249041baa44a7b34c6226583c94797c78f8756b4bd,t,21000,2911383,,5000000,2018-01-30 13:41:33,66
0x7cc930cef131502bb78c13012caf0d99117892601b81fb95958aac98191fe6fb,t,49703,2961086,,5000000,2018-01-30 13:41:33,67
0x7436adb6ed6d0bf52e7ecef8e8396dfae6dbe868b6f162c67d5ca3c31130e2cf,t,21000,2982086,,5000000,2018-01-30 13:41:33,68
0xd27d390d2ced77fe3758dee533f0dd27a41fef5f02089aa4bb7b9669da527ffa,t,21000,3003086,,5000000,2018-01-30 13:41:33,69
0x7f06c2055c6e5cfc50f0e222ff5b16af7642031f9dab1535efb9634c8a00807c,t,59354,3062440,,5000000,2018-01-30 13:41:33,70
0xd1997d2747f6c12807a72f714aa8f3d28eb4c080bb850e7191e6a74543a8ef46,t,21000,3083440,,5000000,2018-01-30 13:41:33,71
0xa842bbad9e3fd0995629e260ee4889b7d5f64f482651b31ae2a08a6a74e25944,t,236399,3319839,,5000000,2018-01-30 13:41:33,72
0xc874c435c2ae2f68a85df428526c324552b35c966b02d081c054b2cc8f5c19fe,t,36372,3356211,,5000000,2018-01-30 13:41:33,73
0x6f8c9babf9f67abaeeb6debb99769ef73efee11a0e3a62b3c994964090c79b57,t,93114,3449325,,5000000,2018-01-30 13:41:33,74
0xbca5f40231f1475d0a70673da84bc56bc2cc7022c5633364f6ffa3b26f4a1c7a,t,21000,3470325,,5000000,2018-01-30 13:41:33,75
0xebc26d92a9bfc0962b23b0eb72e00842c8d9082f44205e5d18777ea431083a1c,t,193058,3663383,,5000000,2018-01-30 13:41:33,76
0x8c4887ba1354d5ba760435bf420e61cdb2f6cf26ece49fef67638d956ccbfa14,t,93242,3756625,,5000000,2018-01-30 13:41:33,77
0x49e4ace49dd66078d5ac652cf72056055917ce7f56f41ef63c4be0ccc2b6abf7,t,84836,3841461,,5000000,2018-01-30 13:41:33,78
0xafd03c910d1743318ec788a4112bb49406a80dec133abcd927595cc71d63c395,t,21000,3862461,,5000000,2018-01-30 13:41:33,79
0xccf3d5613312d26613ef4a601040c924476c6814feb9a89de7ae139f1cf76425,t,21000,3883461,,5000000,2018-01-30 13:41:33,80
0x946dee822a05cf5a76d6485985f08db505780ac72450ecb294c6e4b77b4f7dac,t,2040974,5924435,,5000000,2018-01-30 13:41:33,81
0xe88c93048b74b6b5b285ecbdce75d69ab1cdb38d0b43cdc8982f5e5c923eeb7f,t,21000,5945435,,5000000,2018-01-30 13:41:33,82
0xe62d239137428a372512dcb69fe167a6f9c71c025cdb3a0cfce9cdd57995eeed,t,21000,5966435,,5000000,2018-01-30 13:41:33,83
0xcdfa195b73684ca3826cdd05cbf3a892526797fc1e7e93c3c6931ccd9cc0aa8e,t,45750,6012185,,5000000,2018-01-30 13:41:33,84
0x3968e17f2a168a6864c5815f473678d2b4bc76fa9d853f813b9fc63ffe2b026b,t,437375,6449560,,5000000,2018-01-30 13:41:33,85
0x190c3f6497ddacdf949d1f17401a8eb7529739f49e56293e0ddc783b63c99e4b,t,59354,6508914,,5000000,2018-01-30 13:41:33,86
0x8795a8785ce994ca684c753dcc54df7c89d2a8246170be7bdc86f14f4e427aae,t,44493,6553407,,5000000,2018-01-30 13:41:33,87
0x48ab76fe7c270d86effc34ac3cc7e821feff3c2e01bcdc5667b9730cde03b43d,t,40806,6594213,,5000000,2018-01-30 13:41:33,88
0x8be319515b7535b02367b650f99c0548b02b02091d298f173fb7424451aade2d,t,50448,6644661,,5000000,2018-01-30 13:41:33,89
0x39ff3f84516352a84441191e907ae5828a7e2ccd76d47e41f3288a6178bf0189,t,21000,6665661,,5000000,2018-01-30 13:41:33,90
0x4b8c6449d655ed4869e17817c014b94c0fcc8ebfe79a76124e004736b9aa2f7c,t,232067,6897728,,5000000,2018-01-30 13:41:33,91
0x676306e1489bb343f45f2759fa7d8709da26c0396697b389cb50e0f7fbf462cc,t,133657,7031385,,5000000,2018-01-30 13:41:33,92
0x347f89a131adbfc916cc5f33804f3b3b423c9ddbc993bb30279e6d05b51b4f37,t,133721,7165106,,5000000,2018-01-30 13:41:33,93
0xd8153644752a1e1bb4db3a1ae777c8929fa365e6e714daf1b7c52a93ec2f7b52,t,123050,7288156,,5000000,2018-01-30 13:41:33,94
0xfb5747d8406154a0873cf704194e916e7d531dc4b51b112e32c969700d5a7524,t,49180,7337336,,5000000,2018-01-30 13:41:33,95
0xe269325371a23a2c2df50182e7a35db6a6aa0f839910c3e151597694afc6f516,t,36898,7374234,,5000000,2018-01-30 13:41:33,96
0x49cf4a2fa4fb5f1b3e35d437072bc586246efb09300244b3d686b3064896a7be,t,47585,7421819,,5000000,2018-01-30 13:41:33,97
0x88c7e5f2bedd21066f1cef8c7827e5498b4a9beebd6acf4385dc696d4e0faa4a,t,21000,7442819,,5000000,2018-01-30 13:41:33,98
0xea55618f67ebc1b52dfab39f2ba47bb6effbb04c879c43aa9c1f248fcbf17508,t,134684,7577503,,5000000,2018-01-30 13:41:33,99
0x8cdc1ea122b71a02e5f4b60049b0864f7f3fb2750b5f219d13a408348b7181e9,t,133581,7711084,,5000000,2018-01-30 13:41:33,100
0x292fb1e997df1832ec80a24b61e3f449b056501bc0bc92a86912285a8a819175,t,36367,7747451,,5000000,2018-01-30 13:41:33,101
0x381a07c45b72ac755855c2ebf3a90c9d0fe9a294ce93bd8ae394947f0829febb,f,23220,7770671,,5000000,2018-01-30 13:41:33,102
0xd2846f5c08d917fbc85528af2be757c6de23f7a349e94392cc8fc4fe4654d36c,t,21000,7791671,,5000000,2018-01-30 13:41:33,103
0xc18604dd4c911148f43900ca26480527022132b0fe821a03a72ec6b69d761d1c,t,21000,7812671,,5000000,2018-01-30 13:41:33,104
0x218651412101c68079b2e1a91e9b9c69c4269107a00c88c4c5cee249af7f2d7e,t,39512,7852183,,5000000,2018-01-30 13:41:33,105
0x3f61cfc7597f44b51bda511169ddbc4125922abcaed505c6beb05ac2912efc38,t,47290,7899473,,5000000,2018-01-30 13:41:33,106
0xd67643a3bf0bb11861cdb76b5f791b59a2017f062f0c3ac5e3dacd950bfb9497,t,47290,7946763,,5000000,2018-01-30 13:41:33,107
0xaa2703c3ae5d0024b2c3ab77e5200bb2a8eb39a140fad01e89a495d73760297c,t,47290,7994053,,5000000,2018-01-30 13:41:33,108
0x49ccf4cc91d52f01b84773e73e21c327cfcc4e6b22471470b9c68d0fbbf66288,t,21000,21000,,5000001,2018-01-30 13:41:41,0
0xacfd23bde230cafef13cf7bd147dc7f18b71217367290d50cabd45e45aaa62a3,t,21000,42000,,5000001,2018-01-30 13:41:41,1
0x825e4a0f89b9f8f86e5771b0644a72ce51d09ebcc2a875676edbaf51209ffbe7,t,24090,66090,,5000001,2018-01-30 13:41:41,2
0xcf6c86a094612f8ebae588df83a82caa9c7bd4ee19e721621633d39a8a55bd90,t,36545,102635,,5000001,2018-01-30 13:41:41,3
0x69d1ee38805fb3d0e948ecf96860f18848a484b1570d93121cb75100810aeffd,t,21000,123635,,5000001,2018-01-30 13:41:41,4
0x0ef7930261ca298ba48f94096324b01df5d021845a53b433af7219ee66a7d85c,t,21000,144635,,5000001,2018-01-30 13:41:41,5
0x6bacf29bcbc912a68042b1b395bbe0d2e2d7f26096ba154c81092e97d7523745,t,21000,165635,,5000001,2018-01-30 13:41:41,6
0x1d6adc2a176975af09de7c654b57b1bbb547682a8f5f575a6eb8ae4c7a4ad1fe,t,21000,186635,,5000001,2018-01-30 13:41:41,7
0xcc242bc922fe43bc5d29052de40152ea3ed8036d5638ce2fc7da127a8a71452c,t,21000,207635,,5000001,2018-01-30 13:41:41,8
0x6141e7100ac5c33ffc741e5de875fcdc810ba2bcb47fb36ffd6affd68712ca8d,t,103563,311198,,5000001,2018-01-30 13:41:41,9
0x18b4d95eb8f5c1cf780e511d46e86b013375ac11c37220f9595fd6b845fb7a92,f,21000,332198,,5000001,2018-01-30 13:41:41,10
0x2cfd7194877466e6adb87222e5876c4babf8bd59de299698fdce7f0a9a232932,f,21000,353198,,5000001,2018-01-30 13:41:41,11
0xc939ff0fc519818c4c5b1942d3790f36ecabd14ab98815f68e6d6d1877d172d9,f,21000,374198,,5000001,2018-01-30 13:41:41,12
0x779d5812c384ff62202839925fb27debbdaf4ea0dd42b4dd3c16db29cb792b92,t,37746,411944,,5000001,2018-01-30 13:41:41,13
0x83c06a3f496fdff59f2ed570f86664f97544c77671c0013e11755c2c19855eda,f,23320,435264,,5000001,2018-01-30 13:41:41,14
0x35bdb5c9f2dc6fc192df2b70c7b326f36db7e721f0ea0bec17e171d1c9d43b2b,t,92986,528250,,5000001,2018-01-30 13:41:41,15
0x05aca2036ea24b7099ccd4c75dd0418a36d8366c69df8834c762c16b8d8212bd,t,21000,549250,,5000001,2018-01-30 13:41:41,16
0x4e163a992b0e8f3a47489b911fd896337522327aec5d1896735821572e3983cd,t,22569,571819,,5000001,2018-01-30 13:41:41,17
0x4807f08f768974aa60a2552a8f5fc26c88c8700630f399259c349dd49b31a849,t,52094,623913,,5000001,2018-01-30 13:41:41,18
0xfc3609ce4709cdd689d1cf9039800401d5873f682f8cd251dab78c44924d9bb9,t,21000,644913,,5000001,2018-01-30 13:41:41,19
0x09f57e695705ca88462a1bdbc4697da6831e59a74a26ad71f1993d96eb9a9945,t,21000,665913,,5000001,2018-01-30 13:41:41,20
0x1402b320573c4d6470bc0fa9685e905646f7424279ae7ae923684c9fcab17b75,t,36789,702702,,5000001,2018-01-30 13:41:41,21
0x86824fcb6c67f9393101458cd3ddef9b64342337c69c514202c7d298f7888f1d,t,108114,810816,,5000001,2018-01-30 13:41:41,22
0x1d1490c494629f382a006d79af17329cceadaabf7f9613fdbaa41f5151618f91,t,21000,831816,,5000001,2018-01-30 13:41:41,23
0x144fdbd2bbd666877a845b00379ba817932ac0ffb45f8d1915817eebb8350808,t,21000,852816,,5000001,2018-01-30 13:41:41,24
0x8779af72e08086206e7a5d1ccc0e9f401343595b20dbe6b3b77ae17eae8bf01b,t,37260,890076,,5000001,2018-01-30 13:41:41,25
0x8574298d66a39a4e9e2e8de4cd10122db1e729e0f3943c475527ed23914547be,t,21000,911076,,5000001,2018-01-30 13:41:41,26
0x648aa4d6c1fb510beec8c18fbee846cc0e1e1130f77c35373e913016777920f1,t,36706,947782,,5000001,2018-01-30 13:41:41,27
0x520675f7cba5b9d3bfe7e48d51da8e826ea01a6ff4bc457eadf6d64256b58250,t,21000,968782,,5000001,2018-01-30 13:41:41,28
0xeb1684b63135e512691fe1c0a8a419c51a3b7132a6f70b43d22e4157d0601b07,t,52886,1021668,,5000001,2018-01-30 13:41:41,29
0x4eca240c07228bd07731bf204486dbcb09fac7d09d59e6ef6d044d35be2179c0,t,253854,1275522,0xd36C5cc9EF56d61752c4422c0baF9EB7206CA019,5000001,2018-01-30 13:41:41,30
0xbae300a191c0e0930f94515d3ffb36a30e0128311c7e0250ebc18411f8ef91e7,t,92605,1368127,,5000001,2018-01-30 13:41:41,31
0xc2756a5387125740024d84b8b6719b05f0932343c50fea73bdbea7d004f195e3,t,76606,1444733,,5000001,2018-01-30 13:41:41,32
0xf87f0acf4d06129fb6ec8793bf974d2a17996058ce35b7aad1125cd701b6cfc9,t,21000,1465733,,5000001,2018-01-30 13:41:41,33
0xac0064f8d4ebecebc9751001021c638c91790daf3d9cc38bc09ed572a7e630f9,t,21000,1486733,,5000001,2018-01-30 13:41:41,34
0x577aaeef6b89c73fcd4dedc69a88ca2718619deab614e3223984d71c87d482c3,t,21000,1507733,,5000001,2018-01-30 13:41:41,35
0x5db0ea8326d6a5117bbd4a38335cc261b42011571988aa2d21dbcf8c3c6f7b0e,t,21000,1528733,,5000001,2018-01-30 13:41:41,36
0xaeb5eb73681bdb4ecbe52abf3c8454fca2d553bcaca57e020407727b0270fca8,t,53040,1581773,,5000001,2018-01-30 13:41:41,37
0x2351beb68beda22ed61e3875249d5a8b7bd4dd9ebd53e1659902bd7311ced24b,t,21000,1602773,,5000001,2018-01-30 13:41:41,38
0x5aa5839fca44eab1590f97ea34d1a41f960d985c56c77850a5e0c4b6c80d5ffc,t,21000,1623773,,5000001,2018-01-30 13:41:41,39
0xdc94456dbba24eff0ffe7b777501394126429f598a5b3afab5c4b48c2df57009,t,21000,1644773,,5000001,2018-01-30 13:41:41,40
0x9530cf8263e05fab06e7b957e52e3f6c244297a2ed43a72cd1ba04e1c8d220b0,t,21000,1665773,,5000001,2018-01-30 13:41:41,41
0x24f8048a416d8ba6dc60659679ffe52e2c2d4c077b5884e2e476eded71e86bc9,t,21000,1686773,,5000001,2018-01-30 13:41:41,42
0x7ab0030a728a71b5273a19d947040c63663a858191da794d38f28f7e9188a23e,t,21000,1707773,,5000001,2018-01-30 13:41:41,43
0x290f73b8c9f99f4481d537a530f042e599bd66ccf7739e80460d7c658b2e3558,t,38005,1745778,,5000001,2018-01-30 13:41:41,44
0x79d81e6949db63a967619d8a7ed7f05d833c1ae03a7f50969c27b7f6988bfe97,t,21000,1766778,,5000001,2018-01-30 13:41:41,45
0xf7100489426f52fb1e94775eb15b7c207a10ea595c8f519e5ecc89527b4f2b2f,t,21000,1787778,,5000001,2018-01-30 13:41:41,46
0x8b3f032149391dbf2ed7c63f42fb8477fbf34f0d56591186af33055f8024f5bd,t,21000,1808778,,5000001,2018-01-30 13:41:41,47
0x5f223414199c235251b041a830b517460d688f8a53b9adf276492bd8729c9fc2,t,21000,1829778,,5000001,2018-01-30 13:41:41,48
0x4549824e1070cfa67d704f2b5eb93ad754ec851c41074312bdebc19e7839f7d0,t,21000,1850778,,5000001,2018-01-30 13:41:41,49
0x761e74a76e331fbabf8afdc33be288ed7c76dd573017f9ee9f2c246438553752,t,26290,1877068,,5000001,2018-01-30 13:41:41,50
0xbe1a1f1d8ac3a9f20fa4e2d4675add2b5b520def75283851c3d25e1a303d0dc2,t,4679396,6556464,,5000001,2018-01-30 13:41:41,51
0xc27fac86f8849e8a07c12896a82a979ad24a3ce2727283a860e9fb127b4fc80d,t,140972,6697436,,5000001,2018-01-30 13:41:41,52
0xe0dd45871b263e81c913d057a8e0864e15a14f906794f454c867f2b5f63310e0,t,140276,6837712,,5000001,2018-01-30 13:41:41,53
0x3d6f84f6afb3cbde910e35c977532adbfba604352199fb0c81351514d08280de,t,36964,6874676,,5000001,2018-01-30 13:41:41,54
0xcd5d13687c5ee08d38c12ce4c346778dc3f0af8f13830a6158f58473697d57db,t,23551,6898227,,5000001,2018-01-30 13:41:41,55
0x27bdc5d6b2578fa30679d35e3828d49fa138b01ed316f0542e46530b0d6e3799,t,52460,6950687,,5000001,2018-01-30 13:41:41,56
0x8e236eef4cd9f50d6bd425fbed894996bec62b0bffc70fe5398dddbbd665cd71,t,21000,6971687,,5000001,2018-01-30 13:41:41,57
0x87462356ec3e9e97055339d5263df0cb5f131cc9c18945e37560a93949a204c6,t,42220,7013907,,5000001,2018-01-30 13:41:41,58
0xe9bf501dd2850d2395a18f839893005d93bc8b78b97060f8a8cb8808539356e0,t,37171,7051078,,5000001,2018-01-30 13:41:41,59
0xfff8d22962a3ade0c961f9636782e92360973ba4a5456c72f9e6d0cfc95ab105,t,21004,7072082,,5000001,2018-01-30 13:41:41,60
0x8324cd48300dcceaae8535709c8883cdcdb53243850b8f834708ec6b74b484cc,t,21000,7093082,,5000001,2018-01-30 13:41:41,61
0xe545abbbd67f8622050fb8c40449f866f58e069773ab472431ea6d106189f50e,t,21000,7114082,,5000001,2018-01-30 13:41:41,62
0x6b437d665958df0e39bbbfd08598912c65db62039a5b92bca5f83fac3728d7ee,t,93050,7207132,,5000001,2018-01-30 13:41:41,63
0xd519257d17cce912a13efffdc728d14b2ac7825e2313bf61d6e7add8068c1cda,t,21000,7228132,,5000001,2018-01-30 13:41:41,64
0x9975b69570b61818436f18fdf6104a7cf1b305960e9e8ffcff77eae92212d12b,t,108178,7336310,,5000001,2018-01-30 13:41:41,65
0xa325c7ee311b71c2938e77d8610ace1015121ab5d072c56e04a5f87e48d45b58,t,21000,7357310,,5000001,2018-01-30 13:41:41,66
0x6c281a403a2d3481192c7f5e095902679d29785cb22ce522cb44911bc3a8880c,t,59226,7416536,,5000001,2018-01-30 13:41:41,67
0x0901df4ba5b71960ccd3603297bd37b069f60b172e02e3a099d147e9e845b1ed,t,21000,7437536,,5000001,2018-01-30 13:41:41,68
0x4cb9072c7263eab986807d2e79b7adf222023388785a0ada224c9ead557f1e83,t,21000,7458536,,5000001,2018-01-30 13:41:41,69
0x52901d0aad055350e3006752110fdea8fc3f38a97d3d302d8cd64d7f1b887fc8,t,21000,7479536,,5000001,2018-01-30 13:41:41,70
0xe54aba76f2aee4ef40f155a92c62b8d3eb0ad67685a5b66e466203c47e68ce6c,t,37109,7516645,,5000001,2018-01-30 13:41:41,71
0x5d7cc14f8848d2d7b47974b84d33817d100c6791a6609d693ae10a44925cabc7,t,45545,7562190,,5000001,2018-01-30 13:41:41,72
0x4ab0551100d8ec2db64d6b253f384479c956d5cb96d390f26215cebd2f2d20fe,t,21000,7583190,,5000001,2018-01-30 13:41:41,73
0xa35564a506f84b6b293f37b39524694af6f8b6b1419e6412eb93c438a3626d07,t,21000,7604190,,5000001,2018-01-30 13:41:41,74
0x08679a2a00de267a8659462273c8bb4aaa08e2b30ddfcd16a315bed78e2dbf8e,t,53255,7657445,,5000001,2018-01-30 13:41:41,75
0xec89478783348038046b42cc126a3c4e351977b5f4cf5e3c4f4d8385adbf8046,t,48024,7705469,,5000001,2018-01-30 13:41:41,76
0x9e19d995130cc756719956447916aca051794914d4a3a2e7413a81177722a6a0,t,21000,7726469,,5000001,2018-01-30 13:41:41,77
0x05a6464917bf6727521b0a1f7d8335abe03bf2c0986a91245fb69a212556c4c3,t,21000,7747469,,5000001,2018-01-30 13:41:41,78
0x9af980f2c8b54e163b28c831376f66105ec0e02f2663b4929eab434b333129cc,t,53551,7801020,,5000001,2018-01-30 13:41:41,79
0x7298a78a8593e7c26523ab4892e6cb10ec612b60850655c63da5e1bf936a8a39,t,21000,7822020,,5000001,2018-01-30 13:41:41,80
0x85692f119a6b68d76ff1c720ec72397bda7adead7bb380fba95b747329b9df77,t,21000,7843020,,5000001,2018-01-30 13:41:41,81
0xf4b9fc9c189b6770443379e3e3c4aeb3d11bb69ec7a91b9ed9dca6e0fb2505b8,t,37691,7880711,,5000001,2018-01-30 13:41:41,82
0xe1f5754e9ee1cd21a8991fee4b4a1b8ad9268e2b5456a3f4f3de8b8d23fad933,t,21000,7901711,,5000001,2018-01-30 13:41:41,83
0x4db330f27d3acd0aa093522ce7f0edc2668c2cc90f80b48f5fed4209f5abe5b4,t,21000,7922711,,5000001,2018-01-30 13:41:41,84
0x1037af651369f7aa5eb253c684e19c36988f55d6e11dd417ef2785b9c9573faa,t,21000,7943711,,5000001,2018-01-30 13:41:41,85
0x9948732d6c3e15215bcd87707c1bd043dc5d963e3decde39c845ff6fca6bef1c,t,21000,7964711,,5000001,2018-01-30 13:41:41,86
0x48562511573f040cb8c10f9387cd936f8d7aec627763bbe3e8a7f30a1bba49b1,t,21000,7985711,,5000001,2018-01-30 13:41:41,87
0x5fb2dd6f2abbf409f8b3b86298ca8b243d5691bfce56d81b4ddd7a5ec646bedf,t,21000,21000,,5000002,2018-01-30 13:41:51,0
0xa8e30372844657fe8bb0b5445b521645e339ff3400762b69c94dca64d7543b1c,t,21000,42000,,5000002,2018-01-30 13:41:51,1
0x7445252eeb07aab85380e15dd0304a1ecb4cf7f5c576382880391e8a4a278c0e,t,52155,94155,,5000002,2018-01-30 13:41:51,2
0xad137daf95696f33c611b39858b1b5a3d44273d2530a2397444d125c86bf09a4,t,51703,145858,,5000002,2018-01-30 13:41:51,3
0x28a148e37a13742dedaf1758f90d34d32eb8f292dccdfd88d69781fe464660b7,t,215038,360896,,5000002,2018-01-30 13:41:51,4
0x3f24b580bbc60971adff8b2cf92e056631401447101441d70c323ab4d8430965,t,63391,424287,,5000002,2018-01-30 13:41:51,5
0xcb0cf3817e076c44097515b2e9e7391c0a71f5f71e692f3967b86c276714e71e,t,24090,448377,,5000002,2018-01-30 13:41:51,6
0x596c7b91a709b84f98d1b65daf972a01cbc5c2b2197c52ee3ac8b9526ff6b105,t,53416,501793,,5000002,2018-01-30 13:41:51,7
0x26a231e292d9a85076293c4a6cd34bf13f6ac1c2e825a754819c500a3152fb86,t,31129,532922,,5000002,2018-01-30 13:41:51,8
0x4ef1da63eecbf69dcfb72d4b73a2dfcc40b051f38c972714eafb49d4c15b578a,t,21000,553922,,5000002,2018-01-30 13:41:51,9
0xfe7df597717c03ba09f47169949f699fb3b9b2c69d7c5fe767e66bb5fa255116,t,93050,646972,,5000002,2018-01-30 13:41:51,10
0x02c87e9402a52998f844ca5273eff578935691c732daba1cd1f19418f9041e5d,t,21000,667972,,5000002,2018-01-30 13:41:51,11
0xce89e38380cd61a52b66727351af04e16ae222030dffb5a7cffbd8c43b58d9ba,t,21000,688972,,5000002,2018-01-30 13:41:51,12
0x252de74f4e1bebec0bcd137059913d4a811462ee7f0341dd9134d62e663f5945,t,21000,709972,,5000002,2018-01-30 13:41:51,13
0x689e86c0fe50316913d101c7e211a4f5b0f895ad6230eef4687bf446dbd10332,t,21000,730972,,5000002,2018-01-30 13:41:51,14
0x81041bba71db1ddd25aac85d7bdfc04075eb8c90203c9ed284541ebb08c4b5cd,t,52810,783782,,5000002,2018-01-30 13:41:51,15
0x8d3b31a91b65ab6d55a317f1d84b894cf155fe070370fa51b7b6f824a85be7d9,t,21000,804782,,5000002,2018-01-30 13:41:51,16
0x170d2c189f11ef03c930ff37b360771a7fe157dd8bd00d0c4cb60b4b2c30fdb5,t,21000,825782,,5000002,2018-01-30 13:41:51,17
0x732384d70c9b3b58871cfbde6e43a6bbe879026c01dd916c3b01ba08b9aef060,t,51853,877635,,5000002,2018-01-30 13:41:51,18
0x6b3d279360731f9e980a1a6b093b735b03390be0169488598ba8c22760e38af4,t,46011,923646,,5000002,2018-01-30 13:41:51,19
0x9f1edc3a6a6f8ad5d74b2b456357ba67be2cc770809d18338df1c1157e160d9f,t,21000,944646,,5000002,2018-01-30 13:41:51,20
0x9ccdc30b7cd59f01ea3925f65c64986e9ec783b3b9d15b5c0aa3a5ee6b8f9bb6,t,21000,965646,,5000002,2018-01-30 13:41:51,21
0x715e9929ae1b490f05b3669c40f0830077c9ca81cad2005de28f2041bae7cf90,t,53233,1018879,,5000002,2018-01-30 13:41:51,22
0x2d9b29341588df34f94f995cb0e979e16e6d0140ef61448ad46957e2421e2f4e,t,38066,1056945,,5000002,2018-01-30 13:41:51,23
0x5cd19b0e119fd14020d8c85c2b877d7314729f04a2696c338e1258645f2815ba,t,21000,1077945,,5000002,2018-01-30 13:41:51,24
0xd4e06e4b22fd235177487bf64e30d965f0a62643334cddfb4264c351087ff946,t,21000,1098945,,5000002,2018-01-30 13:41:51,25
0x1f3f75a0a3a5629ff9763f504a1dccf6de1dd21fd8c3c5e80c36f9ed8be400aa,t,36770,1135715,,5000002,2018-01-30 13:41:51,26
0x1f78e102021549e9280b483af3e1034e4f1c74cde76943946eb425ac58189eca,t,52886,1188601,,5000002,2018-01-30 13:41:51,27
0x21b20a1ab7b2d9ec09be3333ae5c8697f0656e78efcd387bce48ecf027ecb984,t,253854,1442455,0x968C07336A986D95940BBE307807270545Fc0356,5000002,2018-01-30 13:41:51,28
0xe330bbdb707fe64daf27e8897dec33bce9e6f5efa51356de8bf048668c30e0e2,t,81655,1524110,,5000002,2018-01-30 13:41:51,29
0x9e20715ef25bd3f63177053800aae1ef29759d09d09fc420a07a94cf762f1ef7,t,21000,1545110,,5000002,2018-01-30 13:41:51,30
0xe130a58663c74967ad7c64b0af71b99d0e81bf0397745d01bd568abfa41532b6,t,164716,1709826,,5000002,2018-01-30 13:41:51,31
0xcccef1054d09fb22ba3548f11bf6d5534fa12a94b2b91e9de21f77e96ebee55e,t,21000,1730826,,5000002,2018-01-30 13:41:51,32
0x689275ca794f97fd5ec0ee7fd720af4cfc4b9f17208d7cf2773b6f33e24cac16,t,36938,1767764,,5000002,2018-01-30 13:41:51,33
0x0f3e64c716839b531b96d040d3b8d1e2b0d42403b7b3b51a41cf6f14463933c9,t,21000,1788764,,5000002,2018-01-30 13:41:51,34
0x73ef71c0e272501fe6ac151007d7b19477e00e8389d7db5f49f3431204288a2c,t,21000,1809764,,5000002,2018-01-30 13:41:51,35
0x50ee9d2105eeead42751a03b13510f0c541a8354b6b352cc004ebba82742ab04,t,32929,1842693,,5000002,2018-01-30 13:41:51,36
0x64f22c97087021d857f40851b96ec5ea5b48acf33d534cc788884dd9c9882e25,t,126505,1969198,,5000002,2018-01-30 13:41:51,37
0x54099858982e424da5017ec6686531df316aafc5a48e81462b033f9a72f95c3c,t,21000,1990198,,5000002,2018-01-30 13:41:51,38
0x25291e7a4bbe80be384f9aa76b31445855dcb3dc11939ce3e856e6fcb9fb0322,t,21000,2011198,,5000002,2018-01-30 13:41:51,39
0x0b374b00fd1d82bb6101a719e7830877ddae1a3296445dfe5258306b7d738597,t,21000,2032198,,5000002,2018-01-30 13:41:51,40
0x0f9bddb41e50f0d9549f76bf1d475716e2932f6607d22f6c784dfa210f7f770f,t,125276,2157474,,5000002,2018-01-30 13:41:51,41
0x157587426047200614347686d4e7a85096427500c76ea16948a7f9a80c190365,t,51947,2209421,,5000002,2018-01-30 13:41:51,42
0x1a357d337ec20ee599e13cd9493367c96665f0f1c0a06840024308799bf40eb4,t,21004,2230425,,5000002,2018-01-30 13:41:51,43
0x4906c37596399c94efccb216972bb811cd64e546135296155b16900ce2216c14,t,266532,2496957,,5000002,2018-01-30 13:41:51,44
0xe5d1d4363ac4639163cb0ec66a5010c58aa3dbae5364024e0f0b1e6c027c42ee,t,29493,2526450,,5000002,2018-01-30 13:41:51,45
0xfe92713636d598a506b09af7dcaa2348cc9509d4f18b75c12c3dbb000faf96c5,t,93306,2619756,,5000002,2018-01-30 13:41:51,46
0x9d98f24159a2f9087c38051eb44d345dc58b0eaff8d588afc43a26b7d030f6fa,t,37288,2657044,,5000002,2018-01-30 13:41:51,47
0xd82786541c2970609efa8d442db91ed4cb2fc5abbde93d914502df5af98f39bc,t,21000,2678044,,5000002,2018-01-30 13:41:51,48
0x8c657fb728b042e63e0404e506f963638b6e3975cfa400010f7ee19ea8bd3c8f,t,38645,2716689,,5000002,2018-01-30 13:41:51,49
0xff9e1fa03a7fb5200a8e144eec6f4e7a2fe655f9d75543d5325fd737b7d4c859,t,59354,2776043,,5000002,2018-01-30 13:41:51,50
0x7ab296dfb345983c4a322f0b9804f2b56ce88bbe410f32be86a0abb6485bf461,t,77858,2853901,,5000002,2018-01-30 13:41:51,51
0x65964f355f1ed8211b3f50492f8d78b118145b44635beeb24f8d12e08dc118cd,t,84017,2937918,,5000002,2018-01-30 13:41:51,52
0x3ea4b9a6dbab469b9fd3d3921bad996b3fde34f5ac552816be79ec61b5f03c3d,t,108178,3046096,,5000002,2018-01-30 13:41:51,53
0x9364b9ce083f51489d263665b372301947d1a14fe0ff9ededa33517543ab0f0b,t,112083,3158179,,5000002,2018-01-30 13:41:51,54
0x6e2e07e641e78f16fd23238133ff8698dabcc4429047e8d1b9e1ea927e9b3a6c,t,78178,3236357,,5000002,2018-01-30 13:41:51,55
0x7572f7992fc9b80cc51bc683e8c6c2f4362df67cf18cde43a2557519d6c89e7b,t,44290,3280647,,5000002,2018-01-30 13:41:51,56
0x82fad0a8a6184fce9e0704d46acd27ea7844c6cf58b87fac742fe3b94607f077,t,44290,3324937,,5000002,2018-01-30 13:41:51,57
0xaf93b735ad0d4448d68a2967e50296c5ac9e23c3fe3f0259365bed692cf7307f,t,51857,3376794,,5000002,2018-01-30 13:41:51,58
0xbad3ed4dd07bec57d6067efcb6979db5d31b5f7b97cc88ee8e35f7fb212f1c93,f,24022,3400816,,5000002,2018-01-30 13:41:51,59
0xe83ecd029ba85361f68a110b68cf5c9097012d4b38ecbf989805b95254620435,t,45990,3446806,,5000002,2018-01-30 13:41:51,60
0x45e5f64911c3494115d6f3f6df3ca2547f26f25ad614bd7372fd2bfde4de6393,t,21000,3467806,,5000002,2018-01-30 13:41:51,61
0x643bf83194a70783b5d9b4cca24590454e8e9e79259ac7e9bf55cbd93f3d94c7,t,59290,3527096,,5000002,2018-01-30 13:41:51,62
0xbb8965f9291c1222c08c1356ceec42ff6dbd19b6c1c942b83efe3f86a7f6cd9d,t,34144,3561240,,5000002,2018-01-30 13:41:51,63
0x0578d3ba4954ac792d6f63c1ca7061101fb2e0c00c88c50bba529c5679e2dbc1,t,93178,3654418,,5000002,2018-01-30 13:41:51,64
0xaf040a2dfba056f019f3f297b7d24689c356ba84b7d93a47dc23643fe7752530,t,37504,3691922,,5000002,2018-01-30 13:41:51,65
0x5741b27985184e74ee43961bc51bad7fb0c05041a3edf0c6e5d438b5d82bc449,t,69504,3761426,,5000002,2018-01-30 13:41:51,66
0xd28c70f427f62003700772f010e406c6e9ebf6b6b985ffc608ac385de36c8097,t,69504,3830930,,5000002,2018-01-30 13:41:51,67
0x8858a1434e324409a0b4e1bef042646856b809249e3817ac2f2b48073e0bb2ae,t,69376,3900306,,5000002,2018-01-30 13:41:51,68
0x26ac53896e45f19f4160d43036e5a55d70f1d0dd751f98d213c93665c350490e,t,27099,3927405,,5000002,2018-01-30 13:41:51,69
0x1d886bc5e188b8e5f699a805e8b0fe7d35d74a0ff61484277855765be13f74c3,t,30417,3957822,,5000002,2018-01-30 13:41:51,70
0x1a38bb6bbfa280393a0b7805513d1b99b5eaa9c7973e1d1579a1beaad49d2e19,t,21000,3978822,,5000002,2018-01-30 13:41:51,71
0xd13c7cc7f34da3372a234ef3746718310a97b7a4111bc31f03b4c35d39943225,t,28066,4006888,,5000002,2018-01-30 13:41:51,72
0x6a2eb61ac4883752a4150655fb45994dc0b502251e01c9b561f558f96c224e4f,t,36772,4043660,,5000002,2018-01-30 13:41:51,73
0xddf91dd247eba5a6ec27014c5580d7d11a9324427a5b5c36d6769186a37fcae8,t,21000,4064660,,5000002,2018-01-30 13:41:51,74
0x8a501ce2e08f67842f030aba9bdb31db93dc87cdf86c26640320e1fde609dc21,t,1560445,5625105,0x6C7a9e0De97D8b47a6b8C2082Ad3A2702D36F13D,5000002,2018-01-30 13:41:51,75
0xa252342b8674fc83727871825c186eaec95406cff7086f4a5b17da0f131cbd85,t,45846,5670951,,5000002,2018-01-30 13:41:51,76
0x762907369c32ce02968802ff19ab5e239f1b9270c2f0fa79090f38a2dea4c431,t,108114,5779065,,5000002,2018-01-30 13:41:51,77
0xc259ad06f9604f23d95462179adcd0f11734a875fed7f4e0151bef7ffaf4e319,t,21000,5800065,,5000002,2018-01-30 13:41:51,78
0x53a3639805c264b84293aeef89d5b705893bdfa0d43c7139cecbccae0d771c58,t,21000,5821065,,5000002,2018-01-30 13:41:51,79
0x209796d5f995d9b623737c6071b2c0efa05bc1d1b4028c5ac2eb4435e94b5f59,t,28002,5849067,,5000002,2018-01-30 13:41:51,80
0xd31d4ad92ecd70b1e84a211de93640af1d80f34d594a4c66a8a1e74675854948,t,34144,5883211,,5000002,2018-01-30 13:41:51,81
0x31e8272f82357df3acee66f0da22f15f5e6a43f50fcc78380725212e6f4370cd,t,21000,5904211,,5000002,2018-01-30 13:41:51,82
0x56f1edb4fcf835378d41f56717bf346d9bdaca486d044cce814fcafbbd045d33,t,36772,5940983,,5000002,2018-01-30 13:41:51,83
0x96d4ffb24c19d080f57c156f9f8f76ba7af035fb7be015168e4095e5c77c1f66,t,117998,6058981,,5000002,2018-01-30 13:41:51,84
0x2902621354060caa22326cb6d1825559267a512e195ffdf53533dc964fc48012,t,197319,6256300,,5000002,2018-01-30 13:41:51,85
0xcd6553fd177fbd811e1e8a8866d7c910455660c5b0330d7495f6ad049f9d9012,t,124573,6380873,,5000002,2018-01-30 13:41:51,86
0x94b709b3ae4a002903318b80a978f76e17d36f777124fcf586a56afe1cb38401,t,79627,6460500,,5000002,2018-01-30 13:41:51,87
0x744e0df7499f2bac054b342ac90e4570f69c5f0ca721d98bf566e173d4811afc,t,144572,6605072,,5000002,2018-01-30 13:41:51,88
0xa93fb05187a767ef5b0244487e1d7512143bf20a63a0588e7ea3461abcfca682,t,26065,6631137,,5000002,2018-01-30 13:41:51,89
0x76c9b5408b17f15e739ddd2cb27404644f2ba469e426336de06cc5195c55a9c9,f,250000,6881137,,5000002,2018-01-30 13:41:51,90
0xb63a95fcfecebaa55ffa0edc70c75cd8d705358822621ca2d851621cb8e72dbb,t,37836,6918973,,5000002,2018-01-30 13:41:51,91
0x1d869219ce77cba4b115b346d36dd5e15ac25db339c39478a86a750dcf87991b,t,46010,6964983,,5000002,2018-01-30 13:41:51,92
0x9d8e0713016f0b374822e2a63a7d741a047500b68c36312f70973aa4aa008e0c,t,47715,7012698,,5000002,2018-01-30 13:41:51,93
0x4e4a03a50a0d0d0e3945492df52c01b36214aa0f235b38b77c99c53824d8d9e3,t,44290,7056988,,5000002,2018-01-30 13:41:51,94
0x833e62bf2af47a0c2130461884614b3aee4d6bf290d5859ddc525dbcfe871b4f,t,78178,7135166,,5000002,2018-01-30 13:41:51,95
0xb2f98a8404252ad28c5c03fba8a58e9e28e30e5c615042089c25a0129c9768a5,t,59418,7194584,,5000002,2018-01-30 13:41:51,96
0x1408061e52580e05f9ae994cb5397579ec176ae6c8c5578175da804a20d05f98,t,44493,7239077,,5000002,2018-01-30 13:41:51,97
0x32ad5d9322ca42f53fbc3ab39e49536ae7f0d3ba81f94f749e7aa31278492333,t,78178,7317255,,5000002,2018-01-30 13:41:51,98
0x5ae504cfed31af5e983e5ae767b64da62dc9ef51ace7a3c0b9296b39de4ddb1b,t,44354,7361609,,5000002,2018-01-30 13:41:51,99
0x2027620c6baa5c7b1ad7cb0e5791b797c9c981d96b92b33e9c7f372356eb4a25,t,37900,7399509,,5000002,2018-01-30 13:41:51,100
0xce38888f1aae5bde25b9fe0db280633a485e12538fa010921fdade4423a43def,t,62687,7462196,,5000002,2018-01-30 13:41:51,101
0x83824fd860e23bbb49d5387915034925f5d4822e2a1c8c0b9646ee02abbbaf47,t,93114,7555310,,5000002,2018-01-30 13:41:51,102
0xd73f3e6eafa4973e8474836d90b2fb6f38a25feef9631544b71a9db2c4d944df,t,59098,7614408,,5000002,2018-01-30 13:41:51,103
0xc9dc4c9406e4fa0d7e4520bfc7e3efde1fee5755d6dcdcce6e8526f44b1ee1d6,t,59354,7673762,,5000002,2018-01-30 13:41:51,104
0x90dde066dc93678e4a19bc94fe1253010fbab1395ecdc49afabe94d9b4b4c822,t,37900,7711662,,5000002,2018-01-30 13:41:51,105
0x653c37541fc2f40bb70b4b6422fa7c8ee32042dd063e5f8b00358c46abbd7473,t,59418,7771080,,5000002,2018-01-30 13:41:51,106
0x09c3b5c177bc31671a6052aa61526ea92794eb1f6098c2b80262376593fa5e6a,t,174591,7945671,,5000002,2018-01-30 13:41:51,107
0x66efd757a0eeaad3db045a132ed16b18dd1116f9981835d2803acf967da0c940,f,21000,7966671,,5000002,2018-01-30 13:41:51,108
0x75879b170428ecdc9b4342dd1b0da1bcefa79d29698fec3e1e23d603d2f9e581,t,21051,21051,,5000003,2018-01-30 13:42:13,0
0x8aa2774b7bebb8963bc7ea43b4f3d61ceb2b5d647be88b6dcc11062c83d7208c,t,21000,42051,,5000003,2018-01-30 13:42:13,1
0xfbea64149d0ccae7ad58da53314eea50fa044e722384009218faf0adb243d688,t,21000,63051,,5000003,2018-01-30 13:42:13,2
0xab48cdc56f284bced00df16c96db83894d0e9ff77b738b36cf8cee1b82107bee,t,39512,102563,,5000003,2018-01-30 13:42:13,3
0x0719ddc4445b3dedbff224420b7fed4daf11b76f5a84e7e950606069e4e9f6a5,t,21000,123563,,5000003,2018-01-30 13:42:13,4
0x604e34d1b27e3290463458bf87a7fcce0da491510b36ca88e45ac2ece5f24884,t,21000,144563,,5000003,2018-01-30 13:42:13,5
0x85ba552c15e5c93f29f0029fc836b2ad765004273cdc3fcecb4d6f5917fbc913,t,21000,165563,,5000003,2018-01-30 13:42:13,6
0x986d4bd09b24173cb6bd3c353d02ecf0d0c49c2b1b306ff020eb5ee795e92e0d,t,21000,186563,,5000003,2018-01-30 13:42:13,7
0x32f0547ed91c3b5dac1cc6c5d3534e20436a92070539b99567c98a36110ac56e,t,21000,207563,,5000003,2018-01-30 13:42:13,8
0x0aa765672b4a8ad2dfe1c8e34481a8bc73a57d51a3df0cfed33049ff302911da,t,21000,228563,,5000003,2018-01-30 13:42:13,9
0x359693014d34f0fef66bc11af22090c9e19e987d1250645f0e6d17243b95367d,t,21000,249563,,5000003,2018-01-30 13:42:13,10
0x39d274cd3e72acfda32743870220715aa770e2d27c4e413c7edf81325f89b92b,t,21000,270563,,5000003,2018-01-30 13:42:13,11
0xd3a6e87a2fc917f183ec38667749ad3c871b2324982b96c7e9ef653340ea8d1a,t,21000,291563,,5000003,2018-01-30 13:42:13,12
0xcec71e50c8a1f3a60db5d591f698e6231fa7f0fcf8656892374d55f58967204d,t,21000,312563,,5000003,2018-01-30 13:42:13,13
0xd2af3443887fab0ef98bf0b689080f26fedab459dab4ba00a94bc2dc6d0b3ee1,t,21000,333563,,5000003,2018-01-30 13:42:13,14
0x7dc3c2880d0d5dbf86b9bca8326d1977c8c9c0d97e89e37a7b0c9ace6b2ecb5f,t,21000,354563,,5000003,2018-01-30 13:42:13,15
0xc5c6504984da28ccc8b19afcb5395cd1bec2f2e8c4ca41c8d0400398a2d539f3,t,21000,375563,,5000003,2018-01-30 13:42:13,16
0xa4e008c6fad50a43799f073c152a1053f0634d475611d1252b77363a4d225988,t,37091,412654,,5000003,2018-01-30 13:42:13,17
0x4d75de16afb7d266cffaa84709cb32662e29cee085b53d43e9ee1c77404dd2b0,t,21000,433654,,5000003,2018-01-30 13:42:13,18
0x45228762415c7d208c4dbc9d9c279b816829fcf3a1596635b032e2069f4e3e4e,t,51724,485378,,5000003,2018-01-30 13:42:13,19
0x2175f1a433fb4b106e73df2afb29aba633c18f9894e1f55b9517828378933607,t,24090,509468,,5000003,2018-01-30 13:42:13,20
0x8f3819c128cadcd3c400de124077cf266586aa130c22ac1d14bd56c5c59f0f4e,t,21000,530468,,5000003,2018-01-30 13:42:13,21
0x3a0e96dae2b7c6ddf8e6b14f035fcbfc82e97504c22ada35550428c539e99312,t,140972,671440,,5000003,2018-01-30 13:42:13,22
0x4a693bae3cb4dbc703c248dee9bfd85b64e87e7f0e5fe634e3281b092ce731bf,t,51545,722985,,5000003,2018-01-30 13:42:13,23
0xcfcdba82d99dcba53c813c0d40b6bed51725fa83e4ec6e7fb3c5c3685693fbd7,t,21000,743985,,5000003,2018-01-30 13:42:13,24
0xb5cdeb5799ad035dad917249c9e4d2e6fec3db39120c4d0b4a44b3ed3938137f,t,37173,781158,,5000003,2018-01-30 13:42:13,25
0x996f54ceb16a13e8bc2dd316df67682cee5602e870808d2b93146a3b79bdeb9b,t,108370,889528,,5000003,2018-01-30 13:42:13,26
0x22098bdeb40c625ae54aabae2f661ef46eaf0cf2849e066b6f94f1d4d1cade74,t,37352,926880,,5000003,2018-01-30 13:42:13,27
0x046d71effd931c0148e74cf0e6977de50a6765f5b96a38f39b6b4bc5f604bd54,t,44162,971042,,5000003,2018-01-30 13:42:13,28
0x04295a56e6cb065fdf219d9bec862b1689c90f5d24e7c0a774170b883b285220,t,21000,992042,,5000003,2018-01-30 13:42:13,29
0x1c987ef293d8e9de1b82951dd09d171a32153c9dc114fcaddecaaf693b3266eb,t,21000,1013042,,5000003,2018-01-30 13:42:13,30
0xa2106d33ecce1064eb6bf538578abd611ca8ca4631a198afbcce3bc97a36ea77,t,21000,1034042,,5000003,2018-01-30 13:42:13,31
0x48b0b9094998f388a01e476790ca685c0d7f69e823092893a8943591903fcd89,t,21000,1055042,,5000003,2018-01-30 13:42:13,32
0x4cc51504433b61b04c37f4c90938eefbbc427fe3cf8e4e0c4fc81f56def24150,t,52255,1107297,,5000003,2018-01-30 13:42:13,33
0xad9ac234220b67061e0eb88ea3e95d159bb64975f85687cc881f90f9cca914f6,t,22632,1129929,,5000003,2018-01-30 13:42:13,34
0xda52b984b661aef43d1a24f3969f46202fa8a6bb352741273b14e8363381782b,t,21000,1150929,,5000003,2018-01-30 13:42:13,35
0x1e6e564764c9813f7f934032e3dc34c03b5856b45474aa79a8013dcde986397a,t,21000,1171929,,5000003,2018-01-30 13:42:13,36
0x24f876be70bdb2824a4b434c1798e59527ff91b36ba2272f1d5121d1eabd9e49,t,21000,1192929,,5000003,2018-01-30 13:42:13,37
0x5008d5967c55d2ab3177dc98e513b6291ea334bd692b3dcc49d94dab76a98182,t,21000,1213929,,5000003,2018-01-30 13:42:13,38
0xdb4eef0bf85b623f9f82abe90a8184ba4cff03bc853ae805ffcd05b8b5736530,t,21000,1234929,,5000003,2018-01-30 13:42:13,39
0x8df9d1dc778b01ecb9f19583c30052e752c105b68c29f6cb46e07a4f85a298ca,t,21000,1255929,,5000003,2018-01-30 13:42:13,40
0xae37c23f40e416fd8719952b480ef4c8fba16199c8d8f1a9e2be170c10235b05,t,21000,1276929,,5000003,2018-01-30 13:42:13,41
0x9ffd62fe7de46666e6782a298680cb04b6a99c3f8182262b66484d42039c9a01,t,21000,1297929,,5000003,2018-01-30 13:42:13,42
0x375c105336746d7bbd952866cf7282a3add8466d540dc1109a2e3b2aaf0a1f91,t,22472,1320401,,5000003,2018-01-30 13:42:13,43
0x8cec967a8b247a7e4273e6291cb815e9f02088adda929cb697d921dbd75fc44c,t,21458,1341859,,5000003,2018-01-30 13:42:13,44
0x7f9a839bb8932e8a81e6eb777be4e5c408ec774eb04a453a7b6c66de956b3885,t,21000,1362859,,5000003,2018-01-30 13:42:13,45
0xd282010bc5bcc5dd88c9998b103d720dc99fb188244f59794847cdd574d27bd8,t,21000,1383859,,5000003,2018-01-30 13:42:13,46
0x8d6c2c930c94c475430b7a88181d8a65a84290936e0eaf546b0f80a8ae2a93fd,f,53047,1436906,,5000003,2018-01-30 13:42:13,47
0x23fff2752038afa1cf9245a879acf9f8cd5dcfb64453c5c2e5ef3ae2676522c5,t,51789,1488695,,5000003,2018-01-30 13:42:13,48
0x06fb5aaec2f6ad3c6410f20d849166d8e1e3a86c835a63d3e4c9b9e3640d5d92,t,37692,1526387,,5000003,2018-01-30 13:42:13,49
0xaffc5ada413afbce432426ba1dd15dd5881c350bbe3a900c7256ed14d7526c75,t,38382,1564769,,5000003,2018-01-30 13:42:13,50
0x023367817f4183d3252f9aac3c984b13b2ada90b43a7072c871f0023e9bf3c04,t,45738,1610507,,5000003,2018-01-30 13:42:13,51
0xb16177d367a5078b8cf225d0ff69625119f740f88a43f76be1f4e5c3767038cc,t,21000,1631507,,5000003,2018-01-30 13:42:13,52
0xaf2ed4c8c1c893ffeb198b7e3a846acf805c81c5c99eebc48069bfacc76a37a8,t,29493,1661000,,5000003,2018-01-30 13:42:13,53
0x2535775a6a0734856822fb5fe70fb2eb1fa034c55015aad017141a443589405b,t,21000,1682000,,5000003,2018-01-30 13:42:13,54
0x3719042ba5954c0f73575aad1898d14cddbf5dcd56b1e678ed723668f4f2605d,t,21000,1703000,,5000003,2018-01-30 13:42:13,55
0x7609f86ddd0e5a8487d9acfa3a5712cc0531e46bc27bba4973082323d96ba7a0,t,21000,1724000,,5000003,2018-01-30 13:42:13,56
0xe602c1d809d414e5ef5b76b67dd694ce924ffe47a33532473a82c3c986bffc85,f,30000,1754000,,5000003,2018-01-30 13:42:13,57
0x58c712a5fabca2280627677b944300f3551e805964dd3496b69d345baf4bba4e,t,21000,1775000,,5000003,2018-01-30 13:42:13,58
0xada47f53117b82983017cc93894fb28b4f516f88b674d8eed7865b6f4fbd5520,t,21000,1796000,,5000003,2018-01-30 13:42:13,59
0xa0a1f67495b647cc24b9a8140582671613ac43507ac17b662d961b3daefdef3a,t,51654,1847654,,5000003,2018-01-30 13:42:13,60
0x6cfa92c1e6ac510ee29415cbaf789185468a325fe9b780230306ae7cb730aabc,t,53762,1901416,,5000003,2018-01-30 13:42:13,61
0xc5ec2d1b2a0183575662b3028c720e0e41a8d6754be2258e10fbdb29f0d208b0,t,68696,1970112,,5000003,2018-01-30 13:42:13,62
0x7a63fe328a7435307ed1fb06111264ef8846813419f80f2a057ec6a57be27b9e,t,21000,1991112,,5000003,2018-01-30 13:42:13,63
0x3a2c62e21a7667a8774e1cf424373ff8bf6fddb4b6dc9ac526c37f43d02db488,t,21000,2012112,,5000003,2018-01-30 13:42:13,64
0xee488c465543cc05c20a35e38894dbcf3bc2d3ce1da25a4281c5b37fef8cbdd0,t,142836,2154948,,5000003,2018-01-30 13:42:13,65
0x12e600f6885525b76b13b5a4a58d9dc8536ac8fd1df97c3d5da9109636faf256,t,21000,2175948,,5000003,2018-01-30 13:42:13,66
0x15f507a65fe3eb894e5c47c3423ff229960d2dc801ca37a741b955de517a5aa4,t,22938,2198886,,5000003,2018-01-30 13:42:13,67
0xd2ec737ab98d1d6bf929c54cadd9730b7fd5f2c9875096ddc047f10661212281,t,21000,2219886,,5000003,2018-01-30 13:42:13,68
0x5060389ea5cf5c5f98e27a270385ae3cc7ba1cdd06278e676bf7adc958acc5cb,t,37030,2256916,,5000003,2018-01-30 13:42:13,69
0x819ad84b5d8f823134b205d9fbc8e1880d4fb26c836753f8205a35a721c5f213,t,21000,2277916,,5000003,2018-01-30 13:42:13,70
0xda832b5904017a959001988675ea3ac28a611d6c156271f97493bfdf5312b99b,t,71110,2349026,,5000003,2018-01-30 13:42:13,71
0x14092e82ddbc838d388d4294eab0d65969d37c67bb69353640316d2c7e8805b4,f,21000,2370026,,5000003,2018-01-30 13:42:13,72
0x878c47c9119d1334bc64dcee9b2c232cd03bae8fb647d0c81702488eb593c438,t,253854,2623880,0x705Cca8dE0c8B5C67493dD3ED39b11d4F0721b91,5000003,2018-01-30 13:42:13,73
0x8f78465d848fa9e5871e9d27554007d2ccd392bbff135af5b8e29e24051cb5d5,t,52886,2676766,,5000003,2018-01-30 13:42:13,74
0x0aabca35dffa77deb7ffc8b464d7290f52f8869330494ce7f43dc35c2fe8457d,t,92621,2769387,,5000003,2018-01-30 13:42:13,75
0xefda79a1198885de8ee5ff8d42525c2c2e839e64943db270ea9c09efb45c4bd6,t,21000,2790387,,5000003,2018-01-30 13:42:13,76
0x1cccf08c86b8a2fd30d3cc881df90810f491108af99c9084077359e55a4ba432,t,21000,2811387,,5000003,2018-01-30 13:42:13,77
0x3234d5ae83074fb24eac41fb6b602adaa09027a17641b43fed28c55dbf23945b,t,21000,2832387,,5000003,2018-01-30 13:42:13,78
0x30474199f08a8018edc89f9bb40ee40f582ef3f1845fe3844b9e9ba2976644ed,t,51542,2883929,,5000003,2018-01-30 13:42:13,79
0x4c49f820ce2bc04d0af3dbb480e6784e822b8bca68a7807ccc7899c7e851a19e,t,21000,2904929,,5000003,2018-01-30 13:42:13,80
0xe954c9690e048c75d25b5ce5f1e65722d45395ffcb1d636e01f5c398079598d3,t,21000,2925929,,5000003,2018-01-30 13:42:13,81
0xb2a7cfa6bcb39ed11e818b450cdf6360a5bb067e981db860fff2001eb6abb0ae,t,52632,2978561,,5000003,2018-01-30 13:42:13,82
0xf8a86bf35796b0128d555c13807770107dc18711988890c822ad05973d385417,t,53167,3031728,,5000003,2018-01-30 13:42:13,83
0xd0d0e5f33979ada6801937410e929fa68b1e1a7eabb4807779a0afa8957a3c19,t,51438,3083166,,5000003,2018-01-30 13:42:13,84
0x2e57e559011d9ca499b48b9b19b4022adcd091809b6a5ab4f35953f374ed9103,t,21000,3104166,,5000003,2018-01-30 13:42:13,85
0xf6bb6743e7fc1b4989eb7fa4aedab1b995ac2e5f0d598e0f53b620e6d13398e7,t,21000,3125166,,5000003,2018-01-30 13:42:13,86
0xbc804b92988a7e67c8a83922553dba8dd33bbeb53d58da799c7500074baea263,t,21000,3146166,,5000003,2018-01-30 13:42:13,87
0x4329da089eb6eddc645688a748edcd8e83ab7b74cc5d42fa9a80dffe3c2c356e,t,21000,3167166,,5000003,2018-01-30 13:42:13,88
0x7b138054447b757f80c91da43ab372d4179c96619b2b6b77e277600f186dd9b6,t,40843,3208009,,5000003,2018-01-30 13:42:13,89
0x2112ec1601ca048c04c4740f9a0874c0c67462802b875b57075fcfd05552c18b,t,38355,3246364,,5000003,2018-01-30 13:42:13,90
0x52aed240c8787aa0e014072487c4fa883dd9c99b6a71c3b99618ea317037d48e,t,21000,3267364,,5000003,2018-01-30 13:42:13,91
0x45f99241d4cc2b16eb7b6957a9fd6f629d692f9a41bec062be6ab7896dad0bcc,t,21752,3289116,,5000003,2018-01-30 13:42:13,92
0xb5b152fbe21322e2701d3bf354b10da72c006012fe5170d9dcef1450f6852fb5,t,22356,3311472,,5000003,2018-01-30 13:42:13,93
0xb0286ed0da75b92a9b9ff4f40386072af473cc860f761c9f1b943a7863625be9,t,21816,3333288,,5000003,2018-01-30 13:42:13,94
0xa8031c7c75add03aaa9a078d5c27cc6b3681f354a3c50610e6a5edb25f84e71e,f,24000,3357288,,5000003,2018-01-30 13:42:13,95
0x09041c4988c5d12aacd75a28bc630ec45b603825ca442d1d68495dfe444b51fd,t,36792,3394080,,5000003,2018-01-30 13:42:13,96
0xb06ae12a422c1c5029b4f6c7bc579e8d76770dc2964d8d2107d75d9fb58e7bc3,t,51411,3445491,,5000003,2018-01-30 13:42:13,97
0x3a111f87473fa21851389c70641740a83dfd7777158d6d0dda6768f4e2ccd56d,t,21000,3466491,,5000003,2018-01-30 13:42:13,98
0xce17ae18ff3e35091b8fb9dc28c9f0d1e42c9b4aa332eec22de17984c82507ca,t,55843,3522334,,5000003,2018-01-30 13:42:13,99
0xfb40d7741dcce63e561db8f54cc831e4f760859d77c153509881617900e1c66b,t,21004,3543338,,5000003,2018-01-30 13:42:13,100
0xc5a80e04367438306341f35c36b9d4b7d61d9bab76abf586cc419a25ae5b92a1,t,23519,3566857,,5000003,2018-01-30 13:42:13,101
0x03e228516e83ec9a455dca0c9eec569a085dd49182238ff6111c5b7aa396b2b0,t,21000,3587857,,5000003,2018-01-30 13:42:13,102
0x74e7fc0d763e8abcd85705b39cc5b3629a65fcba5439fe73c4fbe30848d214b6,t,21000,3608857,,5000003,2018-01-30 13:42:13,103
0x41a64c4d6ad449e5483114c6e58cb271981024472bab895a707155ae681f057f,t,21000,3629857,,5000003,2018-01-30 13:42:13,104
0xf74877645b9b050fe6073cd0f0591e7394a2c2bbc567a3446bd4a24ba4f1bb1a,t,21000,3650857,,5000003,2018-01-30 13:42:13,105
0x5252529b7101ed00bebd2a69a53667e7128724482255e1c605fad05d834aca4c,t,21000,3671857,,5000003,2018-01-30 13:42:13,106
0x67e5402f19b7142a3707ecad64f594fbcd5c0f0c33326e94775a7d8ed3e8c45e,t,21000,3692857,,5000003,2018-01-30 13:42:13,107
0xa99b0afe54e3342f2b21a49000d26927201385c894ad90c59237fdfcf3c9401b,t,36935,3729792,,5000003,2018-01-30 13:42:13,108
0xece5162dd180365936b0099885bc60bdc0191167ee2fe7579c65fecad59ae85e,t,52571,3782363,,5000003,2018-01-30 13:42:13,109
0x19a601793831a20f6ad5327bf327f5082902b547d22e94f0d66e025e7583f4fb,t,64725,3847088,,5000003,2018-01-30 13:42:13,110
0x471d53ffd619f772670b3400a537c31796435c9b03c18073f59b27560a9c08df,t,37460,3884548,,5000003,2018-01-30 13:42:13,111
0x0ff7b063905d9fab7b2408439a6489d445a9ebf52d28042c1c47765b575df904,t,21000,3905548,,5000003,2018-01-30 13:42:13,112
0x143e03470370143ee665ab5e5e55d4ba5ae2d54631329660390d8aff25b31048,t,29493,3935041,,5000003,2018-01-30 13:42:13,113
0x7a093215ffeb473e14abbb4b8bae5c16d24ab06d539b894f98acf84953063dbe,t,36406,3971447,,5000003,2018-01-30 13:42:13,114
0xd7769dd0614556a294a398d62065ae668e0891fa339979c207fbcb61491cddee,t,44310,4015757,,5000003,2018-01-30 13:42:13,115
0x6d9385101ac9d358bdf75d8e3441926de88316e1b93d01e547697a9ec57a2ccb,t,21004,4036761,,5000003,2018-01-30 13:42:13,116
0x97762bde9ec2926014e05c4a76fc46e38d1322a0804d3951b8c11cfeb82c552f,t,21000,4057761,,5000003,2018-01-30 13:42:13,117
0x2a3de33b54b6da8f5d2929ebfd3ebe294f4dcb9dd6dff41f257532971166bc4c,t,21000,4078761,,5000003,2018-01-30 13:42:13,118
0x7c80626919a0ee2f55d93b833e6c3335a0657ccc4a4f9e81073e8b2181ac6d91,t,21000,4099761,,5000003,2018-01-30 13:42:13,119
0xce1b182fa4b9df02f80b7f64c2ff6a6dc63689159aad9602e1685d47cd56d97d,t,21000,4120761,,5000003,2018-01-30 13:42:13,120
0x21fcdab5c7d9a5b3492aacad5057912196d21294bca542afb4ca3543a3390b59,t,21000,4141761,,5000003,2018-01-30 13:42:13,121
0xd59d510a405989656df63ac2e883c2e406a2c8b267936e902f064f65c6f66d70,t,23167,4164928,,5000003,2018-01-30 13:42:13,122
0x08f87e89a2d2d6493d3502d529df3f37a9d864ea283e307690ba5e128bcea1f1,t,21000,4185928,,5000003,2018-01-30 13:42:13,123
0xfbc016ff613e4ab8163edb8bdbe6930a6b90add6ddcc24386b41ab3140dc96f1,t,21000,4206928,,5000003,2018-01-30 13:42:13,124
0x483248a964320743e0de2162d879a7f00f8dfd321156a773fee48289efcdbcd0,t,21000,4227928,,5000003,2018-01-30 13:42:13,125
0x48d239688dd824056d9c727bac008c2262b31c9b0e226862f21dc676caa566be,t,93242,4321170,,5000003,2018-01-30 13:42:13,126
0x5a73246e91bffd754898faa64aa7ac426f8fff209b68d24554f36881cd7e38e7,t,57606,4378776,,5000003,2018-01-30 13:42:13,127
0x39e037c5bc09b5f5cb9a69e890db6153e5d6e38c5640774285bae59b0e3277e3,t,39069,4417845,,5000003,2018-01-30 13:42:13,128
0x58b6808a1bc470994396eff661316d36d0ca06beb2a52f2ed0df7faf4ec4af5c,t,93050,4510895,,5000003,2018-01-30 13:42:13,129
0x6e046f04c07e9b7fc132587994622c80f24f82f7c84cd39d789c50202a58986a,t,21000,4531895,,5000003,2018-01-30 13:42:13,130
0xe4ac48313918bef01fa8cc0d64b12cb6929a2b45c716ca053f5463d28ddb13dc,t,21000,4552895,,5000003,2018-01-30 13:42:13,131
0xca7a8185e12a3e033909f54f186f37cd5648d6112b33557693dca533a6050fa6,t,75156,4628051,,5000003,2018-01-30 13:42:13,132
0x288255373ba7a8e688dff615c151f48f4723414409e15a46adcb90b2867fe2d2,t,66316,4694367,,5000003,2018-01-30 13:42:13,133
0x328c20ed3204119a1ee0586856f8128a4073ee41c18685bb0fe7a539720cab69,t,37150,4731517,,5000003,2018-01-30 13:42:13,134
0x9f70bb8f3d846ab30c18132b8e3792c14237b21200778d1de8e2b272515812f6,t,93242,4824759,,5000003,2018-01-30 13:42:13,135
0xb1ea5be3196635732c6b44405ad66f5276e4acd62aa19eeeadd25a428219f0d8,t,23028,4847787,,5000003,2018-01-30 13:42:13,136
0xa92c43f47333a1d93afa0362aa74943ae697a1623993abe8b658b3520e08dd3f,t,93178,4940965,,5000003,2018-01-30 13:42:13,137
0x58fa75976db7b20e7bf1508406e428c4597e56af646c5f51b99e95c64df65f86,t,93242,5034207,,5000003,2018-01-30 13:42:13,138
0xfe291233989e474188113c1d41f087090ea1ec2ce644a0244c6ea815774d91d6,t,45598,5079805,,5000003,2018-01-30 13:42:13,139
0x1e4a15b567aa03b7c1e0049f0dde795713bb9e59b839b0182d9f6a4a0b6fcbd2,t,51560,5131365,,5000003,2018-01-30 13:42:13,140
0x1fa6366cb5a76c778acbd91b136a66a5bd7d5d1783db9cda3330ca41ab3d45bd,t,45382,5176747,,5000003,2018-01-30 13:42:13,141
0x011538df0356b0b325a50d55ceb26bd7db75cf3641f0525348a2f797765dea75,t,21000,5197747,,5000003,2018-01-30 13:42:13,142
0xd4804f12c8b404c88e4f18646ca2a51ac193e3a21532e2e6058d4d8d740b04bf,t,21000,5218747,,5000003,2018-01-30 13:42:13,143
0x00731980141653afdd7224b75117f8357efedec548a1f785aaac7b7b778a1bfe,t,37746,5256493,,5000003,2018-01-30 13:42:13,144
0x379cf729bfd6a1f05af9ac47fce96dbecfabd5818cd8589e0f27895ed919d30e,t,38316,5294809,,5000003,2018-01-30 13:42:13,145
0x039498b1b3534d2a3a8896b1f502643c1af969d0da9baa64781429f28c149391,t,64725,5359534,,5000003,2018-01-30 13:42:13,146
0x3821531c80cce159b0f98f28b8f70c248fca32ace2125fdd44b2a1a87f08c04e,t,45971,5405505,,5000003,2018-01-30 13:42:13,147
0x161a157dbb14c84af9dcec5bed32af11541b26bc161c4d027121a646cd0027eb,f,23717,5429222,,5000003,2018-01-30 13:42:13,148
0xc3f1e9dab82b42b63099e596854e2c6b03eeebd9f39dbf1ffaad8c5c06376cd1,t,92794,5522016,,5000003,2018-01-30 13:42:13,149
0x8d7421be48efa7c19911bc36d3581e3cd2f0ff6a8385d4413dc170756a385609,t,107986,5630002,,5000003,2018-01-30 13:42:13,150
0x8d2091ffb1ff47c2704c9168135bb8322f68358edf8fe99262c3622051c1a2e5,t,33021,5663023,,5000003,2018-01-30 13:42:13,151
0x4114a10af07c345e37c22fa7330c377a12c48ab969977cb35746ad8079440efb,t,37964,5700987,,5000003,2018-01-30 13:42:13,152
0xde9d2e99e72aed775b3bfbb45bd768f7e8440748aa0676dfe3cd6864ab03e14f,t,93370,5794357,,5000003,2018-01-30 13:42:13,153
0x0fac514bef1d819d25028090c104c5949c015f3eaa8fb7a4c6f866c2ae6e808e,t,79985,5874342,,5000003,2018-01-30 13:42:13,154
0x7fd771f48a1a6103de81bdf4369509fc8810af97b80406d4fb89d2d18c4b68fc,t,21000,5895342,,5000003,2018-01-30 13:42:13,155
0x82a2c6bd717ecb6ab97c50d6de3956a2ce1ac48aac9214d7f9ecbf50a4ef5768,t,21000,5916342,,5000003,2018-01-30 13:42:13,156
0xa539675af3250eab58dd9e1618246f4c0f90e6a11cb8db95aefc6e3e53868a76,t,107986,6024328,,5000003,2018-01-30 13:42:13,157
0xdd78e208645030a0b97183cd67a951f13042da687b0952718241357bed213405,t,108114,6132442,,5000003,2018-01-30 13:42:13,158
0x4760b373367171d1018c46f751258a18f40c2f34c57e56b07023aa8f6540f463,t,59354,6191796,,5000003,2018-01-30 13:42:13,159
0x80beb7803c5dfc51f7ebf1d8cb1cfbcfbfbd770a5c6660bdc5def4f5e6afd66e,t,29493,6221289,,5000003,2018-01-30 13:42:13,160
0xfb1c783e5d541b5a75bf5fb9513e1a70d925fce5aed9ba44165031a0f21c6d1d,t,21000,6242289,,5000003,2018-01-30 13:42:13,161
0x22aeb96efdc014d804f2ec6af885ce6c37a02a3f44a6cb4835fb9b3fd227398a,t,29493,6271782,,5000003,2018-01-30 13:42:13,162
0x3cb6065348fa3c9188c2e425c401623f4584c728985f7d0454c92ade70e51484,t,29493,6301275,,5000003,2018-01-30 13:42:13,163
0xbec074bc26a4e15c562e775efdf1a70f8c6c15038a8aad5f6a0a3c8796d4f23e,t,45512,6346787,,5000003,2018-01-30 13:42:13,164
0x4cf8720638024587a8341aca5816eba68c3e963bccc2cab06e778eea59568af2,t,21000,6367787,,5000003,2018-01-30 13:42:13,165
0x78fba2e263b71648ad042b581f25f73f3e583660ecdec045e3e46e4b7d9fc52e,t,59290,6427077,,5000003,2018-01-30 13:42:13,166
0x023a747f8b479d82bfa52d585f79c4bd59183b9f894740dcefd0b329d7c86f75,t,52240,6479317,,5000003,2018-01-30 13:42:13,167
0xa44d264f178a2e3259b8a2e3409f5d95952acf1f2ad8480ea1b8f74a9cda2cbe,t,47818,6527135,,5000003,2018-01-30 13:42:13,168
0x227472ab5277dd481c7fc88f4426b60dcc7c7fb7338ccffa8a9c090f01d8bf4d,t,37900,6565035,,5000003,2018-01-30 13:42:13,169
0xf66abab511c723ef3bcd1937e80684099ee5642d8e96736c4fde7afe99f1c8db,t,21000,6586035,,5000003,2018-01-30 13:42:13,170
0x2ad59ad91b51a0298a18f1fd6d95fb024f545939167712cd14abb8a2a7cf27da,t,21000,6607035,,5000003,2018-01-30 13:42:13,171
0x0c0e1bff04c51c3a2a3b213f99bd22d2c694cc6eff83ccef0fe01d469bf5ddb1,t,37105,6644140,,5000003,2018-01-30 13:42:13,172
0x1c1f9a2b26757bd28476a8ceb609633a18937732f7d3e136cd320587d098e52c,t,21000,6665140,,5000003,2018-01-30 13:42:13,173
0x5011a51660f10b76726d66bb9495fc794f6aed3f8c14043ba9c1fe160da99d02,t,21000,6686140,,5000003,2018-01-30 13:42:13,174
0xf040af9e23630f16bee7a784cbe23d9276e3cc29d425ea0f780494b2f17f8d9e,t,37947,6724087,,5000003,2018-01-30 13:42:13,175
0xa400f059be24d02e321313371e065c33aaf51663e954ac54b69be3b97666dd8b,t,93050,6817137,,5000003,2018-01-30 13:42:13,176
0x30eac4d765cc55a3a526481ea95857b3b741f483df84d3caac2212c53d9e2bab,t,21000,6838137,,5000003,2018-01-30 13:42:13,177
0xfa4f910553e1f4268a4840a617f0bb23c85935b4a50528bfb07259fd1af21bef,t,21000,6859137,,5000003,2018-01-30 13:42:13,178
0x2b53d714ab4ac1b1a8eaf67caa32be660080a51dc3d369999dceb11fe4c4a4e9,t,44493,6903630,,5000003,2018-01-30 13:42:13,179
0xd3ed9dc21e39b571bfa8c19866704cee9e7eedc5d0ff7ccbb041a2b4e17f966a,t,21000,6924630,,5000003,2018-01-30 13:42:13,180
0x7e42162cc76e8cf233b796e70a8030a757d41a19ab58c5a179e4ba09027ec68e,t,62434,6987064,,5000003,2018-01-30 13:42:13,181
0xa11f24421504aac55e18c77dec8e24f0954316f070438fd9b0108db092dcd860,t,21659,7008723,,5000003,2018-01-30 13:42:13,182
0xc1978884c31058685a439e4dfe31d136b9bc3cc6d7c185c11bdb61262a20c667,t,45967,7054690,,5000003,2018-01-30 13:42:13,183
0x7259ea68ae35711c90c66f5fc631db0c5bce564135b0a31001dce0a42e85b4db,t,37836,7092526,,5000003,2018-01-30 13:42:13,184
0xe7904029944d6500423a775e198ec1e7f2488b0861ade2dc86912c0ba0942861,t,45548,7138074,,5000003,2018-01-30 13:42:13,185
0x181ed2a975dbb8f28eb543854d0540cfae40b10f606551f888eae7f872887b4d,t,44493,7182567,,5000003,2018-01-30 13:42:13,186
0x8befa86b82d71dcb8f13fdd883a8a016348e3213fed827bb9e0b964a3a0da374,t,46087,7228654,,5000003,2018-01-30 13:42:13,187
0x6d97f85d3063eff00a2776e4cc6d579e0090a3f20ed6d44bf591d3d0d14aac8a,f,21000,7249654,,5000003,2018-01-30 13:42:13,188
0x6c8ea60380baeb5495719b84da69bf7163109bfabe7c6b11a2563c0e3d77fdee,t,21000,7270654,,5000003,2018-01-30 13:42:13,189
0x1f0dd088ddc0fdb8c32019b36c744e9d39c8c33dfefc5cead4c4d0992cea9187,t,94618,7365272,,5000003,2018-01-30 13:42:13,190
0x2f1a32cada43df77495f7bdb4e5ebc994d54e3462ba46c3d59c428552f49eb3c,t,59098,7424370,,5000003,2018-01-30 13:42:13,191
0xc1f4fdab43bd1e60d9558f516b0c5f1bddd14e622508f4753e2f1ae4f1e6eb75,t,29493,7453863,,5000003,2018-01-30 13:42:13,192
0xf8d278699a74d04fa9a27bf9a81cba4f9c8f7d2816841a1e17fe559d19f9d7ad,t,21000,7474863,,5000003,2018-01-30 13:42:13,193
0x1569b6fc20196b30d0fe355885e8197d48884420dfa6a0e869e942ba2e856b13,t,21000,7495863,,5000003,2018-01-30 13:42:13,194
0xeee20f6e5e1fb72b3481b660f46db73ab0971de6b3e0a2ee7e4045ced7945b91,t,102934,7598797,,5000003,2018-01-30 13:42:13,195
0x5af9fa296ae7f546a80193113b5ea22cbfba4b8d0675b4b888f45558d102aee1,t,93306,7692103,,5000003,2018-01-30 13:42:13,196
0x9bee4f51c242c9f4f4194779382f1b4640acd7769cae3736d740ce7a9ec64645,t,164716,7856819,,5000003,2018-01-30 13:42:13,197
0xbb9611130853133eb37a476f94d037172690731b18d606d4f77343c22d6086bf,t,40806,7897625,,5000003,2018-01-30 13:42:13,198
0xa60a7cd7d4d2f3b69aef92ad03bf9c5aac27ff49d5a53ef7c91db095ef1615ae,t,21000,7918625,,5000003,2018-01-30 13:42:13,199
0x31bd046b29bad55d9a9d413d022d22831044fce243830f471e7cadc0cfc35407,t,21000,7939625,,5000003,2018-01-30 13:42:13,200
0x0efbeccad225a8fd0a3feabb875ac4ae901846480410888770b8fb17cac26eb1,t,44890,7984515,,5000003,2018-01-30 13:42:13,201
0x20b55acbacda03e1c112635af743e9a02546a355d98f6118a1c0ca0c533b34dc,t,21000,21000,,5000004,2018-01-30 13:42:55,0
0x6015b5f5f29fce66d10f1bba35ab99b0111235baebf649d7cca8a154054d68ec,t,21000,42000,,5000004,2018-01-30 13:42:55,1
0x62c7593f587e920b1f9739497330c5d57d4b439593aa1fbe933fa90ef8253f4a,t,143081,185081,,5000004,2018-01-30 13:42:55,2
0xf0c9c5ebbe03d474f5bcb7eafa15ce5b10de6a61522ce1ef8edaf0d5cae8ac8d,t,44854,229935,,5000004,2018-01-30 13:42:55,3
0x76c2448408dbb59275314c31cfcbec306546e9c4ca445bbd8851bb75ada9a72a,t,21000,250935,,5000004,2018-01-30 13:42:55,4
0xa01f32a61a83ef60f69fb392d59e49f76562901f9ae668fe6b8f7dcecc77e3a1,t,21000,271935,,5000004,2018-01-30 13:42:55,5
0x97e6986b4740a44712e06b709fcaf048e4cba9ef371ba39a68836a513f18ab3f,t,21000,292935,,5000004,2018-01-30 13:42:55,6
0xd748fa85cf1e4d511f00d665d8c26816b3213564721329c34a0781a9908640bc,t,21000,313935,,5000004,2018-01-30 13:42:55,7
0x7e4105de6b24bf51d03ed45d3aa3d0eed87448d33de6b4b0c679e548700e1e57,t,52396,366331,,5000004,2018-01-30 13:42:55,8
0x0ea22b5c15b6f329f7ff5da01fdbb3a9effd71e7ccb076f46784315735301169,t,21000,387331,,5000004,2018-01-30 13:42:55,9
0x28508e100f62b79a95613cebb73d9e84a96c4f5a9805670e91fd71d24fd195ca,t,54929,442260,,5000004,2018-01-30 13:42:55,10
0x103271488edb09a760c8e6bb973228b75d364b8899d63a09aaaba8edd4e89230,t,34470,476730,,5000004,2018-01-30 13:42:55,11
0xbe42091bf1f734a6594f7d6844bf6c68636d044c92bc6600f552819a8fe2ec7c,t,34470,511200,,5000004,2018-01-30 13:42:55,12
0x8de1a6356424693dad0de2ed9750863f395ffee79855668bfd43ee3dd92b736b,t,34470,545670,,5000004,2018-01-30 13:42:55,13
0x5294c05c056b8c8ea308cc7b2dc6491e874030cf0f2adc2888eb1b31fbf526cb,t,34470,580140,,5000004,2018-01-30 13:42:55,14
0x9e89864d0ca07d9432f684a8fa446816fbc25cd8512c87a4465def2cc0c00543,t,34470,614610,,5000004,2018-01-30 13:42:55,15
0x3e5d9e52cd71c6678c5d4a132c2d1c4dbd45a3f6933f7da43e318e22afde7ab3,t,34470,649080,,5000004,2018-01-30 13:42:55,16
0x6299d85fb614e865dfa7ed0802b73281e25e593892aeb8e84773fbeabaf1adc8,t,34470,683550,,5000004,2018-01-30 13:42:55,17
0xc3ac64f21fe76990904c8679ffeca3272e91f9db9cb8c7dac218c7a494c6de9b,t,34470,718020,,5000004,2018-01-30 13:42:55,18
0xdcfa68bb4e687f73ccb56058ec8a309b87e878283817e5753b703d1694e299f9,t,34470,752490,,5000004,2018-01-30 13:42:55,19
0x9c3d420ca7e9d940313b371a5371ebba9cf8330be4847286e06a06e72ba61564,t,34470,786960,,5000004,2018-01-30 13:42:55,20
0x381f578259623b7dad305373032ffc6b5052f02dba1a2d6738cdf6ca740aaaeb,t,21000,807960,,5000004,2018-01-30 13:42:55,21
0x24f9bd07409410e63fff211407bffb9f272375b55974d1b8ddd4f3671e437cf7,f,21064,829024,,5000004,2018-01-30 13:42:55,22
0xdc10fdd6d58cb7d480796cbc5530dfa8f578b2b308e71fd3459a508d98f44539,t,24419,853443,,5000004,2018-01-30 13:42:55,23
0x32e65a209e216e361320ac2ef9c39813ca8dbfbdd3e204b0fcba48eee5306a77,t,52859,906302,,5000004,2018-01-30 13:42:55,24
0x74e9af315dc9802387afdd0538f48b9a3c15ed8282fc11833894d9a0434b6ae6,t,21000,927302,,5000004,2018-01-30 13:42:55,25
0x61378105dac50a13525ec70c2703c6d61baad6b0caa0e2f6f0a0af003ab5e07b,t,104678,1031980,,5000004,2018-01-30 13:42:55,26
0x51f7bbec2380ea433d90eb7148d53b53d26d64655290b6eeba19c10b69b2e7f3,t,140972,1172952,,5000004,2018-01-30 13:42:55,27
0x473c3334ca66ec77a13c32a37e9b230e7dd76763f3de271ea1867ae52c77f7aa,t,37072,1210024,,5000004,2018-01-30 13:42:55,28
0x58116ffd4ce79ac1befde748e62fe3d6116d0b8f72c23bddbb912a6953469986,t,51851,1261875,,5000004,2018-01-30 13:42:55,29
0xad5540dc2a55477155549f52956f0f7a09c25db6d744c25e73b60363cc2953e9,t,21000,1282875,,5000004,2018-01-30 13:42:55,30
0xa315e5644730e0f6cd9b097bb3c9b7b830e7ee36ca98d0b664ef1dd0a9cf3d02,t,21000,1303875,,5000004,2018-01-30 13:42:55,31
0x2127d9a8b1c0594471d44e56ddbca291d253ea1766b81a93c63e85a6cc388867,t,21000,1324875,,5000004,2018-01-30 13:42:55,32
0xf14fa2ff8fe99e6e3dd4632bf9f79477dec21b55bdab8fea52f4c2e7b8cdf2d6,t,21000,1345875,,5000004,2018-01-30 13:42:55,33
0x0a30fa578bc902be2f11c5b787d6a7cae8603b40bc547de5d27009151d0a7bda,t,21000,1366875,,5000004,2018-01-30 13:42:55,34
0x7c9fcad4a172ef513388f1578a4ff068b02907491ce86db8e296be72a49d6ac8,t,21000,1387875,,5000004,2018-01-30 13:42:55,35
0x58e90d3f2d0c2f8e4c729505b7caf98c8712bf2ae1a60a9f26770bf200fd5d89,t,59290,1447165,,5000004,2018-01-30 13:42:55,36
0x186defe93634f23941e749f271795f21257736747fee06bbb88cd79b1932cf62,t,45510,1492675,,5000004,2018-01-30 13:42:55,37
0x477d51d5f599351ab0a6846bc60420ce0dec3f0e9f19f3433e86a96c2ace8961,t,21000,1513675,,5000004,2018-01-30 13:42:55,38
0xb64768ba615d0066e637782e72092f18cdabfad70272213f94b66dd865f1585e,t,21000,1534675,,5000004,2018-01-30 13:42:55,39
0x2ac893dc0d4a333cda5b3aa60ec5fe3b4a30ee125700686641c21c60d408c77e,t,79701,1614376,,5000004,2018-01-30 13:42:55,40
0xdb61e829d73f49709566902b6f642c52647b316d1ced35dc782aca9dbad9b58a,t,21000,1635376,,5000004,2018-01-30 13:42:55,41
0x54056dd4a04c654b44d3e61643c5126af997d7507a4e0f388f5373f4b60740a7,t,48236,1683612,,5000004,2018-01-30 13:42:55,42
0x39e71dcb56fcdb1ff57e9c21290d2caca407ab762aacddedd0e36701e4e19636,t,21000,1704612,,5000004,2018-01-30 13:42:55,43
0x2c3b82b1282add895e44c169d250d41ba820fd0747c38351c83317ccac278cc2,t,21000,1725612,,5000004,2018-01-30 13:42:55,44
0x13743f7f645f31ca94142dae75d4223476e2b29606f1e92661021f502187bd4c,t,104678,1830290,,5000004,2018-01-30 13:42:55,45
0xe4f78efa88edea9b4265ba94a15b2022512bc0bba123e315e06d9955c07f9595,t,21000,1851290,,5000004,2018-01-30 13:42:55,46
0xbf9a0db6ba612de930049233623198477ad6ae0dd853cd9bdd018a637b909c72,t,21000,1872290,,5000004,2018-01-30 13:42:55,47
0xd62cab78bafd08327a3aa27055a120dac0e43f6ac5cf032aabfda68f40112660,t,21000,1893290,,5000004,2018-01-30 13:42:55,48
0xfeb9545d737fecdaa1a28fe81c4b2d723cc5914c7bc15f85ab77690c39f8ba60,t,21000,1914290,,5000004,2018-01-30 13:42:55,49
0x88f413d50af074ea5b13d60cd28ec45412d74edda805dd8bce914744618923d5,t,98748,2013038,,5000004,2018-01-30 13:42:55,50
0x0c95ef57bbfc8c6fc8fd5c6a3dafe2991ce94ffa7149a24d778dad846837b851,t,21000,2034038,,5000004,2018-01-30 13:42:55,51
0x71869706abb7ea1f2a9da8b189ba1bc2d9026653839fc2c7b10043ec2dc4a7b1,t,21000,2055038,,5000004,2018-01-30 13:42:55,52
0x975e986290e37b14596111bb1faf00feddc76299019aec9544af30b6a1d41b7e,t,37950,2092988,,5000004,2018-01-30 13:42:55,53
0x94080dd7e8f4f9d0dcaf5cb5b92335ac47dacb4746c7bd55daed5103cd9db84b,t,21000,2113988,,5000004,2018-01-30 13:42:55,54
0x9ff2bf67d066549d542d2068e8b0c48d0761eab49ff94a0d00a50fce245c95a8,t,91194,2205182,,5000004,2018-01-30 13:42:55,55
0xe45440075993b9a2144cc8168f916df78c8b9ad1c627fb221d59250c9d912023,t,45611,2250793,,5000004,2018-01-30 13:42:55,56
0x9520feb1064e6c6e626c8cb68eaef4ab472a9b3ee20dc1adbde8079a3990f76d,t,21000,2271793,,5000004,2018-01-30 13:42:55,57
0xb8faf6e155c070ede77feb3dc8b7116081d646ff3d3c3328579e7e9511257301,t,21000,2292793,,5000004,2018-01-30 13:42:55,58
0x78160d196cb0b5c8f5d314c2f02e0ed12d2f23597b708a1a8b52d31784a3f77e,t,21000,2313793,,5000004,2018-01-30 13:42:55,59
0xb5246e41b3b365974b49527d7fc8a3c74cce72515bd3c0effda1f2062abebe6d,t,21000,2334793,,5000004,2018-01-30 13:42:55,60
0xe222a38928967fc5037240bc2673126249779607206ac1f282b793579e9d7406,t,64725,2399518,,5000004,2018-01-30 13:42:55,61
0x660e5b608c03fdff61ffd7a82a51052e493cb0ce20cd1adab409f8f28e2d4ce4,t,49725,2449243,,5000004,2018-01-30 13:42:55,62
0xabc6ab387e8411fe032b9257b1d35afe317f355ec4e7a321057bc94baa49e799,t,21000,2470243,,5000004,2018-01-30 13:42:55,63
0x9d42c6f33d4f6c4d3c3ae83b1b40a93ff015d0f38a058ea1ef4856159114628f,t,33177,2503420,,5000004,2018-01-30 13:42:55,64
0xb4d52bab388921e041f4cb049ae889da60b0368cd5035789972c5b1a3250cbe8,t,21000,2524420,,5000004,2018-01-30 13:42:55,65
0x3f9fe647dd7247333943eb754037035cc881923035c5224ba0d687e91f3bff4b,t,52886,2577306,,5000004,2018-01-30 13:42:55,66
0x13eecd7b76c2d8ae1094557690a904f052977575e2e1f73b921d465d17093ca7,t,79701,2657007,,5000004,2018-01-30 13:42:55,67
0x83e728683db1e48813eeade4ea04ff8338401ebf6cc0c6dc7a98e65dfae9e7dc,t,51789,2708796,,5000004,2018-01-30 13:42:55,68
0x04f73f938d27f16ad9f6c92f533d6577df3e056c09462a7ee9f5bde3803ff77f,t,51831,2760627,,5000004,2018-01-30 13:42:55,69
0xb2ded8cd10c925f6b8f6acc219f5541ff1a5d51f63426f53fc56e00605479282,t,21000,2781627,,5000004,2018-01-30 13:42:55,70
0xb457e8bbf8f6d27c2c2a437e0081491eabaab9e4723255ffde8b0a606e9e1328,t,55907,2837534,,5000004,2018-01-30 13:42:55,71
0xcda20cae7b3bd9d42beb17c46dc98f25838ea8c13508cbd694dfb4f186bf7949,t,102934,2940468,,5000004,2018-01-30 13:42:55,72
0xe8d8744c4afc3dbd4b1592e68508ede21e4cc0dab759cd8b133a96f9af428f08,t,22170,2962638,,5000004,2018-01-30 13:42:55,73
0x252539955dbf9a4d358fef3ac1b6334433a45a874a686db882e7d96ee6492a51,t,21000,2983638,,5000004,2018-01-30 13:42:55,74
0x2aa7d34cf21d0512f826d7eef8da1fac750d806c4426a1aaa449bbd160495fb4,t,21000,3004638,,5000004,2018-01-30 13:42:55,75
0xbc6baf5aea707e78b55ac4cbc2a642e69bf9446faeb1cd59f4c8de5323e73d85,t,21000,3025638,,5000004,2018-01-30 13:42:55,76
0xe6dd56031a31daca20c9e60869be0d81b69bf34bf15db54fc91e58c968bb25eb,t,21000,3046638,,5000004,2018-01-30 13:42:55,77
0xd87dc54b95078dc9cc5c684eff9db01e5044b143ac58596abd597ef583128b2f,t,29950,3076588,,5000004,2018-01-30 13:42:55,78
0x0ec0341693aab730e312c659f1fc7f36cabda69f617780bfc93a5d49ba6e6e88,t,21000,3097588,,5000004,2018-01-30 13:42:55,79
0x2589c2c9a78cfb4a94567c8a90273c65b1150ce7b2ea4d33a717cd2c92cc5803,t,51537,3149125,,5000004,2018-01-30 13:42:55,80
0xaf31fcdc79d23d3c8775df40423c52f4be950ab532db18f2025a719d594f87d9,t,37158,3186283,,5000004,2018-01-30 13:42:55,81
0xc3283149259ee2ccd2c5fb9739edccfb248559a4bcd99883abfd94203c6671f7,t,125276,3311559,,5000004,2018-01-30 13:42:55,82
0x13d1d5580414772f8dbeace4318314b4aa47860615e72dfabce31348d26849c9,t,21000,3332559,,5000004,2018-01-30 13:42:55,83
0x6cf1272e617398bfb5ed7e9b632377d93b046ae669eff806f8f8166a1e626450,f,25200,3357759,,5000004,2018-01-30 13:42:55,84
0x3fa787ffab794f64962b516a8c0766ec4402a733898d1f1c4337343d21bff670,t,52460,3410219,,5000004,2018-01-30 13:42:55,85
0x29c7b0f65a785adfcd9c6761deac21b2fe5561fe6c83d0dbb0c34d462e547a6c,t,53233,3463452,,5000004,2018-01-30 13:42:55,86
0xaae29ca3b0850e185227320b710a14bcc87d9b03f7d96a830accec74dc95c941,t,102934,3566386,,5000004,2018-01-30 13:42:55,87
0x6ab675288dd29c743ccfaf9e3c7232e3e85eb892876d47158482af1b92464407,t,34725,3601111,,5000004,2018-01-30 13:42:55,88
0xa86eded91a5ed7715093bf539f7e22193e7006c39329a1af74f56826b5f902d5,t,21000,3622111,,5000004,2018-01-30 13:42:55,89
0x84bc56b08d971b65fdcdb3aa652bd25cb81140aea17aa3af6d1a8a4793a3a428,t,21951,3644062,,5000004,2018-01-30 13:42:55,90
0xd0960c3d742a21016275b74ce1739319a793aa829c329d54044e66d56543a635,t,21000,3665062,,5000004,2018-01-30 13:42:55,91
0x5b1aefda6b37a180355be6a5ee24aba0c99d7f0b0704730306cdfbd55006cc70,t,23382,3688444,,5000004,2018-01-30 13:42:55,92
0xbc22550f5304da28e9ef1cfc5f739b675adfd7b59179cb0453c1b9f9674295b1,t,21000,3709444,,5000004,2018-01-30 13:42:55,93
0x49f9fb65bff42e7b9729efc076379f4be2d83aca04390da1aefe02587557bc8f,t,21000,3730444,,5000004,2018-01-30 13:42:55,94
0x18b1ab70d38564d749658980b423c3e771d0482a117e10508d2bbfc70feef1e3,t,52129,3782573,,5000004,2018-01-30 13:42:55,95
0xc4159ed1ed9277980acf6f1ab9a78a8915ef1f074489238f5a573d4b346e0d5f,t,21000,3803573,,5000004,2018-01-30 13:42:55,96
0x0a7504cb1d9e7427d3feb1ce16f3ac24e4b83b8d203255c93c260096376b4f69,t,21000,3824573,,5000004,2018-01-30 13:42:55,97
0xeb8a694be309c8e9342693e6878ce096c6590c8e08c1ac1368bab2a0372315a0,t,37387,3861960,,5000004,2018-01-30 13:42:55,98
0x50aa4ada085d33151cd7c42f3e5379858f057b05056208783df975679701192d,t,21000,3882960,,5000004,2018-01-30 13:42:55,99
0x7f362ddfdb3d0f09b777c5bdf01cd0bed7d6693d3798f4bc2d86d262111b7627,t,21000,3903960,,5000004,2018-01-30 13:42:55,100
0xa7a105f86cc1868a01d841b6c5a8c72108d08cc124c5645b3cf9634e80b3dd89,t,21000,3924960,,5000004,2018-01-30 13:42:55,101
0xfb34ad8933321972b6d27c52289085235acbe17868d2c3400ae33d75634ff650,t,31005,3955965,,5000004,2018-01-30 13:42:55,102
0x20205993d9b0e075e5aea8445e97f22604eaff59e834087f17fdac982cf957d4,t,48171,4004136,,5000004,2018-01-30 13:42:55,103
0x5afc529770b5074212d1520abd012d8f2f3ecf5ab489df70dac02ea1c36588da,t,51617,4055753,,5000004,2018-01-30 13:42:55,104
0xd9c018db3b3dd431af614ac98531e32554b9c97fe0e94020ee8f96eb4ee9f969,t,51606,4107359,,5000004,2018-01-30 13:42:55,105
0x71b6e244009c1dd38b36e3b98ab56df83d42612789e0b4fd05de2d5ddceb02b2,f,51251,4158610,,5000004,2018-01-30 13:42:55,106
0xf7dbcfe648d01accab6feb2d0c3a6e8b86ef76f886476ffe7769811294a1bb04,t,67741,4226351,,5000004,2018-01-30 13:42:55,107
0x578eb7e55b4031a9ae4912163eb5d21e102d858929bb971a9b67c8a2647ce155,t,21000,4247351,,5000004,2018-01-30 13:42:55,108
0xb947336f652a827ad692221fa08a88ae288b1935cbee4394c1dc537fdf32d81c,t,21000,4268351,,5000004,2018-01-30 13:42:55,109
0xcb9f3a19b66e730f21dc11e8771a0c1ee588bafdc1ef3b4737caf458bf591d38,t,21000,4289351,,5000004,2018-01-30 13:42:55,110
0x7fac5fb65f5a7797fee1d79e224c601f9c935dd62188d5c5fb651038d423bb96,t,21000,4310351,,5000004,2018-01-30 13:42:55,111
0xf85215bf049c45a922278fc3906fe2a44ec259fb581148093f7644332a74b9fe,t,51877,4362228,,5000004,2018-01-30 13:42:55,112
0xe74cf22d5c10adbecb57dccce3d56076365532f9b11e1a9dbc35e00c24feae55,t,21000,4383228,,5000004,2018-01-30 13:42:55,113
0xd6d0ca3acc60c91bde90e87e98da1f7349b150fb0f3bf1c3505e4762d1e7f26f,t,45090,4428318,,5000004,2018-01-30 13:42:55,114
0x0c33b36f2662a6d184b8f79fb30c13b12b078c48e0fcc57da74d3cc03d6a234a,t,21000,4449318,,5000004,2018-01-30 13:42:55,115
0xe6492dfb654f486b7283e7b3ad86171ee06b7d63433653986560db44b662b102,t,21000,4470318,,5000004,2018-01-30 13:42:55,116
0x2fc783d9ec3dbc487fd4348696ab28209f5bcbbeb94f6945c7e0f6d43b1469ad,t,21000,4491318,,5000004,2018-01-30 13:42:55,117
0x8776d0b80dbc2550a61be6482ac04b1a19a1b8568e7d70216d33f3c6e3b96a59,t,21000,4512318,,5000004,2018-01-30 13:42:55,118
0x4d9fdbb3ae332addc64174d14a21b3348e09ac20cfe6f81a7ee8c197361b2406,t,21000,4533318,,5000004,2018-01-30 13:42:55,119
0xa762869861cfb5f18c2d37e28742287e2749f61014cb63b996f6ed200ab02b4f,t,21000,4554318,,5000004,2018-01-30 13:42:55,120
0x9f76588131aa5218609f650aa97f56fb37ef30a6f3364b4796fb687b397c3645,t,21000,4575318,,5000004,2018-01-30 13:42:55,121
0xe32c12731f22b299b3da3d8505b6e0296a040f1f12a9450a4eaab8011556c530,t,74063,4649381,,5000004,2018-01-30 13:42:55,122
0xdaaf5453fadf98668e906c0fdb8922b0c5868268173b2aee8b2900f30e417ffa,t,21000,4670381,,5000004,2018-01-30 13:42:55,123
0x725e470206036a578be5f68f2835e7e99d6a2eeeb74c34ae71721a139facf1d8,t,21000,4691381,,5000004,2018-01-30 13:42:55,124
0xad6d2ccfa3016b67d5fe29a73208c5e4fe2215d8866d4dec832e79da44dd99df,t,21000,4712381,,5000004,2018-01-30 13:42:55,125
0x51f46cac369e38b7d6d31917273905bbdfa0244a43fc25345d167ea9a9f3d0c7,t,144053,4856434,,5000004,2018-01-30 13:42:55,126
0xa46e67c0902c17d4e20e6949147a555d5b14c48ce65be05c1a30c4e25fb3a3cd,t,21000,4877434,,5000004,2018-01-30 13:42:55,127
0x193583967c687e135b523d6ab38bffef683ff0f5c57bbfe6816b75101542f861,t,21000,4898434,,5000004,2018-01-30 13:42:55,128
0xa0fa2711571c2ac6eeb0ecc4f87ccd44fff94794f88c7b205204dd5d6dd2ce0d,t,21000,4919434,,5000004,2018-01-30 13:42:55,129
0x81ff0ef1e852b22c87378636e720d0702f599f35234d2b593310302b5f95c372,t,21000,4940434,,5000004,2018-01-30 13:42:55,130
0xe18931839bc7c752ffe535158360e00db8401ebe17cbb7856ce88926f8b095e7,t,21000,4961434,,5000004,2018-01-30 13:42:55,131
0xf86ec902f7ce3efd81835083b88b87b36aa21fe308410b999516198a4a6411f9,t,21000,4982434,,5000004,2018-01-30 13:42:55,132
0xe4fa97d8114519a3a73d528afc9351d55658049c14c70088db8a45d06a98b1a2,t,21000,5003434,,5000004,2018-01-30 13:42:55,133
0x2363918a41f76d43f8696c767d0e9b06cbed0ec15ac6108f80685110ec4ac3d7,t,21000,5024434,,5000004,2018-01-30 13:42:55,134
0xb1a4919b28ee34a5072dc3f9cd2bbbea75cff39f58f9ef5be99c7037c8391922,t,21000,5045434,,5000004,2018-01-30 13:42:55,135
0x5f882eb548449440efa704b88deafb05408531c921fd719eda1bb33d93b4aeca,t,21000,5066434,,5000004,2018-01-30 13:42:55,136
0xe78d43cbe9384a0b16cc94864a5afcc08c5b28450bff8a22f005c1d2883f1f8b,t,21000,5087434,,5000004,2018-01-30 13:42:55,137
0x6ef9ffa6872d406ca69cbb7f6ed40ad1eebb7267e32d688bf4a815003baec32a,t,21000,5108434,,5000004,2018-01-30 13:42:55,138
0x0eef61a92a5743776d464cde148b643156a4d48122d30a4d2abb1a37a4a68368,t,21000,5129434,,5000004,2018-01-30 13:42:55,139
0xb782227ddb359d7351776eb02086d78d61a4c062cfe3417fa091611bc7fab8be,t,51783,5181217,,5000004,2018-01-30 13:42:55,140
0x127f02b11c063028cc067f95508c4b1dcce2bf1bae639b6cb2a62f22b8130c6a,t,21000,5202217,,5000004,2018-01-30 13:42:55,141
0x8275b0a2a626871fe295bc4bd7f34161db687a3531a8b93c9ec7daba083bce90,t,21000,5223217,,5000004,2018-01-30 13:42:55,142
0x1dd2ccf4a610c66c62ef2531a69921a3232db98229ad043665fdf05f5fa7fcfb,f,23128,5246345,,5000004,2018-01-30 13:42:55,143
0xd5c610227c92505f27b18c483e9fe5adcfe502726cedfd788e85c2373295299f,t,21000,5267345,,5000004,2018-01-30 13:42:55,144
0x85238fab1dc7768a32d86ef69ef80b2946446c9a73ef74c63d7c3a2bd58afb72,t,21000,5288345,,5000004,2018-01-30 13:42:55,145
0xf3c1202643bc5e239d2a1efeb1576bb4115210fcb0e4ba9310eb5ff2c7cedce9,t,21000,5309345,,5000004,2018-01-30 13:42:55,146
0x668e4429f223920d37a70b686080491df6aed812404182e56b02a3e68e29de8a,t,21000,5330345,,5000004,2018-01-30 13:42:55,147
0x9b87053a52b1c11241d50bef3d25e2d6cd4ac38d24e9246bb2123d46495d55d3,t,51955,5382300,,5000004,2018-01-30 13:42:55,148
0xc311bdb8afe4cdd7993c4a58da46b5eb4c2827bdc13d0bc41c450a53e2a9444a,t,21000,5403300,,5000004,2018-01-30 13:42:55,149
0x2d0097677d0603ccace3126b0bc9a1d7a5024ae8c32aa4b7bdc0d7c4243158d7,t,21000,5424300,,5000004,2018-01-30 13:42:55,150
0x4e89d00b5e084391c39309c916a2e7331e1b6d1af3abd4d881e9cd4a129fa718,t,21000,5445300,,5000004,2018-01-30 13:42:55,151
0x479c89da66717c8f8cf9bba2e07d69974e333ef22be2d8f826cb531c393572dc,t,21000,5466300,,5000004,2018-01-30 13:42:55,152
0x6292d45c39ce911ccd775fc33a79afc72ac4c765b198552702375d1048c6a33f,t,21000,5487300,,5000004,2018-01-30 13:42:55,153
0xeb769713f24079043aad3cfa5ed292a85a2c0b38395bcdb376abac569104664f,t,21000,5508300,,5000004,2018-01-30 13:42:55,154
0x02abe4710416545c4450bd756deb240732621807699968b5db65632c8732bf04,t,21000,5529300,,5000004,2018-01-30 13:42:55,155
0xbfcdca3b6b655a37d9832ecb64f301bdff7d786447c0210e93c4d6f56803caae,t,52524,5581824,,5000004,2018-01-30 13:42:55,156
0xc35c0842dfc12693050f2fe8627d377ead2cfa6194798dc8f7c60ca6adf18a41,t,52460,5634284,,5000004,2018-01-30 13:42:55,157
0x11d50210b187a314d3ed7ad285c6cb28fb1c892df142ffb22c8db6228077448a,t,21000,5655284,,5000004,2018-01-30 13:42:55,158
0xd199bdd7e5bd60874db85c848266e6083696eaf70576d51def71632f5d4c8bb0,t,21000,5676284,,5000004,2018-01-30 13:42:55,159
0x8f25d7b8a8b1217cc60af0bca48bd5e1bf6dd6b8d18114238ea800160e96fbe0,t,21000,5697284,,5000004,2018-01-30 13:42:55,160
0x872cc3413b9c11ad0815e88dca8484d7fb193f09642e641c1a2f36a286b85f4c,t,21000,5718284,,5000004,2018-01-30 13:42:55,161
0xe0f8b751b76baf1b8a4bfa3dfec99afeee49d544a12e4c11fbcdd906b3a6866a,t,21000,5739284,,5000004,2018-01-30 13:42:55,162
0x4f3dc2889197a6ab3e4f5660b8ecb2ddc22014d13dc3cf333865e5fd9bbcd878,t,36335,5775619,,5000004,2018-01-30 13:42:55,163
0x8c4a9bd3061292bc47343fc14507d1d18f0c1c1e22a78cd147dd5abf3c914f11,t,52810,5828429,,5000004,2018-01-30 13:42:55,164
0x0e20ac975c44f71f866edcc4302e3edbdff0eeacd9fd50891b085ef42b4adcd4,t,21000,5849429,,5000004,2018-01-30 13:42:55,165
0xa3ec6681568509f97a3621c2f99a5f9a6c27979583a0a694f048247fe2f3a8dd,t,55669,5905098,,5000004,2018-01-30 13:42:55,166
0x135e535f7d202953c9b92d52a80b393d2800d6dc2251410857d6bc56e1ce57e8,t,21000,5926098,,5000004,2018-01-30 13:42:55,167
0x2947371728f4c7efa0dfb879fc3994140a40e9fdda2805ba0d1013b30bb66262,t,21000,5947098,,5000004,2018-01-30 13:42:55,168
0x5e732a0734efa9ad48c4648ff2cf51e2b907ac471ed8fcb84ff7fbceaf33b0e8,t,21000,5968098,,5000004,2018-01-30 13:42:55,169
0x771c252f7adaa699ad044ea4dc0f56c4164999e17eff9dff0cbe07e8bc701af5,t,21000,5989098,,5000004,2018-01-30 13:42:55,170
0xccc1c650220ab752dd7d5c82ad36036c8da238ed1386c5ce22f829b2d385edbb,t,21000,6010098,,5000004,2018-01-30 13:42:55,171
0xc5fa8a05559ba79843f78fb504f5e6b2f414aa829bbe659d11ecff8f6c3d2219,t,21000,6031098,,5000004,2018-01-30 13:42:55,172
0x0e3d449875a2f2978ec8f4a206ad46c08940de9f3bace2ae124afc6d7f231c0e,t,46045,6077143,,5000004,2018-01-30 13:42:55,173
0x047d848c893dc87db2c3d990537d029fb092e93951f6e89b377d6c86b16af855,t,51938,6129081,,5000004,2018-01-30 13:42:55,174
0x6cd4f70f828d30c31da566b1dcf2a404b6bc4c01544f1c5ab8fd0be4856b2056,t,52590,6181671,,5000004,2018-01-30 13:42:55,175
0x9b9de77eb6488a2ddeaa54319dca4a18faf74222c9ce6ca82d0f104ffcebd58f,t,103499,6285170,,5000004,2018-01-30 13:42:55,176
0xda313a17405ec92c52b064296ceac28da354b9ffd9877ed40c9c8e5f553e2cd5,t,52904,6338074,,5000004,2018-01-30 13:42:55,177
0xa9b57bf9d946cb9af0073d990b78d47639fad3dfa8379ff11fcd71a61f7f26d0,t,21000,6359074,,5000004,2018-01-30 13:42:55,178
0x2a9f8351b6484768ffbf8dd9623c17150576ec663526e6359ca70decbf6b25af,t,21000,6380074,,5000004,2018-01-30 13:42:55,179
0x4902171d582bbf4b4f24d02847e953f4a1ac4566825be6088072446d846a709b,t,52886,6432960,,5000004,2018-01-30 13:42:55,180
0xddc30e0144fc792beeb3edce47bc0283fee773400d85e4aa6b8c97ce88b1a324,t,21000,6453960,,5000004,2018-01-30 13:42:55,181
0x8ed6389ecd702ea0b28f49baeb5f8123cdeeaa88e7ae89670c84490570cfa509,f,25200,6479160,,5000004,2018-01-30 13:42:55,182
0x755cded559b60eddd167e6657835d4b9b596500b3572b8a967b7827ba8b19a31,t,37193,6516353,,5000004,2018-01-30 13:42:55,183
0x2556c1c4f2ae0c357cfcada98a6e04ffba5f10cd3735acc71c39cb2136c9c79d,t,21000,6537353,,5000004,2018-01-30 13:42:55,184
0x407709b469545405a203342febb97f881c49698f279fa40406bab5e7bad4939c,t,21000,6558353,,5000004,2018-01-30 13:42:55,185
0x6e7da206573d263a5deff2a19abe3084ef2e59876c721cde288fabad5a112c22,t,52242,6610595,,5000004,2018-01-30 13:42:55,186
0x6563c85c24b114b8fc03898a541c377a0ce3076b990a4cae52df775b4aa84199,t,51606,6662201,,5000004,2018-01-30 13:42:55,187
0x1b0055050995502697aeb3d2d8955ebb3c3fd0cf6292664226f58f9e62e9fe42,t,21000,6683201,,5000004,2018-01-30 13:42:55,188
0xa71b21de969b56352a9e69d1d92545240cf316bba3326bc4f542dfc93a235a8f,t,28346,6711547,,5000004,2018-01-30 13:42:55,189
0xcf6cc38c8d483a43433ba4a9c736b9acdb3cab10ad1f0a65d51a749679db1fb8,t,21000,6732547,,5000004,2018-01-30 13:42:55,190
0x8df900f714c15ea4d1f6a71e493a098f91e252f4ee126681bb2aef977e83fa05,t,21000,6753547,,5000004,2018-01-30 13:42:55,191
0xd5ae47556cfdc5c9cb87df0777cf54924bda3339132b73ee7950af37db90d354,t,64725,6818272,,5000004,2018-01-30 13:42:55,192
0x2435ec26becf202592be5659691558f9a643248048a7ecc96848c194a07d60a2,t,49131,6867403,,5000004,2018-01-30 13:42:55,193
0x228c54e06c961583205ee389afd9743ba76c1f1019ade03706783fb932138e76,t,45706,6913109,,5000004,2018-01-30 13:42:55,194
0x00ceb376689ea550c47481955ee1f53fba712f226f6fe1a2f5b7c0a40f801358,t,21000,6934109,,5000004,2018-01-30 13:42:55,195
0x1f3bf54038f62267823a5974f1029a4ca5b5736577d7afc346754edaa0514a55,t,44493,6978602,,5000004,2018-01-30 13:42:55,196
0xba10ce14d940ff68629a3b951d0e5738d9c29f7904d0f0b28910bec0a0622c2e,t,23028,7001630,,5000004,2018-01-30 13:42:55,197
0x33ad090a8a2e9781545d27727f27e048475dd0b60b4eda6f6629a82fe9b4a537,t,108242,7109872,,5000004,2018-01-30 13:42:55,198
0x801e6496c07ce85a2ce883e833e9824a93e518ff2ce467c57ff0de827967966e,t,71069,7180941,,5000004,2018-01-30 13:42:55,199
0x8846a6edb45e0bd4ce034da3d26297d1a356e2db906a1cb2703f316ba1c551ec,t,84005,7264946,,5000004,2018-01-30 13:42:55,200
0x0788245d280702450721375ae376c5d309a96c3d9da329b625040875c4fe1af8,t,66253,7331199,,5000004,2018-01-30 13:42:55,201
0x17090e9b50b78971b88e0902390d3c2b961f1ce7cf93b1e021df39509a3e961f,t,37638,7368837,,5000004,2018-01-30 13:42:55,202
0xa8b3f63dda1f274e49f9bd8dd9d5ff6ea6e2b362fce6faf4dc562e71b6c515ad,t,36676,7405513,,5000004,2018-01-30 13:42:55,203
0x4b3d5e13743039f65a7212605351c59657528d2c2eec6c573491953c5a506be4,t,44482,7449995,,5000004,2018-01-30 13:42:55,204
0xed9fae3d38def659d96d6f74c6afeb22a600377b3a1a43f74fde134d8bee578f,t,50287,7500282,,5000004,2018-01-30 13:42:55,205
0x74251ea54638cf6f9b4babb0a91260563ca0382aa64078404742418533d85a20,t,69836,7570118,,5000004,2018-01-30 13:42:55,206
0x7b76ba169852fa34659fc37cc50b170fc9a86d8af493eb3fc0478fe09e16edd1,t,115599,7685717,,5000004,2018-01-30 13:42:55,207
0xd1bb3aa98fbc6a22a6459fa9d8844a41d3e4b735e28ca0762fd6576ba5c16054,t,51560,7737277,,5000004,2018-01-30 13:42:55,208
0x5f6f8a5d7b04fe4cc15cbddd594a5e96215fdcc47229a12ca8ea66caf7564017,t,34431,7771708,,5000004,2018-01-30 13:42:55,209
0x470a94f0d3a45eaef3b843425d727f1d8b1ab3c807ba8397dc12d2589ec263a2,t,21000,7792708,,5000004,2018-01-30 13:42:55,210
0x53f0180e13784c9ae9037d02d60e36fdf7350030cdcd5dc71f53ce7e7454b909,t,51921,7844629,,5000004,2018-01-30 13:42:55,211
0x59b2362425ac5420fff2542cbc0dafeb303ab6515ec054eac5a87a5069f850d6,t,21000,7865629,,5000004,2018-01-30 13:42:55,212
0x6464586cb0f3447e149002911e0dbf231ce73dc8e7c003ca3f7d4bbb444aebb2,t,23316,7888945,,5000004,2018-01-30 13:42:55,213
0x9b29d701049a07621309119e71ff7b9853e5b22fef3ed51e34b992543a24aa58,t,21000,7909945,,5000004,2018-01-30 13:42:55,214
0x1b8f5d6982bc5c8c96192bc998e766af80d39393b554e546ab92c637be70b8d2,t,21000,7930945,,5000004,2018-01-30 13:42:55,215
0x660494d6722f07a8d79f155c05f0cc35a37de498896dce587c0c73e1ce23523c,t,43651,7974596,,5000004,2018-01-30 13:42:55,216
0xa21582024c7eb5e8fe893ecd72dc41a517d4ee4b10ad77b01dc6db8e4c3a15d3,t,21000,7995596,,5000004,2018-01-30 13:42:55,217
0xc69f3fec2427a7b7de08b33766cb06a49338bff6314692a56a9f43368bc7c9c4,t,21000,21000,,5000005,2018-01-30 13:43:17,0
0x1691154bfa0e1ccef75910012013e78efae06f0f0dc19028f9496b6a2fce43fc,t,55843,76843,,5000005,2018-01-30 13:43:17,1
0x8a32fa19f5739ec2fd3357c4d8975bd6632760916ad554c7651664408fa70340,t,50057,126900,,5000005,2018-01-30 13:43:17,2
0x86c5987bc32962dce6b029ac5c9712816a5b1d9a702c04d823f530dfda1d10f9,t,215038,341938,,5000005,2018-01-30 13:43:17,3
0x829195d65ce6ae2bf34dcff0396c4564131065213ace87e2e35516b2484057e3,t,21000,362938,,5000005,2018-01-30 13:43:17,4
0x946e92914cc139a92d53804e2316761d96cf55495fc01a85ba9ff1f425369c1e,t,37964,400902,,5000005,2018-01-30 13:43:17,5
0xd4faad1d33fe520004bd80cc34a78f240ae4168fc68478ea904bb801338d4ffc,t,24090,424992,,5000005,2018-01-30 13:43:17,6
0x392b2129657092225677768f67e8b4e1338b568d0361909c458992a431041530,t,21000,445992,,5000005,2018-01-30 13:43:17,7
0x1cf67793e92f0624d6e269eb3841affc62fddb05020e26e8c66dbd283b1c1592,t,51545,497537,,5000005,2018-01-30 13:43:17,8
0x580be2e64db2999cdcf20523e9f8043b191d0e9698147a6638f2066433b27122,t,140972,638509,,5000005,2018-01-30 13:43:17,9
0x80cb0dcc10428401d6dfcf2517358c9e4056fdfaa98510d6ba8a65e252c0ae1e,t,152578,791087,,5000005,2018-01-30 13:43:17,10
0x49a618261175f63020a2318cf1f565d6624360e428981d952d57fd12d35ac724,t,40843,831930,,5000005,2018-01-30 13:43:17,11
0x0f9f659433ab4d6d0d2db93684c29aeef8de432be2a08bc4d1dc741bf879b64a,t,21000,852930,,5000005,2018-01-30 13:43:17,12
0x36760c35747f4391768c76fb688240fdc32ee19b6cd1c2a6d9623313f95081ad,t,21000,873930,,5000005,2018-01-30 13:43:17,13
0xf49865d075b8c18bb985537768ac80c11476d71d532575e38fc80044d7d7186c,t,21000,894930,,5000005,2018-01-30 13:43:17,14
0xb8809dd978530cda73b6295c25990991468f3a2a1743709b9b8559f29a147fae,t,21000,915930,,5000005,2018-01-30 13:43:17,15
0x456a165ac55ed6967f83c34f04ce7a808ee504ab100c0b1f4adaa45cad83a61d,t,51829,967759,,5000005,2018-01-30 13:43:17,16
0xb65a296cea01b97a305c79f79796d48d8f92e4268cc3e9cb296439ece71f758f,t,38269,1006028,,5000005,2018-01-30 13:43:17,17
0x0e272fc1caaad4282afd15ffd763fc596d0c2b6457dd67c33b92d7bcf70a1edc,t,44418,1050446,,5000005,2018-01-30 13:43:17,18
0xd8e294b2ab6e5afb81fa7560094c58cd8f28af242172bad6f3352c0c34bcdb4a,t,21000,1071446,,5000005,2018-01-30 13:43:17,19
0x1889a72b1c4ff7a9ff3279593de33a5b92edae81569ecb1a14407d4a95dd9d54,t,21000,1092446,,5000005,2018-01-30 13:43:17,20
0xb2689b889f9c6ed515e00852a19ed362aa3201748c4c7702f401fd32b92a7314,t,21000,1113446,,5000005,2018-01-30 13:43:17,21
0xe1eb3ece61adf2b5adf24f73b17db5a8d0c5f3c410ca18d8ef766bef27ff45cc,t,64725,1178171,,5000005,2018-01-30 13:43:17,22
0x9fc85df3fa3d1782abb6f0a23d35b25005e3479d63104c3f0205d093eef9b951,t,21000,1199171,,5000005,2018-01-30 13:43:17,23
0x2ea990e299cbc8abbbd360545bcbdcce2461e150d222ad1e52e44e13a675625a,t,21000,1220171,,5000005,2018-01-30 13:43:17,24
0xfe30c22a5aafe07613152436107e5cf3680f3a1eba615b9ad0de307a2ff69867,t,64725,1284896,,5000005,2018-01-30 13:43:17,25
0x0e6b2f59331e4ced451b62000ec53a533fbdb90b5c12c4457fa79206116596cf,t,21000,1305896,,5000005,2018-01-30 13:43:17,26
0x431f0162af87ff6ebc36a3709cfd0573c2ad138f93f9e7d0f09d4cd713a519e8,t,21000,1326896,,5000005,2018-01-30 13:43:17,27
0xbbbc47b580538cf32e8806b14180ac705d998a8894504b98f6ab80296aaf80c7,t,21000,1347896,,5000005,2018-01-30 13:43:17,28
0x7194cbf46cbe3ed3dd1388f700112deb8604d3ff7c1ec1a0f1e2f779f84ade31,t,21000,1368896,,5000005,2018-01-30 13:43:17,29
0xd57e8609054a8e57b163a60c7d8a10fe2408b9e825da0d539bc6a073e80a63aa,t,21000,1389896,,5000005,2018-01-30 13:43:17,30
0x945a5faaf4a3e7ad782dd9b74e3cbfde4bddd7633edb90c9762197432a925321,t,21000,1410896,,5000005,2018-01-30 13:43:17,31
0xd7b1c52b6f9ab23bd2858b30aa43e347124928685b99d1a076601732c4ff27c6,t,21000,1431896,,5000005,2018-01-30 13:43:17,32
0x3e47a7c931c25458c442fbfde0fc4aa34e40f2ba00918aaebf4868f0cf5adbde,t,21000,1452896,,5000005,2018-01-30 13:43:17,33
0x952ace36e92c792711ffe7156e3a2c922c16d4b62407bafd5b67a0db8f3c8012,t,21000,1473896,,5000005,2018-01-30 13:43:17,34
0x411dcbf4b0495931adaa659f8a08a166f54b25c7b102d324f9ca93e1fbc31ce6,t,49308,1523204,,5000005,2018-01-30 13:43:17,35
0xd301008230c3642fd17087a97cc74d8a3bead0dbd57317726da594e1ab1a3f16,t,21000,1544204,,5000005,2018-01-30 13:43:17,36
0x53f2763986cc7be0819191dd196d11f26a9048330ff42ea39af27bbd748e42e3,t,21000,1565204,,5000005,2018-01-30 13:43:17,37
0x9af554de077493a6c103b3b882b25f0bc456a87945cb09e64ad04ef0e520a21d,t,21000,1586204,,5000005,2018-01-30 13:43:17,38
0x028ec04f0864a23983af48f4acfb98cef5fd35517363c937ae965e3ca7420d8a,t,53696,1639900,,5000005,2018-01-30 13:43:17,39
0xe29004ad19ac7ce09b01dfc89367da3cafc920b766a7cdd1abb0228fb3237f9f,t,21000,1660900,,5000005,2018-01-30 13:43:17,40
0x244ab3e353aeca866a1cc605da712dc3b3f445188343095890088fdd66b29f63,t,21000,1681900,,5000005,2018-01-30 13:43:17,41
0xffc82566e58337dc8b35f5f09e50b3619f0e2104a23e901189933eeb63af8cff,t,37158,1719058,,5000005,2018-01-30 13:43:17,42
0x35c036a97052e44ccb6c581e391c3f109faf234ef192c43d38f35cc74c4a3a8b,t,237070,1956128,,5000005,2018-01-30 13:43:17,43
0xd6615a78c78382be99ce099dcd778cf58561719eac64a0286094342aca4248f6,t,52124,2008252,,5000005,2018-01-30 13:43:17,44
0x55fbf9635626ce811df9d6ebb02ba46583f4fcfd1220ef7c5435622aeea72408,t,52830,2061082,,5000005,2018-01-30 13:43:17,45
0x069d06efe3327aff42db71200f136a589ecbbeaf148f0453d8fe80363b31d04c,t,21000,2082082,,5000005,2018-01-30 13:43:17,46
0x84edb527acdd27f01a441ea1e153405818d93937e92ce8e76d75555f45f6c985,t,21000,2103082,,5000005,2018-01-30 13:43:17,47
0x2fd041953ee98f554b75b1c8f6e8cd1f75e898f96e7e3decdd687ad724e0b9e3,t,21000,2124082,,5000005,2018-01-30 13:43:17,48
0x16ba6004716c7c177451b1c06f4200666c1255fef18da2e4e42511d0e734e7b7,t,21000,2145082,,5000005,2018-01-30 13:43:17,49
0x499f07227572ec4642a4e4c22ea971cf1ebdf229bc6c885c6ab6b63f98ed772b,t,21000,2166082,,5000005,2018-01-30 13:43:17,50
0xc7f92d64acdd14ea8cc1885ed1d98ff83f8d6eadcfed3535c30206e7b4eb9c3e,t,21000,2187082,,5000005,2018-01-30 13:43:17,51
0x182db584624ae62a84cb7e3666bfc1b8c5736ec77b1b6e08fea14fa360a1d1aa,t,21000,2208082,,5000005,2018-01-30 13:43:17,52
0x604cfa0b302aa44cce30b6a4067c7932e718264d62a9c97ce2df16a1d814af70,t,21000,2229082,,5000005,2018-01-30 13:43:17,53
0x0b3e9693b8e7451d7ac5bd46b400bdd3afe4e8f74f574dea205a1403d11939e4,t,21000,2250082,,5000005,2018-01-30 13:43:17,54
0x4c790e3a1b1a305576005970ead7e8d6d78aaef6902d56603e950fc0210a6939,t,21000,2271082,,5000005,2018-01-30 13:43:17,55
0x6c89a085a1e5eb36c59ac992a45f7f678169c029e7199262a51f7f99ea926b6c,t,21000,2292082,,5000005,2018-01-30 13:43:17,56
0xabda8d7ab8315d93ac32227a1c4469b26dfb9fa60e801738a4149f9a44ff3a12,t,21000,2313082,,5000005,2018-01-30 13:43:17,57
0x479f22990e4565d320f0412a7acbc41442f908fc86cad26309a595ee0a04a76d,t,21000,2334082,,5000005,2018-01-30 13:43:17,58
0xa18c758e8e8faecae8b7565835c22209587a19065239db711a712fe34f5d6a34,t,21000,2355082,,5000005,2018-01-30 13:43:17,59
0x73622187659b16c77e78c50c2cdd397a054e3f5486b655ce738240a53de1fb67,t,21000,2376082,,5000005,2018-01-30 13:43:17,60
0x677503a9229a9f02350cc950cda2da560541eede4353c9d25e563f935667278a,t,21000,2397082,,5000005,2018-01-30 13:43:17,61
0x8631cb6f365c6b13de70bbcbdd96e0c08aec59bb59a373cafc7c62a02392955b,t,21000,2418082,,5000005,2018-01-30 13:43:17,62
0x2ecfa8a00294cebecbe82caf0e8048556aeae23cc552095c954726c88e825497,t,21000,2439082,,5000005,2018-01-30 13:43:17,63
0xb9c25e2a180e0fe4ef916102ffcbbd11deaaba3b2037c0c1042f3e76acee997e,t,21000,2460082,,5000005,2018-01-30 13:43:17,64
0x0f63e2e3fcb1a72cf1c36c63f91bb00aea97441313685f1a7097eeb53f4d1d42,t,21000,2481082,,5000005,2018-01-30 13:43:17,65
0x3e6d46b80f36a7f8f1dc5717bc9eb2b11fa29ee6151fa9cd5d4cbebd50692177,t,21000,2502082,,5000005,2018-01-30 13:43:17,66
0x6d81cb3b8525bfba817851f226d7745f0dba322335b721baab2d748326120c50,t,21000,2523082,,5000005,2018-01-30 13:43:17,67
0xf05fb753265164841b384ba15cf36e48bf1820505e2bb2ff3084b5c6d8164299,t,21000,2544082,,5000005,2018-01-30 13:43:17,68
0xc26540c5bcba43b7901812b91cd691afc82851b77b9e6d3db6d9f7514ff89112,t,21000,2565082,,5000005,2018-01-30 13:43:17,69
0x7ac76618e9cfe8dd69ef7679d832d3d0b57a2b17ea6aa20e58e2a5f6bae51494,t,21000,2586082,,5000005,2018-01-30 13:43:17,70
0xefe1780b48264cb04975f00a6b9598f8baee856c234f67c14e0540b5614bc5a5,t,21000,2607082,,5000005,2018-01-30 13:43:17,71
0x3b2ddd19f51f257d4f8f097e2806531f81b1e2813abf45a194a8b65a57190a3f,t,21000,2628082,,5000005,2018-01-30 13:43:17,72
0xc57d5453778d87fdbbd8c3bc5e91cfeb752daaaeb9b8fe121398f6b36a65d19b,t,22236,2650318,,5000005,2018-01-30 13:43:17,73
0x595018902735cb4945045d490efbe53ee25ad8983dd7870ae1759876b590b4d7,t,29063,2679381,,5000005,2018-01-30 13:43:17,74
0x210a6292d2addd5996b36cb81a8eff8ce9fc0b46fcc8061b160351544bda8e3c,t,21000,2700381,,5000005,2018-01-30 13:43:17,75
0x4dd68fa363d6c5f85462bfd6b11fd14cd8a77d0b29b350e43885f3ba66bc2b89,t,21000,2721381,,5000005,2018-01-30 13:43:17,76
0xa78fd6e689fa62b8918fa43f0d3fba1c8ec018804767f4787f8071b6d5d08033,t,21000,2742381,,5000005,2018-01-30 13:43:17,77
0x611e83f40669b4df1a9feeb035c428b5e81b179dbb987abf5771b79429427ab9,t,21000,2763381,,5000005,2018-01-30 13:43:17,78
0xa40ef76985c0b9c7d21c8954b100812d9932a863fe6fe494701d372ce7a6d917,t,21000,2784381,,5000005,2018-01-30 13:43:17,79
0x3d0dff000a1c89cb6ad40f36e52cc5d5617c90730c9740395adb5e07e9d2593f,t,21000,2805381,,5000005,2018-01-30 13:43:17,80
0x4d32c42ca3c5cb3d5e9f2fcaed66d807d47899f81b2de34f7c84b75f1e1079ef,t,21000,2826381,,5000005,2018-01-30 13:43:17,81
0x89867ebad3963685a729146b76cd47a4573c5a470148f7f1b79a0d519a1032a8,t,21000,2847381,,5000005,2018-01-30 13:43:17,82
0xacf33f79baf8f7009cd74b14231e6f09458ea789b55363e5b5e2ec7be9e492af,t,21000,2868381,,5000005,2018-01-30 13:43:17,83
0x4567dea56f211676bf39b4f720ff00513705dfb6e6c5fffded35a6ffbd91c8fb,t,21000,2889381,,5000005,2018-01-30 13:43:17,84
0xf2e5bd3cba25ee2d9a275586e014e8d9f2ba8a9dfac22f063d5329bc5a2187d9,t,21000,2910381,,5000005,2018-01-30 13:43:17,85
0x6a47237b7f17609e1f0cabf2c4f347b95bee2e62d73a4182c0049d346f360102,t,21000,2931381,,5000005,2018-01-30 13:43:17,86
0x1cf8f70503e1e1be41b9b8279462a14ba071437655484990c6c7d3c7a764aed7,t,21000,2952381,,5000005,2018-01-30 13:43:17,87
0xe658b17a125215f052cc7188d6ab70b5937e24c8b4cf9286edbf107237192ff0,t,21000,2973381,,5000005,2018-01-30 13:43:17,88
0xa94dbb49f1b2f9aa16adb58a07bc6cfb03857c952e2d336ee7dd6386fa61aaf6,t,21000,2994381,,5000005,2018-01-30 13:43:17,89
0x57a0e9f186403fa47b0aed717624e4d8d556603c8a77a43a5282629a7cc073bd,t,21000,3015381,,5000005,2018-01-30 13:43:17,90
0x3bc7a79e081ecf4697b83d7e362818ae430418b64508bc67a3393d7376232453,t,21000,3036381,,5000005,2018-01-30 13:43:17,91
0xdc6e42a055868e04e7c4ce4d2ee1fe6ed31cc36f49209eea15452116f888fdd6,t,21000,3057381,,5000005,2018-01-30 13:43:17,92
0x005e5c54b50cc4f25a737b4caee88d8a090f78d5056fb479940d055370960577,t,21000,3078381,,5000005,2018-01-30 13:43:17,93
0xffa3d21ba11f942f2dca787177d5c808901ca74e04a1f668f25953d35850a293,t,21000,3099381,,5000005,2018-01-30 13:43:17,94
0x14aa5220da9cbc7e2bf481f6e0425c9f5261f0fd376040e82dc97facd8283663,t,21000,3120381,,5000005,2018-01-30 13:43:17,95
0xf938e6b3343a609d1afb648d148d4c463b24dbcd401e18846cd06164c322d372,t,21000,3141381,,5000005,2018-01-30 13:43:17,96
0x032ad8ab36b3f9d3b3f370b8868860b506eac5501f5620a44a012ac2cd616d0f,t,21000,3162381,,5000005,2018-01-30 13:43:17,97
0x2269628bc18d9bc28d5465b4c601a4d218d69a3408bd054d0e7db60ac77a2c0a,t,21000,3183381,,5000005,2018-01-30 13:43:17,98
0xd6228940a3284d626ec38e66d4a9ad216176dfe919d6e934aa00230a5c9edf5b,t,21000,3204381,,5000005,2018-01-30 13:43:17,99
0xb6e52da66d4335f474fb0205d067c49d91169307411422715c85aafd1b12aad3,t,21000,3225381,,5000005,2018-01-30 13:43:17,100
0x43e5a5b5360ed2e1bc3398399442f9eb92585a1980cafbdc3d105bf18347f55e,t,21000,3246381,,5000005,2018-01-30 13:43:17,101
0x83e8913a268100417f173aee6dc951dc698fc4c12181acae8ceb016739c208d8,t,21000,3267381,,5000005,2018-01-30 13:43:17,102
0x10abd39e0a813679efe90b4cd3ee90f190b646c5162174c88840a4a77cbb5e16,t,21000,3288381,,5000005,2018-01-30 13:43:17,103
0x9cc555fe60645132cc5949c8d1f0a346deef218df11511fb8f2f8bbc38c13519,t,21000,3309381,,5000005,2018-01-30 13:43:17,104
0xd511c2959f9ded5e67d0f1e96af6c8ecb9a3baddbb1db83b1dd8f099260f8088,t,21000,3330381,,5000005,2018-01-30 13:43:17,105
0x5e4b41e4b26bb66297a97386e9af8ce9b5570a4be6e9e61a8884b69f269f6684,t,21000,3351381,,5000005,2018-01-30 13:43:17,106
0x1fb34cd644fe04e1eb8ff37d83fc180f73b30c83a50344eb429f89cb472526ff,t,21000,3372381,,5000005,2018-01-30 13:43:17,107
0x0e201109e938574188421be940dea41a89b5f5c70f3434b90ac71475d65dbed9,t,21000,3393381,,5000005,2018-01-30 13:43:17,108
0xa09d111bcb7ea9e9cf51e229c2f79c52254ae27c8bf5a16c7130b51ebf18cedc,t,21000,3414381,,5000005,2018-01-30 13:43:17,109
0x97892e8d5e278f8509e82f9c5bbe558a4a19a54e012c825af7e1015ded5e8601,t,21000,3435381,,5000005,2018-01-30 13:43:17,110
0xea165bc3c58221583afb322e183477c2add13e3192ef125b80f2ab09a99f56ac,t,21000,3456381,,5000005,2018-01-30 13:43:17,111
0x18f864ba2f80414ffc26ed72edc9a84a703c6181720e9e269484efd78fbf31cb,t,21000,3477381,,5000005,2018-01-30 13:43:17,112
0x21c32d85596c4d7afe1418051ecc17289dd61c7f0e4b98b5ec14ae132e557ba2,t,21000,3498381,,5000005,2018-01-30 13:43:17,113
0x2e35f6751576b7178f57fcc5a5c65a6a00f8783839db6f50e78885c45fee06db,t,21000,3519381,,5000005,2018-01-30 13:43:17,114
0xa327ad466257e54ed67986fceb73eee88679e5f266dbbbeafbe810132586d61e,t,21000,3540381,,5000005,2018-01-30 13:43:17,115
0x29e7adf6b8c95cffe24e9e86d8b9158fa6153faaa8977b6bb136a406bbce3124,t,21000,3561381,,5000005,2018-01-30 13:43:17,116
0x11dcb197fca22e32af25534836b3857f8c370b52690e90d2316d3d94bdd9d7b4,t,21000,3582381,,5000005,2018-01-30 13:43:17,117
0x943e01cde41c5ab5abeb04b22b428fbd239acfe92a8de27ba21e2902d0369745,t,21000,3603381,,5000005,2018-01-30 13:43:17,118
0xd9b219ba7ab52c98901381d879f11843a0703a6e58b7daeee07bd1ed1b78b281,t,21000,3624381,,5000005,2018-01-30 13:43:17,119
0x528b5927b4b20ba2d1d7ce02460c58eec70735b2f114c9ac2739f73af93699c2,t,21000,3645381,,5000005,2018-01-30 13:43:17,120
0xe3f8308a7f0800aa30f22c7f6dd60587099a2023cdfc96d5de3ebab63a98187b,t,21000,3666381,,5000005,2018-01-30 13:43:17,121
0xefedd3fb18a1e4a8ca207431a43b5ec763f4fa357a1316b2fac06000f55d88ff,t,21000,3687381,,5000005,2018-01-30 13:43:17,122
0xd481ec1406beed65f6020f4e313c6100f4ea80c3485448abe454838db28250ef,t,21000,3708381,,5000005,2018-01-30 13:43:17,123
0x361d1c2e0cbe08243e22983946ddc62ae09d27d2c957870d9068408acd05ffd3,t,21000,3729381,,5000005,2018-01-30 13:43:17,124
0x182812b9dc5b0822e91af2efaa9a3653e44514e60f44fb10eee5307dcbeec892,t,21000,3750381,,5000005,2018-01-30 13:43:17,125
0xb3e776cc503a20fbb791a52a224a9c3216bb854d0e65fbfca1b8377c4c21fe2c,t,21000,3771381,,5000005,2018-01-30 13:43:17,126
0xb58987c660c1003da9a7057505b009b7b67341af045cc1180efabdeac7029cbf,t,21000,3792381,,5000005,2018-01-30 13:43:17,127
0xb307f45c8c145b48591c6963dab80922edea06f9fb93a0a6352932da51d789a3,t,36792,3829173,,5000005,2018-01-30 13:43:17,128
0x4af207257d13860df115ba2f096959e45e703255d62615916bc14ebcdc5c8c50,t,21000,3850173,,5000005,2018-01-30 13:43:17,129
0xdd1e7a018a4943beff22fcebf1c8e5fe3e92c24827a6b4a1ae502198644d0c0a,t,21000,3871173,,5000005,2018-01-30 13:43:17,130
0x02ea4f835c13ed5a3f42103429d40068d48a86dc95403696d38b60027bbbc53d,t,21000,3892173,,5000005,2018-01-30 13:43:17,131
0x55b7d67976952a57c5b6fbbe838e845f036fd9b80fff5d8a7c2581ff2e369a15,t,21000,3913173,,5000005,2018-01-30 13:43:17,132
0x452f59fe1c732db9033e69e050ab21b49da4d5cabde2d0460f07a125b7cb883d,t,21000,3934173,,5000005,2018-01-30 13:43:17,133
0xb7dbda234ddfb0b092bc9b51bf5b831b4d7e071e102b4540e0b85751e42277ce,t,21000,3955173,,5000005,2018-01-30 13:43:17,134
0x3836f1c6bd692f38456d231ae313a3e2ac410c44fbd62f7add1b0598d9707685,t,21000,3976173,,5000005,2018-01-30 13:43:17,135
0xede739f42a44f6f8dedf9096fefcc04bff6640dd3c76adf06319997bf7ab0870,t,21000,3997173,,5000005,2018-01-30 13:43:17,136
0xd43c2cd11f968b74e3fa51541247fd7de599aa51929191879956e45381fe1908,t,21000,4018173,,5000005,2018-01-30 13:43:17,137
0x2025bd0f2c102c191a34b10c85ca500e454971ee0b74e423a8a979193fca5aa3,t,21000,4039173,,5000005,2018-01-30 13:43:17,138
0xc152049f79184336a8633457e9cd9ec2f3106edb5143bfc980322a5bcffdb918,t,21000,4060173,,5000005,2018-01-30 13:43:17,139
0x62bba4acf5cac8850d824500640231894e458b14c811156a7dc74f7ab489d53c,t,21000,4081173,,5000005,2018-01-30 13:43:17,140
0x5731f2700b30950fef17bf90bf60f658562db771f5f385f1f4631579e265688e,t,21000,4102173,,5000005,2018-01-30 13:43:17,141
0xf582cc3a4566e8b4db675375a702719da6e07f92861e0db86d5e582a730cfd04,t,21000,4123173,,5000005,2018-01-30 13:43:17,142
0x318f1d2c54680fb42db585dfe89c487967b4c932108c7a61c3b6a6ac84f6aac1,t,53020,4176193,,5000005,2018-01-30 13:43:17,143
0x6b089dff44e3858e46b5aa6136e79220d26240c20d1d1535624f7e2780ff969f,t,21000,4197193,,5000005,2018-01-30 13:43:17,144
0xbbb87421db60e8d355b32fa3851843a02e5f0148bc1ed01731bdd37c7e43b7c2,t,21000,4218193,,5000005,2018-01-30 13:43:17,145
0xcc63093312e6c6075b11c49ab334a7c708ddf5d628933acd4cc187c171983a78,t,21000,4239193,,5000005,2018-01-30 13:43:17,146
0xcfaf7056354aaf8d76ef11da062e1e2721977a5cedb1cb77546f3fb76ac63526,t,21000,4260193,,5000005,2018-01-30 13:43:17,147
0xcc1b96715e671e5d6ba5d2c8ab4fbf5e39bf5a8c1ae94fb47c9016a19c5dd1b0,t,253854,4514047,0x9f9c6977A6837ee55A4607492c36a81A91e2f096,5000005,2018-01-30 13:43:17,148
0x7f2194a81103b74c8b4e247190c733dda38bec1ff3b3966a3ff88b7bc53d9453,t,21000,4535047,,5000005,2018-01-30 13:43:17,149
0x6168f63f8f6a2fc52512d6199e3dad388c47eba298a03cf5a722251fc7a50943,t,21000,4556047,,5000005,2018-01-30 13:43:17,150
0x58b020b3be9063ddcf22f184942f23abc222f58715da3bd18641e9ea91b0f07d,t,21000,4577047,,5000005,2018-01-30 13:43:17,151
0xb2dcd6ab90a115607afaa74de0a1e1619542e5761897ec6e25b196505126d990,t,21000,4598047,,5000005,2018-01-30 13:43:17,152
0xa9e827108b46f676d05d1f0ef09ccdf69dfd6cc2dcdcb3e12143949b7331b929,t,21000,4619047,,5000005,2018-01-30 13:43:17,153
0xabca65cbc354763184da74cd118cc6ae92b85bacad6f2993669af57d7ca579bf,t,21000,4640047,,5000005,2018-01-30 13:43:17,154
0x178a2e291cdb0b355af5bc70702f7750280a803c50b3670450f072b8c10eab01,t,21000,4661047,,5000005,2018-01-30 13:43:17,155
0x81bade40540abfcea6990e0c49ca439fba760994693c3f8752ee32b2a7222d19,t,21000,4682047,,5000005,2018-01-30 13:43:17,156
0x550301c8f67a92c3b0e4a956eb25717688aa415cddcdddfef565c6cbf5f2d622,t,21000,4703047,,5000005,2018-01-30 13:43:17,157
0xb5cd9751d557e2ce9890155004b85ac75249f899239be285db9da8ad5da48374,t,21000,4724047,,5000005,2018-01-30 13:43:17,158
0x0b0679b576d25ea399a68dcc4d9a6344d56bfd7ffa02ed0d6049438f8d03f4f3,t,21000,4745047,,5000005,2018-01-30 13:43:17,159
0xf73d2c19fd88441b7f4e1c3c0dd3af2eefe3c7a6d87f280da5f2b48cc42fffc2,t,21000,4766047,,5000005,2018-01-30 13:43:17,160
0x8661aff1acb2186eef14ed96542178732e908877c5d689fe64a5686abc2012be,t,21000,4787047,,5000005,2018-01-30 13:43:17,161
0x09338666e340f76a9582a615337b1ba43debe2c50977aeea87b1a693f64d290f,t,21000,4808047,,5000005,2018-01-30 13:43:17,162
0x5bc2ff778212e5f0cd045bb51c8eb984216721e0f477db019e381a43310bec6b,t,39512,4847559,,5000005,2018-01-30 13:43:17,163
0x511ad69c6582fc127ddc3768d8f1a15006e637b269eae8ad0119ab3373eebe8a,t,43815,4891374,,5000005,2018-01-30 13:43:17,164
0x7169e3b704de6f32dced5b1ebfadf818a965e26606c92ec0e2849ed310d0477b,t,21000,4912374,,5000005,2018-01-30 13:43:17,165
0xfffcb4100aecfbd786831c67281ec205e72250cafa3b9373ae349da4fe8364bc,t,63521,4975895,,5000005,2018-01-30 13:43:17,166
0xce57fa4a94a2b6a0189358ca6d3648c63f1c6e9f20c293e1e99b11a0fd17ee4a,t,21000,4996895,,5000005,2018-01-30 13:43:17,167
0x42d94867221216710e358b63f7d5bcc6b0243536616455cc16da247947f36404,t,34144,5031039,,5000005,2018-01-30 13:43:17,168
0xbf7547b0a536df669d244620c8a04b631058dfbf7d8b1f04acd156be842a93b2,t,777402,5808441,0xE6d8B300900940ed1dcf2f79bC07b0d8098cE8A6,5000005,2018-01-30 13:43:17,169
0x7ab7d9465aee4d5047fae75b0ac813f48cd9939469825da3fdd8c2e6b27c02ab,t,44025,5852466,,5000005,2018-01-30 13:43:17,170
0x4ed8fad1453793ba0465f5c3f722a17e63d1886b6fd7d1d0b936386f5c39f81b,t,21004,5873470,,5000005,2018-01-30 13:43:17,171
0xe75d703d782a33b32bc571919e60abab93edf395e5db877bffbb7936607a1cf4,t,36772,5910242,,5000005,2018-01-30 13:43:17,172
0xf4cad98c3b98fcd9d186875e17270ccde9a1f0dadeef434e802812efe6f59e13,t,21000,5931242,,5000005,2018-01-30 13:43:17,173
0x8a5903966aeb06d0d25224239e170385b7581e645db212d91721468c95324c14,t,66882,5998124,,5000005,2018-01-30 13:43:17,174
0xb6fd32600f039960d0f2507e07059479eab329f0ae0ade0d95f66a3dbb1af3fe,t,51973,6050097,,5000005,2018-01-30 13:43:17,175
0x7e187361fa8015d180ffdf704dac93977b6856c88759579501c182f9a67554f5,t,21000,6071097,,5000005,2018-01-30 13:43:17,176
0x8654ba003b4b3213d7ca843240345b93f6b61bc106febaa16f3445d1a463f7f3,t,78114,6149211,,5000005,2018-01-30 13:43:17,177
0x4a0d707208667ef8570b99031e1d8d1550d0e6ad8748057578114a4f5700ab07,t,93050,6242261,,5000005,2018-01-30 13:43:17,178
0x5e3455432ea78605b052de9bc0ad7a0388300741c9a65532da745c5b4222eef0,t,21000,6263261,,5000005,2018-01-30 13:43:17,179
0x1fd0241e7be102d357698ca8bdfa2f2bdc5e9a5d5520f4484423e5560a4fe9f8,t,21000,6284261,,5000005,2018-01-30 13:43:17,180
0x330e125d5345aa73176767801248f7f484545c69b2eb1349265f6dc4d8ce756a,t,75220,6359481,,5000005,2018-01-30 13:43:17,181
0xa0035377d390f8258aecbe09e87d61427bbee22367d791007533b49bb35287db,t,37900,6397381,,5000005,2018-01-30 13:43:17,182
0xd26317d29f1d4964f4d1dd29a8b29643fc8b688d82e88e3c23bd03a494e1d8ce,t,29493,6426874,,5000005,2018-01-30 13:43:17,183
0x0363fade4af162f12e8c3adc23482026729684df9b9fcc93250a32ca505ed336,t,53222,6480096,,5000005,2018-01-30 13:43:17,184
0x39511c93840671b030e503ec47b3c5e9797bcf30a4126cf9288ebea63528cfde,t,830155,7310251,0xACF861A3c99CCFd0B7Fa3aaDdc75f333a3d91776,5000005,2018-01-30 13:43:17,185
0x501a255fd8095ef2113e4fd2cfe54c54748dcd0ff047619dc5e9676a48aa7208,t,44493,7354744,,5000005,2018-01-30 13:43:17,186
0xd5d3574a10569ab14ff6867f835a566da703747c883f5c13cf1faadaa2c902da,t,44493,7399237,,5000005,2018-01-30 13:43:17,187
0x6ef3201bdd5dfa1be6371609c4357d5b3f1481e2e323ce212103734fa00d27e7,t,108370,7507607,,5000005,2018-01-30 13:43:17,188
0x78d261507966e9636a5197df119a934f1ef581bcf8b997f93c4ff24dbe470f1b,t,64893,7572500,,5000005,2018-01-30 13:43:17,189
0xb875cf87c63bb7b6fc191c8b024d59ed35a2b986e8947e924fcfc85c579f7a9d,t,49314,7621814,,5000005,2018-01-30 13:43:17,190
0x5a3d804c2cf059baa969ea840954658d4e85b87722b87326c90d26b97b099c47,t,123178,7744992,,5000005,2018-01-30 13:43:17,191
0x11c9f552e571baea30608ea6163d6079ed3eef497ca83e9cf8be6e43d46beb43,t,174591,7919583,,5000005,2018-01-30 13:43:17,192
0x998430db666e97c26e983b841c6de48942a7f087dfe5aad997bcce040fd3befb,t,21000,7940583,,5000005,2018-01-30 13:43:17,193
0xc8316342e6f3c8fc2b3e54cbe19ed2b238c4bce385f2b074b804ec86979a496f,t,21000,7961583,,5000005,2018-01-30 13:43:17,194
0x2ea0143b3571c379a628a3fa0fa8e09c2e3848c0410305c7e9e380d7c6378345,t,21000,7982583,,5000005,2018-01-30 13:43:17,195
0x42943e93c1614bcb5edae462c36578ba17b594101c99f41717f24137dab91f38,t,21000,21000,,5000006,2018-01-30 13:43:25,0
0xd51e2b156112597a2ffb13d795672ab137dc60d7393f87860807fac2273be714,t,21000,42000,,5000006,2018-01-30 13:43:25,1
0x58bdb41fd7c26d741c4903b105cf84cfa9ae3877ba8e0efa3bdf04be5977d5c2,t,21000,63000,,5000006,2018-01-30 13:43:25,2
0xc5dac1b85d2c9ddc4c0c580151c37f48996322ab4a9bcccabb6dd894911892f9,t,21000,84000,,5000006,2018-01-30 13:43:25,3
0x97e71c487f1c80db8bfa95cf2164bbfb20beb67d0afa8827a49625c9462a1136,t,21000,105000,,5000006,2018-01-30 13:43:25,4
0x6ba16ed9d6f78d1e5caed8a5cdcb79acc21c9a60f626c79d2ab6b110b68b3d40,t,21000,126000,,5000006,2018-01-30 13:43:25,5
0x66a525914f21753aa3fe637d05914a0d8117bea12217a4b88fa49293e7425e87,t,21000,147000,,5000006,2018-01-30 13:43:25,6
0x62b0595e655decdc79a16c3bf1e30e20323fe00d4fbefcdca65f94a80eddd827,t,21000,168000,,5000006,2018-01-30 13:43:25,7
0x545c0807a10b208f61bb26d4595ed6b0923f4bacb2d01db47e400d205a37d1ab,t,37222,205222,,5000006,2018-01-30 13:43:25,8
0x03955970667bcaa55dfa913693edf30651f75954461b963bb1bec138bd690911,t,21000,226222,,5000006,2018-01-30 13:43:25,9
0xfe3946e5fa345b658749dafdd871fc93502afe9dfe3b265d00378799cc703d60,t,36562,262784,,5000006,2018-01-30 13:43:25,10
0xf5c76335a99572eb0f097e9ab6a5bf6278decffbc74d8337570e4e94e181fe87,t,37153,299937,,5000006,2018-01-30 13:43:25,11
0xd3c3d84cc9ab12ae393a8cde2a11a4edbef2b41c3a332435b6e978b65067364f,t,52704,352641,,5000006,2018-01-30 13:43:25,12
0x9f612de962da01eff4e11f058cf5189782905a2044ec7447fcb9daca1cb6b72b,t,58999,411640,,5000006,2018-01-30 13:43:25,13
0x5d47d5c31c3ca3118e167ab87331927d7f2d92089a913c97af3a90577aa98ef1,t,52512,464152,,5000006,2018-01-30 13:43:25,14
0x9aa4f0eb01f7a7bbc1162478e65ad0ebaa2d18d3a95efdaab409f995c28c691d,t,37912,502064,,5000006,2018-01-30 13:43:25,15
0x4b0774252d6d899eb05a9075ac846bde9697e470cdbeda415a58be044d13e745,t,21000,523064,,5000006,2018-01-30 13:43:25,16
0x8b6c6b86aa4f3629aa68d159134848ae1fe25ec9cd0c304a27f8c4a2b5767ff6,t,21000,544064,,5000006,2018-01-30 13:43:25,17
0x19e44558f864e2944464ab880a1646f794e757dc73757e32d81328f8ab1c7536,t,21000,565064,,5000006,2018-01-30 13:43:25,18
0xbb9f6ea8e97d9da6fb8b953e73a55376850beb6fd99990cb96deb070da111560,t,21000,586064,,5000006,2018-01-30 13:43:25,19
0x311d53a1d9d7da14fa7b4b6095fc5889f1cc45d2de0d42e958182f7f33c7ed6a,t,21000,607064,,5000006,2018-01-30 13:43:25,20
0xb27bb8104a08c2503b40f061f0bc927a94fb2c5ff5e8802a588555c84c9155f4,t,37155,644219,,5000006,2018-01-30 13:43:25,21
0x18053677bd1ad50a076efb187f4cbf209e17146f2004ba0e840b7d301c9a013a,t,52531,696750,,5000006,2018-01-30 13:43:25,22
0x4e6df93adc13a83c396a465cce62fcf4e8bdbc06c9ba5198ca0d7b824d399173,t,21000,717750,,5000006,2018-01-30 13:43:25,23
0x7a88af20eb59a6ef171ca9d7222cb83e130f91e84ea37f02007b809fd544b6be,t,21000,738750,,5000006,2018-01-30 13:43:25,24
0xc1e83bb3188e9699932c5e30f3e021cbe67d7ae6c79e54d40de29ab963776663,t,21000,759750,,5000006,2018-01-30 13:43:25,25
0xdc4c948e8a92d6717bb7f2218a617f8b73b3b07feed415d4a6b461559c8cf9ed,t,37962,797712,,5000006,2018-01-30 13:43:25,26
0x5b4259f6a0327b102f9545bd7e0dccb163a78dfba275503ef37a432acfea6dad,t,21000,818712,,5000006,2018-01-30 13:43:25,27
0xe421fe4059ded8494136f9132405af52c49cc1c842b208de971c268e859f519e,t,53111,871823,,5000006,2018-01-30 13:43:25,28
0x2441abd695b2503de228a179a1301f5b2112add1d8289ac975f4b257d12ccffb,t,21000,892823,,5000006,2018-01-30 13:43:25,29
0xf29a43417351821a895e8d83f8db664ebce478a53713740a73a4d8281ad4fefb,t,21000,913823,,5000006,2018-01-30 13:43:25,30
0x7e9da5ede7d0d362fd9f6adb427756c3ee5d0f65ddae87e0086ec0aab4b1c04f,t,21000,934823,,5000006,2018-01-30 13:43:25,31
0x76f5f44e1714114b16b8172575d1e951d6a6f1ea3392fbf0307e4ad194186eb8,t,21000,955823,,5000006,2018-01-30 13:43:25,32
0xcf578d5a65eac38853bba2dd4a20347e2678c377f2d18163749f54a64838b059,t,21000,976823,,5000006,2018-01-30 13:43:25,33
0x07cd0b684195939da9ed780ee5f4e15acd29545bb6dce47a02b794a12558b862,t,37091,1013914,,5000006,2018-01-30 13:43:25,34
0x75acd7e46f20a23f95d2c1057a67c641116c2c72a553a7cd85bba9752ca00cc7,t,52155,1066069,,5000006,2018-01-30 13:43:25,35
0xef89eba5e22d525972ceb214f9b8af19576d2d882249f8684f68721262b21efb,t,21000,1087069,,5000006,2018-01-30 13:43:25,36
0x59722508691b4b6027847acddc68c603b528f62b09c076521d014191e6733485,t,21000,1108069,,5000006,2018-01-30 13:43:25,37
0xb2040b42a7dcda495afca0151e42ec38face7f520dbd15a100b182ff367643d1,t,21000,1129069,,5000006,2018-01-30 13:43:25,38
0x3fc24c6905af8ef9cb5be18d1a077b1b573684d1e0e2cd54a2dcf0ae00504c96,t,52547,1181616,,5000006,2018-01-30 13:43:25,39
0xccc0d4a0f14b83532bdd12080df9a0568b4d45ef664111d2aae090b4bfb5efc4,t,55843,1237459,,5000006,2018-01-30 13:43:25,40
0xb2fba56bfa4849f9eb50674f2362cfc2f84294b2a6a7acec7ccf8d27b2f067fb,t,21000,1258459,,5000006,2018-01-30 13:43:25,41
0xa3915465c3f9b97c4a2339daff137f9c95a0cc291a41fb05469f159216d512f7,t,21000,1279459,,5000006,2018-01-30 13:43:25,42
0xd65128e83b554f9fa99a30630deeb93b8a6d4425fd111d828cd844c79e13cab3,t,21000,1300459,,5000006,2018-01-30 13:43:25,43
0x5fa23e84d6522bb3a3c26f6ccbaf709836ba02b85547ed0df9a455ff19bd4bca,t,21000,1321459,,5000006,2018-01-30 13:43:25,44
0xd5535b88bfa15d0e02c1e3cadef15b0cb6f01cbc5b630a82d1e7431feb04703e,t,21000,1342459,,5000006,2018-01-30 13:43:25,45
0xf266da6d698201e38ff6a301427e1973af5274e2bfd870a2d70a327cda13bfe4,t,38316,1380775,,5000006,2018-01-30 13:43:25,46
0x61215ebd65a026ddd9c28b4622fb0d04423d67d22a4bfedcf33f10e3ae4fa894,t,21000,1401775,,5000006,2018-01-30 13:43:25,47
0x8f4a31dffb61e9ff9e5546df9d7d27dbc06dc456b37bec96b2c1eaf3eff55d97,t,21000,1422775,,5000006,2018-01-30 13:43:25,48
0x7234101e1b43fd537a19a5fd42cb1d291f178dc03995fab8aa2e516c83d4b8c8,t,21000,1443775,,5000006,2018-01-30 13:43:25,49
0xee4e4b6548ad46a817381866b1d9cb05169ad068b545079c69a859607fa37679,t,21000,1464775,,5000006,2018-01-30 13:43:25,50
0x9c669a7853d465d5f63376e87fbd0a105056b062b2a493ba55b80464203bba06,t,21000,1485775,,5000006,2018-01-30 13:43:25,51
0xf73eb0319cb03fb1107f4a971cc4f16422c044f2b8d8793c7d1611027d439983,t,52091,1537866,,5000006,2018-01-30 13:43:25,52
0x8e45929e86f7e3aa92616abfb59e978515890314a9e7b77c2a6d18c7f1594cc2,t,21000,1558866,,5000006,2018-01-30 13:43:25,53
0x97ee06d88be70b75efba3f56b3c9fa8f22790fb4e1b7043eb90a93cc8c676bb2,t,21000,1579866,,5000006,2018-01-30 13:43:25,54
0x781d1451b8ccd27f8e18d87e7f149ac9d2d4961781c9cfe9ab655ca90bfcddac,t,49993,1629859,,5000006,2018-01-30 13:43:25,55
0x84617cf034d3e8710033157b00ad61349e82959a01b87cfd7c3b3868116c3c43,t,46558,1676417,,5000006,2018-01-30 13:43:25,56
0x6f70a860b7e0d0abeb8074af4b7fbe64abef7c8bc008e096585a469ed34ccbb6,t,46622,1723039,,5000006,2018-01-30 13:43:25,57
0xd8e67a27235c66fe15a4fe5ec97763ced61bb1775030de274aff798f927c203d,t,52476,1775515,,5000006,2018-01-30 13:43:25,58
0xb723b9a1de502f90e946a00c4b75019f9163859159398808ae7ca802ab465e86,t,50057,1825572,,5000006,2018-01-30 13:43:25,59
0x26ae452834a4cd0227a1fcd53aea69b508d44d4052d129d7a7198ba41738c875,t,49993,1875565,,5000006,2018-01-30 13:43:25,60
0xbe8180480ead650eb13187a750ff0bed4ff4a0dbd390cc34be1dfe11f553d3eb,t,49993,1925558,,5000006,2018-01-30 13:43:25,61
0xefa73e75fbc366651bd57c64af01d9bffc2fa12d3950d13c4441ebba7ddfe6f9,t,49929,1975487,,5000006,2018-01-30 13:43:25,62
0x12508ad8c92ada96a6a0838b0fd837e96de7d9d3b2fa8b7e7c662e1a7011970f,t,49993,2025480,,5000006,2018-01-30 13:43:25,63
0xd8fa9469026c42e2f1deeac1c22b049e1349ee3d5e645289ef086173238363a5,t,50057,2075537,,5000006,2018-01-30 13:43:25,64
0x135855cf8b631d004390163af9f59df2c7d8de70f57610d301a4c78ab75e56fa,t,50057,2125594,,5000006,2018-01-30 13:43:25,65
0x499d2d5433466c390c549fb2fb1c6b61e03b099810912a2cd95a5ecd5dcca0fb,t,51715,2177309,,5000006,2018-01-30 13:43:25,66
0xedd00e86173845ac247d5746fa2c1263823b9f9638c67ef4ec8b757c7f62a460,t,36848,2214157,,5000006,2018-01-30 13:43:25,67
0x0bd36177b0431a8848e0d35247ad1e3df233a0b249297e9c301e184053cac63f,t,21000,2235157,,5000006,2018-01-30 13:43:25,68
0x998ee41d89af31b0905a1839123f6061e4f09fc74bc372f216cf12c56a5ddf66,t,21000,2256157,,5000006,2018-01-30 13:43:25,69
0x65202afb6043f2ca8c533f6df22221d68c5d98f526d3eecfec410df49eee5b6b,t,21000,2277157,,5000006,2018-01-30 13:43:25,70
0xa66ead86c3486f8ef2bc295ce56e98add5b82ab2905148bedcb2a1b4b69f77e9,t,21000,2298157,,5000006,2018-01-30 13:43:25,71
0x37a69c4694a6d873713722aead5703cb10af6066ff45fe74bb68822fb0275a7a,t,21000,2319157,,5000006,2018-01-30 13:43:25,72
0x23b659265275c19353cab89e4da52e3c330e376275dca821c58c276fcbd4f81e,t,21000,2340157,,5000006,2018-01-30 13:43:25,73
0x49e2be61667736709c64a71b35f5ae76766a74e4de5e546f6b3b168662e0d51c,t,21000,2361157,,5000006,2018-01-30 13:43:25,74
0x874925bb908d0f387ef85bf6a062b6d3b1efea4dbdf47e2ff3366361998a0450,t,21000,2382157,,5000006,2018-01-30 13:43:25,75
0x246c89edf5d578a773b3a468f6ddcafc82e8565d6623543309cbc24354b11fc6,t,21000,2403157,,5000006,2018-01-30 13:43:25,76
0x15fc2be62b007f333a486fa48aa94f19fb2828e8fb9ae049ee23a99f4b057bb0,t,21000,2424157,,5000006,2018-01-30 13:43:25,77
0x8106211fb49341378c9a076d0f1dc720dd4a5dcdd315f0492a1b3996a36054b1,t,21000,2445157,,5000006,2018-01-30 13:43:25,78
0x4d43e0bc9fe02387f0eb7d8f19a49305cbff950139cdb7c0f26463439f0febb8,t,21000,2466157,,5000006,2018-01-30 13:43:25,79
0x7e7ce278f99ccb2b42db4ec42653b83384c28069aae8bf9dbcd0b72a6b884991,t,21000,2487157,,5000006,2018-01-30 13:43:25,80
0x7391ab3ba389497be8903ef9838e5f23ec54b97963bd485621db8bff38df4333,t,52222,2539379,,5000006,2018-01-30 13:43:25,81
0xa81e41d8cb326c1b0ba9dcf2591beeac8a5a65a0aa166d2d58a3b16cce501b4f,t,21000,2560379,,5000006,2018-01-30 13:43:25,82
0x4d0f58c9f3a6fc70da28a4d6f449a49c3837c786860fb80aa0c6a8a230e0e168,t,24090,2584469,,5000006,2018-01-30 13:43:25,83
0x37d5c90b709f77bd5205ea48e586d4c8aba4197a4e54e97cddeae2abdeb31c0e,t,52859,2637328,,5000006,2018-01-30 13:43:25,84
0xfc9dd5f3f742027bbc4365aaa0b2e6ba372c24a8e561f4387e7b69bc72149b6c,t,21000,2658328,,5000006,2018-01-30 13:43:25,85
0x114afe295ba1977f2cf96d9ecbd1379fb0be5981c72d6db3b45a26522ed0e88b,t,55715,2714043,,5000006,2018-01-30 13:43:25,86
0xa4529614fed222d0f377ec64eadfa0a6b3ffa084cbd108ca5ff82f8c5527b2f9,t,21039,2735082,,5000006,2018-01-30 13:43:25,87
0xafe34d22d6f34d30f73b965feb446feed8d5d059cf6492ee87523f6c86dc9099,t,21000,2756082,,5000006,2018-01-30 13:43:25,88
0x2430ccec08623d42670f61eaad88e5f87e6f433462eb93a901c7fa73e02ac1c5,t,21000,2777082,,5000006,2018-01-30 13:43:25,89
0x4a427943b2c41e8046833dcd4c9ff6301685cb616f284c658bd63b9cd03a5b3e,t,21000,2798082,,5000006,2018-01-30 13:43:25,90
0x3590e7a6cff806f9e54a80f50ac853cfea1973f5ca000185cbde8765e886cc02,t,21000,2819082,,5000006,2018-01-30 13:43:25,91
0xe1581fefb2af3b60309503944365b21decef52510599631abb912159b830931c,t,21000,2840082,,5000006,2018-01-30 13:43:25,92
0x0f4359f3a40855985557ab24ace2c9c254e6f2b738c47082d7d7698c12e31d94,t,124884,2964966,,5000006,2018-01-30 13:43:25,93
0x55a7778e4175ad6f35f064821a313bcae361e57680e513e65d711445a5784304,t,40907,3005873,,5000006,2018-01-30 13:43:25,94
0xd961b774ed7e13dc74a391e0e85f89d534198c842917f4fcbfd2a15eb99a0e91,t,21000,3026873,,5000006,2018-01-30 13:43:25,95
0x7f4f4587ca444477d38b8578089b67ae0cc837c53a660a9acaa24440ac2cbee6,t,21000,3047873,,5000006,2018-01-30 13:43:25,96
0x72808f85c05e57aaed95f8be7ac2d9e8205177c00389e1734ca128211dd7766c,t,21000,3068873,,5000006,2018-01-30 13:43:25,97
0xdcb72e27ecc542eace98e98fb8a24944a25b23e413e7922d81c1a72fbc846052,t,21000,3089873,,5000006,2018-01-30 13:43:25,98
0x2b536209671d94f4f3f6ed795b779a28e5c17407355da82a48acd35cbf6f74e9,t,21000,3110873,,5000006,2018-01-30 13:43:25,99
0x420c9f6124110a5e4dec77fc01904db33bbd7aebf216b26ddb7f001e8434406b,t,23112,3133985,,5000006,2018-01-30 13:43:25,100
0x1b1261374c288435ade78d5a8afc46cd820fed574677097f2d29201d9e7cd87a,t,21000,3154985,,5000006,2018-01-30 13:43:25,101
0x8c16bafa6d78a29d7814801b8b91818fa208fabdc3a6b1647a8f279a4c55fa4d,t,21000,3175985,,5000006,2018-01-30 13:43:25,102
0xc5c3c5fd7a1bee65a24e5b69cf0fd1b4490e35cfd3996f815b7157a93e2abecf,t,21000,3196985,,5000006,2018-01-30 13:43:25,103
0x61330d7a83dcd431b0b175a03eae16d3554c649bccb16a48b8d466a9b1238772,f,25091,3222076,,5000006,2018-01-30 13:43:25,104
0x560637aea24785edd30b4d979ad8878b393134e23ff32f8452c342455ce8b3fe,t,21000,3243076,,5000006,2018-01-30 13:43:25,105
0x6aeeab67ceb22c4a5690f8b021b575b101ae31c179a2ca84e4cea34608b8d626,t,21000,3264076,,5000006,2018-01-30 13:43:25,106
0xc94eb63897709c3629b03e49d7a5e1fbc1a64f1595aa115e95a057918020985f,t,21000,3285076,,5000006,2018-01-30 13:43:25,107
0xbfa054931274220421bcb3019166be130d9503785232f3da9db4ecf27d363241,t,51647,3336723,,5000006,2018-01-30 13:43:25,108
0x8911ca2de5c0648ad8380d76a15d719f2462de10c9d5d3084aa80c9b7648a736,t,37203,3373926,,5000006,2018-01-30 13:43:25,109
0xcbfbd5ae88a3e972e2ba53d322f727ddd04bfa607dd3188391ca1af5f933edf6,t,58593,3432519,,5000006,2018-01-30 13:43:25,110
0xb28ef26b07dea197e72945cc1074738cdb5c07ae35a06f5ada54ea33bfa6e523,t,21000,3453519,,5000006,2018-01-30 13:43:25,111
0x552f639cb3170c3e0effb9f2f8215d45e4133e3eb23ede29ee66753ee39c85c2,t,21000,3474519,,5000006,2018-01-30 13:43:25,112
0xa6ab1fd6ba69eeebe299d6f62b0c2f5350bc35ed8ccbf52016e4b6bbb794ee63,t,31005,3505524,,5000006,2018-01-30 13:43:25,113
0x736fc044dc3336fb8a28eab1ab390b0a2a21c139b7ee8006bb8c1b00312afa3d,t,21000,3526524,,5000006,2018-01-30 13:43:25,114
0x91d304eb36f1cf221444596490f688b6c31f98d23d5f2b376b78ba4e5509a664,t,21051,3547575,,5000006,2018-01-30 13:43:25,115
0x0220be16fe77620da634831d78b7b2d67887c07b96d08d1f91d060ef404802c9,t,21000,3568575,,5000006,2018-01-30 13:43:25,116
0xf084ab0a3f5f88adf63b3cab5fee4af7df345f3c3bfd2079f38fdf862e1eafb1,t,21000,3589575,,5000006,2018-01-30 13:43:25,117
0xc81d9daa74522f3f2dc5c558c9f49499b15b2dd1537fdfd666e39b869c8e11f7,t,21000,3610575,,5000006,2018-01-30 13:43:25,118
0x591daa4e04244b866c5dc6d88774a13c959995e0c12fa1e1592adee56e7fa8b9,t,21000,3631575,,5000006,2018-01-30 13:43:25,119
0x43db8425830baf886c2c16d8225a40f0adabaf160420aab6a122245a093cb76e,t,21000,3652575,,5000006,2018-01-30 13:43:25,120
0x0c2fdf49c1f8dae610db4d80063bd98512d08dc9aca78f38c5df77e4e50442b1,t,21000,3673575,,5000006,2018-01-30 13:43:25,121
0xfe3159cf1492eb19736836b4759adda1480101194adc7a0bbee203bc2050613b,t,21000,3694575,,5000006,2018-01-30 13:43:25,122
0xfe753a6a99e3acbda9af4028f769539750fc2907b501b5faa570b56097e5d12b,t,21000,3715575,,5000006,2018-01-30 13:43:25,123
0xac3545ecb15345df4ae0b730379b46772d61a70a898da709634e8ca886b12da8,t,21000,3736575,,5000006,2018-01-30 13:43:25,124
0x65448371cdb4a008f925568f49c29699601d6254c9497a7f4c4c39d941e81fcb,t,36682,3773257,,5000006,2018-01-30 13:43:25,125
0x52a8bfef9cc51e31c84e10ecd32f82593634bdb4ac0e7520b4cf30b5251ea8e7,t,21000,3794257,,5000006,2018-01-30 13:43:25,126
0xe8cceaec87659c2dcd02f8a98b5ef4747b58afea9a39bcf636ce40871017d87c,t,36789,3831046,,5000006,2018-01-30 13:43:25,127
0xf7a0e601dfcff1bee7c7b841ae6c262328a3e130b2341bc0c5b1aefa9df5d988,t,51789,3882835,,5000006,2018-01-30 13:43:25,128
0xc3be4c6aa2ba2e98141d00a9e0f2c4252faabfca1bd1d0d02ff4da171c4b1c1f,t,51853,3934688,,5000006,2018-01-30 13:43:25,129
0x408a9c13abc244ef5808183a555e199964100e42997989b19ee2569857a71049,t,36789,3971477,,5000006,2018-01-30 13:43:25,130
0x09415228e9a7fa66d9b934612a2c5b70131750bcd36fe17f25ed83cf02fd0bd8,t,51789,4023266,,5000006,2018-01-30 13:43:25,131
0x5d853b1147f6dae0348b0ee340d732acfe5ab08b129e957c47eea021a1a7ac97,t,36789,4060055,,5000006,2018-01-30 13:43:25,132
0x0f0a3dd64e4f7d012a3c3232f1863946ed8b9b1a5283e184a0086b2f1302d1c2,t,21004,4081059,,5000006,2018-01-30 13:43:25,133
0x438f3e1db27ea0dfd5bc9afe0f8684a47fb7fe94370325d4da97fad187ab6349,t,22088,4103147,,5000006,2018-01-30 13:43:25,134
0x17cc24302c6eb664b29a86f97612ddd570d144f5e94ac142d34eb3132894615f,t,36878,4140025,,5000006,2018-01-30 13:43:25,135
0x2cac19886362e5d3c812476f056d0d8ae01afb9c833b3db5bb65e460e082b6ac,t,38233,4178258,,5000006,2018-01-30 13:43:25,136
0xcf9d215709e21ca7c7a280614fc66d754ebacf151cfbf3a0173fbc285ae6182f,t,53233,4231491,,5000006,2018-01-30 13:43:25,137
0xd199ad5ad7233a672c5c6c6f8644e0abe58b8304a2af62b863c69db6b1b46014,t,21000,4252491,,5000006,2018-01-30 13:43:25,138
0x8eb456d6fdb232eb4d374086cc754bb20f4d20c438969a89abf38a0c129f305a,t,21000,4273491,,5000006,2018-01-30 13:43:25,139
0xec8647e704464c2a190c060ec7926e64861a8a1b45fa59b04b556322ae60d8a6,t,21000,4294491,,5000006,2018-01-30 13:43:25,140
0xf5ba9ba427f96263ba34e9c828f0823c620c3a5434758c89cb214318cc6e6b43,t,21000,4315491,,5000006,2018-01-30 13:43:25,141
0x1532ec830f77bd5da6353af0bfc68167e00035d23435b0e86626a2d45d8bdec2,t,21000,4336491,,5000006,2018-01-30 13:43:25,142
0xe912eb01fabf9b7f3af0191a1e76ca008b170688dd9970c0b74bb917b14930ad,t,93518,4430009,,5000006,2018-01-30 13:43:25,143
0xc96d440185d9b645d6a092142b8c62057f9c359bd5e9e54a68b3e53b7e3db2e2,t,157964,4587973,,5000006,2018-01-30 13:43:25,144
0x25ddcbbe0abf8f0663b45833b356ac38a4ae5e45bddcdd8c0350dd2d9fd96acb,t,142900,4730873,,5000006,2018-01-30 13:43:25,145
0xfb6b5c400028a20d0bdfa5ac036591cdf6f848a9a5412cda92c79e1ba33b8d67,t,142516,4873389,,5000006,2018-01-30 13:43:25,146
0x8b60b43887b29be03034a51f7f212239b8ade6f57ec4693b124e9f0a9d2ff054,t,127836,5001225,,5000006,2018-01-30 13:43:25,147
0xda023b581cf26de94ebcd6f83371b4a6ec73f5c3d2164c782a08c6056c31eee6,t,142772,5143997,,5000006,2018-01-30 13:43:25,148
0xc800f40d6f9785134461df4bd6cbfdfa195363385aca88dc45bc3ae82b318df9,t,142708,5286705,,5000006,2018-01-30 13:43:25,149
0x1ec2610be1dd3cf6cc3c153e0aff957bf7912cf2cbee72860a5a206470c8063d,t,127644,5414349,,5000006,2018-01-30 13:43:25,150
0x16d0770448cff5f5d87ad14e8ecab838cb99f4a834e991dac049bc6664575c2c,t,142644,5556993,,5000006,2018-01-30 13:43:25,151
0x65798b1140d2a513a8ce482096e746ed46f5ddc2ccb97af7f6196d96303afd37,t,21000,5577993,,5000006,2018-01-30 13:43:25,152
0x142a68e4237f55c3216396d43391c104587c11280231ae4a58949db8a9575364,t,64725,5642718,,5000006,2018-01-30 13:43:25,153
0x8b14c8880ed64c603436660fed4fe833b8fb7f5d2b8c6e339ae7dd9d8b82e5cf,t,52852,5695570,,5000006,2018-01-30 13:43:25,154
0x6593ddf6ec56084a95e0f888a0171b11cda158e6e721f727ca4bb59a6f52ef9c,t,21000,5716570,,5000006,2018-01-30 13:43:25,155
0x2c19c3d72f9e38f2d9106b43f912ee73adde4e0477ee62f627388861a52b5352,t,52460,5769030,,5000006,2018-01-30 13:43:25,156
0xbfc0492c629c20fdb77d56b11906fe4b7231e3150035b0169c5821f46ca65e09,t,21000,5790030,,5000006,2018-01-30 13:43:25,157
0x368c9d2365c4cf08e865b259f1239c2d16422743fb5a83fb5a65f9112672bafe,t,21000,5811030,,5000006,2018-01-30 13:43:25,158
0x6a377a2c818a5dc0478b4cd0db5121f5e5ff28f971ee23634d3c1b662c8f6293,t,21000,5832030,,5000006,2018-01-30 13:43:25,159
0x0d08e7ea10ca900208b458ff3f1b8efe0408954ef8a7e32c66858e828c0fb271,t,21000,5853030,,5000006,2018-01-30 13:43:25,160
0x5c4cc248c8a370af42d9bb34953765add231dd53e40733637a1694aa44536ab8,t,21000,5874030,,5000006,2018-01-30 13:43:25,161
0x008ae7aeb0914f0f2d2917fbd285751a072bdd4e214d45538ecdd344e3df1701,t,253854,6127884,0x81f798aeFD256a56F4c3ff1Fb3FA678C128dce55,5000006,2018-01-30 13:43:25,162
0x69ad58bb4ad154d15476500939b4b4c3993745c89d797ed08b4680b1cc845a27,t,253854,6381738,0x5EC23208a9Fe668118578794021dFa0983cE5A8a,5000006,2018-01-30 13:43:25,163
0x6f3e87c6b9dfde2fd4dbbee0b84e072d165695b5e80f6aad3e3a943e721976c0,t,253854,6635592,0x67ce27e3687099E4145a01eF91304531a4f29fEB,5000006,2018-01-30 13:43:25,164
0xc53dda75015cc8eb201d434f4dbc507052ecb6ea8943abb407fc4a26b1a4689e,t,27437,6663029,,5000006,2018-01-30 13:43:25,165
0xdd63fc77053ff9c1cad7abf1cb24c08b5d8f7c88c12e749dd498766c330c340a,t,26262,6689291,,5000006,2018-01-30 13:43:25,166
0xcaa911db951fe251a12ac89dc070395df763290f14165daa914a9fdad842029d,t,27450,6716741,,5000006,2018-01-30 13:43:25,167
0x1d2abe6418b2423469f6a3cf44e06c506d9d6427e66bfbe8fc296a9efd86094a,t,30449,6747190,,5000006,2018-01-30 13:43:25,168
0x896170c0939de1aebd007af0d32647cfe830fdffed2c541136a0c6e598a4c741,t,30449,6777639,,5000006,2018-01-30 13:43:25,169
0x4579639223fe3c0fcf612ba3aa62237ea8131597b2654f5259ecfafb5f62e940,t,30011,6807650,,5000006,2018-01-30 13:43:25,170
0xafc7af0571936399f0d0ad37fa9ba9f451f8d86db79a18053deb190ff1a434de,t,21000,6828650,,5000006,2018-01-30 13:43:25,171
0x8bdb9f78a4e25f0229cbfbc793307f90a349250c52fd87a0d47aba9b13b066f4,t,21000,6849650,,5000006,2018-01-30 13:43:25,172
0x920fdab00e13bf5f282b4dc2d77792e451b2b3cc4ee0eb7586e4bafe2c2b3223,t,21000,6870650,,5000006,2018-01-30 13:43:25,173
0x6a033f196a560ad2c6b2b40ab94d7687bcad8b9c28a33a2109669c91e98890bc,t,21000,6891650,,5000006,2018-01-30 13:43:25,174
0x626e4c8027f61861b0d188f06a9d309c574b64ddaea286f279018e93b5365e20,t,21000,6912650,,5000006,2018-01-30 13:43:25,175
0xc37f50b90787ee184a639b8347c8738d0826a5d8dd2eadc32d24954bbfbe33fc,t,21000,6933650,,5000006,2018-01-30 13:43:25,176
0xad128b157bfa51c0bcf6e5501df65a151d74ad0c6dea01f055b29c2013ee2ce1,t,21000,6954650,,5000006,2018-01-30 13:43:25,177
0xa831fc851d23d5eb397032877d3b4ba7fa0eb435e471813318c9d2d26c5d36d7,t,21000,6975650,,5000006,2018-01-30 13:43:25,178
0xe7b960c973572c2e89f0ca574783c77560ffdf15b2bcf0529c850c7e8fe63b65,t,21000,6996650,,5000006,2018-01-30 13:43:25,179
0x04fd89efe70e8515b2237ec056df2d3b2fada75c93b35043eef15fa957568550,t,21000,7017650,,5000006,2018-01-30 13:43:25,180
0xb83e07f858588a4b81254cb546ea0f8ce073ad5648598b72c576cde46462530e,t,21000,7038650,,5000006,2018-01-30 13:43:25,181
0xac82acdfa799286721fd3e8317024dcb83504ba688ddfca1cd67988c5976c6c4,t,52886,7091536,,5000006,2018-01-30 13:43:25,182
0x58389e78f74eeddb8d7b50f1b7b95be3595717d2c59288b1d7e808ae3d8ab953,t,52886,7144422,,5000006,2018-01-30 13:43:25,183
0x7b249cc8cd49896e3eac0ad133ef201fa51fff3741db495d788ba3ef86d3a3d2,t,52886,7197308,,5000006,2018-01-30 13:43:25,184
0x8706b59955960a36cf1bd81f287fc86e05ecdef2fe046eb9cfdd83ddccf7cd0a,t,52886,7250194,,5000006,2018-01-30 13:43:25,185
0x85fafc1a6b9c0b2e926373c9bd48dde0d1d2f00a45443237cbb58f3fa20d2d3f,t,52886,7303080,,5000006,2018-01-30 13:43:25,186
0x00ba19eea021a322da881c38216b0e6a57a996a3246b57487be112a0451c080a,t,52886,7355966,,5000006,2018-01-30 13:43:25,187
0x7d3939f7ba7c130459f686b16ce55e18d92255860606844324ede77d87e25751,t,52886,7408852,,5000006,2018-01-30 13:43:25,188
0x860bb6760ee6c09b5164fb1c974585618ebc55acfbed24ece65c758cb297fdfd,t,52886,7461738,,5000006,2018-01-30 13:43:25,189
0xfffe12a7dde2dbc21056352619963fdb14c61cc5e2c5ec46e3af58c8841543c2,t,52822,7514560,,5000006,2018-01-30 13:43:25,190
0xe4300c07f68175c716c1e35222a47a595fa91903421a8f3dfcf5d275155ed32a,t,52886,7567446,,5000006,2018-01-30 13:43:25,191
0x4a6c84f51f6881ac3dddcf719d29494c21147988c46ca49aae51835f99fb20a5,t,52886,7620332,,5000006,2018-01-30 13:43:25,192
0x074f5cf21ca69a73a241d32f10aeb3efce61bdac70445827adbced0cacd858c0,t,52886,7673218,,5000006,2018-01-30 13:43:25,193
0xe3ff5226e68c29d50e5b6e0f5f711789f38af29a4feffa4b299229054907d298,t,52886,7726104,,5000006,2018-01-30 13:43:25,194
0xda4123577705842cf266f86750a4809bb6b9e371ba89b923cdb0178656c004df,t,52886,7778990,,5000006,2018-01-30 13:43:25,195
0xd0f3e9d302c13a6ca9e21ce3708e0ce5eb3307b28dfa3941f060a43caef8f169,t,52886,7831876,,5000006,2018-01-30 13:43:25,196
0x6d2ca04521fb3c0e2f0ddbfc9909c3ef7c538e54f218e5c5d8a08a19f138be72,t,52886,7884762,,5000006,2018-01-30 13:43:25,197
0xb6b479860f59ea1072192cb68158f331782e75fa0d52348555ff1d2d608d2356,t,52886,7937648,,5000006,2018-01-30 13:43:25,198
0xfed2fe2fc13ec4e2181d86a9e39ebb7c694451d36b5e884ec7ebb0b78792482d,t,21000,7958648,,5000006,2018-01-30 13:43:25,199
0x0f237572198b8ec6c9e020e68e6a2c358c5ef3de8f69f428db69f3b4cc01c9a4,t,21000,7979648,,5000006,2018-01-30 13:43:25,200
0x5587ee7576c45ffc0b2567ad68182d67c3c732008507c0b0abb8c63b62276842,t,21000,8000648,,5000006,2018-01-30 13:43:25,201
0x8a901062d6c7e08362c8625a0c3c76aac2c00200ff8de3b4d666fffe64b90d40,t,21000,21000,,5000007,2018-01-30 13:43:32,0
0x3ee0a03fb0a93494989a4bb83b3582472adba9dacb735832cbac690c2a9cecf3,t,21000,42000,,5000007,2018-01-30 13:43:32,1
0xc967426197165ead5f44072d12a0fa0261183fd12c0460df901bb9ceee145703,t,21000,63000,,5000007,2018-01-30 13:43:32,2
0x4ccbd91a2028b0c6da67df6ca1880573a9023d0b90fcc15f10340c869b81d609,t,21000,84000,,5000007,2018-01-30 13:43:32,3
0xb232aed65051bcf9d3974a6d5323837f489b111b059759e2785123248d3e7840,t,21000,105000,,5000007,2018-01-30 13:43:32,4
0xb2d98557bb0017236c5d48af96189e5f3c6b2a07d265f7a1e182b45ba86393d3,t,39512,144512,,5000007,2018-01-30 13:43:32,5
0x831c2de1188d40d4dba6431de1ebc88098e8d497d0f82ad125e18819828339e5,t,21000,165512,,5000007,2018-01-30 13:43:32,6
0x890eb69ac2b7d194d2c9b49ff92252ff8e689160c38ce547053f56498d6771b8,t,52886,218398,,5000007,2018-01-30 13:43:32,7
0xda4dbbd1c3af973e58b33da078f391fc71a0df4f33c42c64dcc5bcb5068b373f,t,36792,255190,,5000007,2018-01-30 13:43:32,8
0x5bd627d0442baccf48ad52d21121d7cade9a35c4626e8569b3a1f14bd60d8e12,t,67588,322778,,5000007,2018-01-30 13:43:32,9
0x702b19fb979258aefaef01ea626bd6a346a5430f1d7e221e3bb0d23acb9d23d1,t,21000,343778,,5000007,2018-01-30 13:43:32,10
0xbf1d871d31a06dbdbab1a34d8fb2c3b79c6acf00393b77c6237be40a03bb5772,t,38319,382097,,5000007,2018-01-30 13:43:32,11
0x77d473de85035864f17e7156dae731c5d3a4377d02531a1b341531d7b7291364,t,21000,403097,,5000007,2018-01-30 13:43:32,12
0x36638c737dd72adf992bc26055b763e78c1c816e12ab3b1dcbeaf233024682b6,t,21000,424097,,5000007,2018-01-30 13:43:32,13
0x65fb46af65e7d5b7b81ecf471bec5eadd39a3dd439bdfd17df12020f4f322e73,t,21000,445097,,5000007,2018-01-30 13:43:32,14
0xab0fe595ea80a0cea3b6cdb95e811181cc2b23c37bfca0add896c1685af2b885,t,21000,466097,,5000007,2018-01-30 13:43:32,15
0xf408d93f4538bb7cbf688585ed41bede45632398eccc6fda5d390dcf9b8e5ff2,t,21000,487097,,5000007,2018-01-30 13:43:32,16
0xffa5c964375b4b816c9622a779873ba5e47fcd880dc1db20691d0d0a5bdcaf70,t,21000,508097,,5000007,2018-01-30 13:43:32,17
0xa843b329e8ed76a5766558b78846f8aa71551099a087ba643ab998fa781055ec,t,21000,529097,,5000007,2018-01-30 13:43:32,18
0xcd298db3d594796b4cd1b8818c24489316307bea4618d9a4aeeb3b48bd73d15c,t,21000,550097,,5000007,2018-01-30 13:43:32,19
0x542eedaf42707526c202ce50e67ca72818eae425bf8b36a362ff2b261cbdc93d,t,21000,571097,,5000007,2018-01-30 13:43:32,20
0x0e50705036062abc7d241b092a23985f33f093f56657a1c064c98a26eb2dc13e,t,21000,592097,,5000007,2018-01-30 13:43:32,21
0xe529c6d39af5c2ca425e34e5cff3519a62877051d9d5e1bc1560ae4425798855,t,21000,613097,,5000007,2018-01-30 13:43:32,22
0xa2d3c2d2c1a932f0d83b64ea828737e014a8926e2a140e20eb1ba601ca3658b6,t,21000,634097,,5000007,2018-01-30 13:43:32,23
0xf055c59210dd277b770d194c4782cfa4611b08f0c21928fc33581f71160b864b,t,21000,655097,,5000007,2018-01-30 13:43:32,24
0xabbdb46530aad47c26b5ffc943e24349de97cab09eb869270dcffc1ac80091c9,t,21000,676097,,5000007,2018-01-30 13:43:32,25
0x7ab2c2c54e83c7fd37befcaa1679bbb07b5c6a33bf8f04fd9deaa659da80af73,t,21000,697097,,5000007,2018-01-30 13:43:32,26
0xe1bde17bbfc12f05c5e436c86a5193e2a5739baca896ecdd92fc73c911dac975,t,21000,718097,,5000007,2018-01-30 13:43:32,27
0x54a3ad64771f79b137aeb1064ab770145ff422dcdc59e55f7e68e375973446cf,t,21000,739097,,5000007,2018-01-30 13:43:32,28
0x19513c04fdc8aa00a908752cdee91b622d2c61f23657ef24c6e93d292ffde7f6,t,21000,760097,,5000007,2018-01-30 13:43:32,29
0x5fe04ec5e2b2a77d6720721cbd2c3af48f2f7189ad5c027da81d60f326fdc19d,t,21000,781097,,5000007,2018-01-30 13:43:32,30
0x32b3f0ed3125fc6e78fd7b813b5604ee49560bcdbce0c57f38f9933c978ed606,t,21000,802097,,5000007,2018-01-30 13:43:32,31
0x2b624bb52b630998153e4677c63063d520b9240dd80f8e8344a59db099a7c83a,t,21000,823097,,5000007,2018-01-30 13:43:32,32
0x5539a7a234c77e5356dca70513127105f560ae5cd5965dbe6180f6deeabcda10,t,21000,844097,,5000007,2018-01-30 13:43:32,33
0xddb878e545615421a9124d6235fd55b72eddb578c89558fab91f1b203a524fa1,t,21000,865097,,5000007,2018-01-30 13:43:32,34
0x0da336ec45813225cba9ffc895dcb5307d7e8ca05c7376ef91ba1033d90fc49b,t,21000,886097,,5000007,2018-01-30 13:43:32,35
0xc81ed94ac8515eb3c42eaf4bb3b39704a0ac9b0178f7403157decfdc85ef2462,t,21000,907097,,5000007,2018-01-30 13:43:32,36
0xb6daaca65e420683d20ff18e7ac09bff27af2a292fa696e3bebd3bcb15864f71,t,21000,928097,,5000007,2018-01-30 13:43:32,37
0x3f3567d42d56ea5df05e6dfda025a1baa13b72685c9ecd61ece723ede87fb1fd,t,21000,949097,,5000007,2018-01-30 13:43:32,38
0x82ce2ca7c5127dc7a436d36bf3631cb87553fae51ceb19cad830c3757bf9230f,t,21000,970097,,5000007,2018-01-30 13:43:32,39
0x6ba3117be9215271036fb1c68c9f4bbe39ef37f9a1babf44efb31b7962968213,t,21000,991097,,5000007,2018-01-30 13:43:32,40
0x35d1ba0e48a650ced430a11ccead0fea8a8420941f9d4a9931f071e78e16d131,t,21000,1012097,,5000007,2018-01-30 13:43:32,41
0xd7e67271f7e2adc5344c32db2854c1176a35ae836f81e341ebbae053f04fd65b,t,21000,1033097,,5000007,2018-01-30 13:43:32,42
0xe8a049dc5add4c4744390b505732bce8ddf6511f1add125d9d5097dbb9e2745c,t,21000,1054097,,5000007,2018-01-30 13:43:32,43
0x365a5fb89c82b4200bdb9a0cd56cb783ef9fc1d64813a06fbc5923d85f926600,t,21000,1075097,,5000007,2018-01-30 13:43:32,44
0x2d7693cd649a6ef26690c7c0a26711da142820ad6db05961b202109a283d423f,t,21000,1096097,,5000007,2018-01-30 13:43:32,45
0x014d7925e2aba0c6346968a264a6408f65e387e2cfdc21a342f22afa1489c631,t,53167,1149264,,5000007,2018-01-30 13:43:32,46
0x5d75f1345d441f8c4149ad64b6fea3fbe71dd750029b37f9a1509321eacb6703,t,21000,1170264,,5000007,2018-01-30 13:43:32,47
0x112592f8cefb14df2d5fe88231d16255241aee690068fd21573395bdb68530f1,t,21000,1191264,,5000007,2018-01-30 13:43:32,48
0xfdf97b44540e84f0205a13072c61ec5a15a24fd867f97e84d1203330513d4f88,t,29493,1220757,,5000007,2018-01-30 13:43:32,49
0x4323314f7686138f7eb540dd86f7b22fb56b07ce33b4e711ade5554ad3c2f069,t,21000,1241757,,5000007,2018-01-30 13:43:32,50
0x483cacbc598a988b19d6fba059228d7c1e3685009be94558a265e88be8637cd2,t,21000,1262757,,5000007,2018-01-30 13:43:32,51
0x58705c1286df7a7079f17c2ddee02f43f1017cb4b3aea49b02b766f8f9f8bff8,t,21000,1283757,,5000007,2018-01-30 13:43:32,52
0x85f2c958a896b49ccb34127a716afcd9168742707ee449c3c334bd070f06856c,t,21000,1304757,,5000007,2018-01-30 13:43:32,53
0xb9f7581e4f113ffbc805104b37c904fcec12aa764e88907957cd043d26d50fdf,t,21000,1325757,,5000007,2018-01-30 13:43:32,54
0xa3b903fd27e57c8e2c41b61c72d7144616dfb615f2f3d0794cc847b35f0a9957,t,21000,1346757,,5000007,2018-01-30 13:43:32,55
0x3eefc5ac81434afec6ba82222f2407de55f2e9b719a211fcc52e46c249bf385f,t,21000,1367757,,5000007,2018-01-30 13:43:32,56
0x3a98d3f255c7bb550799fe533670bd4ad4421adff3a43f305662380f923ae560,t,21000,1388757,,5000007,2018-01-30 13:43:32,57
0x39ab9c58e8becbe249042a3a2fef40c3f06a3730d2b88de3c0268cb765ff6bd2,t,21000,1409757,,5000007,2018-01-30 13:43:32,58
0xa9b1b3851c6c051093d097e7912193590283d975eb4030e8d4cb529afd1efbc2,t,21000,1430757,,5000007,2018-01-30 13:43:32,59
0xfc699548f6ec0b3f2c63ef816efa61209c75aeb93840f34507002c29766624ec,t,21000,1451757,,5000007,2018-01-30 13:43:32,60
0x2addf9d58cd45dddc3a9411681925b762d3468cd3b8147e1fdf0225b1c3504c9,t,21000,1472757,,5000007,2018-01-30 13:43:32,61
0x8681b5bf873934705ede3005d5742724eb680ac9c30ccdafd8fd3604dfd6f651,t,21000,1493757,,5000007,2018-01-30 13:43:32,62
0x4967d98508e81b2c442ab26ebb2480b9b226e201e90a930d86a2eedc742910d9,t,21000,1514757,,5000007,2018-01-30 13:43:32,63
0xc6122e158424d04cef60861933429935064ca22a85cf7f53a58de296094e46d5,t,21000,1535757,,5000007,2018-01-30 13:43:32,64
0xd599499a8cfff3fffe0c906cc8abf697b18be70f2841bb1a7484fb9179b00e0f,t,21000,1556757,,5000007,2018-01-30 13:43:32,65
0x43e0359d2fad74f3ba511c79ef24e5db00770a5360f7660bfde04d71743b5e7d,t,21000,1577757,,5000007,2018-01-30 13:43:32,66
0x357a2b1c86ca69104e4700463fab0e957c2bf6a7033e2d276856b5a511defcf4,t,21000,1598757,,5000007,2018-01-30 13:43:32,67
0x7c4553c251d5e13e4d17191ed4e5fd1a148e18ce9441ee4883b7a5aa28f4a9a6,t,21000,1619757,,5000007,2018-01-30 13:43:32,68
0x505dd53b5c8978d77343742bd89b1ab3910e12e8096b518afea8b3bbd1913cb1,t,21000,1640757,,5000007,2018-01-30 13:43:32,69
0xf765391cc618233b35c7035fa59b29c89fa73d7e9c9aeb66cd64a1f491e1b736,t,21000,1661757,,5000007,2018-01-30 13:43:32,70
0x5d12b8eab0aa8a62b9ca4cb03cc01b701b3e49ddb024685f4e43d7ce4717e50a,t,21000,1682757,,5000007,2018-01-30 13:43:32,71
0x9a16db3cb94165dd6cb601d12e0a22eb4045db6031dfafe824365e2f457be487,t,21000,1703757,,5000007,2018-01-30 13:43:32,72
0x4410e0f0be78c654fc1a721bd23b520958eba4f3c46e1166e56dd2c946b2aa08,t,22193,1725950,,5000007,2018-01-30 13:43:32,73
0x15332d64676444e5d4758d113739762e8c4f2ebe88028de9e87c9ecef6b18bb9,t,4679204,6405154,,5000007,2018-01-30 13:43:32,74
0xf99ac0af2e351e1cc0770053e4ffc39bda5976657aabd5ab3d5fa6a7dd06544b,t,21004,6426158,,5000007,2018-01-30 13:43:32,75
0xdfdf780b8c18c041643ef6ed17d194d49fe6ddeb3c6e4ec5d4b3b3305ba15a09,t,47176,6473334,,5000007,2018-01-30 13:43:32,76
0x0181ada698237a4889006583ba2c1fcd5b93a6c1f28a31944341b67c55739d98,t,21000,6494334,,5000007,2018-01-30 13:43:32,77
0x60685bd202507fde719a6803479a40e8bc6960e006eaadbfe2a96d980fac74e0,f,250000,6744334,,5000007,2018-01-30 13:43:32,78
0xc28913fba661ad90312fbe9541c60d22911a7c24a94e41c919cf400b808770f9,t,78242,6822576,,5000007,2018-01-30 13:43:32,79
0x60a1bb356f4421c4299a517b9b602667c07ee8ee4f12161dbbb0834eb55937c1,t,52228,6874804,,5000007,2018-01-30 13:43:32,80
0x90140755c4c9e68999b0469083459555cbf395e5f238514996beb7f0a31b96b1,t,93178,6967982,,5000007,2018-01-30 13:43:32,81
0x4f06e234fd04f56502687a2acec1f5030ae4442c6a8a16114b1d647aedfe233c,t,37622,7005604,,5000007,2018-01-30 13:43:32,82
0xb10dcb6ae69568af21825938e5e5b34a26a59d4268c5f0d4cda46cd4692d56d7,t,37616,7043220,,5000007,2018-01-30 13:43:32,83
0xa9a46515ee7dbad93f356f348c20b209bdedcd0539856237387edb1d126681cf,t,44162,7087382,,5000007,2018-01-30 13:43:32,84
0x1a0ff9f62f63198c462da3ac6f19767ab5f4bc8c897f02787da4d850bf45fce6,t,84081,7171463,,5000007,2018-01-30 13:43:32,85
0x04b52400aad25d4652962341840e35413aca7a0d5c9bbf638cfb6f222cefa5ef,t,78242,7249705,,5000007,2018-01-30 13:43:32,86
0x53922dcf75f0c740af210f4216a3a70d519f8ba91958b6a5d680b56abf5d4815,t,72934,7322639,,5000007,2018-01-30 13:43:32,87
0xe057c35814d585bb403376e7b072026cc32724f53f291a52cfd2c3cf5fd80121,t,36406,7359045,,5000007,2018-01-30 13:43:32,88
0x6c3d44c650e0a4ce4a6351d378d23c5d949aab84c2330ff0946c74b534f04c7c,t,21000,7380045,,5000007,2018-01-30 13:43:32,89
0x688fdae1880debd8ab05fe96e19fc53e311ed32c77e61568986fcc5999670b05,t,107395,7487440,,5000007,2018-01-30 13:43:32,90
0x90d1a0ece010ed3f5e490a078e135b6c66c4e9242331b434f2ceb7ece9d84e5d,t,51560,7539000,,5000007,2018-01-30 13:43:32,91
0x3ada7485388de761204ba00a4c4de92d3651bd8c92e4afb237450c9661ea78b1,t,69836,7608836,,5000007,2018-01-30 13:43:32,92
0x2f5edaee9d40ee5810b5cb22b44a940642f0f4555e1e26e8d994509ce418f978,t,50882,7659718,,5000007,2018-01-30 13:43:32,93
0xccc636291550567be8fb1a7a0731c1f5949c59034c5525833bf1cbb574811e59,t,37504,7697222,,5000007,2018-01-30 13:43:32,94
0x4e4c6bc7d416a2ae0884cc9df1b2a9b4dd4713fc87752f10ed63e5a40ac976da,t,93114,7790336,,5000007,2018-01-30 13:43:32,95
0x66781287c3de47f26718d8c63fafe9a59b96e4c0beb49231b06aa86069166f2e,t,161641,7951977,0xf5BF761209cf411096dBa5Bf19Ecd55d52b5597e,5000007,2018-01-30 13:43:32,96
0xbab63e47c2372be6daf90bd8e50ba477c1f16cb66344c3ecea954087e14e6540,t,21000,7972977,,5000007,2018-01-30 13:43:32,97
0x34b575255213f742c88d1a4783e279f136234dd05c2e45a5590605abf4647558,t,21000,7993977,,5000007,2018-01-30 13:43:32,98
0x9d929548b708d571f819f028405f7fa30facda94b43f2674332c9c1b1d5ac680,t,21000,21000,,5000008,2018-01-30 13:43:54,0
0xf32653a39366ab651772498cd6475e4299027d811e38faf5b1cb250b21a0abbe,t,21051,42051,,5000008,2018-01-30 13:43:54,1
0x40a8c0b9b127c72370b66ab2b58d6d3ad7306cb3b2d73cda834db20bb7767089,t,21000,63051,,5000008,2018-01-30 13:43:54,2
0xe8017a950c5f105b532a72d0024828509dbdc25f894687dbd6f8651d4cc13f4f,t,21000,84051,,5000008,2018-01-30 13:43:54,3
0x5ce10ab5830a2330568e13e278e01fece73fab1b7209ca325c13c257cdd3f612,t,21000,105051,,5000008,2018-01-30 13:43:54,4
0xc12e585f8360616a5fd8e767204d38bf252e4f07b39f7113615d23c4c7eef766,t,21000,126051,,5000008,2018-01-30 13:43:54,5
0x3592ebe5d68bc25ad5dc6ea0466f8700724a3c4e99555837bd21764bbf63c652,t,21000,147051,,5000008,2018-01-30 13:43:54,6
0x0e7a6f0cc7e8adfa45b71a1482695e4724547117a439911896b5f6a7269078ed,t,21000,168051,,5000008,2018-01-30 13:43:54,7
0xf03f925780e0ef3635af8182b8b713c71138527e53a3a7d8906c2086e28a346b,t,21000,189051,,5000008,2018-01-30 13:43:54,8
0x6bbf7811479e90b856d91acd1d623d10e40ba9aec2bfbed7d037db28b4c1cdb0,t,21000,210051,,5000008,2018-01-30 13:43:54,9
0x19cc61d69341e394c27e678a905272df836ed30884b22a52558c2d4c91a476eb,t,21000,231051,,5000008,2018-01-30 13:43:54,10
0x0dc29db3c2a4d50cfb6427db4027a643e2d8ebc674f7b9dd28af83359142fe77,t,21000,252051,,5000008,2018-01-30 13:43:54,11
0xd879fa84a243882b205b7385b55c122e5f3515c8401c9769d3a4e7189c110c93,t,21000,273051,,5000008,2018-01-30 13:43:54,12
0x3b8ce726b603f232c25fd5bd609545cb91b80af779a7ea2cb24acc535dcb04c2,t,21000,294051,,5000008,2018-01-30 13:43:54,13
0x53440986f9c9b5812cd0e45ad27fc1eeaff993d7a5da23c7e94515fea6cdecdf,t,21000,315051,,5000008,2018-01-30 13:43:54,14
0x2f4136f9115f2d4844401736f77f8e9b550e4b499b46998df91eab450f25ec46,t,21000,336051,,5000008,2018-01-30 13:43:54,15
0xacec78717ac98cad847b6b2bf0af8558450da0db425527fcefa01fad5f3faed8,t,21000,357051,,5000008,2018-01-30 13:43:54,16
0x2bde4a13ed85b605fac3661233a77cbc938686d15e29964cb06a2b240c80c69d,t,21000,378051,,5000008,2018-01-30 13:43:54,17
0x44370d7b34485fc876c6a62b5c89da99e7212e7a13d9be0ebd605d8bb1242181,t,21051,399102,,5000008,2018-01-30 13:43:54,18
0x8bf79a6bcf949fa6d2424c81242f2c2081bbcc135b2839660d89e7b78ec60af5,t,21000,420102,,5000008,2018-01-30 13:43:54,19
0x6b98670410c87f8b0e856bc647352b341912120f7637dbc3cce0db8b84b4740b,t,21000,441102,,5000008,2018-01-30 13:43:54,20
0xbac0fa1712656e27cd124b5e9dfef236c022ccabbe59e9d2c8653fa6d479ce1a,t,21000,462102,,5000008,2018-01-30 13:43:54,21
0x619a9168fa1846e0858838c9f51d2478d0ac9d32a0a0b2455371f9edaa568676,t,21000,483102,,5000008,2018-01-30 13:43:54,22
0xd142448332a5653f80f6d21b3699fc2161ec5933ea8d2123ab36430b707611f2,t,21000,504102,,5000008,2018-01-30 13:43:54,23
0xab86b8fd17889af63e2126516786d798124b2115994165404653c1b120d3fdd9,t,21000,525102,,5000008,2018-01-30 13:43:54,24
0x2d4028c2fe249402188f6a9b9ed274674e5f8fccd6d5efb8fec6065c2834115c,t,21000,546102,,5000008,2018-01-30 13:43:54,25
0x5c5eb50c3281a1b79c726a3b6b62764d6013ed82bb95ae15a322b6800c7abffa,t,21000,567102,,5000008,2018-01-30 13:43:54,26
0xb471227041daf56258c1697126148cce47c481e4401d55c825f200a9b5a07c68,t,21051,588153,,5000008,2018-01-30 13:43:54,27
0x0c95e38f839282de11ad3fc2afc84b5b2d882f548f0dd56fc3ba247fbb39c0f0,t,21000,609153,,5000008,2018-01-30 13:43:54,28
0x8f22cbb730c1931e6d517947e00ebb1d316f9f054cb2e8f97660a272afce0974,t,21000,630153,,5000008,2018-01-30 13:43:54,29
0x9e73f10a8d963954159f8453960ec8945d4c0ed520ddf792df3164a86e6541c0,t,21051,651204,,5000008,2018-01-30 13:43:54,30
0xf1c0788a1bd47b6f3eb6e4578b57442cb5f9706012447ad2e62ce148560a5216,t,21000,672204,,5000008,2018-01-30 13:43:54,31
0x02584fc9e26ef690e9869ac957089b441d17e8770d1b63362cb7a32517d0c857,t,21000,693204,,5000008,2018-01-30 13:43:54,32
0x72c81d9ec2b8305e86d37a9487d408ec9e60fc9a248ce34472d04edd81a804b4,t,21000,714204,,5000008,2018-01-30 13:43:54,33
0x434fefb03bcfb4d3afcb6653b69f72301cefd1cbf5e04fca37a151b53a80ea5d,t,21000,735204,,5000008,2018-01-30 13:43:54,34
0x994487b44b29cef222e1f44b82db2f57e0e517535dcf0fa2d7a727cbf5607271,t,21000,756204,,5000008,2018-01-30 13:43:54,35
0xc5dfa139254149f82e21bd288b719029c1a0e7cf0cc28aa5697885b9cd6ef635,t,21000,777204,,5000008,2018-01-30 13:43:54,36
0x20501f04751afaae6033528b98b44e467e693a2b5837122de47eafebf229ad15,t,21000,798204,,5000008,2018-01-30 13:43:54,37
0x2e46a447ed70456f01925e1a182c81d6171f9bab27cccdc6c4b4a782a0b1b3e7,t,21000,819204,,5000008,2018-01-30 13:43:54,38
0xb69dd35c87caa3171b7bea2079aca71f64f7b79785d017d75a7011bd4ab7f7f6,t,21000,840204,,5000008,2018-01-30 13:43:54,39
0xc790f96dc8db243328800a4019c56f67bb28d830e82f979443dbd80b6cb47bd4,t,21000,861204,,5000008,2018-01-30 13:43:54,40
0x37abe95958e8d8a58135bff539fc5b2cf9b69c9d4efcf00ce3432c3ef5489cd9,t,21000,882204,,5000008,2018-01-30 13:43:54,41
0xf7e66b357d813dbd4ed389e67ef10dd4bb112a31b6c367cc97a7f81b88f5191b,t,21000,903204,,5000008,2018-01-30 13:43:54,42
0x58b7a8ce1aa67024e9c7e10f2bcabb7a961eda89af05451e04aebe9671a65abd,t,21000,924204,,5000008,2018-01-30 13:43:54,43
0xbf93a4c689f1653b68413118762b788db8207f33a65c8291a5844b2de9faf871,t,21000,945204,,5000008,2018-01-30 13:43:54,44
0x6d3b0d4a7d17dcd061f974f7d47de1ff0ce951c58cabfe5eb08aecd885ccb1af,t,21000,966204,,5000008,2018-01-30 13:43:54,45
0xd5640f831fac50df0b63fc79d16e0bedf14df1f7e5fa76936bb6ad5cbabdc5c8,t,21000,987204,,5000008,2018-01-30 13:43:54,46
0xe258cea523bb95dbe749250f915349c43f62083a579f5780aae251dab977d32e,t,21000,1008204,,5000008,2018-01-30 13:43:54,47
0x404a932cc8c820fc39033b6944bf968851814855e5224a5f3709f6d5e3b4d0b7,t,21000,1029204,,5000008,2018-01-30 13:43:54,48
0xe8b791cc08a19b29ca1f8ffebdbace7cb38ed28e82071ab3cb2022e6dff5446e,t,21000,1050204,,5000008,2018-01-30 13:43:54,49
0xd22936af0639ddcdd0f4b5657caa42e534391c98e80c3077fc0c7fb6e6e3487f,t,21000,1071204,,5000008,2018-01-30 13:43:54,50
0xdfed5fd8a65102e8bc4f9998c0964f9bfc9f4fa1c11737734eb3b20a1ca2a7fe,t,39512,1110716,,5000008,2018-01-30 13:43:54,51
0xc761803f20d6ab2bb6d955b6191c161330069f4dfb3fd1ddbfbe4f70b1ac7582,t,39512,1150228,,5000008,2018-01-30 13:43:54,52
0xd53cc78955a9ac8a51373951a5926f382a6e8acdb728254ca9d9bd6fee0ccbfd,t,21000,1171228,,5000008,2018-01-30 13:43:54,53
0x26745f3dee00b1b61d4cade939f50778b0da11283733a62a902d20e9c4f86b84,t,21000,1192228,,5000008,2018-01-30 13:43:54,54
0x7edae9f830de3720e3b66054fd8b4a6cf5b2c4328a7df3a3fad7a3d761a4e3b7,t,21000,1213228,,5000008,2018-01-30 13:43:54,55
0xd0be27cb6810fff9b1c1a68ae3ca5adf030e390e793b36767ab7867949f39685,t,21000,1234228,,5000008,2018-01-30 13:43:54,56
0x66968834b784f4c5a94021909648b88ba582baffd424f3e6a5b509447db64142,t,21000,1255228,,5000008,2018-01-30 13:43:54,57
0xc689b57ef05682b442a7b3cf852b3b241a888bb4ba899c7f339a03def38f381d,t,21000,1276228,,5000008,2018-01-30 13:43:54,58
0xc34fe080c628ce127b2b3b0a97346e428638fa53f8f14bb3f73a3dab7b0a76d8,t,21000,1297228,,5000008,2018-01-30 13:43:54,59
0x715bcfeb9d35fa314002f0408d0cf1c2e771dd4d171463e511d964c5de22d430,t,21000,1318228,,5000008,2018-01-30 13:43:54,60
0xf17bc43808b4e3bb19b47629f38a276f5800e738c49e77f61c14c53d7d50d7b1,t,21000,1339228,,5000008,2018-01-30 13:43:54,61
0xb16c7ed4e7be38d5410d3dda742acdc7087e40f2c73c5f24e3994f29790c03ab,t,21000,1360228,,5000008,2018-01-30 13:43:54,62
0x270ff36fea34c7cbaec0140c7ec2df412c36ff2c57fb311b4e39b54cd98a3364,t,21000,1381228,,5000008,2018-01-30 13:43:54,63
0x5427c1a74a4b6ae6d796084e22d75c6a65a5c0831ddb7cfbc4529adcc9a83ced,t,21000,1402228,,5000008,2018-01-30 13:43:54,64
0x3b3206099226421f2f380af0af92f009c7c9b04177952af7f0f9660bb2449fe8,t,21000,1423228,,5000008,2018-01-30 13:43:54,65
0x3995472c0ec8b98d81d48d32cb721cfff364daae4a322b8ece918df13a016c5d,t,21000,1444228,,5000008,2018-01-30 13:43:54,66
0xa5bbcee45532ace2dcab95782e84ca3ab00d7f08d128e5e26dfa8cb74ac3fcd6,t,21000,1465228,,5000008,2018-01-30 13:43:54,67
0x9dbc1e669eb2c5858f658beec2b74d6acb5aa572f80e14f0ee02c07536f7a517,t,21000,1486228,,5000008,2018-01-30 13:43:54,68
0xe48fbdc83366d393271cb094bd1f8084d876cf278aa3ec365f20ad6917bd7457,t,53526,1539754,,5000008,2018-01-30 13:43:54,69
0x99619bf1faf65045f0d2393d5cd9ed2ba44c55494ca1658491704afa6d70069b,t,37065,1576819,,5000008,2018-01-30 13:43:54,70
0xdc41ced90fe03508d6508498841cfdfb7f5c09d2bcec283c2ed11da60ca33c06,t,21051,1597870,,5000008,2018-01-30 13:43:54,71
0xad7fcf5cd2d9ac4778d5fbb79c09ddc1d1eb9dea18b9822965e0bbaf57998b6d,t,37848,1635718,,5000008,2018-01-30 13:43:54,72
0x3f496f7dc7d4f94c5dfbec71ecea276e31c3dd56389a98667688a91addbd79cc,t,21000,1656718,,5000008,2018-01-30 13:43:54,73
0xf3feacf3aeb0750888b235b90d8e3eb12630ac12c0616905460e93b2074f6c01,t,21000,1677718,,5000008,2018-01-30 13:43:54,74
0x5a88a369a4f40e42c71ae90bc3fc7801602359eb1f9f43eca6d5904afc730c0f,t,41337,1719055,,5000008,2018-01-30 13:43:54,75
0xd5e71fad984779371c71c464afeacd40318463780fd166eff3fe822337d019d4,t,59354,1778409,,5000008,2018-01-30 13:43:54,76
0x6b79642d813cc0e717334c7bb59c9e1a8f08b6ab7f4eda602cdd9465c93333b5,t,21000,1799409,,5000008,2018-01-30 13:43:54,77
0xad387bc97342769e6b5099304c7952a3164f33d28d8b9c3353ab162d86f3845f,t,21000,1820409,,5000008,2018-01-30 13:43:54,78
0xb47c718d0d22c2de3f64d11d38ab35f2001c6d276754bce41d4832c43e1ca775,f,28960,1849369,,5000008,2018-01-30 13:43:54,79
0x3bde66974e8f44fd92ae3adf161b44aa2ab94b5efcc27ebd1c9e22d28d1e4210,t,21000,1870369,,5000008,2018-01-30 13:43:54,80
0x1e085cf3297e12c0a656ac1068527ef38bc39ab93a057d1238bb96bbd21e853e,t,51545,1921914,,5000008,2018-01-30 13:43:54,81
0xff19a9b5aadc3c3f2d57d9693cfc9875fd5bc31e4f447395428a9582555010be,t,38679,1960593,,5000008,2018-01-30 13:43:54,82
0x60f9d435ffe25933ab24d79b42bbb78ead6021ed6bc36e395c47c98d83a84d92,t,21000,1981593,,5000008,2018-01-30 13:43:54,83
0xd94c4601baa646e0aece5911769743e3f02d2088202bad6df9584f682962d2e7,f,40000,2021593,,5000008,2018-01-30 13:43:54,84
0xb385e2235bd818da20267773ef98f8800921ecdb93afc7edcdcb99a753d1d228,t,21000,2042593,,5000008,2018-01-30 13:43:54,85
0x31bca9c8291f65824e500c3ef587953f4e110b952acbd8625fcf02a295304841,t,21000,2063593,,5000008,2018-01-30 13:43:54,86
0x0bf740776777785dc9d24d7819bc7737829c6633854720c027c0ba1f35c98027,t,21000,2084593,,5000008,2018-01-30 13:43:54,87
0x390da90379a44467c991557c9743428b89be498297898f7da26882dec2b4cf70,t,49725,2134318,,5000008,2018-01-30 13:43:54,88
0x18026ea714f4206644d29b63e6caeb6fd3d8f8761604a6647f3302c94ed0668e,t,21000,2155318,,5000008,2018-01-30 13:43:54,89
0xe7cee2fd57bbeacfedd1e44fe0a0e177314efebb85fd069fd776ac028857d1bf,t,21000,2176318,,5000008,2018-01-30 13:43:54,90
0xecf8937abc95322538ac0f5e7987fc0a6c4cfa7e4ceefe9c8b44ee511273bf26,t,21000,2197318,,5000008,2018-01-30 13:43:54,91
0x6eb82418ef08a103886050b3ec7aeef606a2dca3c4e33d7f022d483b5e97d837,t,34725,2232043,,5000008,2018-01-30 13:43:54,92
0xe23067998500f9a5b9a1aa05c8c9da2248480cdf14ef924c6edffcd12418a6e6,t,52848,2284891,,5000008,2018-01-30 13:43:54,93
0x52894940ecc78bef32ed0279dff4f5198c42ae6ad0c0c0a9e1b8eb6a919a49cb,t,34725,2319616,,5000008,2018-01-30 13:43:54,94
0x09c636d562f986fcba6a8501edfb90ee56b3a0cf8b2d1e73f68e6e0ae2cac6f1,t,21000,2340616,,5000008,2018-01-30 13:43:54,95
0x1ef8c56f323d3bdd961c8e29966840c14dd530abbde3af2561ec15974d715e3c,t,21000,2361616,,5000008,2018-01-30 13:43:54,96
0x742f8614d17b9d9151659475a38c05c1658b6f33a63acfc1dad86cabd9bceed8,t,46045,2407661,,5000008,2018-01-30 13:43:54,97
0xe463508f0f25cd5612b8f292516f58d5fb7d61839276eaf13f24d9429bf22d45,t,21000,2428661,,5000008,2018-01-30 13:43:54,98
0xa67ad06df5a691a89c4fc6d2389cc82231b2684d6a91649610ca549174290be9,t,37116,2465777,,5000008,2018-01-30 13:43:54,99
0x039c87d8f89347032f3113ff4fe9459ec87c2c549e7abe92e0dd802f870e85c6,t,72637,2538414,,5000008,2018-01-30 13:43:54,100
0xada3f852bafb143dd11a1774e7d3342a4a4d19e72afc6e5fca7533228b0cc7bc,t,64725,2603139,,5000008,2018-01-30 13:43:54,101
0x419fe2c68c8a487d34c0386a5bf71f520f5bffaa8e8d0d484c0ead4a86aa5b30,t,71069,2674208,,5000008,2018-01-30 13:43:54,102
0x08c7d637059d4a6ac659bd38c3a66034d15a8d85fb2a97048c1fb8aa655f3e2f,t,21000,2695208,,5000008,2018-01-30 13:43:54,103
0xe0781e114ec06d5e2e77f5f20048f4b6362f51dc616cb4e6ad136e3e8186f599,t,21000,2716208,,5000008,2018-01-30 13:43:54,104
0x210bbb31ad0169ea2175bf4f2c4ae105160e4751579b834a5591df2ca740311f,t,21000,2737208,,5000008,2018-01-30 13:43:54,105
0x4b227e191185ee58f399a41b057108e1239eef8bd71744114a995d904fcb3daf,t,102732,2839940,,5000008,2018-01-30 13:43:54,106
0xfaa1529c21d8cbabf86ec2dd4dccf277cac114218b4ac7021c8b7e6d0b4ccac2,t,21000,2860940,,5000008,2018-01-30 13:43:54,107
0x8e728d1a69722b343d41d27e18e7bc64c9340d0d432a93fbd1dff597b1306b4b,t,78114,2939054,,5000008,2018-01-30 13:43:54,108
0xa2ca9130164bc15ba06736bf72521a683abdd65e36bf6666c4302bc60799f5d5,t,51789,2990843,,5000008,2018-01-30 13:43:54,109
0xd31956588e15ac7c62a7ce1511b2c7c8308a804ef2d1ae00bab77649ec4b2fe4,t,38679,3029522,,5000008,2018-01-30 13:43:54,110
0xf55070a7136d0df7da06ba644e959d560b3fb7cb4d75a0e4ad7af82995979103,t,92794,3122316,,5000008,2018-01-30 13:43:54,111
0xcf8beb19c2d5be2140d65539c73ae6eed8f973af6a434d3c400949e170e476ac,t,21000,3143316,,5000008,2018-01-30 13:43:54,112
0x993a4164b9ee9e4af7fb7e223cfa03654512bdf41d49f5677110466e001d6e43,t,21000,3164316,,5000008,2018-01-30 13:43:54,113
0x647f9891b880f7381225683db62bb8f49bca32f03da49635a410a246903a8915,t,21000,3185316,,5000008,2018-01-30 13:43:54,114
0x54c13251528558807b0d61b4f660b166fd0c6904dd35acaf556f2c2b7eae1d19,t,21000,3206316,,5000008,2018-01-30 13:43:54,115
0xf893e0e488d1ca89af21496649be825dc1831b5ef33c872cef9a839b4e8cc5d0,t,21000,3227316,,5000008,2018-01-30 13:43:54,116
0x50a3b1fde4b1b6809c2f47c1b116e955e070ab56802c4ddc322534d64d4afbac,t,21000,3248316,,5000008,2018-01-30 13:43:54,117
0xd453e3c390cbc1862be1c120a1372948f0a644155f8c214182cbfdeb8a2a6e5e,t,53696,3302012,,5000008,2018-01-30 13:43:54,118
0xa75fd6b4aee986b020665a2cb5eafd15aef1af9f2b3f0588e03c6370446f652b,t,21000,3323012,,5000008,2018-01-30 13:43:54,119
0x984a48838ae7dbb4064b9e908e3304ff4bafcc0605c10b94c60e7f9be47f2574,t,140027,3463039,0xf095a5fD82c7EB82773159ae83EdBAc2975fFB06,5000008,2018-01-30 13:43:54,120
0xe86d52085d199557a5cce0ea8841be68f878c87a0deaf5bb9681ebfb1ba32792,t,21000,3484039,,5000008,2018-01-30 13:43:54,121
0x876864ba27e724ddea620c0117dde47882bdc8d161c02247ba1f32b699022ae7,t,21000,3505039,,5000008,2018-01-30 13:43:54,122
0x5f71df6559b273862a10fe7bdd072ebfa059f8dede204abc04c1ede427bbbb83,t,21000,3526039,,5000008,2018-01-30 13:43:54,123
0xbeb905bfafabaf5c8e5a43ae330a74936f7c6edf49047f13811e2b33e2a8c7c4,t,21000,3547039,,5000008,2018-01-30 13:43:54,124
0x6e6bc6238ff37fa65200fc39d8c14688dc004544ca60c36f5c4375625f21e3ce,t,157708,3704747,,5000008,2018-01-30 13:43:54,125
0x3b1bd79dffb06d7b82146de67d010fc0ea76f10f63e16517a5cdd8de7f82a4b9,t,21000,3725747,,5000008,2018-01-30 13:43:54,126
0x84518b74467a06f2b195b56a6b50ebddda71e1758c86a405c5c4909d56c70eb6,t,21000,3746747,,5000008,2018-01-30 13:43:54,127
0xc0b67a928e1685210e2f15cdeaec58a832340949d4d8bcc0fbab8a0730e2859e,t,52291,3799038,,5000008,2018-01-30 13:43:54,128
0x10571c01dd91d298edc612d9c192184e3c258be8a72b2820878fc03bd6453ebe,t,21000,3820038,,5000008,2018-01-30 13:43:54,129
0x1322d1287ca0d7442090b796cf80d7f97249da047faa512ef892fa1f06a82c1d,t,21000,3841038,,5000008,2018-01-30 13:43:54,130
0xf358a4c8a6dee3b824da80d55483483be394b522c2263f02e56173db2347e852,t,37316,3878354,,5000008,2018-01-30 13:43:54,131
0x048d1da6aea69a585a6885bf8d1369a09a91a3471f1bdaf84ac93c37a674a205,t,21000,3899354,,5000008,2018-01-30 13:43:54,132
0x7015ce7c2262ad3be0b73d4f3e69e646567ae59f0d65f582f756539e5b956041,t,21000,3920354,,5000008,2018-01-30 13:43:54,133
0xbaf4b6aa938855d84e8ec40f06cb13387edb879f58cd81646001756d9279f40b,t,21000,3941354,,5000008,2018-01-30 13:43:54,134
0x0d5aeee8214686c01a60d1a080ebc8fb3e9b9fdb7122ead607b9c01b36e62021,t,21000,3962354,,5000008,2018-01-30 13:43:54,135
0xb8b663fa627aa1fb2319e3ff8b37a1fd9351df2689da3943c8722b609755518e,t,21000,3983354,,5000008,2018-01-30 13:43:54,136
0xa0afa7b9042a743e05b116592ae77fb7b8581b37dfb2e5dfdf6c79c6c13efce1,t,21000,4004354,,5000008,2018-01-30 13:43:54,137
0x8fa1482a5f3c5a6da12ca39575137486b307ec408f8a6ed552f4cd28a3372379,t,21000,4025354,,5000008,2018-01-30 13:43:54,138
0x10dde465bd7399b8e76bf6f17064948e7387b7d231452f6a1d39884f519f15fa,t,21000,4046354,,5000008,2018-01-30 13:43:54,139
0x9a61818208d506717a22def710b2ce2bb8904428508658219b4a67a490d1483e,t,21000,4067354,,5000008,2018-01-30 13:43:54,140
0x44eafe242a2f32a8b39f1e2b1d1c5bf54f6aa4b1f87b4bef294e175dcb35d79f,t,21000,4088354,,5000008,2018-01-30 13:43:54,141
0x53649e0417dad597e7ba0c6cb327b5a0f1c071d50a1326bdcbea7620377e99de,t,21000,4109354,,5000008,2018-01-30 13:43:54,142
0x5eaf1787817ef36310560b75865527b9466bc2b91718b50d2103b1a1ed89bf74,t,21000,4130354,,5000008,2018-01-30 13:43:54,143
0x4dd3f5b6f7f2977ae4ac4c3716c2073e8b09548b1bcb87d0031ca85a478d33cf,t,21000,4151354,,5000008,2018-01-30 13:43:54,144
0xa66b9f0ccdd8879045faa2a8804b16d041a60f3380ea05b259be2939ffd73cd8,t,21000,4172354,,5000008,2018-01-30 13:43:54,145
0x6a25706a699226d44ea3bd9ffd47c01e69f638dde380abbab81f88d86495dbd9,t,21000,4193354,,5000008,2018-01-30 13:43:54,146
0x095f413ea25fe8a3c8646f9bf405916e192ce1e149b3939d33dba2942e83ccf0,t,21000,4214354,,5000008,2018-01-30 13:43:54,147
0xd814715252bc15ddb80fca1f70d60fc83567d96cf38e0cdd4e7e488161a44023,t,21000,4235354,,5000008,2018-01-30 13:43:54,148
0xd3b11ba15e9011d824959afe485e6a37dfed934157af58d4c60a8622cf11c1ab,t,21000,4256354,,5000008,2018-01-30 13:43:54,149
0xe0ed8909fe98ea4f66c35563460e0fc43221b27b3ac2de2e1a5ad5c7a350ca5f,t,21000,4277354,,5000008,2018-01-30 13:43:54,150
0xed1b8df7415728fe06871e027944cfb20fc25a57986bfd75338752ec7e9d8695,t,21000,4298354,,5000008,2018-01-30 13:43:54,151
0x9761df05d7f6cc8ecf49d3f5be064c9a72265cfcf02afe532589e2f731130c10,t,21000,4319354,,5000008,2018-01-30 13:43:54,152
0x7bad2f13e1ce8189fe2465531b7465451a0560d2b82a1bbdf6abb6f757d61e96,t,21000,4340354,,5000008,2018-01-30 13:43:54,153
0x68da37cdbd211c90018ce12a396599e871a6e166f99ce72a574575777a199caf,t,21000,4361354,,5000008,2018-01-30 13:43:54,154
0xbe39301bea073d9392e549b19fe5027330947d88b93e316af419112ccb1d6186,t,53167,4414521,,5000008,2018-01-30 13:43:54,155
0x87cd53432c68589b8ab0d5262aeb1f9e0e97e99ac7464be9f11deae03bf759d1,t,21000,4435521,,5000008,2018-01-30 13:43:54,156
0x2f95c4a6d41970dc8edd7ba006cf6109745889026fb51676c8ec22bbd5884d67,t,21000,4456521,,5000008,2018-01-30 13:43:54,157
0xf2f041b7b48695cbbd2edde940daedf65876959d97c2c72e12e655246ffbb863,t,21000,4477521,,5000008,2018-01-30 13:43:54,158
0x0760db9fd5a0439ca663196bd353aa2fa9e333e1f6ca3d2c4d1d9a6cf2babd3f,t,21000,4498521,,5000008,2018-01-30 13:43:54,159
0x41ce1d0cc4fe88450e2f96786a038419859a2b8cd1675ac5501654667dcd4ae1,t,21000,4519521,,5000008,2018-01-30 13:43:54,160
0x96b8593c71ec1fb99a05efd8c850c913c38986de2fc40927e936b4d74556e9f7,t,21000,4540521,,5000008,2018-01-30 13:43:54,161
0xb140fdc4efa01b2f8fbc219ba8a0ba5ce3bd6911e52a5e498c95ccecf87f5f3a,t,21000,4561521,,5000008,2018-01-30 13:43:54,162
0xc5def003efbea5de0ecd4c6b65b66872eceb3d47639532b19b72c2e275057a8f,t,21000,4582521,,5000008,2018-01-30 13:43:54,163
0x3a21442361f465978bbafa0d9d482228d5be85fa243bb63bc188227361551d82,t,21000,4603521,,5000008,2018-01-30 13:43:54,164
0xfd6a0561d1f583b45cbe7e0d4396af720d27c644ac17f7d9bc434d1a950fb595,t,21000,4624521,,5000008,2018-01-30 13:43:54,165
0xe5d6872488cab51b7fb0ec86dad01446c4fbb3beded632c52982397ade9f54f6,t,21000,4645521,,5000008,2018-01-30 13:43:54,166
0x3cd41438b8968c09dcd8a81fee208058319c615df6c4187f93dd474f19122b5b,t,76670,4722191,,5000008,2018-01-30 13:43:54,167
0xd229f9a8195d5abeaff3a841ef333202edfea6debfae052596129bf891d8619a,t,21000,4743191,,5000008,2018-01-30 13:43:54,168
0x3ed20c9554724e93091f8cfe7f9ceb4b8bb046f2b5b4472c0ba674310f9c3514,t,21000,4764191,,5000008,2018-01-30 13:43:54,169
0xbdb4a62bcfe88f0a37f51f0d2777c9201f24ca3308f85f1a4392a2c445fac81f,t,21000,4785191,,5000008,2018-01-30 13:43:54,170
0xf18bd36e6a4551c7a6747f8a2f53c9a725cfa72ae123a8e0a77c4f326fc26f67,t,21000,4806191,,5000008,2018-01-30 13:43:54,171
0xb0781e29ad52a1227722dae5ee020d20d412f0f7de50a7ff9ede899b0e5095b1,t,21000,4827191,,5000008,2018-01-30 13:43:54,172
0x846450916071618a58922e21370781a8b445e535ae9be99cd31677e9702c34cd,t,51417,4878608,,5000008,2018-01-30 13:43:54,173
0xbf237fbd456b1eb2f6e7d920f13277c96c23439098cad4b6e67e1a301beac441,t,21000,4899608,,5000008,2018-01-30 13:43:54,174
0xccc0fce6abf898d468a41cd5ba4711d45bec34ad810385f5bdf8b9a33eb2fb5d,t,21000,4920608,,5000008,2018-01-30 13:43:54,175
0xea9c76e4dc715fb0d06b9a7d42d227cbea94f5436c6532dda3a2b6faff98d6aa,t,21000,4941608,,5000008,2018-01-30 13:43:54,176
0x76aba0f92e214a53a6b395cb435b9642fdbf91170048400c09e7b86b55194049,t,21000,4962608,,5000008,2018-01-30 13:43:54,177
0x5b6f828990ddc6a1f55a26c1e50a3508c58e913f3e7265f78c1680862bb81fed,t,21000,4983608,,5000008,2018-01-30 13:43:54,178
0xf84954c1b1cae76597b8b1ae1f6d46749a75b2cef0299cb6f76fead7a6a25ef5,t,21000,5004608,,5000008,2018-01-30 13:43:54,179
0xdbaf585cedbc48df21c0ba43a0342805ee9f0d1902c13446184c8e9e784cdbb9,t,21000,5025608,,5000008,2018-01-30 13:43:54,180
0x1c898c3746fd9f74160765d0ce49de50b397b8492f00bcdde70aafe779860a60,t,21000,5046608,,5000008,2018-01-30 13:43:54,181
0x8a8d18960da24042cbe9832906c0da48853a709dc3183e177333211d7430b7a3,t,21000,5067608,,5000008,2018-01-30 13:43:54,182
0xe50b44f6718cf938649d6c37dae828fa2bfacad3f202332c274e21606cc46ae2,t,21000,5088608,,5000008,2018-01-30 13:43:54,183
0xd436fe9c62f09a80223a1bfa216969e5ffaa7546ecd4b427f828415162bbdab4,t,21000,5109608,,5000008,2018-01-30 13:43:54,184
0x9b885c9683393d5a68063c27fc111ada5c37a528722ec2649350a3c5eaa9fad8,t,21000,5130608,,5000008,2018-01-30 13:43:54,185
0x05276e12405f76fa5de650e0fde04cd632db258983158668d700fa6654620552,t,21000,5151608,,5000008,2018-01-30 13:43:54,186
0x03cecffc770e48521244da650cbd4bd6ea12676776f18974edd4184212b5c32a,t,36698,5188306,,5000008,2018-01-30 13:43:54,187
0xb12b7cea49cba216b650a92bd840330e6a84c33fd2015157c61f43155dc82afc,t,21000,5209306,,5000008,2018-01-30 13:43:54,188
0xe697e80fe8e4005007c702d92984155087d579105e75c56aefae066630447618,t,21000,5230306,,5000008,2018-01-30 13:43:54,189
0xab1378cc8681c0b31bb451c4db37b4bfc468b6bd626332fc68096cd0d5bb57cd,t,21000,5251306,,5000008,2018-01-30 13:43:54,190
0xf1a58c0c6ad21f93573836b2ba3a39d4dc1e2731e9ed8ebbef062ba34c647769,t,21000,5272306,,5000008,2018-01-30 13:43:54,191
0x26efefd2ec6622e1a6221a50205e95f1a146166a74fd3fbe8147e95652220928,t,21000,5293306,,5000008,2018-01-30 13:43:54,192
0x0a8b69a7e63b99b4051a4662709e4290055132cd07063c14039265657d427a9c,t,92621,5385927,,5000008,2018-01-30 13:43:54,193
0x6a84e4022b7c4abd4fe64cec0ac4c1f0eecb8e40f2e3f644d60af09cca9c1b9d,t,21000,5406927,,5000008,2018-01-30 13:43:54,194
0x697b8bd4aff235891039eb3c84442125d6b4d677b5899dbfbc01c95b6890f54b,t,21000,5427927,,5000008,2018-01-30 13:43:54,195
0x16958489a037b23e726708e62cab16af10709f1954021ffc76b3d3c5bfd543e9,t,36347,5464274,,5000008,2018-01-30 13:43:54,196
0x1c7e245c5ca6d2cd55e2d832a63cf13ecf69a34d8c40e7882aac87e32a3bee2f,t,21000,5485274,,5000008,2018-01-30 13:43:54,197
0x3a41cb2b499e8f40c3742bcb2e0e8ed5531c991242636c9803a79f15ed75459c,t,21000,5506274,,5000008,2018-01-30 13:43:54,198
0xb102382ac5d03f111730043efeb1ee95b6b13388a63634efe515e445a81491e1,t,21000,5527274,,5000008,2018-01-30 13:43:54,199
0x9e0291fdd3083285a3c56609eff02dff101498702609da485fa04aa019f69843,t,21000,5548274,,5000008,2018-01-30 13:43:54,200
0xbe9b1b596fb4cd12ee57acf0b5c63ed6d7a109d4b4311543aa38ff850ec44f6d,t,21000,5569274,,5000008,2018-01-30 13:43:54,201
0xe4560de9294f071daa29437c7f0769fecca4e49b0e26b426156bc0775e6e5470,t,21000,5590274,,5000008,2018-01-30 13:43:54,202
0xf01dd0b1c3cd7ad4e1fb7405bce17104ba17d49764d24a524be1a1a9255131f1,t,21000,5611274,,5000008,2018-01-30 13:43:54,203
0xb70077e0024b5525d9fd639b9af1e6489d0f0401307753ab4a9c525015127363,t,21000,5632274,,5000008,2018-01-30 13:43:54,204
0x2713d71a967e80189a6ba8978d802d781fcd4b339218b92c969410a0299738d7,t,21000,5653274,,5000008,2018-01-30 13:43:54,205
0xde346c7ec9b07c0967e4cd041a6b6ca01c6b35a5a59a035b00a24aafc41100eb,t,21000,5674274,,5000008,2018-01-30 13:43:54,206
0x37795b9152cdb935e49465e5193a89db2948a47bc889ed187252b1773a8ceb9a,t,21000,5695274,,5000008,2018-01-30 13:43:54,207
0xf311887fa0cccc72dfa12ead2a9cac342ca20331b4724b3892da0c8367439951,t,21000,5716274,,5000008,2018-01-30 13:43:54,208
0x1905b35176b81871674e72805ba5d5b5932a0d0e4e5ae864048834487bdb058e,t,21000,5737274,,5000008,2018-01-30 13:43:54,209
0x0ca06746f30043e342b1fd92cda586e870ae1cd0749eb82e4b7fe3ac51d3b631,t,21000,5758274,,5000008,2018-01-30 13:43:54,210
0x42530fe0f2a664ac209cc115ba018f4bb3d36f42ed3e63da7583615d0c6d0eef,t,21000,5779274,,5000008,2018-01-30 13:43:54,211
0xf9d72d677d21ba6e3495a7d98a9adb5223a1d9a3fd2b03ea20ed78db7cccd1ef,t,21000,5800274,,5000008,2018-01-30 13:43:54,212
0xe10509b014ed177553251fa6f741aa8bd24bbaf4f25750c694f1f2115b3544dd,t,21000,5821274,,5000008,2018-01-30 13:43:54,213
0xb8da88c50cfa9514e2aa457944361c460e026ea98de5cb51b51aa711dcf71f82,t,21000,5842274,,5000008,2018-01-30 13:43:54,214
0x1a6a3d34d08db2b490af58dc45f10a979bfcff67ec1e7890d969320ae17fffb6,t,21000,5863274,,5000008,2018-01-30 13:43:54,215
0xa508f06c5a9f69ce162e42de07a75a829605a0e00145fd43211023a7245ead20,t,21000,5884274,,5000008,2018-01-30 13:43:54,216
0xb203de0c9551bac1f4835ff2ec38225c41738a8396921dc4db7f8a55e1fdd2c3,t,21000,5905274,,5000008,2018-01-30 13:43:54,217
0x8c8513eb3505d99aefe6c22af0d697ae809f6918c8b47c97968073dddd763cec,t,21000,5926274,,5000008,2018-01-30 13:43:54,218
0xb4e3b86d20af3a13bdebed2e814f248d4178640720af50dd9a89b9afd8226962,t,21000,5947274,,5000008,2018-01-30 13:43:54,219
0xd571e6f77276065c89eb7b9175769702a267adf5a12364561649fbf95a759d1d,t,21000,5968274,,5000008,2018-01-30 13:43:54,220
0x54a93abf83eb7e4ee95455adf0afc63336f5908d9e82e4f208f1c0b9ba3736f7,t,21000,5989274,,5000008,2018-01-30 13:43:54,221
0x56609a19f28ce99b1f7733d2cf91ec6814f389a373dc1f6e82f136ecadf4637d,t,21000,6010274,,5000008,2018-01-30 13:43:54,222
0x546e617390089f961c92d622bc2cb3601e06cc9b80637f68bf89ca7c54c4b9f6,t,21000,6031274,,5000008,2018-01-30 13:43:54,223
0xcc79af48c04297078b0f56f88ae49d796c28660d1a0b9f8141503d4aa5116706,t,21000,6052274,,5000008,2018-01-30 13:43:54,224
0x52a6577fbc6f46f0db211da2b5c2ec396a1491abc7d29d26dbddd029bd09932e,t,21000,6073274,,5000008,2018-01-30 13:43:54,225
0x7bc309602d457430039eb4671b508ad0fab00a7c7739a6aef3b6c56f2455cdeb,t,21000,6094274,,5000008,2018-01-30 13:43:54,226
0xb0dff0a4a6abb287590781fcdca3e43c277731381e1d232d51adedd9284c923d,t,21000,6115274,,5000008,2018-01-30 13:43:54,227
0x2020c9950f9e09ce2fae4de22eb60a5d235fceb8e2269dd04e955e01baf0b1af,t,21000,6136274,,5000008,2018-01-30 13:43:54,228
0x9a05b19f2479c865c7394141f75af5f719e0db7ef183c79d6375f4f65c035b1e,t,21000,6157274,,5000008,2018-01-30 13:43:54,229
0x831503c6503acdc2334abba3efc0f2958d01d2d1dac51a0cd4869fde860b3b45,t,21000,6178274,,5000008,2018-01-30 13:43:54,230
0xeb3daee0923e4c107462895664d786e621ab96565ccad946f35d8f0d4b03a8f4,f,100000,6278274,,5000008,2018-01-30 13:43:54,231
0x11bfa119e243f2230c7f423e5750db994c555bbade68645b51e06dcb2ed20935,t,21000,6299274,,5000008,2018-01-30 13:43:54,232
0x9107ef7ea3804e9299b163bb4476d7e9ae94db3036ed2de7db024d92faba91ec,t,21000,6320274,,5000008,2018-01-30 13:43:54,233
0x4a4a171303ba7dc67baf560cca6478332b24aab60c7a88eb3f41249d9cc218b1,t,21000,6341274,,5000008,2018-01-30 13:43:54,234
0x082852858898a7d3b25f742bf82263d84dcd98af949cf103bada18f107e2ba04,t,21000,6362274,,5000008,2018-01-30 13:43:54,235
0xf52b613fc9a790eca767f831701aa1c6d243e4a5ae1c59de40c6b89c9b1a0b9f,t,21000,6383274,,5000008,2018-01-30 13:43:54,236
0x143f6fa51188d40654b41c645ab9367fd04aa43b540cb240cc9c9dff7b2ac5d8,t,21000,6404274,,5000008,2018-01-30 13:43:54,237
0xeb0da1f01bba5af28e219d42542d8b7c8fb287a4d21b6ff682165f00108518a6,t,21000,6425274,,5000008,2018-01-30 13:43:54,238
0xef392749e665200c969c52b88cd62cf00d18d7266f914de7f60d3a37425ec7d1,t,21000,6446274,,5000008,2018-01-30 13:43:54,239
0x29143cce0e783c570cc88abd2377a57716eab90f8dc75ce8ecdfa65b5395a4fd,t,21000,6467274,,5000008,2018-01-30 13:43:54,240
0xe65760bff89c1f49aa813b5f25fca68874a0a50aa00f20b13275ab58f8b11072,t,21000,6488274,,5000008,2018-01-30 13:43:54,241
0xb5cc3e5f67cf4a0b559cdcaa1bf5f47c6ff401e825c67f927e42c037b1fe8bac,t,21000,6509274,,5000008,2018-01-30 13:43:54,242
0x7892a94643931bc27a0d5d6852a54fc89842a94613455c27f6392615c16962b6,t,21000,6530274,,5000008,2018-01-30 13:43:54,243
0xa9857ec22d485f2ede64e75a12db1ca4426161d0309cd03689796040709be696,t,21000,6551274,,5000008,2018-01-30 13:43:54,244
0x34a3f684533130b33ade3a2eb2629741540e2f4616dc6b8a2b088a9ac506400d,t,26122,6577396,,5000008,2018-01-30 13:43:54,245
0x01f0af2c1494b58b7844a889bd410c991d0a59b7ed09650e224c5ed617a100c1,t,21000,6598396,,5000008,2018-01-30 13:43:54,246
0x5cd35959fa2b0311865331ac7e42ef1b286d0afe4e179cfa18b7969dc5863c6d,t,21000,6619396,,5000008,2018-01-30 13:43:54,247
0x1b98cf6ca074734c61f2fa140a117b1cc19d693e393418d1a6022f8ccd4772ff,t,26122,6645518,,5000008,2018-01-30 13:43:54,248
0xd253c873ccffbbdeff38142400d562cd1f49b8c6d4b8808c515f494282c47abc,t,21000,6666518,,5000008,2018-01-30 13:43:54,249
0x80ca56c72973ccd19d4854ace8c4ff2994739ff978b9991768ac1a5dd4961d92,t,21000,6687518,,5000008,2018-01-30 13:43:54,250
0x37cd175c1c0107d5a2c827d7b7448f558f29168049c760acb2f7779bf0b464b6,t,21000,6708518,,5000008,2018-01-30 13:43:54,251
0xb958162454c98a7aa8bcf6c7d7da07af5dcd86ae1dcb5a7c2e5d81151c80fb28,t,21000,6729518,,5000008,2018-01-30 13:43:54,252
0xada79b6b7cfe16291af06a2b7a30626644dc07b8bc2d9dbb192b9f0c16b3ab80,t,21000,6750518,,5000008,2018-01-30 13:43:54,253
0x5b2de9b8c20d524f7ab03c3fd729ceb3dee2ef82cea75ce6262af3537e881c7f,t,21000,6771518,,5000008,2018-01-30 13:43:54,254
0xd7cd93b7f030df87ce521b86ac3a6cde50f7e08dd54f90ff8e59cf662410d535,t,21000,6792518,,5000008,2018-01-30 13:43:54,255
0xb3399c923efcb4deb9c1610b73948582bfb251e9586bc683f2e5406e0b87676a,t,179066,6971584,0x918f0BBbe57898ebfaB892B76A94ca08b5c72462,5000008,2018-01-30 13:43:54,256
0x4174b713caa15ee44fbbb73e2990c5ab794fe79f448a711430f34acf41d4b17f,t,21000,6992584,,5000008,2018-01-30 13:43:54,257
0x2e14c6a6aa808eceb8ab81b74d2cadd099f2312204c64bc4523945d0f24e8546,t,36980,7029564,,5000008,2018-01-30 13:43:54,258
0xcec66f2dfe75df6f78ba7ad67e598bd78f984caf5f0697c740cbc9d18f6c7764,t,21000,7050564,,5000008,2018-01-30 13:43:54,259
0x0d00c23debb2e3a8c83e8103ccb831515ddc9e3d3acf82336aa799a2c87ab6f6,t,21000,7071564,,5000008,2018-01-30 13:43:54,260
0x259279df8c5e4f7f910d7d2e36faa3949eef0b8e7c085ab17092cf001441d60e,t,21000,7092564,,5000008,2018-01-30 13:43:54,261
0x2f36dfdcf97f4ee376832da45dbb8823feee0b86784a56724f3600d25c6b2979,t,21000,7113564,,5000008,2018-01-30 13:43:54,262
0xa529d882f152fb9b8720c2f3fa9a455512a854f143b07c166cc220fe2e82de43,t,52886,7166450,,5000008,2018-01-30 13:43:54,263
0xe15532a009e1a2df3e39cf933dc842de2d07b4caaaaf47e3981938de4f5721ce,t,21000,7187450,,5000008,2018-01-30 13:43:54,264
0xc044fdb8db30bd69a8744bed8e75676f8153172106ef91ef10a657be399d6e25,t,21000,7208450,,5000008,2018-01-30 13:43:54,265
0xe8edbac28e2d6629c8a00537897e4206d493f24b84d25997476b100e3f846be0,t,21000,7229450,,5000008,2018-01-30 13:43:54,266
0x37a5814bfe1a8cd861b2c3e9037c0fa8c8e7863e8f8938e0b02a9b6d695ce9b7,t,21000,7250450,,5000008,2018-01-30 13:43:54,267
0xd534bfbb55cf9082ea29d9f7d6fb982babf55ce643edeb22922a1c1a0748c73d,t,21000,7271450,,5000008,2018-01-30 13:43:54,268
0x56a9c7716d30271052f97857a9d80d7620869914185cbeb6b9393a675df4b795,t,21000,7292450,,5000008,2018-01-30 13:43:54,269
0x0522aa96611a31e215742f84eda9cee489d7ab8d9addbe49e5623e381dc34951,t,21000,7313450,,5000008,2018-01-30 13:43:54,270
0xeccd85bd37af86310e86063a7aa7f3179d43e0d9075866009aca8fd39ead80ea,t,22193,7335643,,5000008,2018-01-30 13:43:54,271
0x28dc51ffa9ef82b98ab33ffa75fabc3aa62aec6c03a37100d89cb8f6a7ce973e,t,21000,7356643,,5000008,2018-01-30 13:43:54,272
0xee8a1692d0e2052fb638a93368071439de1171fa8941dd90943041df06a2d15d,t,43346,7399989,,5000008,2018-01-30 13:43:54,273
0xa217a46a01510160955bbaf8b2a184100f404577bdd6559e2c30da50268d322e,t,21000,7420989,,5000008,2018-01-30 13:43:54,274
0xd996a27af4804947b48d965139bf78fb6bb7c5cff3a68f6a805a9450f9ce7025,t,36621,7457610,,5000008,2018-01-30 13:43:54,275
0x62d4828acacbe20ef6400a44ed71752c70a3a4278a90b05e68961340455218fc,t,21000,7478610,,5000008,2018-01-30 13:43:54,276
0x9251bb63742a11ddfe6f72c4755caf9f07faea5155538db0f46b3854d4dcf2b7,t,22193,7500803,,5000008,2018-01-30 13:43:54,277
0x14d4e3ab580a082c88c327dd6b31067338c767fa59c630e308f7ea7bbfdb3240,t,44226,7545029,,5000008,2018-01-30 13:43:54,278
0x1101d4e9a23a64840c2b98e68d3aeeceb6da7f724c85c24cb6c365604350c960,t,49390,7594419,,5000008,2018-01-30 13:43:54,279
0x5695b723ee1af2719a5dccbd65f8fbebfe1edc7e59698185c7895d2fb52d507f,t,21000,7615419,,5000008,2018-01-30 13:43:54,280
0xcce9e4df66f8e7b7d0e264559b4f804345df8b77175905cec5e171230bc22dd5,t,21000,7636419,,5000008,2018-01-30 13:43:54,281
0x5c448ce387a470dce22518bf18545feed6952a40e0eef90629ec153bb599742e,t,66253,7702672,,5000008,2018-01-30 13:43:54,282
0x74442fbc8d97bf88610c555e6f696a2f4536af2c07d1f71e8746142a2ec70a73,t,184950,7887622,,5000008,2018-01-30 13:43:54,283
0x5c2a28891eb984f7e9785bae7b7817d01d107d510c9d58546c86c8b60ec3cda5,t,38252,7925874,,5000008,2018-01-30 13:43:54,284
0xf8759812a26f7bdbdc90b6fa270068590a90fe137da4bf003fb113ffde6af52a,t,52124,7977998,,5000008,2018-01-30 13:43:54,285
0x2e0179e0a3f12a6de7e8a8d409217cc7517fabee4762badc31baf0fb0f069971,t,21000,7998998,,5000008,2018-01-30 13:43:54,286
0xb2183c1e1669e4405a130299e073c3220a9abbf71c281ca7a8bb9c55c035f60e,t,36537,36537,,5000009,2018-01-30 13:44:04,0
0xa6f36e14d15f64e2b794f6b2f4ceb37679136a47bd2098a72a7095887217b84a,t,54835,91372,,5000009,2018-01-30 13:44:04,1
0x056a2db69aee1827d9dbd0befb46553aac4b489bb297c4dcb9da286242e98972,t,55907,147279,,5000009,2018-01-30 13:44:04,2
0x5a25cfabf3639ff6c4db3f04bacc89081d61906e4440312a291106c0ded34d8d,t,21000,168279,,5000009,2018-01-30 13:44:04,3
0xe01e050a658869938e05e701e03b2569b4c471a33783c11c55928113fffc752c,t,21000,189279,,5000009,2018-01-30 13:44:04,4
0x1fe876488adcf1834c5e64d0547c08555a4ad04e9e39fba51a1c2e7d6b413819,t,21000,210279,,5000009,2018-01-30 13:44:04,5
0x3fbacf7486c823be6801ff53aa2bfe843318c6603264195b163bb68b90549bb2,t,21000,231279,,5000009,2018-01-30 13:44:04,6
0x77167a2e73f6db87c0a0808a2387b4f9a29c9b21660bfa8b6f7f6fbd7905e829,t,21000,252279,,5000009,2018-01-30 13:44:04,7
0x7272ad42923ede09057c99f0064e5d86b1331c147d7f4725ca92a86702a428bc,t,21000,273279,,5000009,2018-01-30 13:44:04,8
0x745546d86d80056a96ef7d9a2dfc59c1c36af5d87c380f8daa2067ce6e4025a9,t,52460,325739,,5000009,2018-01-30 13:44:04,9
0x48bdffafcab819d444028fa6990535d4070511d6e78b0c819c3e930ba072f5e3,t,51725,377464,,5000009,2018-01-30 13:44:04,10
0xefde84ab2b2aa3b01a95c66eb8e4f1bb640130204e00e10e60d808b6bac0e5a3,t,21000,398464,,5000009,2018-01-30 13:44:04,11
0x7c7bb0274797d787a38de80bd8d108f266775caef806bae3844f3cd181edf74c,t,21000,419464,,5000009,2018-01-30 13:44:04,12
0xd1a28d5bcc1dd8149d2e717e88b9b0d0c415ceed105e566bfb4aa74029811cfe,t,51521,470985,,5000009,2018-01-30 13:44:04,13
0xc7bd5ebb44ed8fd6107717cb6732d0a307eca2f1c91ecce4433bd94b371d3f92,t,21000,491985,,5000009,2018-01-30 13:44:04,14
0xafc20a01635bece53c83497827cf9ec9ca53b414c9b8e7f36d28239e28c84b03,t,21004,512989,,5000009,2018-01-30 13:44:04,15
0xb7cccfc894d55616cbc4afac28a395cfdd5b1ac1bff96a08e2c337d8ca7292de,t,21000,533989,,5000009,2018-01-30 13:44:04,16
0x76c25867fe0a2f2034b2b55255e4b963fc96d05c92aa5a0183d077876ff9bec0,t,21000,554989,,5000009,2018-01-30 13:44:04,17
0xa954b0c2c6b384598f60b388f00f6f384d771fffa977836cb849d0fc7cedfbb8,t,21000,575989,,5000009,2018-01-30 13:44:04,18
0xc6b928b2bb4cf6e1ebc5eeca9371e208c0fd5bdbc0108bd137655e892030c988,t,21000,596989,,5000009,2018-01-30 13:44:04,19
0x115d195cd01d4ceb605aaaa925bcd23c4aff7644db09e6387a408cd3d37a93b6,t,21000,617989,,5000009,2018-01-30 13:44:04,20
0x80065e113fbbfd9dd71795586baba945b1df98231f70539a7755527310c0bcd7,t,127836,745825,,5000009,2018-01-30 13:44:04,21
0x207ad0e45c5946d764c174cdfba7f44c38219c5a3d278c382bbb9d227197b12b,t,39835,785660,,5000009,2018-01-30 13:44:04,22
0xf739d1c879cba2ef61dc40660969171eaca59551d58d5c519e7fb95c159e13b6,t,51955,837615,,5000009,2018-01-30 13:44:04,23
0xa2830341d04eb8fe5c3bfd17578334a882da3a84a4d7ae3e021eafba6084032d,t,52822,890437,,5000009,2018-01-30 13:44:04,24
0x3897cb5d358978498a5e697280a60dbe7e782eb4c7077d08a378221a2ed08f9f,t,21000,911437,,5000009,2018-01-30 13:44:04,25
0x3bbaacf2ea096259c943ede8dad83b6d011faac2f043cea3fcd9c38dbeafa912,t,21000,932437,,5000009,2018-01-30 13:44:04,26
0x60dd83f574901bac4ef26b2f38ef119a394ff9d94c7aa58fc7c013ce72437918,t,21000,953437,,5000009,2018-01-30 13:44:04,27
0xc60998399cf06cfe070cfb3261d4068b68c9003532ea285c8fd85e991314017d,t,21000,974437,,5000009,2018-01-30 13:44:04,28
0x278bde859a3e4753c1846bd4af6ff447d0e80388c3d199265b6aeabf34905065,t,21000,995437,,5000009,2018-01-30 13:44:04,29
0x3fe75eb5282b1f5403e6fffad6f9762226e6261e2ebfc21560df4a2771831faf,t,21000,1016437,,5000009,2018-01-30 13:44:04,30
0xb68d21d8041184560c33e6f81181ff56e4e9e3e8b1dc18ef0be61be715909e3c,t,21000,1037437,,5000009,2018-01-30 13:44:04,31
0x09579b275bd8d0515549950b2a1d75e7738d5ef29986d95290ca233d1ae8f7ac,t,21000,1058437,,5000009,2018-01-30 13:44:04,32
0x54061f627a57d9cc73203f98293cabc5b72cd1356cfe494e11099401e61383d9,t,21000,1079437,,5000009,2018-01-30 13:44:04,33
0x751a1069b1a3e3dd1e9338a460ab42a9335daa01ae4312d04bf4957f373086fa,t,21000,1100437,,5000009,2018-01-30 13:44:04,34
0x62711e8f26b1754b2c2f2e3db8d1001e0034cc1eb464e9a20fdc5ca0adbce680,t,21000,1121437,,5000009,2018-01-30 13:44:04,35
0x3de35cc3e298676c8664f734af4bb0928e3da647508d9d9272f7a54cdaa635da,t,21000,1142437,,5000009,2018-01-30 13:44:04,36
0x754f9bce4f57d4cd57cbf82b909b6ebd786a42c794934f54c82afe4e2951f2b7,t,21000,1163437,,5000009,2018-01-30 13:44:04,37
0x5eeb491bbd0edeaf8af1f08fa26296ba40d704cfef67023a8b88f715871dc316,t,21000,1184437,,5000009,2018-01-30 13:44:04,38
0xbad7c8f8262034d7312a79baeeb7d511b51ebdefd85c9109efec16830cf89ccb,t,21000,1205437,,5000009,2018-01-30 13:44:04,39
0xdf6ad9847d2ec04f94d9ac0ac0b7da0b15ffe8093b1c5a9f7635972ae61d639c,t,21000,1226437,,5000009,2018-01-30 13:44:04,40
0x847242cb570244a6bc36694baf0936cf52f6549c0a7d3173d95f319751556c9e,t,21000,1247437,,5000009,2018-01-30 13:44:04,41
0xc947189bb863f54a132ad4afe4d515525aed226020dee139a773b3bed00bafec,t,21000,1268437,,5000009,2018-01-30 13:44:04,42
0xb223108eb3ba1eeecb4712e3896804ac40f4cb141a2afb88e2693ce5327c3c83,t,21000,1289437,,5000009,2018-01-30 13:44:04,43
0xa8981133b4aa7bde488b668489be6d3fc226f45df10e3ffe2398c351e06a4833,t,21000,1310437,,5000009,2018-01-30 13:44:04,44
0x6cba1308319939ffbe651479749443f62d3ae1384549207efcca53815de1feef,f,28960,1339397,,5000009,2018-01-30 13:44:04,45
0x991d5948b1df4590b77596ef79078bd58cd9d1fed177d07df3a1ad7716954ae8,t,21000,1360397,,5000009,2018-01-30 13:44:04,46
0x2b73c4b0d574ad34475be7475203dda733d41b07b8f1b90fd22fee86cc589393,t,21000,1381397,,5000009,2018-01-30 13:44:04,47
0xba7f9092eb218d34057430590dcba49f02ef1f32547753fda0364ec4520d24fc,t,21000,1402397,,5000009,2018-01-30 13:44:04,48
0x5dcfc467df86b599644ab8861703d5a37d76246e4f4a4ac6ba2090664f48e623,t,21000,1423397,,5000009,2018-01-30 13:44:04,49
0xff17fdded1a3afee9ab5e1ee35ef1d2b2c44aa80ca288eebd86c648c4a1f0af0,t,21000,1444397,,5000009,2018-01-30 13:44:04,50
0xe8aca24479705babeeb79c0476215c3368a4109f7bb787f6592186a3183088ee,t,21000,1465397,,5000009,2018-01-30 13:44:04,51
0xcb27ea32aab1f095e762b711fa1efda057d00d3f9865c6f49b7820651e40fffe,t,21000,1486397,,5000009,2018-01-30 13:44:04,52
0xd913b05e9bef6ce9f03d53ae688b8e198921e48ec6ef7942e2015ff9b8c2976f,t,21000,1507397,,5000009,2018-01-30 13:44:04,53
0x134bc6ffcd134f50d3b8c0c810dbbf77d12b067eaf8d6d19fbc243db7a606d5a,t,21000,1528397,,5000009,2018-01-30 13:44:04,54
0x6aefad948e48e0c848fe7f7bba345a3ef667da478dc11200e5ac6c715129c004,t,21000,1549397,,5000009,2018-01-30 13:44:04,55
0x5bb9b45d9cd4f4ffed6450fde97deeb3b0ddd7643fe4d2cd972165901ef6974d,t,21000,1570397,,5000009,2018-01-30 13:44:04,56
0x4e8ba726126e960f080363bb4f74539628e30a924f2922e90ecd7e9861fd5b9d,t,21000,1591397,,5000009,2018-01-30 13:44:04,57
0xb362eeaf9983c83324b84b4c0fe5e8a18093e19ad8a9b4cdee0fde894043e896,t,21000,1612397,,5000009,2018-01-30 13:44:04,58
0x03ac66820e21ffba35282a0cb1b304de99111b0486fa242a95997b54367d6a2c,t,21000,1633397,,5000009,2018-01-30 13:44:04,59
0x9bcb029386c4ff202e53ce448b00d1fffbbc9db903f4ab962fd8ecfe157313e1,t,21000,1654397,,5000009,2018-01-30 13:44:04,60
0x1e57cb8d2020716048b9fe2a516f7eddff55baafb445b225dd55af7452616d27,t,21000,1675397,,5000009,2018-01-30 13:44:04,61
0xb5f65f3e960e232b67d9c796fced7875c63df3a962d7c87f0c3c686b9e667c5d,t,21000,1696397,,5000009,2018-01-30 13:44:04,62
0xe5af69aa1c65cb6dd739d7ff20c84dd85e5f18e570b3fb8d86b196e4d9c625ca,t,21000,1717397,,5000009,2018-01-30 13:44:04,63
0xf18a0568c9a96bbfbba4f0d876152a4362571a3f906c6fbe7f8f38767f9c68a2,t,21000,1738397,,5000009,2018-01-30 13:44:04,64
0xeed87d3b9dc1da5b37df690daca0febe05a467452d01c00db226cb22349247a5,t,21000,1759397,,5000009,2018-01-30 13:44:04,65
0x28f90dbfab46736ed29d16595ca6f64f877d4998df03fb8bf08884b54fab0fa9,t,21000,1780397,,5000009,2018-01-30 13:44:04,66
0xe8435e5e5d19379d48945cd2b4347831314112d80816370605f40c78c1951984,t,21000,1801397,,5000009,2018-01-30 13:44:04,67
0x57cac6aae89a4ebab613b269cbd1af6060612789a94417e053163fc1380a5dc0,t,21000,1822397,,5000009,2018-01-30 13:44:04,68
0xbedbfba2bfc33c07c3e40b17ff0e774d4ed0c6d84e83727aeb24b4a5a8051dde,t,21000,1843397,,5000009,2018-01-30 13:44:04,69
0x65ee9a8fdb2c396350afe0e6fba2e2daddc7f137b78531b0e38001eba8759c70,t,21000,1864397,,5000009,2018-01-30 13:44:04,70
0xc47162d2ee262fe3300a18381a33cbf8e59c35320fa4b9c24b76082c68c8b499,t,21000,1885397,,5000009,2018-01-30 13:44:04,71
0x30b7c0c8e4a1a9c5655d127c8b3d230e3ade37478829607c942bfc4b88ad1662,t,21000,1906397,,5000009,2018-01-30 13:44:04,72
0x26e3baab2bcc85e6cecead343d23268ecfe794e13a9f7ebe010070367a6f8d73,t,21000,1927397,,5000009,2018-01-30 13:44:04,73
0x119ae54fe23c578faa277dc99b48fc5b0815e97ae8d6be20cb796500e9ef967a,t,21000,1948397,,5000009,2018-01-30 13:44:04,74
0x57a24c4f834f4e1d65cf1cf298d2970ddfcd40841bc37148e8a870664522ec14,t,21000,1969397,,5000009,2018-01-30 13:44:04,75
0x30d73b61567b4c18efa9d8aa1527399f9061003e4964bfd1550a01d1a56eb651,t,21000,1990397,,5000009,2018-01-30 13:44:04,76
0x5e97dec8c63d6f81f62891cb0b739eeef5314f362b6db1fef97759b2af91bf70,t,21000,2011397,,5000009,2018-01-30 13:44:04,77
0x99bec85274750626791bc15befec43c8341ae3a3b1fa1401761fda5db9264291,t,21000,2032397,,5000009,2018-01-30 13:44:04,78
0xbb379e5ba9a59d98e09435407fda1433240814283178096e13a532b961256531,t,21000,2053397,,5000009,2018-01-30 13:44:04,79
0xe8d3d9a2c9841f57b5fd918756873f6194f26515f51e0af77a0214067a7d75d3,t,21000,2074397,,5000009,2018-01-30 13:44:04,80
0xa43d1717504752be5548f81563a866130fe599427b086a2be8d57f217538936f,t,21000,2095397,,5000009,2018-01-30 13:44:04,81
0x90c6043ebde95882a28eb70ef65ccef0fe3e04233bb30fc111e2bc76d4c1ac13,t,21000,2116397,,5000009,2018-01-30 13:44:04,82
0xf674c7c5c8806d8355d9558e16887b0493752760e43375d644f88a31eca2c63d,t,21000,2137397,,5000009,2018-01-30 13:44:04,83
0x6d202b70ad17ca00c702681f1a06bef40a083204298f4c7f40b43ca28f03ed1d,t,21000,2158397,,5000009,2018-01-30 13:44:04,84
0x7cdb1fe25d3bdbb322bb4c9d127bcc30560119a919b66a0d6b46b17988a9d913,t,21000,2179397,,5000009,2018-01-30 13:44:04,85
0x4a29699cb1bcd59c94a695f1733895481dc56419a9f46d332335a659203a5d26,t,21000,2200397,,5000009,2018-01-30 13:44:04,86
0x185d07733bd1aaab981aa6c831c2c12a4c92f6823578216aee9f8d8897392ac1,t,21000,2221397,,5000009,2018-01-30 13:44:04,87
0x4ee095d7665f3df647d552abb254e635bec5dfd2d7eb860b139f6f02dae43071,f,100000,2321397,,5000009,2018-01-30 13:44:04,88
0x2a24f7065f149dbcf76b596e98d1326f19f2bccf09d34c545b1b07fcc196d510,t,21000,2342397,,5000009,2018-01-30 13:44:04,89
0xe781967067046d8a789aa83ac74c71ceaca0a6b059e1d23c2a6cbba15906f574,t,21000,2363397,,5000009,2018-01-30 13:44:04,90
0xa70840acc240ab950307b49b8334948a831f5930f6751d1cdb0972a9d2c63737,t,21000,2384397,,5000009,2018-01-30 13:44:04,91
0xbd0681b9ea8120ff0325ec24811ed0f95825c16cc8c6566eb4334a5fbc91cf3c,t,21000,2405397,,5000009,2018-01-30 13:44:04,92
0x5d29f0b88744636562d92c259138053a4f2326b92801a564025fe5217f8ab39a,t,21000,2426397,,5000009,2018-01-30 13:44:04,93
0x14f4446dbbe617c68ed32b7b303651f72e0ccc9e442fc58b7b8f6e77cdb60759,t,21000,2447397,,5000009,2018-01-30 13:44:04,94
0x68f7fbdd2587d9b1e3378d34e8461cfe630c9aa880f5b3355ddcdf52e4e8d4d8,t,21000,2468397,,5000009,2018-01-30 13:44:04,95
0x9f321021a2bf8bf178f7d71fd4fcf3aca581ac415b54dd83b14f4a2a8f21e63d,t,21000,2489397,,5000009,2018-01-30 13:44:04,96
0xef84d8a2385cc83b070a5cae312537c568325290e8a0a99dea3c300a8be8cbc4,t,21000,2510397,,5000009,2018-01-30 13:44:04,97
0xa90898b67cbb6736aa6a3107aa5fe98f57a45e2d4a3a44783ad2a72b61544d8a,t,21000,2531397,,5000009,2018-01-30 13:44:04,98
0x444572f91343c3ef705dcb7ea278b804baf944f4168e8432072151d8ffa8af2e,t,21000,2552397,,5000009,2018-01-30 13:44:04,99
0x2665e41e562a5fe1c970b49b6937be6052a5747452aae3f2056141075fad86f5,t,21000,2573397,,5000009,2018-01-30 13:44:04,100
0x6910a4fe1a745daa4da5f9247ae2ffc43a5997df776bc4064fe6543367253ca1,t,21000,2594397,,5000009,2018-01-30 13:44:04,101
0x23e4a1cd04edabb9946aef095570784b7a8e3fd1a686c55ccb8b2d1159ab256c,t,67549,2661946,,5000009,2018-01-30 13:44:04,102
0xd97110e135ba2a48652457dd18d2431225013821a55ca2b7a96b5bead1329f4e,t,21000,2682946,,5000009,2018-01-30 13:44:04,103
0x531a8f2567cf7814526554c48f83d5fb2dddc71d57e042c98a38b499b529f64f,t,21000,2703946,,5000009,2018-01-30 13:44:04,104
0x03518ada31a5a9630a6a3608a427b4f6b474c4e81b36a226e06ae0e6d66345c8,t,21000,2724946,,5000009,2018-01-30 13:44:04,105
0x36d397e4af0b4595c4ca7ec208b17788382622c6dd0af2eb71b11cc585bcff34,t,21000,2745946,,5000009,2018-01-30 13:44:04,106
0x87b1e098b790b463762d1b05e5945bd8101298907264164f94e24732eed11317,t,23028,2768974,,5000009,2018-01-30 13:44:04,107
0x90db7020b7d52978d37ab663ebc78487036219c8e9d42c03996bdced6979f398,t,21000,2789974,,5000009,2018-01-30 13:44:04,108
0xcb236cfbf3d218d4408e3372dad4c5536964b3912d55a5858d6bb8ea52fde88b,t,21000,2810974,,5000009,2018-01-30 13:44:04,109
0xae4985fccd375e018b11c74bd05e712fd692b2f60776e8a4bae0ba8532fcd0ed,t,21000,2831974,,5000009,2018-01-30 13:44:04,110
0x35b9d2433c941ce603a7fc6e851f28498c26c39bde482079b962a23d594cfc22,t,21000,2852974,,5000009,2018-01-30 13:44:04,111
0x99889ca3aff6223c0ea3876636da309f8871192cc3eed8f7f03e9cba3c601037,t,21000,2873974,,5000009,2018-01-30 13:44:04,112
0x4f78b424465a768aaf0a6b6e6890da5a9cd8aac0eb25f2e9e8b18dd827a2630e,t,21000,2894974,,5000009,2018-01-30 13:44:04,113
0xcc74e860363f2b26b3ffc4ab145455de9f1ff0d16c30075d0a3ee42d69d4e51a,t,21000,2915974,,5000009,2018-01-30 13:44:04,114
0x1cb71954407448a4c61c0e13599083fb7276beeb97a96da751372b23ba36f514,t,21000,2936974,,5000009,2018-01-30 13:44:04,115
0xe9f2f810a07a4dd27474d04ac77ef71ad97e070a986b9cf7a7628d06aacadffa,t,21000,2957974,,5000009,2018-01-30 13:44:04,116
0x4f28018d603d6f4ad86a4ff7c4e13b38aefcda68b1cf0e3a1f72a60e598f9a06,t,52218,3010192,,5000009,2018-01-30 13:44:04,117
0xc64ae6264eaf10bf436ce523a3d4fcf9f2c09e7cce679b0c51206d9787ce2992,t,21000,3031192,,5000009,2018-01-30 13:44:04,118
0xf256700b4fad84b1586a28f918c814237080b636216148c20c92010b2deb3c2c,t,21000,3052192,,5000009,2018-01-30 13:44:04,119
0x3559e2e2238da0fafa1f9e41a9976914e6e920064d842e4f0fe2978a8302473d,t,21000,3073192,,5000009,2018-01-30 13:44:04,120
0x229268ce8f75fee56ac3146ab28d4130acd6f0b53825f89c08a9191ae6c934e1,t,4679460,7752652,,5000009,2018-01-30 13:44:04,121
0xdf58bc2506cc5a9ef1011b59d6b02a26b338784faf98ee07aecddca34e6d9fb6,t,23316,7775968,,5000009,2018-01-30 13:44:04,122
0x6a0902af4c19ebc0ae494343a68747d43f65f476c05b99b2d11aa3b229c3088d,t,40806,7816774,,5000009,2018-01-30 13:44:04,123
0x5cc0c3046dbc622402d7a125aa8bea3510279fa5cfed73bf836a899f91c634d4,t,21000,7837774,,5000009,2018-01-30 13:44:04,124
0xfe327d3091c13de81da266414ad98964318ab749ab66b2928a5b5aa9c6be788e,t,21000,7858774,,5000009,2018-01-30 13:44:04,125
0x348472d2806525d60325ec122362884888e74c43cde47b9e13b6a4d206009072,t,23252,7882026,,5000009,2018-01-30 13:44:04,126
0x5797051d5ef03624ccc9639cab5be24ab1be797d8bc7596ea9986c8543c81fba,t,69836,7951862,,5000009,2018-01-30 13:44:04,127
0xaf3a5c0591abc3cf826a0b370795ff39af272806cfb73ed10be9d89baf521f1b,t,21000,7972862,,5000009,2018-01-30 13:44:04,128
0x9bd90a7c18f53ecd8f34f2697a3a7d0b50fa4be92970fc3dd50b3728eaff1b1e,t,21000,7993862,,5000009,2018-01-30 13:44:04,129
0x347bb0079f142f6e825d7639d4cc9e7ca8988b675dbb808a35b0234c70b1215f,t,107794,107794,,5000010,2018-01-30 13:44:15,0
0x34dbaebd74673ccb6f2d2b2ebb1c4aca7cfa00400d91f05ebec0159853af0051,t,143081,250875,,5000010,2018-01-30 13:44:15,1
0x4123a10c418d2e7367e6b3162fdc99cebc42ffda2cdd0bf71d1ff2e8f7870f1b,t,37468,288343,,5000010,2018-01-30 13:44:15,2
0xe043c7c5c179919c8316515950df19e18103d5fd1484b5d2f2465d9cfecdbaf4,t,21000,309343,,5000010,2018-01-30 13:44:15,3
0x0a1a322638b912c2fa0bf835ffe9a067ea0188edd9545a493c2bec12bd252972,t,21000,330343,,5000010,2018-01-30 13:44:15,4
0xa22503a124c4b5e2696ed863193b58639b9ee0e0b5052f82a50bbd469c7b3bfe,t,21000,351343,,5000010,2018-01-30 13:44:15,5
0xfb091d0880ada062eb6101f2623e7bddfac831483685ad7e878b8a07e7649da1,t,21000,372343,,5000010,2018-01-30 13:44:15,6
0x1eceb681f1e96d1177d8c8b373da5b8c565c9d18fafab77e2a54fe47c2c42ef6,t,21000,393343,,5000010,2018-01-30 13:44:15,7
0xb4aebf39f13b03c2ef18f81e1803049b57f5d960851a1c9bd6c17599f0c5376a,f,28960,422303,,5000010,2018-01-30 13:44:15,8
0x7474bcf4515add6ac4d4f432547b335186221253e82982f5daf1a7761b630e6b,t,21000,443303,,5000010,2018-01-30 13:44:15,9
0xa26441bf0e5c226e739da57ba3a18cc6dbd8627f229b9dd9388d79dde3e817e4,t,21000,464303,,5000010,2018-01-30 13:44:15,10
0x160df8e72ff66379483ad705770e9360e34289656a9d21ef30061deb65970b94,t,21000,485303,,5000010,2018-01-30 13:44:15,11
0x885666f4275c70732200077f9a28edbe5ad3b033d4adae7d3a4db6ccb4312b66,t,21000,506303,,5000010,2018-01-30 13:44:15,12
0x5475afbbda1ab642a3915ded51a4b453a826a9ad61e7e60d097fdef9533e352b,t,21000,527303,,5000010,2018-01-30 13:44:15,13
0x6cdcc2b140a17aba406f200de961fac99905775fa9927b93cd83cc3ea442fadc,t,21000,548303,,5000010,2018-01-30 13:44:15,14
0xc375276da86cb35e7259ce4a7f5107dad9b341db9befb77c806e768847b452d3,t,21000,569303,,5000010,2018-01-30 13:44:15,15
0x62109c177aa8f2dbd24b8e14654c0289d0c51276ed967c5c9e0e563895c71786,f,21594,590897,,5000010,2018-01-30 13:44:15,16
0x736b293242d983c930f242ec466f77e1d54e25cd252346d23834189fb3abb175,t,21080,611977,,5000010,2018-01-30 13:44:15,17
0xdc4b545ceb0684e353bfeb985c7d1218e18815210608bea732b1ef0397fc89b4,t,55779,667756,,5000010,2018-01-30 13:44:15,18
0x9285ee2a2e8cb2f31dadfa5641d22c66ff8ba0c9207c3139bbc28579b7b390d3,t,21000,688756,,5000010,2018-01-30 13:44:15,19
0x0a2198976ec1760d3ae2d92d02e25fad23ab2516ff708e26ab36d0ab4b993694,t,23176,711932,,5000010,2018-01-30 13:44:15,20
0x4be55ea9cab28681a4f2a4649a5a9cdbdc3d3d957b839093cc0ff2165943d39d,t,21000,732932,,5000010,2018-01-30 13:44:15,21
0x0f86d6fb94ff02d4b2d8fbfcf8f29d68ea791abc5ce210931416aad3373273ae,t,21000,753932,,5000010,2018-01-30 13:44:15,22
0x1bf47aeb0622041a3733e8227a37fd5f529f896b60a68865d5ca8b7801470f48,t,21000,774932,,5000010,2018-01-30 13:44:15,23
0x0db756880bd059f1d078ac98df8d657e35a636127884e7eda49901ae7ecf6ef0,t,22588,797520,,5000010,2018-01-30 13:44:15,24
0x67d88796ebc8bd4a9c46717bb7fb74a6d579e043a48bef233b18e9072dab5063,t,52632,850152,,5000010,2018-01-30 13:44:15,25
0x5f7a0a5ea1745c30cc4f89381c57d4851a14288ee9474b6fb29d4a05ccbe1a46,t,21000,871152,,5000010,2018-01-30 13:44:15,26
0x6c899fe1a0d847c2b7edd6693461f6d2bf03a7b59bdf3b5112850ed8902ae03a,t,21000,892152,,5000010,2018-01-30 13:44:15,27
0x8a3a0f9c8ed429b9b3c22f044eb5731836f88361559f0f48887c8a8d07498ddd,t,21000,913152,,5000010,2018-01-30 13:44:15,28
0x02f782af658a2ebe9e8034bb8ac73fdd7828b3d078cd4804b5bf6f16a71e1395,t,21000,934152,,5000010,2018-01-30 13:44:15,29
0xf78a34b7bfcc2e81d7a30f15b63dbe30139eb2b05be076a8ccc116e61452966e,t,21000,955152,,5000010,2018-01-30 13:44:15,30
0xe41dd3e34c81942516f6565c819bd7fd055086146b10665a4ca4218044e431e2,t,21000,976152,,5000010,2018-01-30 13:44:15,31
0xd00f251cffde395812943fadd4a0f12e31d637ac5b517910415d89530c7a8ca8,t,21000,997152,,5000010,2018-01-30 13:44:15,32
0xe5cc9dc2d15e791b093b108f09d1b25d04a41e7f3b4236bb6b88f1d621ca2104,t,21000,1018152,,5000010,2018-01-30 13:44:15,33
0x53f73a6d8e75a1728cfd577018c53f556e098ab06f48807ea25da3c70d064b82,t,21000,1039152,,5000010,2018-01-30 13:44:15,34
0x341eb3bbf1053387fcff934e35a5b8663d681a359705f6dbccdc74c30a397e53,t,21000,1060152,,5000010,2018-01-30 13:44:15,35
0x1d9e1648e53869f302c6e13205bfc9cc183383e84cfb642e138fdbe1c6f69d5d,t,21000,1081152,,5000010,2018-01-30 13:44:15,36
0x3a4f52f4406aa9ce3e7cd2215478973c91679fd0efe19fb66dcb01a3ee0724bb,t,21000,1102152,,5000010,2018-01-30 13:44:15,37
0xb2191ab9b34e471173e529a763ddc3f1275b9e0a6ae8498dcd90f7cf27ca9435,t,46045,1148197,,5000010,2018-01-30 13:44:15,38
0x3a2b27614ba3ae39f02a44df0f639abb7f8a96faa6ce96e6a46f316ce0907efd,t,21000,1169197,,5000010,2018-01-30 13:44:15,39
0x5d5a8a3143b8df371293eee90aa21b1b706b11ba86c862ad2c6ae5d3100adfff,t,51725,1220922,,5000010,2018-01-30 13:44:15,40
0xd1e3f29446d54fa2ece961785571ca079a73f0edac99878fc90d9348f144fdc5,t,21000,1241922,,5000010,2018-01-30 13:44:15,41
0x126302aa50228eef57a38c4adc136c3ed4912f5631d0724809b408943ddfb6ab,t,37251,1279173,,5000010,2018-01-30 13:44:15,42
0xa5d8723e6edfdd551ddcd7e37af5ce3f6a890467cc8fbd6239b2ed99af38bab4,t,21004,1300177,,5000010,2018-01-30 13:44:15,43
0x203bf8f7484617a6ca3c50fae1365c42a1059e5fa5862730edf88556f080d784,t,52940,1353117,,5000010,2018-01-30 13:44:15,44
0x18f0ff0c0af4c2e7acf9587d8cc36219c4d12f2c4213bf7ab0df5a7b607c387e,t,21000,1374117,,5000010,2018-01-30 13:44:15,45
0x9d0a7d72e98b841d6a3cf06595d3d448df2311ce3c6c734ea2a88970462dda3b,t,21000,1395117,,5000010,2018-01-30 13:44:15,46
0x40c4c977eeb914acf0029c84cd24f088ad58dfdb6622575b70329d4f7cac4065,t,21000,1416117,,5000010,2018-01-30 13:44:15,47
0xa1a23300c583f63cb306c733c2ff790e268d39ab3eca0456b403a27aa22ac4dd,t,21000,1437117,,5000010,2018-01-30 13:44:15,48
0x0a01f1d04eedeb357c96fed4f18cc596c15564ad57498fc00c2a02ee41a72c3d,t,21000,1458117,,5000010,2018-01-30 13:44:15,49
0x638f2da2e4e24ec526143231145c53310851aada90aa30ab4093d4c8e2b75015,t,28973,1487090,,5000010,2018-01-30 13:44:15,50
0x700cdb1a6d49f800be802e6ef0a9f1d93627e9090adaf426772606ba58318c05,t,21000,1508090,,5000010,2018-01-30 13:44:15,51
0xcc31ef1fc0a841398c10c4449b5fd5b1c1eae0b14812c2d4720bad80884155fc,t,21000,1529090,,5000010,2018-01-30 13:44:15,52
0xc70f6fb6420873ac55c65c8aaab09c77476e21cea92c71a937f4163104988d9a,t,21000,1550090,,5000010,2018-01-30 13:44:15,53
0x2828d12ae8f698088a2ab4c0a4d285988d53e40783fdf18469cb16a2f535cc80,t,78434,1628524,,5000010,2018-01-30 13:44:15,54
0x5eeba371f405bf3a56b55bb9e467e7797db7520720727eae52d1b814dbd31285,t,86688,1715212,,5000010,2018-01-30 13:44:15,55
0x3ee699a8b34a3a50bd71ab818adb3dc9dac4e0f9d3d47ef39833d69998dfad80,t,611504,2326716,0x86eE7352c121547d6BdF4e7BD2AE44269C56A7B8,5000010,2018-01-30 13:44:15,56
0xafc9224446d833ad7543dd7973dc83991ab5bd0e87a3c7097fbc00e2c656885e,t,21000,2347716,,5000010,2018-01-30 13:44:15,57
0xe390bc63347cf3b02ee346b29724fac5596bbafa76ddc17fb080f1cd5fe29854,t,21000,2368716,,5000010,2018-01-30 13:44:15,58
0x1d089ee6547e949147bce57f84c1c7f40b7e65a82453b1338f978d6431ec70c6,t,68696,2437412,,5000010,2018-01-30 13:44:15,59
0x38190cad72c761209a10e2e2a1aa1bca6643fd4e7d5d5f6d07ddef7e24d31fad,t,55907,2493319,,5000010,2018-01-30 13:44:15,60
0x1e326d4a7e3156bfcfed42e0e9d831e30c827d49951f3d4d529486f5755800c1,t,21000,2514319,,5000010,2018-01-30 13:44:15,61
0xdbb6718607e4347016e7922a6918dbe9cde5547df8ac75a7cfef25b9ad31e6a4,t,21000,2535319,,5000010,2018-01-30 13:44:15,62
0xcb21dc30dddf7b15b525e74db5d226fef8773cb91937e26765b549c51191d9a7,t,21000,2556319,,5000010,2018-01-30 13:44:15,63
0x9773fe926b94f402ca9b49219cfb48acfb891c50074614cb9255f4d91f6b8f20,t,21000,2577319,,5000010,2018-01-30 13:44:15,64
0x322887bb1cc176725c81b1c983fb461dfd32cb3a1d1be7cb436190fb2000952c,t,21000,2598319,,5000010,2018-01-30 13:44:15,65
0x193b3bd1dc7c39b8656a88d459faeaf40e4f3c2d2503023756b6d9dbae38b1c0,t,127836,2726155,,5000010,2018-01-30 13:44:15,66
0xe3f27abeeb928c6b401c06b3ac2cace4d601f13f34b32635e58eece4b941139f,t,21000,2747155,,5000010,2018-01-30 13:44:15,67
0x64a9d7f74eb0e94b3cd6bf931c3617d137c4513a4831b9899488318dd977100d,t,51752,2798907,,5000010,2018-01-30 13:44:15,68
0x45c59fc93d541bd246312040a492db24400eca096f480fc72ca5a84a8af02264,t,52547,2851454,,5000010,2018-01-30 13:44:15,69
0xb0c688180574e0459c7e354d7f2e52b11fbf8d4e9dae2ad310b69380cbe61f55,t,52019,2903473,,5000010,2018-01-30 13:44:15,70
0xe0809cecbbdebafe06326d8e103ad263d8ca202500672cba126d1551a4bc544d,t,52030,2955503,,5000010,2018-01-30 13:44:15,71
0xe5c40bd70caaded829b17d3093520ec5e0f2b24ff1bdc35a3def65a2daafaaa4,t,37884,2993387,,5000010,2018-01-30 13:44:15,72
0x0c8dc85d7f8b9636ee002f9fe6ebd3907f82b4e8c3ec6ea67fc57bab82c1b5e3,t,51955,3045342,,5000010,2018-01-30 13:44:15,73
0xafec36c9f2c9164c0df31e0fc602209e560c52fa62238be516747f2d0138c3b1,t,52391,3097733,,5000010,2018-01-30 13:44:15,74
0xcf9cae973fea2dc39d87fbdbb2f194694c38376989787cd3991b310c64c089ad,t,51688,3149421,,5000010,2018-01-30 13:44:15,75
0x8d572eb555e1dc3b19076becf281c372d66c49720cdffdf855fa2a70f66d467b,t,37711,3187132,,5000010,2018-01-30 13:44:15,76
0xe9b4d596e0f643791d8940b4eb36a6c684ed4b802096bb74304e0b9bceaa7992,t,64725,3251857,,5000010,2018-01-30 13:44:15,77
0x76ca548baccea3aa75bb5f78ad559f22de9a6223e8d6bab143e0aa34ae336941,t,21000,3272857,,5000010,2018-01-30 13:44:15,78
0x0ca2ff651baa8de4f838b398172063f74ade1a9fdca43d9b94721cd031625a17,t,21000,3293857,,5000010,2018-01-30 13:44:15,79
0x61ac4c0fc0514a889f2890ced6c1a131eec76474c24bcc491a6b64d682d4e68f,t,21000,3314857,,5000010,2018-01-30 13:44:15,80
0x0023ba2489ff1a1f68c433dde57f8b96f4c180715e7a593a313f867ef4c596c9,t,21000,3335857,,5000010,2018-01-30 13:44:15,81
0x3bcda10bdb9225c0860464ff659c5a175b028477477d8ed2b0a617645afd5349,t,21000,3356857,,5000010,2018-01-30 13:44:15,82
0x1030a412aa9b9ef69da3fd36488ab4f46db9547a11646d70f7e19bb8de0cc806,t,21000,3377857,,5000010,2018-01-30 13:44:15,83
0x25b88e8fb85fe5abc91ac0b0cf77b74c636e348a11049b50f79a1bbba1745173,t,21000,3398857,,5000010,2018-01-30 13:44:15,84
0xee4ab5af2aa5ea3288bbfb66170d5a46f3b4485a0489b8b46c26fe4cb64ff659,t,21000,3419857,,5000010,2018-01-30 13:44:15,85
0x79343f5263caad7daf1de91ca6b3edafa40436501fd3f31b1e0129ac80c28c6f,t,21000,3440857,,5000010,2018-01-30 13:44:15,86
0xf19c2be350a14b6911f9d1d055cd60bd4a32c62d737b6df221f279fcf30573b3,t,21000,3461857,,5000010,2018-01-30 13:44:15,87
0xbb873bcd896b2603554d85b83d41c47a45699948096d453775112cd154c0656c,t,21000,3482857,,5000010,2018-01-30 13:44:15,88
0x4defbe9f34ee38ac166718aa5162525011e4ba89edc3ef5a904b23709254f0de,t,21000,3503857,,5000010,2018-01-30 13:44:15,89
0x385b88a5ec82ca61e8b88d1b38e492f87f22f010f70d69e9e41a2379a080679a,t,21000,3524857,,5000010,2018-01-30 13:44:15,90
0x15dded3213ae02323dffbc4663da8a8ce033e68b5feb61f2e94c06a6039d57d2,t,22222,3547079,,5000010,2018-01-30 13:44:15,91
0x84bf25d19d534dd6f249a60a394654f6c9fd692e6c236bc7cbe57745d0902584,t,21000,3568079,,5000010,2018-01-30 13:44:15,92
0x6d09f89eb5c398bd8045fbbb6dbfbe9cee76d5438064fc15180aef67168b55db,t,21000,3589079,,5000010,2018-01-30 13:44:15,93
0x3fd25dc2f44de2a0b421b24c4d6e86fa1824233487d1144687897913b1c4f390,t,21000,3610079,,5000010,2018-01-30 13:44:15,94
0x247eaf151e46c4cfa250cde68148e71e0ef02e4477ae455782ac89d7606247b6,t,21000,3631079,,5000010,2018-01-30 13:44:15,95
0x9b6a6b07adf8944d8c97a0c53a5f873ed2e29292fb6028bb57dc6f98110497e6,t,21000,3652079,,5000010,2018-01-30 13:44:15,96
0x5a413f4beb0f528c4191702f167c5db478734ead9fd00b9cd28f81dd841b80c9,t,78178,3730257,,5000010,2018-01-30 13:44:15,97
0x9c69977629f8df1e1babf8567d389e96719e012f8fa09d208be28aea4112e669,t,21000,3751257,,5000010,2018-01-30 13:44:15,98
0x1af78acdf7d0b06a492c59c4e46d385fce1e6933aa003a78225f2dbea2702c25,t,36632,3787889,,5000010,2018-01-30 13:44:15,99
0xe01ec71187de203a51272106d1063bc83ee3c8407207517698a2f8f01c5de287,t,30327,3818216,,5000010,2018-01-30 13:44:15,100
0xa403fe52cb47d5919e41b5f9ebb5c04562a53aa4633a3576bade4e9949a25044,t,21000,3839216,,5000010,2018-01-30 13:44:15,101
0x227439a9a899ab5a972d17d1b5aa3ca81a07601ca65a29dfff4ffb575b1fd835,t,21000,3860216,,5000010,2018-01-30 13:44:15,102
0x04e69b3f7ac293482417bd23df97984501e03baff208108ce80f9542d11bdedb,t,21000,3881216,,5000010,2018-01-30 13:44:15,103
0x6deec7b2e49cc657d2ff085e505f9dc894b95be7fe23dadbb1e357f5aa68fcad,t,21000,3902216,,5000010,2018-01-30 13:44:15,104
0x520e1dca29c1e91732ff8312d61db5451141a99172e754658e2dccf98d3d553f,t,52886,3955102,,5000010,2018-01-30 13:44:15,105
0x91c198a9384124b6a9508560c2b5963772ab2eda98e8b2041f2d5db793bd62d6,t,21000,3976102,,5000010,2018-01-30 13:44:15,106
0xa4277a392e2ce544ba955ea6eb1d3fd0283d7738a87eca9761a8a54d419988e2,t,21000,3997102,,5000010,2018-01-30 13:44:15,107
0xe3ac49cbb38a940098b4fb608c9c957a5bd7ff68bda23b2f4e0239391f73f352,t,92613,4089715,,5000010,2018-01-30 13:44:15,108
0x0f8e7aa2bf40e026dfc09cb4cf1d4c0fa76021deaad916bdba02900afa264bb2,t,36792,4126507,,5000010,2018-01-30 13:44:15,109
0x432a7b90b1928b5410206a97df07721c195dbd52721608e8e3ba94b6867de746,t,21000,4147507,,5000010,2018-01-30 13:44:15,110
0x3be50a9c00bb2d3f7a048ffeda4e5da9fd84dc71a872519ea169be1525a6d761,t,21000,4168507,,5000010,2018-01-30 13:44:15,111
0x1860c88aca27b5675f44a6a30ba9a2232138acc9171f916614ab83cf27b44013,t,21000,4189507,,5000010,2018-01-30 13:44:15,112
0xe5df2e6897943de40e6f92f71987d803c1cbdc59f793f31fa100b5c27b6c0864,t,21000,4210507,,5000010,2018-01-30 13:44:15,113
0xd94f8ba0eb030ba874b63ec9b6527cf89df313598161e7cc41c08c324d6a94b2,t,94701,4305208,,5000010,2018-01-30 13:44:15,114
0x873fd24ce14d2e1ecf34ea895b3d850d2977c1fa3e1e9b288c8410e70f163c4a,t,21000,4326208,,5000010,2018-01-30 13:44:15,115
0x585ab5976ee6f81373080c9ac93664091e5306c3e30ca1ae8db268937a462c0d,t,88422,4414630,,5000010,2018-01-30 13:44:15,116
0x0ab6a675c136c4157c04675d5a2432eb127df0365c264877ad5bf48dbb361619,t,21000,4435630,,5000010,2018-01-30 13:44:15,117
0xf0bc2c24e71c382e6da85804c9087d41bbb5d462d204fe73be8d53cd16094841,t,21000,4456630,,5000010,2018-01-30 13:44:15,118
0x59833770ccf89025d8fe0b9e39bcd1fee7f6649206853df939af5f3e0afd3fca,t,21000,4477630,,5000010,2018-01-30 13:44:15,119
0xff773e20bef8534a8961bc8d19f432267984d6b1beed6330351349dd43c5158c,t,21000,4498630,,5000010,2018-01-30 13:44:15,120
0xbb3053693bd480c1ea8fef2e556c19530088ba40eff6f43052951374123a93d5,t,21000,4519630,,5000010,2018-01-30 13:44:15,121
0x7931f912a92873ebaf4396971fa715968a946373c0af418aa3a68a02a828425b,t,36938,4556568,,5000010,2018-01-30 13:44:15,122
0x587c8d5bed09522b5ef645d0deea32d8ed8c08a9e15566fedd7c0783c9794394,t,22193,4578761,,5000010,2018-01-30 13:44:15,123
0x55c335416f67a6ddebba9d1f4dd3a5ea69405e0b8e3d6b403477fbc52cf5a351,t,58970,4637731,,5000010,2018-01-30 13:44:15,124
0x4610d39e3d20f94f2031028b663b5bfb1b9be624ca554e804872c81dca0477fb,t,38188,4675919,,5000010,2018-01-30 13:44:15,125
0xaf984c0e362e78a6059fc62aa572d8a6fa0b9df3967536bc5a733002eb40ea9e,t,56344,4732263,,5000010,2018-01-30 13:44:15,126
0xf87896f2aa2c569462ceeb5506b0dae60a9b382220873d8b5d62727857357f8b,t,46045,4778308,,5000010,2018-01-30 13:44:15,127
0x17177e54ece6abd7dd7bda0787982471df608529bbaad5ccd4507357bb3926e5,f,51947,4830255,,5000010,2018-01-30 13:44:15,128
0xb7262ea3859c9710fefc3c3f966480abddba71b42501b8703a8bc7417c0a8fb4,t,27859,4858114,,5000010,2018-01-30 13:44:15,129
0xe7c94475878edb03c1dbd0fd26f49eedbf2b3302ee74817acfaf9b2586a30e21,t,84005,4942119,,5000010,2018-01-30 13:44:15,130
0xa742f98bf10a3bf9e3b5ee82adf9066337634c952960e0c37afa5ff3636af793,t,23382,4965501,,5000010,2018-01-30 13:44:15,131
0xdb918c91aba7984702c2fe26a293632ee1462ae3e233725f68581ac280b36493,t,38318,5003819,,5000010,2018-01-30 13:44:15,132
0x2e92f958bedecf02d14a90e0ae291ae246beb397597dda348d1cce620406fcf7,t,23254,5027073,,5000010,2018-01-30 13:44:15,133
0xba9b7ad31d8e87c50bc002433c8bce090866a42518b3de4a85ef880146ba44b1,t,37065,5064138,,5000010,2018-01-30 13:44:15,134
0x732d397f4922690f41fd7a0b89edd73bfb2f578cdd245da089cf01379e4c7c0f,t,23318,5087456,,5000010,2018-01-30 13:44:15,135
0x6afd0e5e7bcd9e82ed1eaa47822fce8b6cd1834b48e91e3c399d03cc8ce33bb0,t,22402,5109858,,5000010,2018-01-30 13:44:15,136
0xd504179956e70f02a88350c4507ae26309de3aec6b347090e1687bcdb753e07d,t,22460,5132318,,5000010,2018-01-30 13:44:15,137
0x2662dbd476c2376efd7c10e104ce09030540ed72db314d0eee53d2037d30c189,t,23318,5155636,,5000010,2018-01-30 13:44:15,138
0xc6eeb668d2ca02da69a0576650c565521a84605c6949a9a46a23e301ab952874,t,22524,5178160,,5000010,2018-01-30 13:44:15,139
0xf59c7f8074539137fb65ac55e2316fdac7fe08794db9833b0530201e97313099,t,23318,5201478,,5000010,2018-01-30 13:44:15,140
0x533c158df502ae1f77383a61c28a258bffde4fcb768a39cb208a1a3855dd1e91,t,22524,5224002,,5000010,2018-01-30 13:44:15,141
0xd8dfdef7b8cb4d69b18ed97a7b6dbd00c0e92c4f8ee0a0e0f7274ecd754c1ccb,t,40971,5264973,,5000010,2018-01-30 13:44:15,142
0xdc17a8a0b9c9723acef6328ed5fd77c948e2c4d167b8c3bb0d8bd4e5d333c36a,t,92858,5357831,,5000010,2018-01-30 13:44:15,143
0xcaae73b63c620fcb8810dbe594e486abb95317fbd34b0278f0e24f764be4dded,t,51416,5409247,,5000010,2018-01-30 13:44:15,144
0x124503e9ec01378609e2dda5010f0a4e8795caa3c4814d5d286e3c3fdba20b2d,t,37964,5447211,,5000010,2018-01-30 13:44:15,145
0xa9baa8d27751cdaa3922c9d0a073e942ffdb4ef1213b84509b2ba4b255484fa6,t,59354,5506565,,5000010,2018-01-30 13:44:15,146
0xf6f33df6a96aba0f295c93c52ac0c100254b7241128bcff67751aceb7bb745d1,t,92794,5599359,,5000010,2018-01-30 13:44:15,147
0x684488a7083ea1024edcd3a0b978841fe89a60680141e4cf5a81182a6609df06,t,140276,5739635,,5000010,2018-01-30 13:44:15,148
0x6621a5848c64a0b74f44c9bcca66e99f8a6515390462f3b14db6040068a323fa,t,21000,5760635,,5000010,2018-01-30 13:44:15,149
0x9e80b224720dbfca312e3116479a18a27f2ccf0e4522dddaf4506085d86793d1,t,21000,5781635,,5000010,2018-01-30 13:44:15,150
0x11544b98d72cde974e732541a9e28bcb1a6f26a9c2216bb78fadc411879bd412,t,66316,5847951,,5000010,2018-01-30 13:44:15,151
0x8346c176cb1cf71c4eff9f86910409d0dfd6d9e3fa14c13f68d1b5c135debca0,t,51560,5899511,,5000010,2018-01-30 13:44:15,152
0x2a845adf38a0142deedfa12e1e4dfbc1d44b931b37ca612a16cbde1acf5667d5,t,446392,6345903,,5000010,2018-01-30 13:44:15,153
0x00b8069eab73e564d8b2a5fd29a8e79fc778f259fefb61a70b175659993b7052,t,48075,6393978,,5000010,2018-01-30 13:44:15,154
0x034bdf3c9ba707d4127e3b7bef80f39a6e7cb3e131cb0dd5fc87dcffa3cffc21,t,37836,6431814,,5000010,2018-01-30 13:44:15,155
0x18907f087b998ff370e51558875a8eaa8cdc47a126c6af427b2563aa4fd7d32e,t,93114,6524928,,5000010,2018-01-30 13:44:15,156
0x88191c01ffd14499bb817a6d48a2b1e8177f14210e4974de359f31a31172663d,t,44162,6569090,,5000010,2018-01-30 13:44:15,157
0x8acb0812640e4e8ba61b1b7c0db702fc27ec64784921e4d76833b5e8af8ecea6,t,37900,6606990,,5000010,2018-01-30 13:44:15,158
0x04553c755fe9eca3f3bbe514616b141327b6e300848bf886f739798d52169775,t,29493,6636483,,5000010,2018-01-30 13:44:15,159
0x37b7f54906335dd009670f56583fad48e9119dab4ebc77f67cd91f650f01846e,t,48021,6684504,,5000010,2018-01-30 13:44:15,160
0x19c1cc265eac40336bc09884aedbaa866570de9684fd14b8d2a768164be574ec,t,65882,6750386,,5000010,2018-01-30 13:44:15,161
0x7b958c7761db038b0dc1dfbcee5ad367dae47f0333cd2131eae23bea6b3ba113,t,186185,6936571,,5000010,2018-01-30 13:44:15,162
0x78d8d8e176f4c19c2ae4945da7509cc920d9b7e38b82771e0f1e50d340eac705,t,45843,6982414,,5000010,2018-01-30 13:44:15,163
0xfe03bfdcdcd233e812862da594373c55774c0ad7343d12993effd2937397651f,t,48331,7030745,,5000010,2018-01-30 13:44:15,164
0x81223ed82440afe2e69d09497e7750d9849bfd9342dcec84d20613fbd3dc0c06,f,250000,7280745,,5000010,2018-01-30 13:44:15,165
0x379c435830b18c3232d712ada697603818b62b07759167b20813f67969406ff9,t,21000,7301745,,5000010,2018-01-30 13:44:15,166
0xb2558c59661be3d376d2c5728e611898619add840e9342b5dca661d0ad2b1219,t,30706,7332451,,5000010,2018-01-30 13:44:15,167
0x07a04a9e84e36724a1a3bbdfb9ea9c9062124961060708e5cbc5922d2a749660,t,174591,7507042,,5000010,2018-01-30 13:44:15,168
0xc495bfedadc02891311d089ceb3bbd23a41f97268b82038fe2c3315e9191c354,t,45694,7552736,,5000010,2018-01-30 13:44:15,169
0xd567ed4f2b198e1963abbb7bf39537d78cee677cdb42507d7fe8175d831af335,t,100204,7652940,,5000010,2018-01-30 13:44:15,170
0x9f872dcee6856fc1949b5a530fae3da07a63a37217eb74d947bd445972138357,t,59354,7712294,,5000010,2018-01-30 13:44:15,171
0xd750f42659be8aad58e316cb1c0c3c6645ee214da3e71ac33d3256b2af67bdab,t,22964,7735258,,5000010,2018-01-30 13:44:15,172
0x79a5de31dc8d2c87185c31a5096d40d8e0fef5963cca7746d3fd715d3b702491,t,59354,7794612,,5000010,2018-01-30 13:44:15,173
0xfa769c1d4c65ebd4bd31f6957dbfef9ef31dcc859038d8958e59cd31ab516346,t,54005,7848617,,5000010,2018-01-30 13:44:15,174
0x080b549c92f07f26f29acf2d23962396ee6e4674dae347b450112632d0d0c581,t,21000,7869617,,5000010,2018-01-30 13:44:15,175
0xc53c0e1c0feec793da2e821cdf1ca754742d26f5e02a37821cafe913124c6f72,t,21051,7890668,,5000010,2018-01-30 13:44:15,176
0xe3d09b90944a86ff2e31783a47dc44c43c430e21219129f7f4704d830af38412,t,21000,7911668,,5000010,2018-01-30 13:44:15,177
0x68af06a17c9e367362883b83944f3f42b78dca8d614a0cb9acbeb5d1f9922633,t,21000,7932668,,5000010,2018-01-30 13:44:15,178
0x950b155528559a9a7a40cceaa85e9cf9b7a8d96aa1c8e28bed68697e817b7a0a,t,21000,7953668,,5000010,2018-01-30 13:44:15,179
0x85c274f983d7f146c2b3ac57c12e3416de22fcaf3f12643245ebc19dd97d540b,t,21000,7974668,,5000010,2018-01-30 13:44:15,180
0xc0e8f1517b69f5e980cca9602f97e18d7084fbe6ca217ea7c5fa6bc5ea143866,t,21000,7995668,,5000010,2018-01-30 13:44:15,181
0x553fb8d94b75c0992897a1dd39213ccde0791a6ee5a261089b7d6b511401cd44,t,21000,21000,,5000011,2018-01-30 13:44:19,0
0xfb3adeaec76393a1c47a8085542738a0e0ef7009ae9bd79e95dbd6bb9322acfe,t,21000,42000,,5000011,2018-01-30 13:44:19,1
0xf00726aa422ce734a378e102d2e59be2e222fd810008d4b2c186e2758e7d17e4,t,21000,63000,,5000011,2018-01-30 13:44:19,2
0x9de372d71304f31ed4aa0540e00cd00768919dc56c8c79923a14730d064cccf7,t,21000,84000,,5000011,2018-01-30 13:44:19,3
0x3dc7fa6daf7d21be7ff5b4ac7b47af853a13bb88c98da240d381aa04886f0551,t,52412,136412,,5000011,2018-01-30 13:44:19,4
0xda806d73734a0f3fae71dbf0da9262b569b41dafb28467ce81bfafd12830b39c,t,21000,157412,,5000011,2018-01-30 13:44:19,5
0x8396bf4f91ef45a260294aae99838f11336362c03ba7234674c195fe69791822,t,21000,178412,,5000011,2018-01-30 13:44:19,6
0xf150a1f0370fda0d789093a32105a7f494dc6cbd1eb06723657b05636b995243,t,140972,319384,,5000011,2018-01-30 13:44:19,7
0x929fa63ed1ca14752f841ff7cbdfd9d58609920ac19344f52a1acf17cb59b4aa,t,21000,340384,,5000011,2018-01-30 13:44:19,8
0x227eda5749035e4f25bdc8f8ea559de19a2f5e6c1a7c243bd81c60a7dcc5abc5,t,43724,384108,,5000011,2018-01-30 13:44:19,9
0xe42f8d5021e750f629bc96fe52268f72446ff565d6aacc5f151c1a8d846283eb,t,22588,406696,,5000011,2018-01-30 13:44:19,10
0x0f848d366469cdd8fb4e177a805d0b57846b93a387c0e7e653fa1529d383bb58,t,40843,447539,,5000011,2018-01-30 13:44:19,11
0x1a553eff08aed39654951bb98dd4d794393c864d6f7978714f30eb823471b37b,t,21000,468539,,5000011,2018-01-30 13:44:19,12
0x1250b920a97c289682830e41940b3489f410311a32d72193dcd0fb4ba3414e12,t,21000,489539,,5000011,2018-01-30 13:44:19,13
0xc4a92b55cb1f05c2debee91b444daa5fb0ab225724781629e427f4863740e73f,t,37106,526645,,5000011,2018-01-30 13:44:19,14
0x53a7260f1c3d9b44433255de6e8bf85b6f1da1b256fb1b14bbf25a62b4194181,t,38318,564963,,5000011,2018-01-30 13:44:19,15
0x90707bd0c41542f8faae6a8c2ae76ec9f5fdeb52875a3d7a570626e33c5e8415,t,52940,617903,,5000011,2018-01-30 13:44:19,16
0x0d91e8365962e2bcbbeac8f8f07b636733814bdf4afbfd1b4caf27d239750e7c,t,21000,638903,,5000011,2018-01-30 13:44:19,17
0xb06e7192940cb802eba43cf3dc62572046fdbd1cb201dd5143ab9b94d38089eb,t,55843,694746,,5000011,2018-01-30 13:44:19,18
0xdfbc0da741288b4b7d2b78fa94686b9be4431544f8623bfba4ab78309049ee8c,t,21000,715746,,5000011,2018-01-30 13:44:19,19
0x937d91d8e0c2775033b4d11af72c17ca9606114d40732b79503a3c66e17a4bd8,t,21000,736746,,5000011,2018-01-30 13:44:19,20
0xf8d10d5d01b902cd416d1a49a3df216b2a8648feb68f5682b6224fbe09c847dc,t,31984,768730,,5000011,2018-01-30 13:44:19,21
0x3279fb66079f402de1d79e36040c552206673c1a7aff24f5f33941668a843b71,t,21000,789730,,5000011,2018-01-30 13:44:19,22
0xe810bb958179bf2d640edfbadd1311b229432f06e14ff78b2e79dd9fd4c9809c,t,37356,827086,,5000011,2018-01-30 13:44:19,23
0x6460ed4d9627360cf633303532521fa67c64247b4743730b196a570076f51865,t,55843,882929,,5000011,2018-01-30 13:44:19,24
0x3572d2e5f522e00d3212f10688b06e38f7da1d871c767e9bfc94f7be168616e1,t,52948,935877,,5000011,2018-01-30 13:44:19,25
0x17a6128a8edc78d67f3555e89dcc926d486c2b4e84439f23e955adbaaceaa5d9,t,98809,1034686,,5000011,2018-01-30 13:44:19,26
0x7f0a29a01d18fbcb44b9daf5f05df02f6ca723487f9c0834f1a6a3d6c3f80fb8,t,21000,1055686,,5000011,2018-01-30 13:44:19,27
0xb8e3a6ca2324bad1c11084310d3071390ea1d175bc6284b194676e20691064ab,t,67669,1123355,,5000011,2018-01-30 13:44:19,28
0x31ca54ed5d124a6371de0c69a19babbdf579a42a730f617ec0c5c38a501f8d15,t,21000,1144355,,5000011,2018-01-30 13:44:19,29
0xe3790677405d0b9b6bed218ce13d6a2bcdb1c16cec86edce191d0158f3756e6c,t,21000,1165355,,5000011,2018-01-30 13:44:19,30
0x76c9d23558ceabbc19370e7d53c6bddb6c904a11f98223b3d97116d9bf1d5df5,t,21000,1186355,,5000011,2018-01-30 13:44:19,31
0xc7cbc63c1a3fff25d6276b0e5d305bef3ce40023fe95f4ab5b04b19a770bd80e,t,21000,1207355,,5000011,2018-01-30 13:44:19,32
0x559b70b65132215e37385ac3cab0a43f1b1ce6f76a353b0b5ba16b263422f52d,t,21000,1228355,,5000011,2018-01-30 13:44:19,33
0x9e3ea155dc4ee76315f85075de3d341922a6bf9ee4e4ef29566d0841b31de75e,t,21000,1249355,,5000011,2018-01-30 13:44:19,34
0xd1b91b65e4d2ce815519fab2f990a66bcab1186e930aad7c0baf43e195a3575b,t,36792,1286147,,5000011,2018-01-30 13:44:19,35
0x1e2c1fc77490ab31bf4fb73a3c6dc4384311e74c8f8556043ece7e6e3bcc2ea0,t,21000,1307147,,5000011,2018-01-30 13:44:19,36
0xa16c730e784eec0f2e3ad87f045d37c4db4db691ef68e602893701f4ab7bb797,t,21000,1328147,,5000011,2018-01-30 13:44:19,37
0x75af623513b3394dbeff2a472f53ef2f50a762602eec22cd36a43bc000565941,t,21000,1349147,,5000011,2018-01-30 13:44:19,38
0x45a37e277cb9c0b161b465b73c4ce1f2ee716dcbe61ca06f5e128938dd3895a8,t,21000,1370147,,5000011,2018-01-30 13:44:19,39
0xb976bdd4e0e6b3cb89bca6d9aa0265d417fa6b460dbf3bbe8559368c32313e95,t,21000,1391147,,5000011,2018-01-30 13:44:19,40
0x85558f5f1b7d040462ee3ca1ab7ed143aa578499d45946fb1ccaff373334d5b2,f,21000,1412147,,5000011,2018-01-30 13:44:19,41
0xb84553adf0ca7c27b7e3d58114cabdb88c7fe718389a8a7d9273a83ed615da78,t,52031,1464178,,5000011,2018-01-30 13:44:19,42
0x1df58c664de8107932351a58f37538b7d2e21830883b10c662777a2e571a84ff,t,34378,1498556,,5000011,2018-01-30 13:44:19,43
0x3923ef977f8ac49160812eeb486e6b1227149294dce2026e5e29855bcf51d359,t,59034,1557590,,5000011,2018-01-30 13:44:19,44
0x00761e5a6f605e5b9e29976778dce249992faa6d365506d01d4902f806fbd951,t,38319,1595909,,5000011,2018-01-30 13:44:19,45
0xa85d560228f1bccfed6f70d08576d9f659b694d76e64a58943781811d20d5306,t,22524,1618433,,5000011,2018-01-30 13:44:19,46
0x230653cf0ae75a7c551da9dec51b962da0e3b8ffbdfc2647e1dcf2c9d6f94158,t,23254,1641687,,5000011,2018-01-30 13:44:19,47
0xeb3b9188f02b75fb639e8d1d98cb0aadcff4048d1c26caa549894089fe792a96,t,22222,1663909,,5000011,2018-01-30 13:44:19,48
0x9bb3fa384347b4b6dfc6fe1dffa4abd44dc96540b5585146b595c2c9ce4be488,t,51560,1715469,,5000011,2018-01-30 13:44:19,49
0x348cc74c1bbcd3cf8a8ed6c810ff18b9cad61a8e13646a5735b40f87b27e9d3e,t,38345,1753814,,5000011,2018-01-30 13:44:19,50
0x060ddeaf9ca5f979abc6593390380c22f28c85c195f0501716719cc36c2f4c27,t,21000,1774814,,5000011,2018-01-30 13:44:19,51
0xc0e2011c1ee31880825a36792c802e5fda03c0d392e0cad82ddb641ce42094ac,t,23028,1797842,,5000011,2018-01-30 13:44:19,52
0x755cfbf5a937994d993a493764127e7cabbe752e5a301169324118d07714088e,t,52353,1850195,,5000011,2018-01-30 13:44:19,53
0x29b5621da49f4e8fe6df1b34e6c2deba5c85d585736d6601a67018eaf2405bac,t,59354,1909549,,5000011,2018-01-30 13:44:19,54
0x424c73c84d3b85ae4bb02de3670da7793d072f9b0192c9aaee2ff6cae31fc15f,t,37836,1947385,,5000011,2018-01-30 13:44:19,55
0x786b06eb895a8bf9587be58ac58fea31f4a35f5f33364178a58028a032c3a21d,t,108050,2055435,,5000011,2018-01-30 13:44:19,56
0xe9c84949313675e1e1fe42040dcc1bc8a7cbf453d0b48f1ef81d5930b820bba4,t,122858,2178293,,5000011,2018-01-30 13:44:19,57
0x19be495c8447461bb838fa098c499f0c05d96cc495f08ca9f8626dfb30516cf3,t,47952,2226245,,5000011,2018-01-30 13:44:19,58
0x58209bd111c9054c42dd6b2b8791374e1d178d6cc03dcdcd3c83b4f6bc301f18,t,45967,2272212,,5000011,2018-01-30 13:44:19,59
0x808b6f4086fa0f1ecb27d2a9915b84f6b6bc097d4bf061671649b3a698849c85,t,21000,2293212,,5000011,2018-01-30 13:44:19,60
0x096759026391942533343cb301a0dd2dbc75ece6ccd1698cc4c79e256a882a72,t,44290,2337502,,5000011,2018-01-30 13:44:19,61
0x3023df86122fe16496589f9ee91f1600016599c61616423ee32205ae5593ac9b,t,21000,2358502,,5000011,2018-01-30 13:44:19,62
0xede9c8babf48c5c60465c1167b1addd6ed9c0e99e9ea4bec9c72571853d1dd16,t,37091,2395593,,5000011,2018-01-30 13:44:19,63
0x7e73518ccfab40a800cfaae118b58c7f534315ab244ed66841dfff1d4c765931,t,21000,2416593,,5000011,2018-01-30 13:44:19,64
0xa4d520d5fe30ff928083b19c00d251055d314b387a8f5f80eb071042ee4ed0fa,t,21000,2437593,,5000011,2018-01-30 13:44:19,65
0x0339477175fd853a47dd3bc89525b464848e209bae6960f470744fa9536cf1f1,t,21000,2458593,,5000011,2018-01-30 13:44:19,66
0x0570990f9c44c5726d8221cde7db0e768a7103a17cfa85488c10e8cc1581a3d7,t,21000,2479593,,5000011,2018-01-30 13:44:19,67
0xea146b08a31a9c13543b92ce241d2a0316ad5a9226779a1b81a0b04b7fababb7,t,21000,2500593,,5000011,2018-01-30 13:44:19,68
0x04e89bd2cf71a82cda44ad5ba91a80a8daaabe456393007a537fe628e9c01379,t,52675,2553268,,5000011,2018-01-30 13:44:19,69
0x0bd9875e0afb4ef2d5f32d1727028267392044f44bd8d830b6635635726fbb60,t,21000,2574268,,5000011,2018-01-30 13:44:19,70
0x1c8cfe71cdb77f9e229af9abeed293c535d1c1f135d4a656ece27afd0f6f48df,t,21000,2595268,,5000011,2018-01-30 13:44:19,71
0x775451fdfbd08c47dcd9df0b476ebc1b312e8e772faaad4be8a0e282ad36a043,t,36948,2632216,,5000011,2018-01-30 13:44:19,72
0x86074104e272d79c0b8f68cc1bf5ba3a5bdf0f49095bfb728647f552cfd64297,t,21000,2653216,,5000011,2018-01-30 13:44:19,73
0xb11c1bf6d69acf604cd2d79726f0e78d2d23cd207ef6e18783e642a6f9a20c6c,t,51560,2704776,,5000011,2018-01-30 13:44:19,74
0x50195e0e73ba0050fe8122e5b5d9223b7fd72091c1835f035a2c80e1c886ce67,t,42041,2746817,,5000011,2018-01-30 13:44:19,75
0x705c9fa94b2ba04e05b9e6cae4678127dac8030e3fbf156a8b907fd988567fc2,t,37155,2783972,,5000011,2018-01-30 13:44:19,76
0x319f1b4338e2d5a4dd2bd00f1084a8636fb0208f8b1685213052d407bb15d9db,t,21000,2804972,,5000011,2018-01-30 13:44:19,77
0xbd5ed079339c1592badfc3322b027bc51d6834af147d7b223b03155976c62c7a,t,21000,2825972,,5000011,2018-01-30 13:44:19,78
0x2cd7e54f2395967ef60ae6ea6ab1e1bcfa190c82b54b313b0d4645cd0a4c73e6,t,21000,2846972,,5000011,2018-01-30 13:44:19,79
0x1f4bb9fb29fcac46fe5470a98f678b5a467b923f4f4a1c9972f741bb73620455,t,21000,2867972,,5000011,2018-01-30 13:44:19,80
0xd625bb588977469c3c292ef810f4bc6dde3c755c3815ce050d152a52fc0c39ba,t,52316,2920288,,5000011,2018-01-30 13:44:19,81
0xc1f4605c534416b7e3e46f421310542e5cbd96477312cdf1e316287f020cee2d,t,36682,2956970,,5000011,2018-01-30 13:44:19,82
0x2e1b639ead5ececa882293ebf0806706eeecbb97a1c584974d8c51c349ad0838,t,21000,2977970,,5000011,2018-01-30 13:44:19,83
0x0fad5c4e9483a4295f3e15c93983c43ad2c95b6c9ee1204bf6ee833d30f3ee3d,t,21000,2998970,,5000011,2018-01-30 13:44:19,84
0x1a13ef6e3cd1a3d565debc92e036cc0b944347043f18bcb648825afc004cee1d,t,21000,3019970,,5000011,2018-01-30 13:44:19,85
0xd6bad2bec3706fca272452a2d7a24cebfd65f1c5864f693bd64556f21655145f,t,21000,3040970,,5000011,2018-01-30 13:44:19,86
0x3c8436d3eabea08541b12f5f651e79e7081a4195bdbddc293ce0db710d14c4ea,t,21000,3061970,,5000011,2018-01-30 13:44:19,87
0x39114694d22d65946cbe69229a0cdbfde5d592296e825f6facc595f180c3d286,t,21000,3082970,,5000011,2018-01-30 13:44:19,88
0xa61bad50bee624a3c95fd23c2be49b19c61724f824017e9c6011896a44548cff,t,21000,3103970,,5000011,2018-01-30 13:44:19,89
0x93e6d89a2086bdebc01369a522ddf04e70e7d593e12d63bdc466c4f5b0583ca2,t,21000,3124970,,5000011,2018-01-30 13:44:19,90
0xa4ebca49bab4b85aaae05d01c35e8d2f33926e9a635eb2dd3616bedbeb8e7a06,t,21000,3145970,,5000011,2018-01-30 13:44:19,91
0x4c051d1e80dfe9b348e3c24f8508a26870cac86855162ee386e57fa33a342375,t,21039,3167009,,5000011,2018-01-30 13:44:19,92
0x58fe5e9247f3e8b3f931ac42d2c3b2e4fb39c5640fe2ed42614127152bed822e,t,21000,3188009,,5000011,2018-01-30 13:44:19,93
0x6a0a579b0ff45e6a06344d9f7455f9fc2ab841e26ee70c5b48f6d8da367e3266,t,21000,3209009,,5000011,2018-01-30 13:44:19,94
0xc30d01cb66fbeabc0ccb9abf929d07c88176f1d5a8aa368cbe93b65ae26bc5d8,t,21000,3230009,,5000011,2018-01-30 13:44:19,95
0xd459c290ac9871df3410d4d02f59559d3416b7ca5bc9b08f3a958d135a90784e,t,21000,3251009,,5000011,2018-01-30 13:44:19,96
0xdc4048284bfbbcb299ab60b943c176301ec67d9859ac6e3df4bfd34ea05ddd78,t,21000,3272009,,5000011,2018-01-30 13:44:19,97
0x295eddd8877045e41712ae9d53a53a2a0871d4c321e870ef0520916557a0d649,t,21000,3293009,,5000011,2018-01-30 13:44:19,98
0x2a9538a6772b7caba5939d94513b7a47f63d5b680dfa9e8c83fc266e0bec88c9,t,21000,3314009,,5000011,2018-01-30 13:44:19,99
0xaad2691c6ef44dfebb53965a4a3564edb8bf7bec2675840280f7930cb218b3be,t,21000,3335009,,5000011,2018-01-30 13:44:19,100
0x185992fa36580531d4e639a7aa5b6655c4d0ea6febc2e43b33bd5ed5d4a0d329,t,21000,3356009,,5000011,2018-01-30 13:44:19,101
0x13844a3290bf6ffdd8e2ec32dba2ef4756f8bdd93d4b2864be2391164f139de8,t,52810,3408819,,5000011,2018-01-30 13:44:19,102
0x96c4b1cdf498e3c6f76397fec550b8d0872afcf761b971ed0b616c450c7bc21e,t,21000,3429819,,5000011,2018-01-30 13:44:19,103
0xe5d655321f53093e762275ccd30c16e2533f0ef786703f1ec20295c9dfed1529,t,21000,3450819,,5000011,2018-01-30 13:44:19,104
0x2aecdca4af448c191fda693fccaecd5bf0d826add2416af20e323c5a1d98cc35,t,21000,3471819,,5000011,2018-01-30 13:44:19,105
0xbc5399461de7362c7be046467c22dcc0e0e67a88fa292c7a0ff59f920bee7136,t,59034,3530853,,5000011,2018-01-30 13:44:19,106
0x74d5329accb51c4ffab44e40133c55e4444ca38841782a37557a6758cd7e21ba,t,36124,3566977,,5000011,2018-01-30 13:44:19,107
0x805d1997933b69725422d799f822078b7685290db041de692a4b7ff4e094921c,t,21000,3587977,,5000011,2018-01-30 13:44:19,108
0x1114661ba0df162cf606f273f6536234f381c0d09144a5b38bb14f53dc3984db,t,21000,3608977,,5000011,2018-01-30 13:44:19,109
0xf258a90e7c9f49095f6dbfa85e63732a2eab94105eabbde5be0d545fb17aaea2,t,21000,3629977,,5000011,2018-01-30 13:44:19,110
0xcb11215b7cb9ad3a2ae48700aadfc0b10c395e17c4b0817094a3a63cfef27d1e,t,21000,3650977,,5000011,2018-01-30 13:44:19,111
0xd4bc756c0af7b8de74b3b383c3e84a58e1611beb7a891ab1acd1be191e2cd79c,t,21000,3671977,,5000011,2018-01-30 13:44:19,112
0x0ea3cb7433301eb57d12d13f9ea641ea49e1d59eea30df703e2660be8b061c30,t,21000,3692977,,5000011,2018-01-30 13:44:19,113
0x72c5ec7e80f324205340ca0242da8e23d25ed4173fec90f276c67adf714945a4,t,21000,3713977,,5000011,2018-01-30 13:44:19,114
0xd9fbde78574defb3a3ba8c2e9b3a1abf415c7294905daf394631e416828f69a8,t,21000,3734977,,5000011,2018-01-30 13:44:19,115
0x679db0832cac358b9ecb4a74e0d73129a2969287ebfd9f2c5c28dfab231527a4,t,21000,3755977,,5000011,2018-01-30 13:44:19,116
0xab91dd768cc85f8a5b7f42f0efeeee297f0e7ed1a41eb0454495e48754390d9d,t,21000,3776977,,5000011,2018-01-30 13:44:19,117
0x3363b6c9cd985ce6f9723a73895738b102056de751574cbae76ed12586f7ac8c,t,21000,3797977,,5000011,2018-01-30 13:44:19,118
0x142f70035627570203a03ec1d57f2b9fec797165590ecb12cc932a296f00b444,t,21000,3818977,,5000011,2018-01-30 13:44:19,119
0x405ac5502c4425cb1fe97c632eebaac372f33bb3f666fc52bcb10f19b990efbb,t,21000,3839977,,5000011,2018-01-30 13:44:19,120
0x41e63c0f4f0f981a3ac4960a1c219b76eca46e0205eb64c4d5c842c641cf8c80,t,21000,3860977,,5000011,2018-01-30 13:44:19,121
0xd47c4ebe2daf67bd0b6ed513f7bfc23da48457a8647a76e15c99b721cb19da05,t,21000,3881977,,5000011,2018-01-30 13:44:19,122
0xd921065d1f883ec8976ae41eca27b5b01fe8e5d3651046267912e053b585e2cf,t,21000,3902977,,5000011,2018-01-30 13:44:19,123
0x48370845ec34000853a242efe21455c40f3f157cf7ce45f3301c8c6131cb8a98,t,21000,3923977,,5000011,2018-01-30 13:44:19,124
0x3abd8788d5ec7c6e1cfde65070311b267825857ebe3e825aa12bbfb57d78c0cb,t,21000,3944977,,5000011,2018-01-30 13:44:19,125
0x61f4c2668ba74f9f9cd94540276c36a61e44d10ef99ce5efdbd5c60b841736fc,t,21000,3965977,,5000011,2018-01-30 13:44:19,126
0x87f72de6ea879bee18f8ac1c87889467c92ee8525b962c28a1b1ef334aa1b5c8,t,21000,3986977,,5000011,2018-01-30 13:44:19,127
0x6c9353878ef4a84ba048e53d1dfb3255cf076b82df3de20849a94a7bca6868e6,t,21000,4007977,,5000011,2018-01-30 13:44:19,128
0x6bec3bfab5d43c599e23eab588aaf949a742e714cdebddd60c9aa0137c46015b,t,21000,4028977,,5000011,2018-01-30 13:44:19,129
0x9e5f4c0a3cc4b02641cbc88152aa00ab29dd48a80548e2ded3eff5a04a3baacc,t,107666,107666,,5000012,2018-01-30 13:44:30,0
0x0136329acb1f95130f3993a1b5bad410108634c7a303cc463ff6035023819108,t,21000,128666,,5000012,2018-01-30 13:44:30,1
0xde566f7be0b883134b8b6e67c95b6f32ca37daded3e28d66c4a8b6e5a74c0a5d,t,48900,177566,,5000012,2018-01-30 13:44:30,2
0xe963978f15c47009887c185a3f26b5dc8327b896f25755485d17f907584cd05e,t,52027,229593,,5000012,2018-01-30 13:44:30,3
0x77bf22910ce62c7ff11409d424b96631d5e7467bde57f784352cb3f6dfa54b59,t,51545,281138,,5000012,2018-01-30 13:44:30,4
0x3a381abccdecbb5c44cdecdd51f0b661bef23394d11cee051277bb356552a20b,t,21851,302989,,5000012,2018-01-30 13:44:30,5
0x6abbacb2634583861bd3434ffed58b8e3e8fae3286f765b917637cdda7e12ac4,t,51248,354237,,5000012,2018-01-30 13:44:30,6
0x588d0a7589befcdef56edad09647f232236ad476a4b88c06572e472e5c280705,t,21000,375237,,5000012,2018-01-30 13:44:30,7
0xbe133b0f5704b55266e0b01e02677796618b9b6c59ba9a85ba2c2d895a7ad19c,t,21000,396237,,5000012,2018-01-30 13:44:30,8
0x5a0bb3a91f26b4139bc3a04ab1342902d1b7f34c18882ff84e37de800609c8db,t,21000,417237,,5000012,2018-01-30 13:44:30,9
0x5f032520cd0551cbef26cb8abc0cfae862fdc28ee7ca20a7c82b5feef5f4abee,t,37963,455200,,5000012,2018-01-30 13:44:30,10
0x793ccdf4bbc6af21383cf1cd2e99e972368439c24ba2770a2169c73ced537e06,t,52568,507768,,5000012,2018-01-30 13:44:30,11
0x74073971954895018c1fb7011fc3bea6e175348fcef15b8cccf6e99e531b695f,t,21000,528768,,5000012,2018-01-30 13:44:30,12
0x2d8e4f3584894759b5b386e640aba06b131cca7186b70e2e904c9b03617c4a0c,t,116893,645661,,5000012,2018-01-30 13:44:30,13
0x8deb95d102eefe75fd127917e1866e14f78a4e44b54e2267eca31d64c46c1888,t,21000,666661,,5000012,2018-01-30 13:44:30,14
0x66074544bb2fcd8a228ff4aeaeb5af36fa7559c21ee8d43abab2d709878a0806,t,21458,688119,,5000012,2018-01-30 13:44:30,15
0xab4f65554713f0fe23ff4c76ca3b1251c6dd582f50c3f9e171dbc55abf8d66b0,t,21000,709119,,5000012,2018-01-30 13:44:30,16
0x212aa9713461c9a94d30ec6fc699ce2a32ff6f74f44934996259b46541de69e5,t,21000,730119,,5000012,2018-01-30 13:44:30,17
0xdba849ea53ea7b535b998bd71548264200fcde3d3486cff8d7099272374e2975,t,21000,751119,,5000012,2018-01-30 13:44:30,18
0x4c053f57d7000825cd5947772bdc38414d399b47243c17a3094bf03b8c8a6366,t,21000,772119,,5000012,2018-01-30 13:44:30,19
0xf0c06766dace69acbdc7feb1a044d7bcc9c291274e64f2115162f6bf7b10aa44,t,21000,793119,,5000012,2018-01-30 13:44:30,20
0x42adbbda1aed5b916f201e7dc867a16067a8eab51b8d2b2cf8b783903ba62601,t,64725,857844,,5000012,2018-01-30 13:44:30,21
0xa96d8b7267daf29ccbfaefe57ab3589c22622472a39cebc69eed6e31ee8fba8f,t,21000,878844,,5000012,2018-01-30 13:44:30,22
0x335b4a68684321dcaeb47c7ca87a474f5a8bb729b47651ba3a8e2e37e821fba1,t,21000,899844,,5000012,2018-01-30 13:44:30,23
0x5723bc36529a4301e19b8fef1706349b20e8849317ca2dc33a6d6b0d9bc4e606,t,21000,920844,,5000012,2018-01-30 13:44:30,24
0x4c877ae61762d8a7aac5875efd1d9b860e1269416c4ce30fd8f5fbe3290849fc,t,169098,1089942,,5000012,2018-01-30 13:44:30,25
0xebf7b99a36adf317076ba0da0cf53bbfeb88d0a4fa92a48d9598b841e9e6607a,t,36789,1126731,,5000012,2018-01-30 13:44:30,26
0x79eb51a7cfecfc70e44cdd0ace4d7f7667fb5f0591bbf62ce87d02fd53ab51b5,t,21004,1147735,,5000012,2018-01-30 13:44:30,27
0x8765738c62884035d5293d79b53e0ce61fd9f861391a9f1d5c13d895a701ed33,t,21000,1168735,,5000012,2018-01-30 13:44:30,28
0x51be447d6f3461213e0ecb56d3044425f506bcd0a6ac5e5869bad6f2d60bb86f,t,26937,1195672,,5000012,2018-01-30 13:44:30,29
0xd0852e2adabed39f0c9ed499212ad9ff07908f202a22d3fec4a68adf195889fc,t,21000,1216672,,5000012,2018-01-30 13:44:30,30
0x9c5a1d66202b860eb7fd770d70e0aed1a33895beb932bcb37f09224c4c333508,t,21000,1237672,,5000012,2018-01-30 13:44:30,31
0x053006c1befe390974f41acd871670ad107ad92a2406bdb731f234c281debd13,t,21000,1258672,,5000012,2018-01-30 13:44:30,32
0xc92a2d8173cc82e128b9f5d9a9571fa17404355f885b433f52f97ed27d2b69b3,t,21000,1279672,,5000012,2018-01-30 13:44:30,33
0xd14f16853670a384beb8a8055227afe689a91312781e5d179c561fb5a4b10e9b,t,21000,1300672,,5000012,2018-01-30 13:44:30,34
0x135a2a8058f8a25babf075ad8bbe784e41dcf25b4e66dc8406888ceee686df37,t,21000,1321672,,5000012,2018-01-30 13:44:30,35
0xcbf6b838169611f8381f79e07983857d1bf17e4720cb62e3894ee20f10800c6d,t,21000,1342672,,5000012,2018-01-30 13:44:30,36
0xba8f22d8170e1bae70cff58053e0d9582c971dfa52abb43b19fc1066de7d2860,t,21000,1363672,,5000012,2018-01-30 13:44:30,37
0x804a141514d2d8d73f92c62f791c0f01e852c7fd6e95e3aa6c20f1ede86d7fab,t,21000,1384672,,5000012,2018-01-30 13:44:30,38
0x81546f69e693954d9accc35ffd81f276084f16f92a4254d7d3316eff5b5184a5,t,21000,1405672,,5000012,2018-01-30 13:44:30,39
0xf3e08420dcf1cb6edddbc1057e2ee264bb1679a701511c28fd41f2b0956ca72e,t,21000,1426672,,5000012,2018-01-30 13:44:30,40
0x27df32c4ff9e27ea333070742d0640406344aafa54c801342d666dd4307eefff,t,21000,1447672,,5000012,2018-01-30 13:44:30,41
0x14fd28dbebd4e54bbd46e6c021d3b90b0970990b17ea97203826fdb42df51646,t,21000,1468672,,5000012,2018-01-30 13:44:30,42
0xcfd98cc5c6fe57c93fac72c7fa8d2e07630b55cf7576ca29278ef8aa6a591d79,t,21000,1489672,,5000012,2018-01-30 13:44:30,43
0x935e97f26d294f18428bce177637c3a16609b6e170b8268ecd58a65a58496a3e,t,68005,1557677,,5000012,2018-01-30 13:44:30,44
0xf8f876771b8e0cabdf0edadcbab605e211693b6dcc5da415d6fbf8ca8f58b5ac,t,49725,1607402,,5000012,2018-01-30 13:44:30,45
0x357c1ebca38d233dcd3f820d9dae7fd57a678085e30a2fbb67bcd347ec3f438b,t,37391,1644793,,5000012,2018-01-30 13:44:30,46
0x445fb76bed625c0b919527d23d91c455d374df7be7d7f7b77fcfaebe7b569a32,t,38519,1683312,,5000012,2018-01-30 13:44:30,47
0xe098213194bec3442dc890a0b70edeb1f4db594b47b3a634868c75fff1c63d7e,t,52881,1736193,,5000012,2018-01-30 13:44:30,48
0xea07de4f1baf1b17cd209a6bc3e27d955c7d7f304091a39c99f8d634cc1e20f6,t,53104,1789297,,5000012,2018-01-30 13:44:30,49
0x0b22924aa285796f72a08c22abdc5b0db073ba28059ad01426a2cddd8e80c165,t,21000,1810297,,5000012,2018-01-30 13:44:30,50
0xfb5f67a3d2e1683f673d374e507c95f55891f0bf410eee7508d6417bef1b6967,t,21000,1831297,,5000012,2018-01-30 13:44:30,51
0xc19bc4638eccb6dd94b189f786cfb417ea134308106e6b264c30e1617f643c63,t,21000,1852297,,5000012,2018-01-30 13:44:30,52
0xa69098e959fdb090cdec86f7b5e97d888a9484be95fb9fab4eec5ff4a414c636,t,21000,1873297,,5000012,2018-01-30 13:44:30,53
0xac4e381c812ec2b8217bbdb5ed0ec4aee899cbeb99e56e8db6fa4cb240d5f67a,t,52886,1926183,,5000012,2018-01-30 13:44:30,54
0x237dbc13457c0690c6529836d84c34ccc0ecfca0d1a067ebf122f8a5adb6b759,t,53679,1979862,,5000012,2018-01-30 13:44:30,55
0xc1fe88217f4dd0a95073ddff0642467f5ef6cf86d351f292a838a1a23eb430ad,t,21000,2000862,,5000012,2018-01-30 13:44:30,56
0x2c38042f7ec3cfc065dd5f0ee23d5afbe667672e5221965921b96bc2b229e228,t,21000,2021862,,5000012,2018-01-30 13:44:30,57
0xc519cf5f4794d1d8d5894b7aaabeeb84cdd25b2de43ed5fa692e8375c73a5ff6,t,21000,2042862,,5000012,2018-01-30 13:44:30,58
0xc496805499ccca07530fb965916675c9eb934f568cc0446f7204a80df8908a95,t,52158,2095020,,5000012,2018-01-30 13:44:30,59
0xadc1c2458e38644cbcdd29db03385a946fcac91ba5bb3cea7115809d80204159,t,37305,2132325,,5000012,2018-01-30 13:44:30,60
0x52b1b6f30ecdd6617e9aed199800655a2a8834cb2ab0e9842e82adef3fdba3e7,t,52027,2184352,,5000012,2018-01-30 13:44:30,61
0x6dc93b7aac9f5734ae0c1ac0205df04cb89fb696ea8b7558508ed3d81e19a1bb,t,21000,2205352,,5000012,2018-01-30 13:44:30,62
0x5045b1b6d8adfda4091c312782b3ccf41fdacac95ba510ff0bf28072e116f326,t,21000,2226352,,5000012,2018-01-30 13:44:30,63
0x8d438657128fa00f6acb5447c3c39e011f4c687bb7b2b102ef1b9565aa127e61,t,21000,2247352,,5000012,2018-01-30 13:44:30,64
0xdd5f3bf0963323a5371e3b2d113ead25404a2e38b687ddaaf108c25f0ddc4cca,t,21000,2268352,,5000012,2018-01-30 13:44:30,65
0xb6e5bc63d549e902d224639b96b445fd0efb4ed0e74077c86b524f61b6310445,t,37900,2306252,,5000012,2018-01-30 13:44:30,66
0x1f06832dd496f9ed3c21fb3b2698101d339ea5ea6abd6a9eb75673d9239f5142,t,21000,2327252,,5000012,2018-01-30 13:44:30,67
0x3af27686a0fdd5a3fd77c19e19b8eabbc58079e3b96b47a32a14f77a10833d3b,t,21000,2348252,,5000012,2018-01-30 13:44:30,68
0x5e02e5cf8b9cdeeaed1892f3a74bfdcd19c653a88785419629c1e00baff8fa9e,t,58970,2407222,,5000012,2018-01-30 13:44:30,69
0x87b9839acc8af3ab3b534af0699d71a1eec8ea4e07b5d85c7f5ae33624df5e84,t,4634140,7041362,,5000012,2018-01-30 13:44:30,70
0x2c1d090f31112326d22f8d67e70af866a360ae63385e02475d9a2894e6d0cea8,t,56344,7097706,,5000012,2018-01-30 13:44:30,71
0xc738aa63bdaa5e8d3f07737cca74ed83d6c5610d6bbcb1ee6477723ef40821bd,t,21000,7118706,,5000012,2018-01-30 13:44:30,72
0x576ee961c8590602516ef2b84ef530e2adefd25025d726f184637a5f057fb7a5,t,22075,7140781,,5000012,2018-01-30 13:44:30,73
0xe66de899a1bdd50119e91beee560caaa326e7bebd76d2887e5a5731d706a1e58,t,22143,7162924,,5000012,2018-01-30 13:44:30,74
0x93e78cf5c0de0660a8f107323ea697785ace4f9bf47fb85e7611461baf6f126b,t,23040,7185964,,5000012,2018-01-30 13:44:30,75
0x2a1fecffab73bd5a40834cbcb321c39828f62ea512bc583a6ee1ce624546c715,t,22158,7208122,,5000012,2018-01-30 13:44:30,76
0x619e0941cb0e62f528e1c4a73f95f7b28ad403b90457eafe9ebc972982014643,f,24000,7232122,,5000012,2018-01-30 13:44:30,77
0xd117d89197b98f46953fc6fcbdf810bc67c98d883dfa70e1f10d8b14532948b2,t,51557,7283679,,5000012,2018-01-30 13:44:30,78
0x9741e090e5b58a960b9cd79eeeab4144ad3b44bc825c54164acf857a4d42114c,t,108242,7391921,,5000012,2018-01-30 13:44:30,79
0x0fd11589aa8d639d8c849bc514a63d368fd609158650ec00f3d8421296ea5312,t,93050,7484971,,5000012,2018-01-30 13:44:30,80
0xdf0c6195781d9e97aab700868fce2139208bc5ec41e3927d87f39a86f2b217dd,t,174591,7659562,,5000012,2018-01-30 13:44:30,81
0xa12c4767d8f84471e4a4c3a5b57bfc89efdead8a1786891a181564676eb4b3b5,t,108114,7767676,,5000012,2018-01-30 13:44:30,82
0x9c02936bb60b58c3512374e779e892cbde275e1efc0dab05cc97b2dd6a811464,t,21000,7788676,,5000012,2018-01-30 13:44:30,83
0xad662814491537a90e9b46abb4304f645624a8ba848ff0869e3b945c4a87e0f4,t,21000,7809676,,5000012,2018-01-30 13:44:30,84
0x664960458e21fc0b336e9845e1c11c6c7a78913d06a160beb24abe0ece2798ff,t,51789,7861465,,5000012,2018-01-30 13:44:30,85
0x649ff92aa8d4eedc03b5ab7ff6fd6de06cbdbd8a8a7e4e49f5035ab7e7866302,t,21000,7882465,,5000012,2018-01-30 13:44:30,86
0xe4dce5d69a9c363cffc4b8787bd747e7a29e09a0d9987b6d22ffbfbe86c04a30,t,21000,7903465,,5000012,2018-01-30 13:44:30,87
0x914d4f9f141e2d058b48f0271a5238eea6b4e72bd407b0244dc24161d5e1ad9b,t,55843,7959308,,5000012,2018-01-30 13:44:30,88
0x78c51dac8050cc1e575ba206cc0785384e4d12cc0deae0711a8c561dafdf8108,t,21000,7980308,,5000012,2018-01-30 13:44:30,89
0x7ddfaaca3421d5e7d8746b7f2f3a230827dec697db0e9cb957d00bd87dd8aad9,t,21000,21000,,5000013,2018-01-30 13:44:48,0
0xa65dfdd0fe57b1ed4cd5fc12e302e2add3a758238ced30548097e3e627e22742,t,21000,42000,,5000013,2018-01-30 13:44:48,1
0xd23fb3e9c2de182e6069d617c1a49c094d53acfc9623ae70f6a17b9533202c5c,t,21000,63000,,5000013,2018-01-30 13:44:48,2
0x03b035a8ea65a31f13255df0ea600c18583c885107c5a13312aae12bd3d1348e,t,37623,100623,,5000013,2018-01-30 13:44:48,3
0x27774f89ef2ff6c9eea4aedefcbe13a86e5752aea2c8d80a212c3558730e17a7,t,21000,121623,,5000013,2018-01-30 13:44:48,4
0x9c6d7467dbfc46142131222aa236f18613193c5faf74ab7d3b7e33a78ba5a477,t,37153,158776,,5000013,2018-01-30 13:44:48,5
0x733e8adcf80fdfbb4d1aacb1c0159ba9bde0cbd8b0799a53307f4a4e015e632f,t,36522,195298,,5000013,2018-01-30 13:44:48,6
0xcdd503ec33e4a386a7dcc1c70f61a2038c9e7a24349065b84f1e9ffec210bb58,t,37158,232456,,5000013,2018-01-30 13:44:48,7
0xd7f73bd96aadedaac7868b170f07f109cbe089e09d2a125828a05533148370e8,t,21000,253456,,5000013,2018-01-30 13:44:48,8
0x1f42e02a6b3ee350678e80737fae0114f813dc1ce41d5ba2b88af0481656c592,f,21393,274849,,5000013,2018-01-30 13:44:48,9
0xe6929377b4a1a47ef919d4c3d9781d78b9a4ae625812da36d9541d5f82458472,t,21000,295849,,5000013,2018-01-30 13:44:48,10
0x03ea27b51d7ae7ca9dd7db8d9da3de775d3401af23cacd8148c64a7c943a1c84,t,214974,510823,,5000013,2018-01-30 13:44:48,11
0x35f9c46183016d7d300948c5d775fba823d87c2f78c13351a3df3dd904cdfe83,t,21051,531874,,5000013,2018-01-30 13:44:48,12
0xcb788a2a10a62ab145dbbe131773d47651bb5358473e5b04e9253634bd26d0d4,t,33341,565215,,5000013,2018-01-30 13:44:48,13
0x3877c0af57404c6330416cf35ed5ca1d4c39bc6155b2224e1e698f156b31aed2,t,104678,669893,,5000013,2018-01-30 13:44:48,14
0xdef5f742744a29553a2e1a3179b6bd3cf1d6064da8c88cf706d44e3037f6fb89,t,140972,810865,,5000013,2018-01-30 13:44:48,15
0x0111b5e7ead199a99f2adf9ad40c90a43cd377d1a54c1ec6d0a97f6b4b827de1,t,124573,935438,,5000013,2018-01-30 13:44:48,16
0xc3ecaa3b84bd6a519820c067c54fc98e70c8a7e2e6aef3149c6914c7e836a93d,t,21080,956518,,5000013,2018-01-30 13:44:48,17
0xbc1828e6e1a835e2842a591969a0b1c15442cde881ee8d68b9ec06dca3caa2a0,t,21000,977518,,5000013,2018-01-30 13:44:48,18
0xa3c13b16b2e625ce93c17b52ac93f3332dcdebda39489c2690bb6cd3de1452c5,t,44418,1021936,,5000013,2018-01-30 13:44:48,19
0x8328bde553f5b54ae95b750764be5c12f0d4bab0a299339be268d127366ae861,t,21000,1042936,,5000013,2018-01-30 13:44:48,20
0x018b367354c482cc1700251d0c33d79174ef528405fc55b7be4d18963f74162b,t,21000,1063936,,5000013,2018-01-30 13:44:48,21
0x7778e1b1130103c87af4c7a2e52a77b38d061e0b5d1fd9da83bc7ce29985b3ef,f,28000,1091936,,5000013,2018-01-30 13:44:48,22
0x28486d396c91316616f5ce9133b4ff3f1b30eb80a94ce02d6aef1137832e455b,t,21000,1112936,,5000013,2018-01-30 13:44:48,23
0xcd72097820db8568ed06e1d7fbcaec8638db9c56cac2f5f9744403608e361bf1,t,169106,1282042,,5000013,2018-01-30 13:44:48,24
0xdeb544ecb68091777eda65834d110fd6d063fd3112f5fc29390623e7b80b1769,t,26937,1308979,,5000013,2018-01-30 13:44:48,25
0x880586c41122bb708c1167a26dc5321240e0f84222c2038b49b749f1ebb43bb9,t,21000,1329979,,5000013,2018-01-30 13:44:48,26
0xe807b4689958c3ea860d3bb9240f7735f13216fd934cede95bf3bb4f913f6be9,t,21000,1350979,,5000013,2018-01-30 13:44:48,27
0x17962ecd3627834ec73f83e18a2d14528cf133fa595d475b5d0ff5ff3c4e2a00,t,21000,1371979,,5000013,2018-01-30 13:44:48,28
0xf83497a6c6658d4ccddcc4b23912ee4227d246b2b39f8d80f6cf00ec5b48d84e,t,22529,1394508,,5000013,2018-01-30 13:44:48,29
0xd25b72451644759376bbd95dcecc721d6119173b19af3e2420ef594041a645f7,t,21000,1415508,,5000013,2018-01-30 13:44:48,30
0xb41cf80cb4da067feae881b99a4c3c38ce29199cf7d556014ef69ab12057a8c9,t,51947,1467455,,5000013,2018-01-30 13:44:48,31
0x937a7cf9dc703eac5ef0387e387601f3d6c6e09d46dade3a253e42a041ea752c,t,21000,1488455,,5000013,2018-01-30 13:44:48,32
0x9c799d12078947adfaaba8f2792685f10512b2ef0c0b59d030abaad82c3f528d,t,21000,1509455,,5000013,2018-01-30 13:44:48,33
0xba2deae161f955db0b75c4f6b614b92c1e978e84cb4ca14ca1b289072d43151a,t,21000,1530455,,5000013,2018-01-30 13:44:48,34
0x0d5d96fcb91a3080b00baf007bf0c559985b38a915cc2167faa04e76407d9148,t,47855,1578310,,5000013,2018-01-30 13:44:48,35
0x7842f744a9f4a73eece4417ea0b40bf04210e8306a16ebea70f7745b72ec928b,t,52233,1630543,,5000013,2018-01-30 13:44:48,36
0x9c2116f4ada9bfc510d004cc4d94483859b87c398306d9c221e91ccc0416fa3a,t,52222,1682765,,5000013,2018-01-30 13:44:48,37
0x36bf597b795e3a8e05ea32273a6074e7226ea544da30be5f579e1e9454b726ab,t,51553,1734318,,5000013,2018-01-30 13:44:48,38
0x005d228e2de946330bd9b132ea4db7c390cc1e46657b0a3cea7575bf1f7d0bef,t,21000,1755318,,5000013,2018-01-30 13:44:48,39
0x42b34d931d9cda74ec74475b0e5dd8cbfeed5dba6472ca7b9af69bd6feb10b26,t,38679,1793997,,5000013,2018-01-30 13:44:48,40
0xa7f25ca9bbff2cf03cf2ed25f7da4e2ee0365fee05a67dec95bd6a5f7288e1a1,t,21000,1814997,,5000013,2018-01-30 13:44:48,41
0x91e7fb6a6ed6949a9853a37c8072a3ee2c338f11c9e0abf7aac3e3c0d6bbda4b,t,22385,1837382,,5000013,2018-01-30 13:44:48,42
0x3659d69b1f6f90d4e7b7967004013d3df9e36c1e591a5925d37bd982160d0934,t,21000,1858382,,5000013,2018-01-30 13:44:48,43
0x669fb06f6b600a915ca0b733cea6a678817485116d297fccfb85322b855dfbeb,t,51789,1910171,,5000013,2018-01-30 13:44:48,44
0x64108fec074e793ece7d1e85a8d334776083542523af26c8e71c9d7035b83b78,t,21000,1931171,,5000013,2018-01-30 13:44:48,45
0x3d829f83f9edfb0c9baa6aa95162a7879de805ec2ec87e361463e882ecd1384a,t,21000,1952171,,5000013,2018-01-30 13:44:48,46
0x816e1cfd2678fec18e830c522e0cb945a2d532eef150c76768ecee7f2252fc8c,t,21000,1973171,,5000013,2018-01-30 13:44:48,47
0xc82ff2a4a8dd7f16fb67afdf14e28fd2d1d1428a3fb8df476570928d89d32689,t,22088,1995259,,5000013,2018-01-30 13:44:48,48
0x760cd96c7501096a929d4ef79fdc629cfb435409560f74c8bcf6f7e347322568,t,29204,2024463,,5000013,2018-01-30 13:44:48,49
0xddf646031f0336bf40bf8dd103171d5cee372822a9697b192f98edf89418a4a5,t,21000,2045463,,5000013,2018-01-30 13:44:48,50
0xa2b270234302bc1e74104fddf005e62745b191816534a652d44ddd296200e811,t,45638,2091101,,5000013,2018-01-30 13:44:48,51
0x415f8a497ab9402717b16f2bffd6a4df8313a115aa03ef43e15fbced1dba25a0,t,21000,2112101,,5000013,2018-01-30 13:44:48,52
0x820883c8b0218cdf01445da4871811bde9a0e88d5ceacdbd44223a48a96652a7,t,92858,2204959,,5000013,2018-01-30 13:44:48,53
0xeca38e936da4cec97f5f34b9ad8cc0f4add509745db7ddcf9fe8314154d6b70d,t,21000,2225959,,5000013,2018-01-30 13:44:48,54
0xec4931cef21e9f5415e2c710aa701cbcd5b551bfd741d6ed859a1091bcec6875,t,23028,2248987,,5000013,2018-01-30 13:44:48,55
0x998934898099f5b8852615ac1629df4ec2e3e5e1641b363dff652fddee6625b7,t,21000,2269987,,5000013,2018-01-30 13:44:48,56
0x716c629ff193f767600adf03a19db1af45857e851096b8146a32a7a0d2267c22,t,53233,2323220,,5000013,2018-01-30 13:44:48,57
0x89bc3b63bf46f47f0c1751e3e01cae21ab9cf389360ced706b68a741f1acb0fb,t,21000,2344220,,5000013,2018-01-30 13:44:48,58
0x754d2b4b5d4f7a136fc878244a1f4f891d06e43a7d5a60a71b4d682733a97d5a,t,21000,2365220,,5000013,2018-01-30 13:44:48,59
0x268ac7c81c6f8f7a1e4c9948a58681801c5ab5f2189dee9bb0d6b39241bad709,t,21000,2386220,,5000013,2018-01-30 13:44:48,60
0xcf5fb7138fa517ace299d6a861d964d558f6a06c2bf1f16f441acbae770b748a,t,21000,2407220,,5000013,2018-01-30 13:44:48,61
0x3e70be44c5b2a1d2da7bb114d41afc4b3d325af047decdddc37be86d56c4855a,t,21000,2428220,,5000013,2018-01-30 13:44:48,62
0x036351eae4c8574a863e0bd8c3db154160e0dce832620c51ef8f3bfe73d61725,t,21000,2449220,,5000013,2018-01-30 13:44:48,63
0x55ce493b0cb713cef937904e9d0042b303c58104128d3bf05f53c7363af92bc5,t,78646,2527866,,5000013,2018-01-30 13:44:48,64
0x2a9e684b454a11d842f30f93f6f655683b35fbac199505f470bcb3107a27add7,t,31984,2559850,,5000013,2018-01-30 13:44:48,65
0x01dd4df04b76434531f646307156bbd2ec87df8467474dc432bca69554429857,t,52912,2612762,,5000013,2018-01-30 13:44:48,66
0x6d298c0f5f59b4a57ab2354f57e8c48da33e6e7dbfa4c076bb8f79a2c968dda3,t,51752,2664514,,5000013,2018-01-30 13:44:48,67
0x72e6aa0284b69cf832d5f90789b15fd56001046e6b0d69b9a8f7d1aabf9963da,t,51884,2716398,,5000013,2018-01-30 13:44:48,68
0xa30aee717999b5a74d76f4b8ed903084c360279faf7b750cbb5db9add7c66eb3,t,21000,2737398,,5000013,2018-01-30 13:44:48,69
0x38ec9c1b27d86e5c7ca797efc5044487375958dd8f26a6291205aedfd8a099f9,t,52106,2789504,,5000013,2018-01-30 13:44:48,70
0x28beea88a8596ec6154f9a9283980edbb7707d6b2f5462ec4db563b67a8d4dae,t,124627,2914131,,5000013,2018-01-30 13:44:48,71
0x2e88abd39777865d6c1df8492c3e52bea4ecd465efe3bdc5ca5ffd4ef3ec4e1b,t,52886,2967017,,5000013,2018-01-30 13:44:48,72
0x87064a43b50ecc5541a36cbc1052ba3e3d55d5d709d70da4010814f622744a2f,t,21000,2988017,,5000013,2018-01-30 13:44:48,73
0x47a3f9aa96d8382c5861875f3f2ecf1dfc27d75ed5ca7dbd200c59efdad9d957,t,27437,3015454,,5000013,2018-01-30 13:44:48,74
0x6f94d6ef748ed1ecf838637723aa0639f517824f2cbb0791e79932d557e22166,t,21000,3036454,,5000013,2018-01-30 13:44:48,75
0xb6fc15d87b10319c9ef5db74ad3c5c83944366ea0047e8fe1eed302d2b776562,t,21000,3057454,,5000013,2018-01-30 13:44:48,76
0xaca88f239eb93a55acbe55197a292fb1e80702463333b6661905a85f1c205778,t,53012,3110466,,5000013,2018-01-30 13:44:48,77
0x5f22cb4c438984fc03a1462ba506c9f6d795a7dcf54c75b0978e8a4e45c5b22e,t,21000,3131466,,5000013,2018-01-30 13:44:48,78
0xf239206de6a0f3d603306b5697a1cd304c6de060f6bb7a8ced6e61f408a601d4,t,21000,3152466,,5000013,2018-01-30 13:44:48,79
0xfd53a10ad9515d19b10607693043c3fec1396b3a994bccc4f123461884d98734,t,21000,3173466,,5000013,2018-01-30 13:44:48,80
0xa6ddde51c03fae8f93f26e18843e723da1cc12df1771f889d254ae425e061a82,t,21000,3194466,,5000013,2018-01-30 13:44:48,81
0x84b3c6f2d51c247ec1cd80f8b41b8a61e06692d194b986851e4b8e5c24b4e1d2,t,54210,3248676,,5000013,2018-01-30 13:44:48,82
0xacf1664ed302868188b5064ae8c05c9c5d608120e6224505bde04adc3efe3368,t,21000,3269676,,5000013,2018-01-30 13:44:48,83
0xa8431319be09b95c3567d83433fd041af26f168b81f185a076a425d7b070e9ae,t,107858,3377534,,5000013,2018-01-30 13:44:48,84
0x4567e497900b743a2341e35974ad4fa4c9a6774bde0036f1d3e845a368c96a7d,t,21000,3398534,,5000013,2018-01-30 13:44:48,85
0x7db3276b745d08f2cb7d8fc56cf1837730cc2ecf5b654804188e420c51a81770,t,21000,3419534,,5000013,2018-01-30 13:44:48,86
0xd8a7b3906f48e712f6fbf0e0f623ab757c13960807344b6bb7398e2809f5803d,t,21000,3440534,,5000013,2018-01-30 13:44:48,87
0xde09c82c50a09dad434b7678b1ac5d1dc451ca9a91812b931753d55fb01d2105,t,21000,3461534,,5000013,2018-01-30 13:44:48,88
0x7dfa9b9afac04cca991ed63bc17b489bdde29a8fef57ba810d0815eddbd1cdd8,t,21000,3482534,,5000013,2018-01-30 13:44:48,89
0xbd914d9115da2d0e8c5004bf2736da79f410cf68b24793c8abb67ce7b1980f06,f,25200,3507734,,5000013,2018-01-30 13:44:48,90
0xcb520a5fe31afabd75b6d43858b1a82035c21252a00b2e85750b99fc3bf1c77f,t,21000,3528734,,5000013,2018-01-30 13:44:48,91
0x167ad785066a6d283f80036376c2ec55aa6993038e39d48b2188f8f7a1cefebb,t,36728,3565462,,5000013,2018-01-30 13:44:48,92
0x2b61f9bbe48fe6ad84da3ff30c74b49c667be8c1beb18694b26374a3b6948c1a,t,21000,3586462,,5000013,2018-01-30 13:44:48,93
0xba83da2111e2c9d9ac3ef6342184a72cf4343ad60d6a29bf5e2baf26599da3fc,t,21000,3607462,,5000013,2018-01-30 13:44:48,94
0x3a0da09e86cde1711c3254609931b81c75c41f4003b6eaf6aa956640f4322ed6,t,21000,3628462,,5000013,2018-01-30 13:44:48,95
0x02626b6de9cc93025de6ac4322f4c354f8be70587298c6312dff3ba851903ffc,t,21000,3649462,,5000013,2018-01-30 13:44:48,96
0x16a89f1a6b1c7258907c39c880fa75bb48d2c2ab005eb6de6ec1b187718a325f,t,21000,3670462,,5000013,2018-01-30 13:44:48,97
0x789ad9f1a088e88f5e95c48775ce90beb9517d82b82463371a7078d977b5b562,t,21000,3691462,,5000013,2018-01-30 13:44:48,98
0xfb7bfc797dad0c8b7fe449e447d7d0189242eb04d02c6f36b73bf3df29706075,t,21000,3712462,,5000013,2018-01-30 13:44:48,99
0x9ae56a57506072535b4f1ef570a27dcf6d9b5c26d6bddd861fbc4daed0444473,t,36848,3749310,,5000013,2018-01-30 13:44:48,100
0x5f73ec5f35f37a39bead4a04b11c1bda5d5e8c07f65746a89878c3ad7e7fdd72,t,22193,3771503,,5000013,2018-01-30 13:44:48,101
0x6bf98cca7e1bc942a0b8fb9cae6c210884d3ee53ea6934f07f40230a5c0d1f34,t,21000,3792503,,5000013,2018-01-30 13:44:48,102
0xce2ff12e0afd2c789b96cbc6836707ba678ae8c71aca1d28a07f66e6e36b84b2,t,21000,3813503,,5000013,2018-01-30 13:44:48,103
0x5b802f37ee933f62b03ed321235a33af3e4bd7f4848ef1bbfccdb8607ded4a33,t,21000,3834503,,5000013,2018-01-30 13:44:48,104
0x071875d3b2e4f64a121b008e9afff0f92ba6b6318f9cddf918ea93db7732918c,t,27200,3861703,,5000013,2018-01-30 13:44:48,105
0x7acb3d08fa1887b5918966ea43a991f2903fb4e5e8013cf03c37a734c22bdb7f,t,22075,3883778,,5000013,2018-01-30 13:44:48,106
0x668a052407a3a83e704f4ec1bfb3413965581791a5c121c323b8b0d8f039f3f3,t,23583,3907361,,5000013,2018-01-30 13:44:48,107
0x30dde5faa87899717cfe345bb8769868abbe1e3a174067265546cde986593c6a,t,23318,3930679,,5000013,2018-01-30 13:44:48,108
0xf8c6a4ad909d585a079aba12833b7554c4339e3e5ef5e7abc2dbfe751119794b,t,23318,3953997,,5000013,2018-01-30 13:44:48,109
0xe51caf32c2ff309cd2c2076d675ca126cee56213179ef348d8ec98cce4439175,t,23754,3977751,,5000013,2018-01-30 13:44:48,110
0xa12ebc25373c86a857d513436e919930e69ee5233e23a852f523a9efee77ab06,t,22222,3999973,,5000013,2018-01-30 13:44:48,111
0xf70e1231b46a58b7b02e37f584b6e03d5b967ead3d38a1a5ffdf64328d2dc451,t,22316,4022289,,5000013,2018-01-30 13:44:48,112
0x749231838fe9fae7393f4d754467a90c0e2d8a797d71be8ac6a7ead988aeaa56,t,23040,4045329,,5000013,2018-01-30 13:44:48,113
0x94d77e7271d26580af45da850656001e594c00aa336fc486457f49e47213b579,t,22460,4067789,,5000013,2018-01-30 13:44:48,114
0xe58f72ea3d97cdb0b44221c02222169fb262858a5ce3e1df8bbe6f4633b2ef40,t,22334,4090123,,5000013,2018-01-30 13:44:48,115
0xa7953cc6330f4a3006475ac3d19b6c0646cdb520b8e086980f554a7961bc6f9a,t,23818,4113941,,5000013,2018-01-30 13:44:48,116
0x8ab06cae8d34ad87f669d6810ae0d6700c9d90ed6c74b83604283fb4793d0429,t,92858,4206799,,5000013,2018-01-30 13:44:48,117
0x0494ef6ee6b0d1be93fc7f92dc7e8302761555011e328f316d3426435768d2b7,t,69568,4276367,,5000013,2018-01-30 13:44:48,118
0x689cfddc98bf2437b636f9418b8e4eec6fad661296c2548524bc780105ed4932,t,21000,4297367,,5000013,2018-01-30 13:44:48,119
0x9d5e39e95012a73889d89b942d0b10d0ed9e029faf17acad1d08ff340377b42b,t,21000,4318367,,5000013,2018-01-30 13:44:48,120
0xbe970ffb5c286f9dbe848d4d9bf3b15b5392db819fffa656bec505524f1616fa,t,69504,4387871,,5000013,2018-01-30 13:44:48,121
0x410fbaf03470f3d1f88c75796f30ef0f03dfb3db53a5a39a66d0849e2961f615,t,21000,4408871,,5000013,2018-01-30 13:44:48,122
0x555b4585400a0e2b960ea5b270e6dbe7819df2c52b9a56359492a8171b212ac9,t,51493,4460364,,5000013,2018-01-30 13:44:48,123
0x8fa0e030a7d002a4658dbbddbfd7aae45ac58ccc98718bde6af83f7097695c0f,t,32561,4492925,,5000013,2018-01-30 13:44:48,124
0x4f28063e877e6c6d673026c14a45ea4fdbd32d815e732778a9a237fbff688e6e,t,21000,4513925,,5000013,2018-01-30 13:44:48,125
0x61947cca6a41508745da21bbed352fe88207454bcab2ede79de4b015acd96a61,t,21000,4534925,,5000013,2018-01-30 13:44:48,126
0x9242d7cbc68ac32ef3b35921372e61e93a2844201ae59f3eeda2c8028eeed318,t,66316,4601241,,5000013,2018-01-30 13:44:48,127
0xe7bfc6a77be06cf90cba98329a43c03a8e67731c1552b1bc094da43afd95b693,t,44493,4645734,,5000013,2018-01-30 13:44:48,128
0x7eab45952bb78fa52aa69d1f203857e037d25e8c4dfef2191c4682868f3fd4fd,t,37068,4682802,,5000013,2018-01-30 13:44:48,129
0x78a0db2a88d922aea4b759b04dc09d87d9a74d5f867a3f4d9817dc4171f0176c,f,250000,4932802,,5000013,2018-01-30 13:44:48,130
0x9e9b092101daa7cb1faf232b68c34cf5b3b5e5230cb690b406f4975811dfc94a,t,37900,4970702,,5000013,2018-01-30 13:44:48,131
0x5b42a72aa9942912eab34a18edc574893c12495bc2a4a14d00c3f12f56b0fb68,t,102998,5073700,,5000013,2018-01-30 13:44:48,132
0x89f98931d1c601bae51f60791127ea6786caf17803fa91643f6b7228afd3d735,t,45576,5119276,,5000013,2018-01-30 13:44:48,133
0xd87aee564fb61f34a8c47691cea737027576d3c80b754b69936d1718cc144701,t,43545,5162821,,5000013,2018-01-30 13:44:48,134
0xbe652fce9eccab336e122cae94b9695ba4770809ad4fb2d97190ce32c90777f6,t,29493,5192314,,5000013,2018-01-30 13:44:48,135
0xe6b30713e3fe39657b8a272b69d623d40845a3b188830d1e8b23c32f488b1ccc,t,21000,5213314,,5000013,2018-01-30 13:44:48,136
0x8c6d9b183ecb1d01d7041379b2e3cfdb7b5295787200a3ff0b3e5b520f498c40,t,108114,5321428,,5000013,2018-01-30 13:44:48,137
0x79024761a0144f47767dbf142ab5a07bd8aa55a70b96a367dbb6ddf984e66274,t,78178,5399606,,5000013,2018-01-30 13:44:48,138
0xa260c76e19c9e11fcd95a13db56e3e76f6ddf9de9febbdac4288797723001c43,t,78306,5477912,,5000013,2018-01-30 13:44:48,139
0x84d0fdd8fba8815cc31e8a2617c738941658351fd7af876fa7c71f60400852b2,t,37900,5515812,,5000013,2018-01-30 13:44:48,140
0xd5828cf8d9229aad713d948ea32eb4c29787d88677be03aa29338350c0add676,t,21000,5536812,,5000013,2018-01-30 13:44:48,141
0xf14ea4910948df1e65bfb97c3b52fdb862012f03406023e13c074ea2b1530811,t,53416,5590228,,5000013,2018-01-30 13:44:48,142
0x6a07fc3b5cdc9ac5477386434a72be3d773339a5401236df4c933a36698f8662,t,52142,5642370,,5000013,2018-01-30 13:44:48,143
0x4dff5b3404f5e392776e27da4266924d9a1a0dc20e3c8942e629f066b11758e0,t,37848,5680218,,5000013,2018-01-30 13:44:48,144
0xb350c0729e0b9845d3c7f9c14a2d7113adb3cd1b285943c6f2ad73c51884b96b,t,21000,5701218,,5000013,2018-01-30 13:44:48,145
0xfb76778c616a33999a124f65c659d9f931830a60b06bc8716e199eb594b32bb0,t,21000,5722218,,5000013,2018-01-30 13:44:48,146
0xe2dfde4fd6f6861ea9228c52d9773a56ef96b70c167185460cd840c4f748ff40,t,53962,5776180,,5000013,2018-01-30 13:44:48,147
0x3b031a29c55582546cc208c77358328ce7722e72d3512fec522fd353203d125f,t,21000,5797180,,5000013,2018-01-30 13:44:48,148
0xa4c2da287e930641aa68634f9ab1d713cffacb0661f75152749842043d7aa0ce,t,21000,5818180,,5000013,2018-01-30 13:44:48,149
0xea7a0683d24360fd420c4c45aba696822fd6dd85927fe546d45487faa0cfa495,t,21000,5839180,,5000013,2018-01-30 13:44:48,150
0xcf2b7f8d896ac0871c31d77d1de79ddb912ed88cde532bad86812847dc831aef,t,21000,5860180,,5000013,2018-01-30 13:44:48,151
0x3209534b40b9b35c276062a57bcc55783a0f7fd1fbe1fbe377bf25cafd8890ad,t,36789,5896969,,5000013,2018-01-30 13:44:48,152
0xb79d9bf2eb99a40ca124e6cf25332331713d6d89015ccdb4a5bec5ee1ec504a1,t,38318,5935287,,5000013,2018-01-30 13:44:48,153
0x393bea433575992e575611bccdfc2d583d6aa90df92760c6ce33c0c420e0e43d,t,21000,5956287,,5000013,2018-01-30 13:44:48,154
0xc067989f9667a852941cee7200dd888706fd6fa0c15994a807d72b63ca195159,t,21000,5977287,,5000013,2018-01-30 13:44:48,155
0x3f72087b1fbbb67040c9739f0c724c09ccf5a2bf3c89e1deb3b169b55fc3b056,t,107167,6084454,,5000013,2018-01-30 13:44:48,156
0x2a21caf4ae39555c6d8b3df321a243b4afb478555bed643824201a3585c32bc8,t,52886,6137340,,5000013,2018-01-30 13:44:48,157
0xd6af8df1a54ae2adc020238903795b39714432560d7a7b41164e7c6513ef4a5c,t,21000,6158340,,5000013,2018-01-30 13:44:48,158
0x0c363b9ea6d82b99f921e230933ee593064286a992a1cfc672389cf495784666,t,26262,6184602,,5000013,2018-01-30 13:44:48,159
0x25371b0807e315355b015827fedfaf31dc07c9edd866b2de7226bde4b0c2ec87,t,37193,6221795,,5000013,2018-01-30 13:44:48,160
0xf8836bcc31d1956074f8d59aec3c1bf415291c8d9572cb66b83685bf51abe791,t,39771,6261566,,5000013,2018-01-30 13:44:48,161
0x491e2bc1503c70536bee110bc01b9a13a9e5e45839a9c0affcd3769b48f539f7,t,21000,6282566,,5000013,2018-01-30 13:44:48,162
0xcf20e03d86f42a0cdcf41d602d0407b9c6ead13daa23d8409fa9c25731bc0d0e,t,21000,6303566,,5000013,2018-01-30 13:44:48,163
0x2c30603c9c9824425f53fa0069f904307b2fd94dc0e96888c3cb940cfa95be04,t,21000,6324566,,5000013,2018-01-30 13:44:48,164
0x567b43ccd15e3f003f7a26e10f7ae89cf85d77c84539b7e4af9a452a7a70ebcd,t,21000,6345566,,5000013,2018-01-30 13:44:48,165
0x9d1485de6b3e725f0a7d7f7e390ac3d95c22579999cb3c7970734b1afbda6ff5,t,51789,6397355,,5000013,2018-01-30 13:44:48,166
0xa2a7f5afd6175f5c81f27bdfd86e98078649829247a51ee13b32d49631a997a5,t,38382,6435737,,5000013,2018-01-30 13:44:48,167
0x735fd2884bd9e42a6d598f84db00f3d14c77aed1c3a1d09e6398403819a0082c,t,21000,6456737,,5000013,2018-01-30 13:44:48,168
0x5f8a19a82a1eab3e90f9b4e040710495d932da48e1f3fe7e8b8ed51e98615be7,t,157516,6614253,,5000013,2018-01-30 13:44:48,169
0xa3ea91f7eb1b8ab8fc53af50831c3b837763deaca646d2a03a7bd8e397bf4c2e,t,52822,6667075,,5000013,2018-01-30 13:44:48,170
0xbe5ee81b1636c48c9d10998f9afca2e396d18a9ffefc1c6bd90b59054abdc27d,t,21000,6688075,,5000013,2018-01-30 13:44:48,171
0xd868edd7d9370d166a77f87707e3d0fe437c973dbd3328a13a00f9470cd5543e,t,27450,6715525,,5000013,2018-01-30 13:44:48,172
0x270a7e470cc2d0cbf226fd5df85810133766acc01267d36144ef17fff2e4a150,t,21000,6736525,,5000013,2018-01-30 13:44:48,173
0x378d397bf9697aabbd558152634220e005530711b870d9770dd0e4e78119fe21,t,51789,6788314,,5000013,2018-01-30 13:44:48,174
0xa24dd64d74f023485a586da05103fe7b8b989d612ee38e043f7754121b7ac32c,t,38318,6826632,,5000013,2018-01-30 13:44:48,175
0xdac0e92f4628f8c5a092e11244f5cb5c03dba6d56d7f02f7f428e16e01700562,t,21000,6847632,,5000013,2018-01-30 13:44:48,176
0x321d28ce6d1805731ba48b5caa02b22b4525e44a26c4ab801131d96acc607dcc,t,77295,6924927,,5000013,2018-01-30 13:44:48,177
0x7d5878181f39327afe00e68e2f2db333401e6909b3ebf95560a62da590373fa3,t,52886,6977813,,5000013,2018-01-30 13:44:48,178
0x2b84f6acbb4467b03857852c42053d8c154b691e3d2924d6fecaab5abbcb2b8d,t,21000,6998813,,5000013,2018-01-30 13:44:48,179
0xbbdbcc8fe035ba752917b18407c9f4970fd93a60a5de71cd168f448caeaeb28d,t,26999,7025812,,5000013,2018-01-30 13:44:48,180
0x2ed2886dd7e8dd86e46ae2a8bc6b4dab9bb3ca3cb131518dc5211b8626a1d6a2,t,21000,7046812,,5000013,2018-01-30 13:44:48,181
0x1f4dfcdf2e1b329feabe27f4f6c540cc5747f606cfc0bd5cbc9c8677b808d08f,t,51789,7098601,,5000013,2018-01-30 13:44:48,182
0xb6547b169b3da30b16ff09b0f1307e9419a6e4023a3fbb9c9cadd89a039642a8,t,21000,7119601,,5000013,2018-01-30 13:44:48,183
0x9fd6a251292d1bbe2b6f4138c7da5448055fab997e4656e6c12177d398ad197e,t,52886,7172487,,5000013,2018-01-30 13:44:48,184
0xb68cb93fd412bb9af0299336cfdb08c479de446ca27ed84afbdde413beb97c76,t,21000,7193487,,5000013,2018-01-30 13:44:48,185
0x4cfcf468963b9cfe5822efbd967cf964cbfb9a4ef6688662596dab3fe73c0369,t,21000,7214487,,5000013,2018-01-30 13:44:48,186
0x08a4464a24406f87ae94e8aca6341e4223fee0eeeae949659867f63622fcd71b,t,51789,7266276,,5000013,2018-01-30 13:44:48,187
0xb405b58ec35e7b018d7e1b8e23a0af5f093b259639c928b6280e60e19f26fd96,t,21000,7287276,,5000013,2018-01-30 13:44:48,188
0xb28c83241462c84bd46d49ea302153cc5c63493ac9fb3034d7e3b6ab7a86197b,t,52886,7340162,,5000013,2018-01-30 13:44:48,189
0x08458ff06eaa34efb08c740c0b4d99ef26f202791130f7c08b30c0f78ada55d2,t,21000,7361162,,5000013,2018-01-30 13:44:48,190
0x0a50b50feff1b81229cbc4030dbad403db681ed9345163cd55b1155804b3fc71,t,21000,7382162,,5000013,2018-01-30 13:44:48,191
0x88eccc1e7ca3e3741ceb322627faf44ba75ef2f8f3ff9bb5c9139087aef63f13,t,52886,7435048,,5000013,2018-01-30 13:44:48,192
0x396dc81f9612228ae970c886eaff2475368580f97968d4d819c0784db65c2190,t,21000,7456048,,5000013,2018-01-30 13:44:48,193
0x35585273f1b842b2a80deda156c702fb8001cf98e145a95d6911e5c1ebcb7f22,t,21000,7477048,,5000013,2018-01-30 13:44:48,194
0x2ed430e07215b9fe1dc7ccc46d86c8bba1e07ab85cc020601b9cfc1a3108afaf,t,52886,7529934,,5000013,2018-01-30 13:44:48,195
0x88fb8509fd11e04a3464bf143da388d237ddfa5189f2ffce170b0848ecdd9ca5,t,21000,7550934,,5000013,2018-01-30 13:44:48,196
0xd7016fb158da2a0527af7ad26522630587b92be030343450a814daf5306c964e,t,52886,7603820,,5000013,2018-01-30 13:44:48,197
0x66576a151bec7517181730523c171e3382509df817ac2a2db9a3eef1720ba057,t,21000,7624820,,5000013,2018-01-30 13:44:48,198
0xcf28837a6d182b0a05ce7aa3511f19c34ab404dc49378ebcc9a0521fc32eb9ef,t,52886,7677706,,5000013,2018-01-30 13:44:48,199
0x91d4da5cc0cf8777109d99e70f5369a4893358c795906d497dbd0e7fd44046c1,t,21000,7698706,,5000013,2018-01-30 13:44:48,200
0x5297917bf916b2cd901d40ddce8ae300f154a5b1f7ca04849edb5cc0640532a8,t,52886,7751592,,5000013,2018-01-30 13:44:48,201
0x7955451833f878fea72ddcc9e9d46124a478d5b515d94ebc45483f1fa447e1c9,t,21000,21000,,5000014,2018-01-30 13:44:51,0
0xf92c5796a1d4585b9d302ec33f65ff43077425d5b4633c2835da4ee15176ddf4,t,39512,60512,,5000014,2018-01-30 13:44:51,1
0x791a607dcaf956c99545de69e6ce8c8c2b06ec57026f5adc401273e81e437242,t,21000,81512,,5000014,2018-01-30 13:44:51,2
0x9f96580c3c5be9d57eb60edb375d4c77013615799316ee6e5b0cf742bc18eca2,t,21000,102512,,5000014,2018-01-30 13:44:51,3
0x7cf1ff468e650dd81b5e767d5f42f7a6c75317bbb421d1b8ab020d0364f02a85,t,21000,123512,,5000014,2018-01-30 13:44:51,4
0x958af45c1e0ef50aa7f3502141e7428e21ff1a784f69602c229c2569027a1ce1,t,21000,144512,,5000014,2018-01-30 13:44:51,5
0xaf78883070ebaab0e9719273f2483b595064f16d9a6b093db1516b22387c84f3,t,21000,165512,,5000014,2018-01-30 13:44:51,6
0xc6d906910041b9cf9ecb3432d3bba2f67cb1185ab20181a9f4bab2e566c052f1,t,52912,218424,,5000014,2018-01-30 13:44:51,7
0xe31a9e8e5f6aba8c2da0ee9f73be94ed5518167d5143140d9b303e8bdcc44fb6,t,37142,255566,,5000014,2018-01-30 13:44:51,8
0x542993bf1752f3a5d5a63382193e096ae3f4f7f2e113b62596696f5d25712aeb,t,36784,292350,,5000014,2018-01-30 13:44:51,9
0x12097827d15c05b6f9b626b094363116d936b1a682be3b3ca2382ce1df474f7b,t,29493,321843,,5000014,2018-01-30 13:44:51,10
0x2b65ee2fee72d83d2045384aeaeb3e04f81bb903e4c2669a2c7c53428a4d3a35,t,21000,342843,,5000014,2018-01-30 13:44:51,11
0xd2f9494fa64a8c18e3709686b7747c5f5da0d5f0c24b3d4a1989be1e3957f001,t,21000,363843,,5000014,2018-01-30 13:44:51,12
0xb0504f2a625f22385b8932cc067194173050cf38b925e5616fea0c5848e44650,t,21000,384843,,5000014,2018-01-30 13:44:51,13
0xd9a93562f59bdc364479b276f6972a382303c7f4f8ecda2996946d734dac176f,t,22091,406934,,5000014,2018-01-30 13:44:51,14
0x0881d7b0df1a2ef17ca5550912625b8eb7cdd60d8c6167d0578a0c1c830beabf,t,23465,430399,,5000014,2018-01-30 13:44:51,15
0x20788879c56ff082841f7fe60b24a71800a04ef0e0e32fe0caf9d6eef94d6ae1,t,108178,538577,,5000014,2018-01-30 13:44:51,16
0xa7bd2e355100c3f06706c6a7856ec483a572a9c5f937c6e3870c3ac762eae290,t,21000,559577,,5000014,2018-01-30 13:44:51,17
0xb8b49dfdcc4498ebde4187a0b599771451775d8cfdc96bc228f21d3337180623,t,92402,651979,,5000014,2018-01-30 13:44:51,18
0x0c3a1530bc4ef31a20022cd37f3080005c7d39b1f85ab76f31edf2b74cd55fb0,t,51948,703927,,5000014,2018-01-30 13:44:51,19
0xfcd23233fd265303533a44feb970c12e9f8117a7d0fab5cccf50e8209cf94e9b,t,52173,756100,,5000014,2018-01-30 13:44:51,20
0x2940aa6709672db5adaf9877f202290faa0f0a593dc4b7903bbb51c4d0dbc590,t,21000,777100,,5000014,2018-01-30 13:44:51,21
0x847342f109cd647001f770a6546e818b578198ecb6d3f2fdf6e96e0ee30cb188,t,52886,829986,,5000014,2018-01-30 13:44:51,22
0xa11c299c81081a9fee168d2d8d78d0286835ec8aa74f40e30a43aef0f32579a6,t,30449,860435,,5000014,2018-01-30 13:44:51,23
0x79e8e1cf606fa9e8281a64ec1b89fe5742f427f2d93fd4429e79f60abc715e42,t,21000,881435,,5000014,2018-01-30 13:44:51,24
0x71a8cb2dde4b02b19391abbf979f3f4ce6d1473960be53df0a178e3c25f9a523,t,21000,902435,,5000014,2018-01-30 13:44:51,25
0xe0eba6a39cddbce9da2578a3d8eea82d2e5688c1d1fc5ada10141cd5da4d6eb2,t,53803,956238,,5000014,2018-01-30 13:44:51,26
0xc87435ccda654662a7bb4883b5fc3705bee52ee29f5c86395739b0be4cefbcee,t,93306,1049544,,5000014,2018-01-30 13:44:51,27
0x8bfdd1d96531dc0aee5c6a826e128ad7bf1006b915e62f502d06481e47abcfdd,t,23316,1072860,,5000014,2018-01-30 13:44:51,28
0x41e05d34ff2b25556f2aaace7476c4d1fd4233bb358bdeb922bc06e8401bfaf0,t,23040,1095900,,5000014,2018-01-30 13:44:51,29
0xa0ea99f843efbeb39439d1a210105104e3ea2b841a876daa83e171954a63eede,t,167213,1263113,,5000014,2018-01-30 13:44:51,30
0x6d0793a64250615023e5d86004d5601c99a176478537a4b5f39b396bda2b15fb,t,66316,1329429,,5000014,2018-01-30 13:44:51,31
0x70855b99c53d6f06e27db37ab04a149343464af476c360c303a0b44c46a3351a,t,21000,1350429,,5000014,2018-01-30 13:44:51,32
0x99da76bc6b30b92c8b8d0e17f15031be996960053bf2dad10abb4cdd2583202c,f,360646,1711075,,5000014,2018-01-30 13:44:51,33
0xd4f295f65f7a4e4089e55a128447f0278b913259f8d02caee3f5eda9c2895cad,t,161641,1872716,0x0dAF56F15875DbB158D12954041b75549BCCBdb6,5000014,2018-01-30 13:44:51,34
0x9dfcafe84e663121517625422300520797e66fdf1786ac8ffb99c1b30075d214,t,59098,1931814,,5000014,2018-01-30 13:44:51,35
0x79b3ab10a054f673482805b3bcce5d7785a6c757c4d569f26644b7083b3f6fdb,t,244829,2176643,,5000014,2018-01-30 13:44:51,36
0xaacb12d9e8b04b3cd91d5cbb0d7dd3b9ad1675bb881bd596e8ed27a8150687e9,t,51984,2228627,,5000014,2018-01-30 13:44:51,37
0xa2ab0296a5c90a3b1561d758a78ed03621f80d65e99ff31cf024641394a03b65,t,33235,2261862,,5000014,2018-01-30 13:44:51,38
0x6496a6eb23c8cd2ed0b58e6b3ab92a91f760c9214d4e1c9e4ab11e52d197af88,t,84005,2345867,,5000014,2018-01-30 13:44:51,39
0xf907252f9c137ebad6e00cb2667b9fc0b2ca40d39bce44d17b9676ff76175fe1,t,37900,2383767,,5000014,2018-01-30 13:44:51,40
0x2df931d0b8bc914dfb7428e25a0b4fe3191537ebcbdcb64a403a041b5cc18ad0,t,518906,2902673,,5000014,2018-01-30 13:44:51,41
0xcfded2b955c09a377bc5e45b974c951f6077e52f05436aaa29d1c73c58864ce2,t,37352,2940025,,5000014,2018-01-30 13:44:51,42
0x97f373682d30a820a5210627a1bceec30f505f78a53deb1058419405d0b91ea4,f,21087,2961112,,5000014,2018-01-30 13:44:51,43
0x40281674474aa59c3ced741de62c0cdc354afac04df0200030f9d45d582ebf93,t,140340,3101452,,5000014,2018-01-30 13:44:51,44
0x484c959c5ce9e402e3a8ec37dd80d3fd0d13c690a27eb883f94d6e32445a745b,t,141151,3242603,,5000014,2018-01-30 13:44:51,45
0x6bdd706f7d9e70dc890a1ee4b6d841648d0fb4edf82763cc72711dbc309b928d,t,141857,3384460,,5000014,2018-01-30 13:44:51,46
0x878c5a55f16271307bfda0b0f00691442019f1ab927c7924cc78fb85be00e1d8,t,51416,3435876,,5000014,2018-01-30 13:44:51,47
0x52f75681a384838c48fc7555d559df5cc6995973539ba9ae4a67c6fbfc37dd67,t,90729,3526605,,5000014,2018-01-30 13:44:51,48
0xd51a701d91ccda705f59c74548dbbf2d5d6c2824a32586df1d6a42fdf2bb0dc0,t,46398,3573003,,5000014,2018-01-30 13:44:51,49
0x01a96cb81ad3983783527ae4d203e9d640ce3222ccb2c48c62f50e6f71f0d138,f,61978,3634981,,5000014,2018-01-30 13:44:51,50
0x3954649831842313c3ca9b051db3d3f8c61157644065248c291996b0086eef87,t,84005,3718986,,5000014,2018-01-30 13:44:51,51
0x0167288adba039ea0413f3ad381ef022cb78fb65aa47600c4211a82797676b26,t,51921,3770907,,5000014,2018-01-30 13:44:51,52
0x35d853568590ce0eedc232a52f10d3e76c9ab71679d24bdd3e5c9d144a89f5ff,t,21000,3791907,,5000014,2018-01-30 13:44:51,53
0x65109b02d9188b4f60915ee2da0a06b85e5c7fb8df0c7c4ad6d336a161b53420,t,37682,3829589,,5000014,2018-01-30 13:44:51,54
0x8a263fa79e0d240c31cf95984cb7e7ceb168f32a6c0e6f5d8176133a1cbd7595,t,157452,3987041,,5000014,2018-01-30 13:44:51,55
0xafe1beca24fb4f054de0884128461d8650eaeb08a4ea40beffc9b6665aef1db7,t,52886,4039927,,5000014,2018-01-30 13:44:51,56
0x66c95bedff0f421661393cbce6f948252df455eeb5ed6e031c0eeeb0edc0a869,t,30449,4070376,,5000014,2018-01-30 13:44:51,57
0xb0cb12e4981373eb13b6d65a04a23104d8c0a69df556c942602649061570347f,t,53803,4124179,,5000014,2018-01-30 13:44:51,58
0x44cc0723a36fd486ffe587617c2fef2f38bacc7945caec0d3319c4cb5ee9401e,t,49041,4173220,,5000014,2018-01-30 13:44:51,59
0x2d14932cb3ae9b9f48c326458c34d6f5e5607ec633005c2df11849c85c22c089,t,66316,4239536,,5000014,2018-01-30 13:44:51,60
0x1bb30d07d3581f3fea51971df060bdd95828b42fc52fd63d0252e45ec74093ae,t,90558,4330094,,5000014,2018-01-30 13:44:51,61
0xb6872556bf6dcf61cc8196baaa56c4a54063797c2683212e67e7d31cfeb28934,t,161641,4491735,0xd5d112897db19Be87D9332F1FCe6BDD7ceFbf34D,5000014,2018-01-30 13:44:51,62
0xcd34958f6b6c23f89245c7ef7c32a796d0da8ad96a27b7d366867c6d8089d765,t,51984,4543719,,5000014,2018-01-30 13:44:51,63
0xa521d5b66bbccd52179e6b9af0bf134a7ba5f55bcb1529d055964816ab4c4596,t,90729,4634448,,5000014,2018-01-30 13:44:51,64
0x0cfce671bd3f4be1789f03edeb6d468905686c593248cf0977539a4c6f64bf28,t,82749,4717197,,5000014,2018-01-30 13:44:51,65
0x741ed2f7f7a0503125246fc5e6c5d33ef6a38f3dd1d569c0f55e0c7f1aee6308,t,52886,4770083,,5000014,2018-01-30 13:44:51,66
0xeec005ae53b1a54c89d23c4c3f05866d61a910f90742f87df2a67e0e14eb0bf6,t,30449,4800532,,5000014,2018-01-30 13:44:51,67
0xa21fa186f0cda94af3829277d10b7ccec489830c697458ed05b624805662910d,t,161641,4962173,0xF1a26AD407a2657b5aC53A21B826C7a2D412DEED,5000014,2018-01-30 13:44:51,68
0xd2acbd07b6fc819eaa1220380d93061805ccbaf2d4b368164637937e6df2d63e,t,51984,5014157,,5000014,2018-01-30 13:44:51,69
0x7209a42928082ef16c2b7545ebdf8185e5ff0c917e1bca0061df012203250d83,t,52886,5067043,,5000014,2018-01-30 13:44:51,70
0x9d85a4ae77c562d4bce07de3ea51d0ec4350a6588d0bf22873532787514b22c8,t,30449,5097492,,5000014,2018-01-30 13:44:51,71
0x7b6a1d72a48fa16c10d6a0d50ddeafc42895f9b13c13d2eb1f28bf0882fcb996,t,161641,5259133,0x514D90224fB34622B5bdE07C1DE783f660D3eB63,5000014,2018-01-30 13:44:51,72
0x8d42322f688ad7228773800fa3ac9a3ffddda9326c73dba112bb8fd1ac3b6b24,t,51984,5311117,,5000014,2018-01-30 13:44:51,73
0xc5945121a43372c042d82d564f9d7d0c34bf4220e8a8060a19351c44bc848d66,t,52822,5363939,,5000014,2018-01-30 13:44:51,74
0x9c34d4e4f1da40ae994ea04d7b9329d1b241d50141aec944a3b005a4f9b67eb8,t,30011,5393950,,5000014,2018-01-30 13:44:51,75
0xce48fd85c1cd20f75e873852d6cbfc5b9c8ad8b349b233ec672627ecacc991db,t,161641,5555591,0xf32994A1Db35F2B21dD07Fb03dC461a172d464a0,5000014,2018-01-30 13:44:51,76
0xfe485ab5d1e9be961e69280c26c6fc5cc9d4da8a92216be2cfa6603ac240a336,t,52886,5608477,,5000014,2018-01-30 13:44:51,77
0xa00edc462644dc1398c8649683c4fd4c6f7a020e4d2e41b950fdcf6cf4b8a59e,t,30011,5638488,,5000014,2018-01-30 13:44:51,78
0x9ae896123a08a52013f885442b07b27dae314a4e3c8a557c10002c55d5eb8b16,t,161641,5800129,0xcAc1Deb1bD3d67379C58AA3C605993C6eaDb46bF,5000014,2018-01-30 13:44:51,79
0xfcbbd36ac001167c35abb7b2066354dd24560cd45537aab58f632214632ef31a,t,52886,5853015,,5000014,2018-01-30 13:44:51,80
0xf2ab43191da23ad22b2294607ff19c198908a4eb451536a86a80cc41966b0cbc,t,30011,5883026,,5000014,2018-01-30 13:44:51,81
0xfad17c730877292ecf3d76f1a692ff184eebf8ea6dc0334930d65cf71f65f428,t,161641,6044667,0x78547468777008fe1618ea467e75cB8536aF2885,5000014,2018-01-30 13:44:51,82
0x238419dc58a53edf8e863a29002dee3876225da3bbdba9797cd3fc3408d26918,t,52886,6097553,,5000014,2018-01-30 13:44:51,83
0x97bce2c6320a7902db265e99162044afcea5495f765f74c116789449f0c2229b,t,30011,6127564,,5000014,2018-01-30 13:44:51,84
0xcde5425ace95dba8e2c28334f3636025728cc7a7c68bdd14840eb45f3838aeca,t,161641,6289205,0xBdF2D4B366da3b4937BE8c61252E89c76ec8e996,5000014,2018-01-30 13:44:51,85
0x57031c0e7e9251bf982ba39affa9dd1d4b8db887220cec766b8757d3cb3c1d9f,t,52886,6342091,,5000014,2018-01-30 13:44:51,86
0x65c4d4875a4b1e4e016e7c70baccf8366abbc99330004219b48c56bfc2990271,t,30011,6372102,,5000014,2018-01-30 13:44:51,87
0xcaecdd5eda9761954947728971cc20ca9e7e5a74712f3916df7481af4068e3c5,t,161641,6533743,0x1Abd1522Fa7347453217eDb8D185F49a489f20b4,5000014,2018-01-30 13:44:51,88
0xd68ec3166592a0e98a6b7b6616826413fc178675330b03177a3729bbe370f87b,t,52886,6586629,,5000014,2018-01-30 13:44:51,89
0xff80c7757a2efa35fd13939ee996d91f7e400771e75ef9c830fa7e2b23a84ee6,t,253854,6840483,0xe798909769C3A8287279958b94f26c09aADAbAf5,5000014,2018-01-30 13:44:51,90
0xa1a11e8d99fba803efb3ac41a0a02765ddd860a9bc6453581728ff491d5e721d,t,161641,7002124,0xFbfAff3d76D3907010912f1645c0aEb5ca04551b,5000014,2018-01-30 13:44:51,91
0x2f3576d7012542be9bfcaf1a606c64537c0557b73afe8f37ce244a8f556a82f3,t,52886,7055010,,5000014,2018-01-30 13:44:51,92
0x8a9451cb95b101521b48e037de116f398e7089db68cabe8d9ac019e61002f1a7,t,253854,7308864,0xf4f9b37C9969Ce4d38411A7b60dD1e24e53319AF,5000014,2018-01-30 13:44:51,93
0xd5effff7af54be453cb43b38aaebb71bdef53fa79852ee61691f37402f19c974,t,161641,7470505,0x8E537bc52b6784A037dE11865F5f0CD560b342F9,5000014,2018-01-30 13:44:51,94
0xacf2e16ae809445becac6ca632fc55124f81edecb105b80df98f3f577d9b5668,t,52886,7523391,,5000014,2018-01-30 13:44:51,95
0x71af63ab57582042b1ba3338a7db0fdf6f1b5a200b6ced899f5792ae70eb8b94,t,161641,7685032,0xad25f0cbCdeC1852300808DF408d4A74DFDbda91,5000014,2018-01-30 13:44:51,96
0x3a881722bc825b76b0d5c861f207bccb5b6efbca50cb56e929ea6db966353809,t,52822,7737854,,5000014,2018-01-30 13:44:51,97
0xdafcdb5e44492de0ecb6c7168d1f6a1bbdd810a490b87b6cbc515ab1cae7a800,t,161641,7899495,0x255cBBF54d851adB5762d75d17c948132a8cf3cD,5000014,2018-01-30 13:44:51,98
0x3b65744c801d107b5da5b6d968c93c320bd365c925553584177816d27a2b0a2a,t,52886,7952381,,5000014,2018-01-30 13:44:51,99
0x153261c4338668c392e8e217ade30fd511d628f7401a154fe89e818731dc2d80,t,52468,52468,,5000015,2018-01-30 13:44:58,0
0xdf962e50eb21f8fff94b0c2b4aa093d54cc93781386a39148a3aaf3fe017e93b,t,21000,73468,,5000015,2018-01-30 13:44:58,1
0x562e807bc0813eb7155b654952540ea5d79d41d44b794c9b5532085eebc625e5,t,21000,94468,,5000015,2018-01-30 13:44:58,2
0x1f31285c899b937524313538a335d521729b38c9e888877186d590fbb748e608,t,24632,119100,,5000015,2018-01-30 13:44:58,3
0x21ae8f528c33762b59505be2db6813b4042a6306a2f1884b3f07e48c74825539,t,40843,159943,,5000015,2018-01-30 13:44:58,4
0xb72a3000b52760af70d72a0bf513f2a6e89821be248518aacf436bb2e062a9ec,t,21000,180943,,5000015,2018-01-30 13:44:58,5
0x9d6ffa3f26b5114ece7f9f22d445451590ac27c3e9eccd0b0eec70c57f1c50e8,t,46109,227052,,5000015,2018-01-30 13:44:58,6
0xe68164e24f24dedb78913435b0986752b9b7690200fe8f06f9b5cb3644c98c8a,t,104678,331730,,5000015,2018-01-30 13:44:58,7
0x1f0db00a976d65288b56aada66f32e68984fde619acff8c7866817266b7dc0f3,f,24000,355730,,5000015,2018-01-30 13:44:58,8
0xb190abfe2c65d24c56125473f0caf24fcf53470189ac21ee8909a9f854b76206,t,43724,399454,,5000015,2018-01-30 13:44:58,9
0xbf5aea33bd814ddda4d7f3d02a6f6df6e9b94afd68762eaea7e2e793dfd8cdfd,t,21000,420454,,5000015,2018-01-30 13:44:58,10
0xac5747525367acb77649b33f1ec3dba2609afc81e55727275ddfcb3216bc6a83,t,21000,441454,,5000015,2018-01-30 13:44:58,11
0xaedee695b4768d00488273c4d5d16aee03cdd47c2dbcbe0884cfef987146b6a5,t,51812,493266,,5000015,2018-01-30 13:44:58,12
0x9155ffa80395f814ea8b48e35a19ab8689bff930d810306e2d527930d0fecd87,t,44493,537759,,5000015,2018-01-30 13:44:58,13
0x9ada537620b96fbcbffc4b27cdbe16eb715f63c16d6e423e0513d8c049e3afb5,t,55779,593538,,5000015,2018-01-30 13:44:58,14
0xced47b7768c3b855b11fe0e2a6818b5841ed18fe8b3d8d542892e8409b00be16,t,21000,614538,,5000015,2018-01-30 13:44:58,15
0x270210fc6287688067c34215bac490deea47a0ad5e6baba0557cfc0e451ce349,t,23593,638131,,5000015,2018-01-30 13:44:58,16
0x1a34b8c7e4d5b110ccf514a22cfdc361c0c947f193c7e76e27e9df34d44c1d49,t,23529,661660,,5000015,2018-01-30 13:44:58,17
0xfaacf5b411dfa93f1c067bf641c4521966885cdacfd40f7212bff463b2584c91,t,102934,764594,,5000015,2018-01-30 13:44:58,18
0x890268b4a97f2bac05e7db8de79d2570afd7ff74699419ca7a5603e6a5ef18ba,t,51654,816248,,5000015,2018-01-30 13:44:58,19
0xe1b7fca43fa47081e2c609677ccf8be1df799f6902da11fc8708b1b733c49264,t,21000,837248,,5000015,2018-01-30 13:44:58,20
0x726a0ce96d444cbf05c22caec23ec4232c77dd8780ad60772131b58f71199428,t,21000,858248,,5000015,2018-01-30 13:44:58,21
0x3e39a28fd56b3d3ab1c4955d34e4b5055a5247de8a1c5d1f86b425ba499eb023,t,55843,914091,,5000015,2018-01-30 13:44:58,22
0x47cbcba25b2cbd307710ce1834a93aa274717bb43e9b49006d4e8b32fcc8dc60,t,102998,1017089,,5000015,2018-01-30 13:44:58,23
0x721938716111d6572607528b784f5c1cd71388bbbb8810a4f5745c2532db4821,t,253854,1270943,0x6CC2cd9b62A5a2dEF4F4B1ecDd53e6Ba7A789E1C,5000015,2018-01-30 13:44:58,24
0x4c3f0eaa72d918d49f3b73771ea864e8d464e3d88c103fce3874e9dd37d00fb7,t,53803,1324746,,5000015,2018-01-30 13:44:58,25
0xdadc97e6007c902e1118b8b1e3a87608c25da5837276b54aa6aa99abbce0daf6,t,36930,1361676,,5000015,2018-01-30 13:44:58,26
0xbe2ec60651a37c0357167f80eb59233764f326e80e88b77c206602ff494b64fd,t,36938,1398614,,5000015,2018-01-30 13:44:58,27
0x30d0a39cfde3f5e4afb7b5990ad0aeec321f7de9a66af70c9acb450117d080f2,t,21000,1419614,,5000015,2018-01-30 13:44:58,28
0x182e8bd6438e9497fd5ecb6e2f5cfc65aa231712f893efdc06c2bf85dfec9a3c,t,52886,1472500,,5000015,2018-01-30 13:44:58,29
0xb8678372420a88d314502c3af308cb910a13c60f048e60ff8a160a727a51d68f,t,21000,1493500,,5000015,2018-01-30 13:44:58,30
0xc2395459034214ad457edb8a08d98cdd3e8acef18636fb7c8e62b063cb15064f,t,36821,1530321,,5000015,2018-01-30 13:44:58,31
0x0e94b074e657832aa9ce734124808cfe67c0343ed9ed2cf229987222705a605a,t,21000,1551321,,5000015,2018-01-30 13:44:58,32
0x680c79810599be710fe40c6cacdc4d1516efe97ca90fb0514564c9d99f84fbd1,t,21000,1572321,,5000015,2018-01-30 13:44:58,33
0xae49d41188dbd55d8053179a2071bfb05b0d45b4e1104f862393a30c8e568145,t,33705,1606026,,5000015,2018-01-30 13:44:58,34
0x3a3795020edb5ba29f3b2f9531cd22b95916cdb79221b6258bd06e0c201e5de4,t,21051,1627077,,5000015,2018-01-30 13:44:58,35
0x4b6cc1aa8b13fc269f642c29c178dcb9ed7ea319a0301d8b5cf60f8c0a59a8a3,t,40806,1667883,,5000015,2018-01-30 13:44:58,36
0x6ea623ed4d349fe8cfb18e956671b46502b3243c7a6042d4dab36dcd472a86c8,t,21000,1688883,,5000015,2018-01-30 13:44:58,37
0xa3748154cadd406ab1110a6150d0d66ed7b297eb00f4d365e37451004ba446dd,t,52148,1741031,,5000015,2018-01-30 13:44:58,38
0x537fce7fce6fce057bde5627b0486e731f3859eb0548bdcc38e250b6d656a64d,t,42220,1783251,,5000015,2018-01-30 13:44:58,39
0x93e1f3f61618a9ed9ebce3f663fa576fb615a664cc153c2d7ade7c91f78db9ec,t,92986,1876237,,5000015,2018-01-30 13:44:58,40
0xe9803299e1ea8c48a7bd686680dd081f925b0ece73046f045551044967b11b26,t,22460,1898697,,5000015,2018-01-30 13:44:58,41
0xdd05f0fc752b255ad7aa50f67711550fcf25f058ec46a7ea2c56972a8047b865,t,38254,1936951,,5000015,2018-01-30 13:44:58,42
0xb3775e885eb17c0c44ce3d6a27cb627c9fcebe21fb76df0e0b8e2ade1a01d2d6,t,23318,1960269,,5000015,2018-01-30 13:44:58,43
0x39f65d17be1396926d7df570c9195522fa23939ebc6aa9ea58c91e7ab63c33bc,t,23103,1983372,,5000015,2018-01-30 13:44:58,44
0x81b7db0f7c2d9f9c676046a0392041bf5af923d1f0b0d36f27fbd795476a279b,t,51779,2035151,,5000015,2018-01-30 13:44:58,45
0x564f647984d3ea137ecfaf785ec2b6b112c11ef07b3003561fd8c32bd6a02a2f,t,26543,2061694,,5000015,2018-01-30 13:44:58,46
0x98d7925f773e838bbca92e130f0e1ecfd91434fb68ec9fbc49c97b35625b86d2,t,174591,2236285,,5000015,2018-01-30 13:44:58,47
0xc92a3c9b3033b7cc30f96943283db5f5919d64a06c3d77d7938c1f230430dee2,t,21000,2257285,,5000015,2018-01-30 13:44:58,48
0x82e1e30ed5dbd227a0a91ccdc87c1154299dac3ae9cbd3523ae53979a7ea0768,t,40907,2298192,,5000015,2018-01-30 13:44:58,49
0x9d3c4b28c47e7f18c76444ccac098507ac6731ab8793f655f16ebdd93157c0d1,t,52810,2351002,,5000015,2018-01-30 13:44:58,50
0xee30e393d1d6c0d6dc47a2a3fd669f72dd137e3dc26ea21c0c9c646767a778bc,t,21000,2372002,,5000015,2018-01-30 13:44:58,51
0x6ec776936841c27fe4ec6e9359f80620ab938a53eccb0a58cd7685ddd78c7138,t,253854,2625856,0x5C54CAeF96CfE293043EacbAd70e914B4E6C2eEc,5000015,2018-01-30 13:44:58,52
0x303ced23c862e298966dc3cd3b88fd712c116ad968664142d3a2eab07e257a7d,t,55979,2681835,,5000015,2018-01-30 13:44:58,53
0x8d04bde28d24b76b58e454c6450b7cea4cf18786a9d6fedbcb8020a3238768c1,t,52886,2734721,,5000015,2018-01-30 13:44:58,54
0x33b1bf15b228c3ac7b62a8e60b61837d14aceec2052389357d8fc35f98779035,t,253854,2988575,0x2712fBc2F56188BcE839Fe8D3F77EA9fF64Eb692,5000015,2018-01-30 13:44:58,55
0xdc0f727afd5846e9f0485641507bea1850cf1c47df4147282f2f62be118864bb,t,53739,3042314,,5000015,2018-01-30 13:44:58,56
0x07f3a5ed2b4097eb116bc40c648948cd904d6b075a6844fae8d5bec9a97b02ef,t,253854,3296168,0xb372030c101c1f9db3Ea85A5a50A88945049B432,5000015,2018-01-30 13:44:58,57
0x01cf1dfe08362f93578d42a9f367497a15bdcb74f14003196c3b6dc4003cb80b,t,53803,3349971,,5000015,2018-01-30 13:44:58,58
0x996ad0d23cbb3fa2c85c6fc7bfdcf962ca272e95b85c296b11ee99248b897397,t,51762,51762,,5000016,2018-01-30 13:45:00,0
0x9b34952bbcae8b126b371c5596a9e4f10e291d17a5b02829858c91aa14d00a8c,t,37884,89646,,5000016,2018-01-30 13:45:00,1
0x56d74b91b907b5bde76ce276898ab3d1d898b9de9720b4ffc196892e7846e613,t,163464,253110,,5000016,2018-01-30 13:45:00,2
0x3bd5bae6b97f7d453ad91da946ea27386ad0fa937bc6aacb2e379cf1d535f8e9,t,53047,306157,,5000016,2018-01-30 13:45:00,3
0xdd289c9cf2a729261dc66b7b5c735cc00200f01c6effee7242cbcb3b120f694a,t,21000,327157,,5000016,2018-01-30 13:45:00,4
0xe283d18c40fbbaba5e4f5c105b7a9dea9aa1024c84e07b734b55a485b6cdb603,t,21004,348161,,5000016,2018-01-30 13:45:00,5
0xc0555ffeb4866d38a7986a9e722722b7083c05abf601d4a8ddaab1a275b73b46,t,21000,369161,,5000016,2018-01-30 13:45:00,6
0x619917bdfb2b17f453569fa37a4102db03b962de3da814d7513adf90bbcf1f1e,t,21000,390161,,5000016,2018-01-30 13:45:00,7
0x59c78fe9f949f87f89d4e3dbce7c204424618a22407f721526b32160ce53281b,t,52886,443047,,5000016,2018-01-30 13:45:00,8
0xa7d5a75d019f40453d065a6223b5c7a60761d67920b7e06194a6788282f69ab8,t,253854,696901,0xaa018703dE2AC38B1230045eB147B59d5D3d43BB,5000016,2018-01-30 13:45:00,9
0xd6bbd782e0a45ab027478bb9016cf54298cf998bb631c4edc818f1d779188b11,t,53739,750640,,5000016,2018-01-30 13:45:00,10
0xea5a0a6167f70a21d737c81393709ec46f217e48710486b0d6a1656f41cb720d,t,21000,771640,,5000016,2018-01-30 13:45:00,11
0xead1af5af3810a989b9e19a4117e37fa44ebef54a92547aa81c5b14d516142e0,t,21000,792640,,5000016,2018-01-30 13:45:00,12
0x405c90f28924cea3961000d3ea20430540e1d98c796fd251b51ee6fb6e5ae7de,t,21000,813640,,5000016,2018-01-30 13:45:00,13
0xe4b202f1a197ba21ffe342da219ed07924a13516b0bf9db0364372bf921d45e6,t,21000,834640,,5000016,2018-01-30 13:45:00,14
0x07979071cb34900eeee9e0c1aa89e772651466967b2d0559c3a6189af67dee30,t,46095,880735,,5000016,2018-01-30 13:45:00,15
0x6fdcbb9352485b3157b180bf494a3075f8eebe6da25e6b98595ddffd9fa883d5,t,22900,903635,,5000016,2018-01-30 13:45:00,16
0x6959de2f8486396ff9290689d6d5df1597727b2b2e3bbba8173660995e12d094,t,161641,1065276,0xbF39f25461Cc212B08074F3108287C045028b62e,5000016,2018-01-30 13:45:00,17
0xaa986844214ea00f383c341b4a53c385b3066b34194774e8bf7008605658a053,t,102998,1168274,,5000016,2018-01-30 13:45:00,18
0xf9de902c39e32d95b1cf935fc1598a1394dcf631adaeec81fdd878e106c7dd8e,t,69312,1237586,,5000016,2018-01-30 13:45:00,19
0xf35b97091a0b92a2e9fc81cead223f38fcd29be9073b27db1bdadf7e02f3e270,t,21000,1258586,,5000016,2018-01-30 13:45:00,20
0x37dcada1c64fcdcf72ae9f505a196d6c86a996e8ecdb790ce4227f24e6b2206e,t,69361,1327947,,5000016,2018-01-30 13:45:00,21
0x5b335e908482bf86368c248be5edbaf7d1365f570b11b86a6c9ca750c0905151,t,132739,1460686,,5000016,2018-01-30 13:45:00,22
0xb9693d6ce58c354a7950105c02d4249abffbec012da110325167eed2b7b32244,t,84005,1544691,,5000016,2018-01-30 13:45:00,23
0xbce8a7bc1dac4d4c6c97f5c10a718a7b4524d5c1826dc90d67fdb1c035f4c710,t,98113,1642804,,5000016,2018-01-30 13:45:00,24
0xd7e563c8e156467ac70d537582b1446a4e6a3e678f8c765f231b7dcd6911d288,t,79985,1722789,,5000016,2018-01-30 13:45:00,25
0x3e9d541cf7c5a6d6505f4bda6eed9a55c20d7fe78b14cf08cc97a3729ab70827,t,21000,1743789,,5000016,2018-01-30 13:45:00,26
0x4d7848895aab11dab65208a296fa93928d35700f1f4476675577881da2244114,t,22900,1766689,,5000016,2018-01-30 13:45:00,27
0x954d40cc2457958fce8e1a19d89baf0f00d484f768e30e87d0d82b92ef9b0db1,t,21772,1788461,,5000016,2018-01-30 13:45:00,28
0x986bad506d3eadb49e0f71a5014ad14bc0673a959e1a55a367faa68c51845ffc,t,21000,1809461,,5000016,2018-01-30 13:45:00,29
0xaca6609c312088d14ca3a0f63ae546baaa09f78e3e87b89603a8905e94f00333,t,52185,1861646,,5000016,2018-01-30 13:45:00,30
0x7fe012428393ecaaaaf6a51cf80a3830042a4d934034bd108a28348d86beb33a,t,21000,1882646,,5000016,2018-01-30 13:45:00,31
0xf6751f25b98d9d374befe8359cf97a6e1750c4affe17f5fe1bf6146598dc9230,t,22233,1904879,,5000016,2018-01-30 13:45:00,32
0x7083bbfa089d71e72d2c476fad0cab76e41507ecb8124339c9b36bb112e12926,t,53780,1958659,,5000016,2018-01-30 13:45:00,33
0x4ac33febdb477c9ee6c1092fa093c0b32a5881c1e25763a5d74c34248f8eb950,f,21000,1979659,,5000016,2018-01-30 13:45:00,34
0xc94747547932bc579f39eac0db3a9f86095ad87ac9711fe75574957bd748aa96,t,96514,2076173,,5000016,2018-01-30 13:45:00,35
0x6cb77d3d2bdab12ce855875f776ac9703c973005fad4b12eae2a2dddb6707c2c,t,65281,2141454,,5000016,2018-01-30 13:45:00,36
0xb510bfaa268bc72cb38b9edf9bba7bdf6126d883ef71a0a06d257ecd87a4a4a1,t,21000,2162454,,5000016,2018-01-30 13:45:00,37
0xac4947a42d8612e2766ad99a5b815a88884a5409fab7c891b6f47bb88c72e363,t,21000,2183454,,5000016,2018-01-30 13:45:00,38
0x5879bc40b43659d6b3d4fdcb07dbaa04173742ae627bf94bdedd07c8184cf6d3,t,21000,2204454,,5000016,2018-01-30 13:45:00,39
0x3819099e8786bbb5c31fe9dfd0a8a299c5ecd56fe607ff1086de0d5259d95c6b,t,23812,2228266,,5000016,2018-01-30 13:45:00,40
0x30f8f350a13d3f721f4ca7a9c14270ad010dbd6986d74a54d48aebf1d324edf0,t,54005,2282271,,5000016,2018-01-30 13:45:00,41
0x7d98aa9c7748181769c32d417bad95f58bd928f45cf2ae7d1506000623bf3706,t,81253,2363524,,5000016,2018-01-30 13:45:00,42
0xe299c9698d36e7d257bc59781e706e224c72be0b1f72dd1282a1cd51a2a4fcd5,t,81253,2444777,,5000016,2018-01-30 13:45:00,43
0x3b614087f4cc89c9c844d434fdd30b178311c1bf0af4c69df2ac5ddee65d285e,t,21000,2465777,,5000016,2018-01-30 13:45:00,44
0xc40e6ec00a3ccc361e1b6c53f468e02db5bb781f5b300c7a28940fc8688e642d,f,250000,2715777,,5000016,2018-01-30 13:45:00,45
0x5d890404b89ad42c8adc87163db9d207ae2cea5620eefa43c5d2c1888170f3af,t,21000,2736777,,5000016,2018-01-30 13:45:00,46
0x82b0e83358875f5efaec82d57838a032aa90e5f676f09e544cfe78b2697a7cef,t,21000,2757777,,5000016,2018-01-30 13:45:00,47
0x3c077392e2c217a8b82cf5dd2daba456f11308f5b441ad52957f3c6d75c1e0bf,t,21000,2778777,,5000016,2018-01-30 13:45:00,48
0x6e15593295e43fafcc9a3f66e557b0ba75197ff82bcff9f1101b11e97054d27d,t,93508,2872285,,5000016,2018-01-30 13:45:00,49
0xefaab7a13be55516d5e7849c8f52591979cdd856bd40e21dd23c37bf2288dd17,t,49725,2922010,,5000016,2018-01-30 13:45:00,50
0x8453260519869fb1c44896666bc08345a63d26382436ce0d88612499a5246d9a,t,47738,2969748,,5000016,2018-01-30 13:45:00,51
0xfaa1d226579b8b3724158e992ea8b7b1fb6d997b92be8a64595fc9956ab7e7cc,t,21000,2990748,,5000016,2018-01-30 13:45:00,52
0xae0920b635ef797d2800c22f372e8fedc5cfe9f823b0d136e6c3ac2089482f2f,t,21000,3011748,,5000016,2018-01-30 13:45:00,53
0x5cfa6b36e9a945d44047b95d8249d9fa80f09a3734c5e90c15b21321ff3ddf1c,t,90117,3101865,,5000016,2018-01-30 13:45:00,54
0x9fa1a99515bb2c4811536faea35b7fb0205a112a3bc46cdb236d2eb0adaa053c,t,21000,3122865,,5000016,2018-01-30 13:45:00,55
0xcf7d6f699bb55be9e519ac2811d95c766bc048f28816015b289a14cb6686f0e5,t,21000,3143865,,5000016,2018-01-30 13:45:00,56
0xaef4a6d42677e74d48e13255ba86d651abedcfa8b501acc4963f9097ecda9955,t,21000,3164865,,5000016,2018-01-30 13:45:00,57
0xe0eaa2616b7219dde97fbfdab3e960c1b1a61c5ada3040999dcc830348fd2858,t,84005,3248870,,5000016,2018-01-30 13:45:00,58
0x83e1568e7791055c217dd401d7674fae196c8daecc3bf7bbe75cd139c75d3524,t,21000,3269870,,5000016,2018-01-30 13:45:00,59
0x44b4b3e6eb3b7bfb3b21a21fec61dbbbb97288cad047bbce5f833982094aad47,t,21000,3290870,,5000016,2018-01-30 13:45:00,60
0xacfbd6fab486190f264f0a6990f38565b61d18d587e244449866b739df4a7e6d,t,195059,3485929,,5000016,2018-01-30 13:45:00,61
0x768e4b85d4b23eba70e2bca422162cadad621b74b4b1bf36df04768ad78acf11,t,21000,3506929,,5000016,2018-01-30 13:45:00,62
0xbbac17e1f735246ebf9dd7650510c2fd589624ef6b8da4bffbaaacac2668d51b,f,21000,3527929,,5000016,2018-01-30 13:45:00,63
0x6d30e3a667d406f603df39d3fef9867aaa8cccc7ea9a7339b5d7fe2781fa9f75,t,66253,3594182,,5000016,2018-01-30 13:45:00,64
0x9d5a354896ccce6d1e4e77a0f42cfa0d7cf4e0cb4878a917de151fe8c5cd8d2e,t,51921,3646103,,5000016,2018-01-30 13:45:00,65
0xf20dc060cc00d02b1894dc06f7b41a289c1b52663bf20052ec8369dfff806a96,t,36389,3682492,,5000016,2018-01-30 13:45:00,66
0xb8d0301090576da35cc963e517c65829a328a72c5f2ed3f7b30f965d434a305b,t,44290,3726782,,5000016,2018-01-30 13:45:00,67
0xfd998611f8a117c7a7fedc0da0460f185689577a7c509fa4413896ef2695060a,t,21000,3747782,,5000016,2018-01-30 13:45:00,68
0xf54dd481d1ed85f6f442579fc0274c559f5ab2216f267de4a7376e9590aeb9fb,t,90729,3838511,,5000016,2018-01-30 13:45:00,69
0x0130b8ae26e2fbcaae888980f44b7b39a39f045195215321061b8017ddd8d7f8,t,273291,4111802,,5000016,2018-01-30 13:45:00,70
0xb42e8a96805f57eba6ceb0c60d9602f5e7fda52cbd8b3780f097ddef567fb324,t,71448,4183250,,5000016,2018-01-30 13:45:00,71
0xa65f7b6c50b13d98ecfbdb6a0c216333471db4e20be0293497ee619baa9d559d,t,96514,4279764,,5000016,2018-01-30 13:45:00,72
0xe92226746bdc8b99dd031ba7ec10bce89f210fecece9becb5dc38712eaff3892,t,52187,4331951,,5000016,2018-01-30 13:45:00,73
0x7e85c29ed27c68be817305a4a1510197738b2402b6dafa21dfbf670ec94a86be,t,133111,4465062,,5000016,2018-01-30 13:45:00,74
0x12554aa486ce6b72548f3182a5f304ecbfa67d849e10d05ea3d2a987ebcc7302,t,53027,4518089,,5000016,2018-01-30 13:45:00,75
0xae404dd749adceb91b6138c542f4b3bfa141fb62c21129cf5c6e83bdcda30962,t,37848,4555937,,5000016,2018-01-30 13:45:00,76
0xc91b7affd31e54c1348fb25693fd754e754a74b2d82f39e371f8857c760fe686,t,21000,4576937,,5000016,2018-01-30 13:45:00,77
0xc31b38e4d352a2ea73aef2793dcf4c3f907df0c944afd769eba96d7aa31e5fa2,t,21000,4597937,,5000016,2018-01-30 13:45:00,78
0xd6f3d6cb7bc4b432a5963d6dd2fafa6a892886668ca195d9707c2434c545ab2c,t,79985,4677922,,5000016,2018-01-30 13:45:00,79
0xb3c8add896f3fac0387844bccf90ff0625c481072ebede483428152ffd9728b5,t,52100,4730022,,5000016,2018-01-30 13:45:00,80
0x7ee3c8b00a6139b7b9bed2f098f7ec4e4ab3867676b52731916fce2369440a83,t,21000,4751022,,5000016,2018-01-30 13:45:00,81
0xbab4d34c5d3c5fb4ec92246a8d2ec15b95b8677fde5f1b2b65c50875901c11a4,t,96898,4847920,,5000016,2018-01-30 13:45:00,82
0x3abbebd9b1ee39f683301ed8f797e9aeaa301c58059c1a75f3f252b8dd9d021f,t,48601,4896521,,5000016,2018-01-30 13:45:00,83
0x937929635470dd5b4bf6a13127fa24dc2f34f682d35afd579f81f96ada907b17,t,62521,4959042,,5000016,2018-01-30 13:45:00,84
0x41c1e82ee4ab3752027387eb9b29bdb202699e34a2131bbd6c81f1bd3cbc1684,t,21000,4980042,,5000016,2018-01-30 13:45:00,85
0xc721b1b9503bd6392885358838844d334b941b99211caffc3792481adac3d237,t,52886,5032928,,5000016,2018-01-30 13:45:00,86
0xd5de9a8d2a81331b6ea4dce41dbb25752e925328942abdde8c57d8e585f47fd1,t,253854,5286782,0x05d0e5EA4d1A7Ff6A2d4b17344bc731D5BF021B0,5000016,2018-01-30 13:45:00,87
0x939cfbf977e5ba1d6bc753d3b177e798e64e5d8fbeec439d078aa5be8b04ad89,t,56043,5342825,,5000016,2018-01-30 13:45:00,88
0x13f2a8c1760b5cf34b64dc35ec12f8238ba481296efbe12e77b6226e55b5c3b6,t,309217,5652042,,5000016,2018-01-30 13:45:00,89
0xccd8bbcb1d451f2fe2c61547d9695c0133629afeb5702f2e179d5c28a57bd7de,t,54209,5706251,,5000016,2018-01-30 13:45:00,90
0xbd878f1191cf8f0d0e85d1f5fa5eee1ee23969ca69f08b0d6d96b861cbcadd89,t,90117,5796368,,5000016,2018-01-30 13:45:00,91
0xa98d31f433feeab10b11a5ce4aa3d3b3534ded417489e2c98832eec09842cc66,t,21000,5817368,,5000016,2018-01-30 13:45:00,92
0x4c7d19e3b0bda40a0cbbc308125b1366200e54bf3132878449fd2679bf45d7bf,t,23812,5841180,,5000016,2018-01-30 13:45:00,93
0x4d815f836e725a62dfa10694a73738abead5c79539060fc774dbbd8ebabc10c0,t,90729,5931909,,5000016,2018-01-30 13:45:00,94
0x514b766c9ead50199f487772da32eef2357d8d27fc2cdbce5ecac10693d9d9af,t,52886,5984795,,5000016,2018-01-30 13:45:00,95
0x20dddea34e01a1a063bcb9fba1447eecbe90d7d587f5e8a93b812602f5368b00,t,253854,6238649,0x30A36216f3b58cD421b80a50125686544Fb5d1f8,5000016,2018-01-30 13:45:00,96
0xebdfd30cedc98d67c74c2bc2795692934be973a121573d862df82e7073f75711,t,55915,6294564,,5000016,2018-01-30 13:45:00,97
0x773e3cb16f3d78907493f4befecdbeb3186eec37c3effb6fd586db55f9b72b42,t,90117,6384681,,5000016,2018-01-30 13:45:00,98
0x6c61b04bc656c2eda05da1dc10b8f78c7baec50c65be7955237d85f1975649d3,t,21000,6405681,,5000016,2018-01-30 13:45:00,99
0x6732ee01320439f7fe82643b101628cee4ce934d19399023b1a6ecab6759b78b,t,90729,6496410,,5000016,2018-01-30 13:45:00,100
0x1af57f383dbce8fd47d971b894b4293a1f388dabeba0503f496dcbe5c6b7e6da,t,52822,6549232,,5000016,2018-01-30 13:45:00,101
0x7affc2ba3084778c1aeb8d799d4b339615b4f566e8a89b6ad554214ba95c4f3a,t,253854,6803086,0xB4961B836F3e5429aC9012E54432272Efd7C129c,5000016,2018-01-30 13:45:00,102
0xc790bebb4bbac750b984f05067a8e6b7a692797933703eb66986eeabf396901a,t,90117,6893203,,5000016,2018-01-30 13:45:00,103
0x456809f21fbb09c7abceb82da4afa65df4c42d26936ade82fd3511745e0973bf,t,21000,6914203,,5000016,2018-01-30 13:45:00,104
0x54c4f652e5cae003a2c49e3723cbcb187417905edf7943fe4e4daaef9c8d8db3,t,90729,7004932,,5000016,2018-01-30 13:45:00,105
0x9618b12fdcd521c81b0d4cd0bd5dde8fdb28493ff4025989d2cd8d5424f01dbf,t,52886,7057818,,5000016,2018-01-30 13:45:00,106
0x0ead2b403dfd7d0cd78e0d115e664906e7242eb8184945b88ec460833526b280,t,90117,7147935,,5000016,2018-01-30 13:45:00,107
0x498bbc405a3c2ba84d08cc190413ea9571a9d0751d40ad157e4a43a515d7a2d6,t,90729,7238664,,5000016,2018-01-30 13:45:00,108
0x02aac7bbb381e449c5beb2a63209461a57ff4b1d534fb01b404ced734a1aecba,t,21000,7259664,,5000016,2018-01-30 13:45:00,109
0x8cb76ddc523dc08fdf90a4f82c0eaa8899d4f9fb59d16beef6bf87e0431e72dc,t,52886,7312550,,5000016,2018-01-30 13:45:00,110
0x52009a682eac1eafcde8cd88209f7ece353190e30065e8bd4c4361971eb679c8,t,90729,7403279,,5000016,2018-01-30 13:45:00,111
0x6a47be4fdca5aa6fb4d982c95c8f66ad1e880c229780a81f4532e6249465b9ce,t,90117,7493396,,5000016,2018-01-30 13:45:00,112
0x22536fb4364c515f9feac39ea3a6e739f80a8016f0771960b8571b5c51f61b8a,t,21000,7514396,,5000016,2018-01-30 13:45:00,113
0x74317a1e8b3dd8f1d47e46b4c2f6387da4780e23b98fe884c66f9c18d19b7e3e,t,52886,7567282,,5000016,2018-01-30 13:45:00,114
0x35572cca1b59c3240ff783b01d6349943030344acf45a3f617437712d451a3fb,t,21000,7588282,,5000016,2018-01-30 13:45:00,115
0x5adf84119f0ca8d9753a70919780eb1ae604d3fae1baa25fbdfd72bbad43113b,t,90117,7678399,,5000016,2018-01-30 13:45:00,116
0x6cdcf2573ce9de0b3a279e7aace2f325396bed813c67ca4b8a22d7bdca5d57ae,t,90729,7769128,,5000016,2018-01-30 13:45:00,117
0x9f673c4e796f4cb78c11374af8f2cbb3d299eaf0274778bdb93f17984997c1b9,t,52886,7822014,,5000016,2018-01-30 13:45:00,118
0xcaa3b45a9c49b538c37e5ed90a09685c0e60913ea0c84b2d0fca441a44e15dd5,t,90729,7912743,,5000016,2018-01-30 13:45:00,119
0x76c40717773eebafca1a3d716b43cd38c74fb8207d01ba865b042de9c41f7e3b,t,21000,21000,,5000017,2018-01-30 13:45:08,0
0xf3c04001295d7cc4acc3a37bb30fc0d578d77132154d34c919572b4d47b0448b,t,37292,58292,,5000017,2018-01-30 13:45:08,1
0x0450043333884fc45a6b4403344002d48e66d47902a18c884dca6b17df76dee4,t,21000,79292,,5000017,2018-01-30 13:45:08,2
0x3f901db5c8a66ab1b3357d0e7adb946a583360b6013025ab239fc04979cb7e31,t,52091,131383,,5000017,2018-01-30 13:45:08,3
0x43c1a236bf8c2e2fd5d09600397f5359b8bafaea5d2d317206ab04d40756ae04,t,21000,152383,,5000017,2018-01-30 13:45:08,4
0x6648557b0a03f561ab0708a833874813e25a12d86e478e8c8cc2d2f0ef7767b8,t,21000,173383,,5000017,2018-01-30 13:45:08,5
0x05e0b954348fea861de0bc6246dbd8b98c65ab0eb2cfcdcdfb5e312f6fde5d5b,t,21000,194383,,5000017,2018-01-30 13:45:08,6
0x4b6dc0f7a679ff9fdb6919c0107f428035a149f365cd46f4e17f2f503324ffed,t,21985,216368,,5000017,2018-01-30 13:45:08,7
0x6435dddce1352afb10df2f7ba15c917467470e6da4c7f75dc339a1bd22b193d4,t,21000,237368,,5000017,2018-01-30 13:45:08,8
0xbb2d549b0ae41cff01e8e4b6b300c23946ee3a60538e11b57387a92f28e96a0e,t,21000,258368,,5000017,2018-01-30 13:45:08,9
0x60a3feae1d780ee10a6c643bf27de5eeea65f60e3bf9b69a4a43de3d407d9fb6,t,52186,310554,,5000017,2018-01-30 13:45:08,10
0x7b9aab4b4e928e9b9a115d090dc8fe7a49f8bc0de07c6037ef241981139028c3,t,51545,362099,,5000017,2018-01-30 13:45:08,11
0xdcc54683fd49eba5081a02617615db81a36a7ded64963cc1a0b0addcbf704e41,t,21000,383099,,5000017,2018-01-30 13:45:08,12
0x0e15d4daf6480ebf08e3a2e687a2e07c2e0b56d7996d50a05a1f8549343b3703,t,21000,404099,,5000017,2018-01-30 13:45:08,13
0xd9dda34c965c7ca727a711f0697f211532c87d2fb15fabca04a15b3310374c23,t,43862,447961,,5000017,2018-01-30 13:45:08,14
0x3a67dee135bcdcd54c00e49c2c4c3c2ef40aa92b76227e715b0adaa3ae6cb661,t,37571,485532,,5000017,2018-01-30 13:45:08,15
0xaa8f8f1829fa09f893070afb845daa650789d08596b772c8dcc6cd1bd206d3b4,t,21000,506532,,5000017,2018-01-30 13:45:08,16
0x490f7a31dbdf2ce25df7985406d4b0c1d5917459cc03d5b5927e007f442ba24b,t,21000,527532,,5000017,2018-01-30 13:45:08,17
0xb7348aff51416a0ee53c9057dd7f30e4ec269b304f53db1006a8032df13fe57a,t,21000,548532,,5000017,2018-01-30 13:45:08,18
0x6cdbd599e34f6ca92fc6bf44b51f3534ddb320c6fd15bbff15fe03bb8c8f18ba,t,21000,569532,,5000017,2018-01-30 13:45:08,19
0x2bb56833ea2647d1969db06b1cf0e1d17f496500a95cd52b93cfef720b0631d8,t,21000,590532,,5000017,2018-01-30 13:45:08,20
0xe8d37e861b7c170aa920478f75c3a2d2ed1c48c03d86eabedca8595d23d03223,t,21000,611532,,5000017,2018-01-30 13:45:08,21
0x89ca804363ca6b69a0423c3c4da9b9f75453703e102689df3fa69b6ade2115ab,t,45921,657453,,5000017,2018-01-30 13:45:08,22
0x23ebac859cb82971cbd5603b60c776b123d4b49144be7a410945c75862998f44,t,64725,722178,,5000017,2018-01-30 13:45:08,23
0x5058202d925f7ca0d042f5c154a472a86f8afdbc5571d7105717e0614882d3bc,t,21826,744004,,5000017,2018-01-30 13:45:08,24
0x782d5d840a203d50cc4be7ab7d3f6dff9553a48da18452444236855099bf23d8,t,21000,765004,,5000017,2018-01-30 13:45:08,25
0x949af2d9a87ac1462613de2a96367437102110b5f075580aee91cce29bd5a401,t,39771,804775,,5000017,2018-01-30 13:45:08,26
0x828de55817f5c378c49fa1fe9147691d90b83a1a201632c856d4e1b300d52c3b,t,59290,864065,,5000017,2018-01-30 13:45:08,27
0x8aaae997d688fa3ec156601755568f02075372bbb3783f92ef0bd2d2e3790fe4,t,37155,901220,,5000017,2018-01-30 13:45:08,28
0x88b16174e7db90ce207be133279f066203fb8b8296152c5b3135627494743314,t,21000,922220,,5000017,2018-01-30 13:45:08,29
0xad4db0cf891c7a24778d23bef24507a155d7a8844cdeff8385c70794f0b05794,f,25200,947420,,5000017,2018-01-30 13:45:08,30
0xc0f772ed7f86a4b318f0bed7a983adfef375b9ab5e59bfef2e006d737db50065,t,21000,968420,,5000017,2018-01-30 13:45:08,31
0x50b1b6514ba7e19cdc907cc953a4d46399c3a864cade95f3b7c70edf51ec963a,t,21000,989420,,5000017,2018-01-30 13:45:08,32
0xad2da1d6e3cb60271b29b96713c1bb5ce59c96df8198c50c943475b45d46b469,t,21000,1010420,,5000017,2018-01-30 13:45:08,33
0xe5d55935b2c379c0552aeda3557c7ecbd891f6cab25450a44d32458b825ed1ca,t,21000,1031420,,5000017,2018-01-30 13:45:08,34
0x32e8ea928d43d3d0f37f61649834513a0a55ecf2cf52198c16fbc13680dfb368,t,21000,1052420,,5000017,2018-01-30 13:45:08,35
0x5b9c1fee6376b543f0a369fe3415675d32342cd9c34011a1d5092ba485e16bbb,t,142196,1194616,,5000017,2018-01-30 13:45:08,36
0xd79cec9a1687d280167bf7252147d544148b8b551c99b335981e535874c5ab71,t,51948,1246564,,5000017,2018-01-30 13:45:08,37
0xd491bfbf4c5924f6015ffcc3b3912e0a158892cb7b4547003b52d0e7359663d5,f,21000,1267564,,5000017,2018-01-30 13:45:08,38
0x6123f2e8d77a6d4a4eaa401b25692ac9b1c58eb944bd78c15209f09ebd286e3d,t,23844,1291408,,5000017,2018-01-30 13:45:08,39
0xbf74c6d4fbf9a2b96d2df3c4911489df477a2ed1b2ef73bf78e189d76c60a3cb,t,21000,1312408,,5000017,2018-01-30 13:45:08,40
0x8638da7b25497ee1fb11b259c227467c946b1ddb4c7105d8ca8430204e749d5f,t,66467,1378875,,5000017,2018-01-30 13:45:08,41
0x6972028046bafe6f5af8d7c2d128d3b5357a2645ba891903f51e971662ff152a,t,21000,1399875,,5000017,2018-01-30 13:45:08,42
0x6d5923b9a2a339f88d77dbd49d62cb43433f51cdcb2ac68e11091538bb1bf870,t,127547,1527422,,5000017,2018-01-30 13:45:08,43
0xce19e0b04b353961b1068bdff8aa26e7a58051f8adf67b1945f63677f4449fdd,t,51955,1579377,,5000017,2018-01-30 13:45:08,44
0xc089803b0c21a4ca4865e9f99feb19c95c4f4608753d8d1e61ddaa227c3db9eb,t,21000,1600377,,5000017,2018-01-30 13:45:08,45
0x4ba1d2f7e11186167effecbe0855b0ee97f11767ec9f8625e2663883aef211cf,t,21000,1621377,,5000017,2018-01-30 13:45:08,46
0xad29e7b1f501b8873aee66419203a0428ed5fda5b148078258929ce47511b87b,t,21000,1642377,,5000017,2018-01-30 13:45:08,47
0x78a94ed11a51b0c9bc77fd0db39b5f224337ef34f073cf0765731c86d93ddaaf,t,21000,1663377,,5000017,2018-01-30 13:45:08,48
0xad118f7033671862eea10089413b99a5e08f1b1a7e98635508d9c7b8f64e8370,t,44063,1707440,,5000017,2018-01-30 13:45:08,49
0xe2b1b472776264758ac85e3f56e4162bc54fb3e3ac4c9f553e185a9b155d74c4,t,21000,1728440,,5000017,2018-01-30 13:45:08,50
0xcd24241062975283fa46738ed20cb5b2d08144ddf5027293d3eb6046d97b446d,t,51712,1780152,,5000017,2018-01-30 13:45:08,51
0xc375ca374480c5f4e97909d09ba5e777f1a16e735a09f0953c379eb6f7b3ae76,t,52460,1832612,,5000017,2018-01-30 13:45:08,52
0x651a28acfd7365f4ae9f8792013c1052e5464fa5044db1e20a3a2d38cc73fb81,t,37571,1870183,,5000017,2018-01-30 13:45:08,53
0xb5161aab8df43ce7b59d923f30ce1421f646a56381ff62e12f0ff6d6a2094ee1,t,53313,1923496,,5000017,2018-01-30 13:45:08,54
0x88531a2e40f5f409a136302fb943af4fee55fd580fb206638cce53dbdef8d3eb,t,37380,1960876,,5000017,2018-01-30 13:45:08,55
0x240182e5f3487b24d1708e6a8ed988cb24dca95ebe3198318cdb0ee8c3588a36,t,21000,1981876,,5000017,2018-01-30 13:45:08,56
0x85d6f3f03a73643bd4387a4dbcfd67673707830bc3f4bbf358278c3c4030e414,t,21000,2002876,,5000017,2018-01-30 13:45:08,57
0xcee8e4c08b41f473ae555da79fad97b77f65db85b501a7dc382708288f49f4fa,t,21000,2023876,,5000017,2018-01-30 13:45:08,58
0x0daef632ad967a9b61521c661c4e48f3dfb46afe670a48d5ad70fbc500869a62,t,21000,2044876,,5000017,2018-01-30 13:45:08,59
0xc7ff9942b37f33c27a9fe5268b8a540ff7ebf7f973e7aeee7dca8329cd436ac7,t,22193,2067069,,5000017,2018-01-30 13:45:08,60
0xb865593d4a182cc6618b6762b4d1f30f1bffdd7e31b21a6ac09e9c62857b9e4f,t,37947,2105016,,5000017,2018-01-30 13:45:08,61
0x52b4d314608792003dcc8cbbc10d36b8c5d9e982413e4c224e2b1a81dfe61042,t,4679332,6784348,,5000017,2018-01-30 13:45:08,62
0xf186985b1e640dfdbd83525da1e2e26527b6ce3e2267e6296e114955bdf9caf7,t,180532,6964880,,5000017,2018-01-30 13:45:08,63
0x885a1db702b85f4c26d4284490b079d34b0494a2dc463e0cd8f344893dee0222,t,21000,6985880,,5000017,2018-01-30 13:45:08,64
0x92b63375df6a8b538e1f1a24aa72a03d343b1f3c0aedaabb20a6ac54d40f79cd,t,21000,7006880,,5000017,2018-01-30 13:45:08,65
0x6d65db1d29a3f36e666bcc77ac2dd1ee646df2c306b6b883a974724b5e4c1a32,t,52460,7059340,,5000017,2018-01-30 13:45:08,66
0x99e4e907071d867f9850027a27c0085477636750d7f6960af338b2c353c580af,t,21000,7080340,,5000017,2018-01-30 13:45:08,67
0x4fce32f6275aac9cca841182908ad88c43099a2d5af26c724aed2276e93fbd13,t,21989,7102329,,5000017,2018-01-30 13:45:08,68
0xbd886e6616b8fe0b2d48dc6441402ea5d584c83cba9b92789906fd9920246e8c,t,22173,7124502,,5000017,2018-01-30 13:45:08,69
0x4597815890edd43e6a749ce8fc9eecb997fac19b6d0024953f16b3b5b625d102,t,23318,7147820,,5000017,2018-01-30 13:45:08,70
0xa953b80026e99097f7cd95ced846fefc539fa8058a07f0c257f9ff5f096c350c,t,21000,7168820,,5000017,2018-01-30 13:45:08,71
0xbe27dbc5310791f405fc0f533b4ae00a3257eab69505bbd52cb2461a6d2b71aa,t,49436,7218256,,5000017,2018-01-30 13:45:08,72
0x3a0e4444a58791f38f2caeb2f4b352456816e0dac0020c3343e07bdf8245df9f,t,174591,7392847,,5000017,2018-01-30 13:45:08,73
0x43d8ec041f4332d2e824ab0e05f8ae2419cbe5133f80b4f43da163b601715470,t,22964,7415811,,5000017,2018-01-30 13:45:08,74
0xf23fe7a3e75e23acb888ab0766871a9ec2be5f03ab377f840cec5f4f305fc2bb,t,134404,7550215,,5000017,2018-01-30 13:45:08,75
0x79145dfd66d009dee91711c9a5d135f6edef78147ed81904d9826014e569c03c,t,135261,7685476,,5000017,2018-01-30 13:45:08,76
0xe3ff388af5615772f56dc04344ebdd563289567228bcbb94baf9013e2b75308a,t,132595,7818071,,5000017,2018-01-30 13:45:08,77
0x0a95b908d734937f3c30fcc38275314191693f885e2a836f8fc53b5cbbc54ef2,t,92730,7910801,,5000017,2018-01-30 13:45:08,78
0x8881ba70aa178dd46e66146d3b50d60f079c61dff027da81a7cc68d360b02069,t,22360,7933161,,5000017,2018-01-30 13:45:08,79
0xd378ef3d6e8caf64ed5e380c8634f8efcd83aef28c874f7fc037a949b644ebb3,t,21000,7954161,,5000017,2018-01-30 13:45:08,80
0x6fffbbff09ee02d6fefcac51e76fd59cd4121c59431870a7c6c1f21760ffd3a7,t,21560,7975721,,5000017,2018-01-30 13:45:08,81
0x5ffe7f7a68a3460ed71f9dedd9cfda4ff7da3f1bd9a59218beeb6fb180280632,t,21000,7996721,,5000017,2018-01-30 13:45:08,82
0xa43be7a8907f2bc7fc5743be6f24514c2e7dd005c8a294c8936d2a7e8f93c1a3,t,21000,21000,,5000018,2018-01-30 13:45:56,0
0xea90a8c9406b56ab17ce7fe7e46265b887437e6ca0b737675429fb3c936cbe1d,t,143081,164081,,5000018,2018-01-30 13:45:56,1
0xea1d62074c17fb8664bd191b0bce0d366d35f6683506c8ed7433928b8da92bfb,t,21000,185081,,5000018,2018-01-30 13:45:56,2
0xd41ef1984aac4dc5db9aa5b8fc4a36749aa15ebcfa85de2f7abf5ee7db03c51a,t,21000,206081,,5000018,2018-01-30 13:45:56,3
0x937a7c21561674abdf560855b98d518c1f8401b237373904a5503e12c86833a1,t,21000,227081,,5000018,2018-01-30 13:45:56,4
0x4b49564d9585c950b95db0f1258e6a4e314ca4293546ea422ebf2220c73b5b08,t,52711,279792,,5000018,2018-01-30 13:45:56,5
0x30f6645629dfac1254886dbf9580094c9285c03f16454c1ac17e73865477b566,t,52112,331904,,5000018,2018-01-30 13:45:56,6
0x7322e519fe47ba4d0ac566031bb2f5307fbc1ebe6f08de336eb52b788be6a23e,t,21000,352904,,5000018,2018-01-30 13:45:56,7
0xdf41ef25d9d5cfb1da5f9374d03e0e8a85d7cb2b1cef5b744eda24ed0de70186,t,21000,373904,,5000018,2018-01-30 13:45:56,8
0x078a666efe392a2f9cbc858b5c6cd8a605b770c103ff0171d9673546bd34ba9a,t,52155,426059,,5000018,2018-01-30 13:45:56,9
0xc6c7a6aee7317a5332c06268cea606a82ebee1aa6b3876d24a9617b83ea1d17a,t,21000,447059,,5000018,2018-01-30 13:45:56,10
0xa0aec10cfdc98db54f788c88af8f95faaac4a8f2fc07eef725498a8cd11869bd,t,21000,468059,,5000018,2018-01-30 13:45:56,11
0x842b68a5f71d7caf709d67e1d7761a876d6d49edbd372ab30d47c41df2ba4cd9,t,37907,505966,,5000018,2018-01-30 13:45:56,12
0xbd4edae6054a9625d33d272655ec25aa07172eaff567f26a7fcea25ac248b1e4,t,102934,608900,,5000018,2018-01-30 13:45:56,13
0x30e0ba981546067e970b841edeb21676d9aaba527e79d729667ebabdb85a826c,t,21000,629900,,5000018,2018-01-30 13:45:56,14
0x94277d370ede29c15ce3dbbbd6d631d7a435cfc209081ad635758a41b98c4719,t,21000,650900,,5000018,2018-01-30 13:45:56,15
0x05da92ff610b93abccb54bf05c7b21e608d42529ddcc67fffb6e860f02f4fc66,t,21000,671900,,5000018,2018-01-30 13:45:56,16
0x52cc131830ff3ae3ea1a5a2eaae37d3190b390a5937da6d854a0d8c198001ca4,t,34470,706370,,5000018,2018-01-30 13:45:56,17
0xfd66384d73511701573ff5fcfa95401e4128b59214ee09c8602fd8e900e65de5,t,34470,740840,,5000018,2018-01-30 13:45:56,18
0x1e8dda0b08769b8cbb12349ff84e406e47d167b086b340f164023c6357f768a1,t,34470,775310,,5000018,2018-01-30 13:45:56,19
0xbe02e3ec0ad5f7cae7e4431fe1c3ca2bb2c2014c97e7b284317f0c8469f20822,t,34470,809780,,5000018,2018-01-30 13:45:56,20
0xce0fff878ce15e4d6850aa23783b5619bb763a74e290eeb960c30498d260e71a,t,34470,844250,,5000018,2018-01-30 13:45:56,21
0xe4e8aee9ddb98a04f3572ab51f6d24c8222f3318ba953c73e7a4b55a00ec38ec,t,34470,878720,,5000018,2018-01-30 13:45:56,22
0x8a66859035f8f361daddb01484fa7023be224151e8483898de7f06876bca839e,t,21000,899720,,5000018,2018-01-30 13:45:56,23
0xa40721e2218915f9369de0f4643f3ee1b4e10961f8fd37dcef4e865e2b42e013,f,80300,980020,,5000018,2018-01-30 13:45:56,24
0x70c2342db54717c0e6808f36e8c3f77643d0c7c77d85a1d01da7425863626e35,t,21000,1001020,,5000018,2018-01-30 13:45:56,25
0xf6e926360bafbc5d5b311ab888e4cc125018b79f8d325cda3a1ce2571d22afae,t,21000,1022020,,5000018,2018-01-30 13:45:56,26
0xaa8772c32cb37617109e83317d95870f6577c2308ce7be45a61f9f1bf5f6e2b3,t,21000,1043020,,5000018,2018-01-30 13:45:56,27
0x878593e4419c0382ca016d0d3035cf02c6fa19a6a169f3acc2cda585198d9f2f,t,21000,1064020,,5000018,2018-01-30 13:45:56,28
0x2b6f0f000c9f7478a5b673e645306201046245da320e6eb6a81ef9c742bc74db,t,21000,1085020,,5000018,2018-01-30 13:45:56,29
0xf98d4931f54f1ee4f1c835fd57e707457b81ca43f967381ae9757f57ad75f967,t,103563,1188583,,5000018,2018-01-30 13:45:56,30
0xf286134c7b308a8e3812d827ca0a2e83dd81fe3892d74b9e1af01104e7282b81,t,98450,1287033,,5000018,2018-01-30 13:45:56,31
0x3b994cb29086816a3ca8d0a86011911b5af25d16469258cdb82bebb635254796,t,29732,1316765,,5000018,2018-01-30 13:45:56,32
0x47cdca45371a94c2d9634edd1b8f566c19d87ab8921811619c995e3341a13ac2,t,21000,1337765,,5000018,2018-01-30 13:45:56,33
0x47a6f450e15bf0d144e46aff77566d2b54556f22d44e68b501310fd8e93f6eeb,t,21000,1358765,,5000018,2018-01-30 13:45:56,34
0xb1433f169acfd44a6df66f5fd91313d79971e6750012c4d75d0a548da6e526ca,f,51000,1409765,,5000018,2018-01-30 13:45:56,35
0x3da2653c41466ff9d4a3ba02c3f631ed6fe301e258f1f038f9a0a2d752dd50c1,t,23176,1432941,,5000018,2018-01-30 13:45:56,36
0xbd7489b7799c9e1358ee1fa959fb18810d39d966a5ad597b498a629372014067,t,108242,1541183,,5000018,2018-01-30 13:45:56,37
0x86d2682ee58919a0922ffcff55f9d8c2e4881469045c27692bc646fa425d0477,t,21000,1562183,,5000018,2018-01-30 13:45:56,38
0x5848cbf323b5771022e3a80511945ab913fa5486ab81f6eefeebf6e20315c47f,t,21000,1583183,,5000018,2018-01-30 13:45:56,39
0x923c70dc880274ce6452f3c03c612599048356a327a97758e729dc241bd55871,t,21000,1604183,,5000018,2018-01-30 13:45:56,40
0x0c17f20f3ef2805b9a2fca35fa590ef325fade74870f98c24256da9b5038d688,t,52352,1656535,,5000018,2018-01-30 13:45:56,41
0x742636f96b62a0fc731143983ddeed986871554da46b99bf5ef97bacea6e6fcb,t,21000,1677535,,5000018,2018-01-30 13:45:56,42
0xbb151e96f2e2386feb7183bf7a09b10713045226c8988977a31e412ea2cf118c,t,21000,1698535,,5000018,2018-01-30 13:45:56,43
0xe591e553ba85f82b5f28c0758fa1e8b91a5f05816707a705243b98022a1305ac,t,21000,1719535,,5000018,2018-01-30 13:45:56,44
0x54d4b16edfd7e5400a749363f187024981393dbffb853d10bf0b5260ac6ce61d,t,21000,1740535,,5000018,2018-01-30 13:45:56,45
0x3eee338c4b25e593c286540fe1cbf288d1a479a72c6a4dd19118987f80195044,t,28002,1768537,,5000018,2018-01-30 13:45:56,46
0xe76f6d73537c07b1d4103a913249ff7ee758a1ccbb102215902e1308880523bb,t,22496,1791033,,5000018,2018-01-30 13:45:56,47
0xab67e31367c8f85c16336f3423dbd75cf84f488386d2b821507857138900f8ef,t,41337,1832370,,5000018,2018-01-30 13:45:56,48
0xe8fe91a370a13f79be04c60bcf92812f7b7f53c25678057b06e1add703d573bb,t,52191,1884561,,5000018,2018-01-30 13:45:56,49
0x9b41212dcffdeeb7c31de80525c48e72f876aa7f34b00fa791e2241adb506565,f,21000,1905561,,5000018,2018-01-30 13:45:56,50
0x46467b442494f89b64891e5c4a0a1c8981662c99c06c52164b9714d4f0adb601,t,24574,1930135,,5000018,2018-01-30 13:45:56,51
0xa629e1796512d70c5cb3807b70ba6abceb6a7c032a46e5550acf903b809bee45,t,21000,1951135,,5000018,2018-01-30 13:45:56,52
0x30e6aea8da9661d4e6446e8d7294ed487a918cf76b3684187ff621d1d3829719,t,104678,2055813,,5000018,2018-01-30 13:45:56,53
0x1ff3916a357e544c798f3a839618988811b804430c05f92c55e92d5512118fbe,t,28194,2084007,,5000018,2018-01-30 13:45:56,54
0x0bad51a8f1ac7985534db7460f835e42b95bd28de2761f2c18bfc5a425ce0a94,t,21000,2105007,,5000018,2018-01-30 13:45:56,55
0x51ff5cc8a28d4d9443012570422899949db829a03a3cc5574e4eb9ac0ae55309,t,21000,2126007,,5000018,2018-01-30 13:45:56,56
0x1ab973cf58d7f65c3cb91e83dcd9242c2e893d927c2480e9affac2ee86f39ed7,t,63723,2189730,,5000018,2018-01-30 13:45:56,57
0x83d55454eaea2b596ade25e2a8e34af2bad289c6685789f683d052b9f51549e0,t,21000,2210730,,5000018,2018-01-30 13:45:56,58
0x77a2f3032834890de0f5acf0604f8b31a9ec00a7e76e4cd7d17b53939763dc06,t,176885,2387615,,5000018,2018-01-30 13:45:56,59
0x747a6ec54bdc1321a7f36c45daccc4d0989a5343f308691f1a1cd15ff69643c9,t,21000,2408615,,5000018,2018-01-30 13:45:56,60
0x893d5cf0e255add3db0790109aed0560782e83f118b68e75901548edd28a2d8f,t,55907,2464522,,5000018,2018-01-30 13:45:56,61
0x754e9108abef9e6a81e34689766fbfca1628c41e4b968d324fc1e3a7d2458c59,t,68887,2533409,,5000018,2018-01-30 13:45:56,62
0x4d164d092f97264247561a5565394add9372f4f250aaa4de3da350643a29ebc7,t,21000,2554409,,5000018,2018-01-30 13:45:56,63
0xec9037d023d9235c3f46f5f4e842acacd58fb28a29496967bc9f00f5c4354e9e,t,21000,2575409,,5000018,2018-01-30 13:45:56,64
0x1b4f1f3ce0cfafd052332af434fd70aacb8e2f0726353e73f07ca4385247a7ae,t,21000,2596409,,5000018,2018-01-30 13:45:56,65
0x827bb7734da7d817bbaf4335b14e47d76da317c45207fbc2db8db3f74aec17cb,t,21000,2617409,,5000018,2018-01-30 13:45:56,66
0xba8ceb938d6a97c0dd24b6fdf9c7e42e61af0a19c50ad17de0f675f8c9bd8cb9,t,30921,2648330,,5000018,2018-01-30 13:45:56,67
0xe9d1ab4ed7443ff6c7768cc078d4f778e5e7f4d97aab4a0eb7fc7220aeac5709,t,21000,2669330,,5000018,2018-01-30 13:45:56,68
0xea2038b311f552ad84bdacf2beb55358b50fd833f9f0175536dfdea97484626c,t,21000,2690330,,5000018,2018-01-30 13:45:56,69
0x4a09246b27daf2f2ae87cc1e4470533c8bdf1f9ed5963f93eca27d918ea8f5db,t,21000,2711330,,5000018,2018-01-30 13:45:56,70
0xbd6330e2bdf2052212c0d29555c0d18bad24d0e047fe3b6181125a3c32be8e13,t,52337,2763667,,5000018,2018-01-30 13:45:56,71
0x6110adb97bedb9b9a218a55c70eb65f5624a53c1966b60513032101a252693c2,t,21004,2784671,,5000018,2018-01-30 13:45:56,72
0x13ee9117786f1f79eea948940d382d01921aca9b54fcd7361175fd37f0e9f3eb,t,21004,2805675,,5000018,2018-01-30 13:45:56,73
0x806f382f1ae8124f6f2ed9848cc08f279a201576e0e1d3077dad36ce235f50df,t,40540,2846215,,5000018,2018-01-30 13:45:56,74
0x3765f7b74e39666c46ba9364139e1ee827bcee52ec2eb565b802e130887a0381,t,21004,2867219,,5000018,2018-01-30 13:45:56,75
0x9005ab3df9bf4943feda523733f4b49af505a60eb973d7b75c2018b310e2665c,t,28623,2895842,,5000018,2018-01-30 13:45:56,76
0x34cca44ab63b225bab139417c284ba873cbaf19a90313898b5d2d8898319fd27,t,21004,2916846,,5000018,2018-01-30 13:45:56,77
0x39921b9f8c8b9bb3dc7b2350e8356e20454df4ec72b750f72a4563e32bc61dcc,t,21000,2937846,,5000018,2018-01-30 13:45:56,78
0x569f46abd657b0531eed40b62cbaf604760ca4b622ac54e29b295bc0580b2ef0,t,21000,2958846,,5000018,2018-01-30 13:45:56,79
0xb58bd30d7ece8bfaaaff6876149209f7e9bf14db199fe7b946e781bfaa52ff2d,t,48240,3007086,,5000018,2018-01-30 13:45:56,80
0x293e8b2cf551078dd2dc2195fe72cf86bafd6395fbecde17d7336dd155491608,t,21004,3028090,,5000018,2018-01-30 13:45:56,81
0x926a95555467ad324e43ddd369c55fcfd51f3c3bd53b4d43083696e8b7fc9691,f,24423,3052513,,5000018,2018-01-30 13:45:56,82
0x559e8dbd72b59dae0519391f4d4b964be15529011e4b7b6e6038dab048c1f097,t,21000,3073513,,5000018,2018-01-30 13:45:56,83
0x14d23c99f1b204ad85fef2559784486256a415261017234ba0cc6b90aa9b493c,t,21000,3094513,,5000018,2018-01-30 13:45:56,84
0x0dfda436257230b4421c92e91ddc9f48c20e900b9c04e69cbc40f2e2faec1bd5,t,38233,3132746,,5000018,2018-01-30 13:45:56,85
0x50278d23151b075823511a8f823c4450c465cd688e1c5e71ca2e88d3b537f1db,t,45988,3178734,,5000018,2018-01-30 13:45:56,86
0xae390b5fec8d0f3f1a1e2038721221a1442e18f573958e7ca6a25a6c7f3c1219,t,59418,3238152,,5000018,2018-01-30 13:45:56,87
0x0dfc0ef521153cb720e39202e45b9730a21693757ba0c19d10f68f3871e202ed,t,102934,3341086,,5000018,2018-01-30 13:45:56,88
0x39f18f69d590b3ca8829beb7c2a8fd9a5dd5a6b189cb5da5478455eefe703884,f,40000,3381086,,5000018,2018-01-30 13:45:56,89
0x33e78842c4963ed7291644d70e01a0f651053159adb642da852e85ce7ad5a946,t,21000,3402086,,5000018,2018-01-30 13:45:56,90
0xaa41ad434452ddcbc11d6f64a05e2e69c3fbc53f79b7c373164b106505e6495a,t,94521,3496607,,5000018,2018-01-30 13:45:56,91
0xd68371d9abb05c9432cee709c0f48b2f36dc9e87306f926defbe790dd1f17bf8,t,21000,3517607,,5000018,2018-01-30 13:45:56,92
0xa74e3399ddcb7a15b75c72fccc156f022626d571b9ef5abf0ae29aebe74d6d11,t,21000,3538607,,5000018,2018-01-30 13:45:56,93
0xe61f65c454ca49733c01d9b40a1c2cff14dc09ffcb00faeded5bfb44dacd1eea,t,21000,3559607,,5000018,2018-01-30 13:45:56,94
0x23530bd814ae57ea9ccfc0b33815863f4c7705030448db85032e52d84171634c,t,21000,3580607,,5000018,2018-01-30 13:45:56,95
0x09f082613d9e22a4be4902a74898c579b10a7c45a0ce3bb7e30823a40bd703d2,t,21000,3601607,,5000018,2018-01-30 13:45:56,96
0x4dc62b5efe33c773ee9c8c2585ad97f1f57b0805ea61363e0054813b77558d3f,t,21000,3622607,,5000018,2018-01-30 13:45:56,97
0x08cb6573f536f7ecaa2929d0266bdaead81524255a685d0302cbda4d776a3f04,t,21000,3643607,,5000018,2018-01-30 13:45:56,98
0xd06bf859a55a127b850853d657450743cfbcff12cadbb60987bf6a168ef4d348,t,21000,3664607,,5000018,2018-01-30 13:45:56,99
0x34a692d69e9d4bd617f2dad5b905f19bf7be9882491552b98090b7fbf77786bf,t,21000,3685607,,5000018,2018-01-30 13:45:56,100
0x7a4146afafcb2c18aa307fb55de99e45610ddbd9b9a272b1a8160486816cc71d,t,21000,3706607,,5000018,2018-01-30 13:45:56,101
0x11761746a2205391a004395c7b821beddfd1f27cbedb866231a05b125305e97c,t,21000,3727607,,5000018,2018-01-30 13:45:56,102
0x84812625574c1699d9b1a0652dcec716afb8eff08a5c9a936694fd20a759e466,t,21000,3748607,,5000018,2018-01-30 13:45:56,103
0x9833b5359d9fe43fa6a632a20892e2c8beaf2ada4ba1f5ddeb18b8f4f4d1c9d5,t,21000,3769607,,5000018,2018-01-30 13:45:56,104
0x33a7078b027216a1bc810f870e458481a56c776e217597fdbaed3f73178b6eb9,t,21000,3790607,,5000018,2018-01-30 13:45:56,105
0x64e404790372c917d46d63c232137cbe570248bae27a7058ae1f45bd93c9a45e,t,21000,3811607,,5000018,2018-01-30 13:45:56,106
0xed8604acd108dfd952dc16b796044bd6ba55bc99c72d5e839779c3660b4c5fdf,t,21000,3832607,,5000018,2018-01-30 13:45:56,107
0x5b0319abd4109c462ffce0a5a76e3d9db5f4058bafcc520060523a1e2d5f0458,t,21000,3853607,,5000018,2018-01-30 13:45:56,108
0x8587f9b5f083f0d3255f58dd12bb260ac840da01bec07f7a09fdc0505034fc59,t,21000,3874607,,5000018,2018-01-30 13:45:56,109
0x53f05949ad69317d5d8e8ce92796ff3c87aff9dd29a65f5805ae0ecc23e35df2,t,21000,3895607,,5000018,2018-01-30 13:45:56,110
0xd3a1478b3a81d0639a5c02df8c1fa00adaf0b200e43eefec41b2be7990a544c2,t,62759,3958366,,5000018,2018-01-30 13:45:56,111
0xaf8ad8d00bf3b7462718ee8612e4764aad5c5b6513c40493521b351b17cd42f3,t,91794,4050160,,5000018,2018-01-30 13:45:56,112
0x5d253b0ec13d8bfae2a6183e0c7dc1bd72bfc0671c89de61d8bdd693c5be41ae,t,37129,4087289,,5000018,2018-01-30 13:45:56,113
0x9406b68f29346c480f8fbe3354e4c83f5993b6b15753f4f3a0257ee7e3ef9e20,t,52455,4139744,,5000018,2018-01-30 13:45:56,114
0x98e66f6dd69dea7b9255e6d16feb816c498415337ccf415609c3578ca46fd685,t,53104,4192848,,5000018,2018-01-30 13:45:56,115
0x43c1166382a31607876d4d05e7645e56b8ffbfc22bdfbae0b3b2eaa315384ead,t,51752,4244600,,5000018,2018-01-30 13:45:56,116
0x996c720f6ebcc440c4d786b877d9f2427a4e151893a2b908a04dd8d30969712c,t,55843,4300443,,5000018,2018-01-30 13:45:56,117
0x24a9486ae37b1e50b31759c8bb9dbc06e4546f0d5635e2f45cd28f4709c85f07,t,37380,4337823,,5000018,2018-01-30 13:45:56,118
0x0a501b718e2e37f285a5f92ece5cf6ecf09af72c39d9364e998ae75dbf6d67da,t,55843,4393666,,5000018,2018-01-30 13:45:56,119
0xe5dc68d7861cd14f3346678b559e445a4ec18d5dd7166e2150453089daf42adf,t,55779,4449445,,5000018,2018-01-30 13:45:56,120
0x58c31134421a56d1fb84bde9cc63f426b37382a6527e81b625c353d5502c1d83,t,51606,4501051,,5000018,2018-01-30 13:45:56,121
0x9bfd17239af58dcd36575cf8fc61558d2247052da2c38c115056e6df422f9efc,t,21000,4522051,,5000018,2018-01-30 13:45:56,122
0x45c0c6569bd3e0999533188c1e5b2ee62f2e2580049739db5e40af689770afc1,t,21000,4543051,,5000018,2018-01-30 13:45:56,123
0x76a7e0a9455cb4863ce456a18483013870b8ac15a112b139288e8b98ef8ccb32,t,21000,4564051,,5000018,2018-01-30 13:45:56,124
0x9264b140747800fe722bc7287d9bc3a8c6b5e65e0cafde5ebdeb560954efb129,t,52886,4616937,,5000018,2018-01-30 13:45:56,125
0x6e2fe0cd43702777693a7bacbd906f81a1e7e4776c55a083921ff5d8bd1f7339,t,30011,4646948,,5000018,2018-01-30 13:45:56,126
0xd408a2792dbe6a350155e58022c8c9cbd27339768ec959877645748e51e04bdf,t,21000,4667948,,5000018,2018-01-30 13:45:56,127
0xd485e28a0ed9d9f202bbd0623c0c05641710e1d9cd83c56187d179a557292a71,t,102934,4770882,,5000018,2018-01-30 13:45:56,128
0xe8b6dddbca5b47965bb2343797e4c6a6703923ffdd3b8da9ecf807123efb4eee,t,21000,4791882,,5000018,2018-01-30 13:45:56,129
0xaf8eb4d6a82801c29f2fb73a770d7af39cceae1e1b10a9ed14b393d536c90713,t,21000,4812882,,5000018,2018-01-30 13:45:56,130
0xee75c63e6c38c3f7d21dd3d1d27cb65ca733584294d2f2240057d9393cf7b540,t,244829,5057711,,5000018,2018-01-30 13:45:56,131
0x88e7f226de16e8b5a68fc0c438e2c348ce77287aec9f473032009d163bab3a2b,t,21000,5078711,,5000018,2018-01-30 13:45:56,132
0xc378254f2d1c2a2a1e611c8720e759036ebbbe9e653dbaffece74bee38f71466,t,92434,5171145,,5000018,2018-01-30 13:45:56,133
0x280473723ac2cdf57dac3b827832b434313c9287a7f7cf25025bf26150e3dd6f,t,94920,5266065,,5000018,2018-01-30 13:45:56,134
0xe8ee3e4c5aba03ec0da9b3c35d632be2a115e51de382316e4375e3144bd90a0b,t,21000,5287065,,5000018,2018-01-30 13:45:56,135
0xf622aaa5dffdcb9e04ec1a77cffdbc57086a7e77a6b023c88361e8a7a6e858b4,t,21000,5308065,,5000018,2018-01-30 13:45:56,136
0x534d3782a5bcab51851bca90d27762013ef7bcc790ebba07739e4cbe2fde6a60,t,36792,5344857,,5000018,2018-01-30 13:45:56,137
0xf3c7e6282d27ab05df0e80827a8f5ec8110439be0fc0dcaed715f4ef87a503e7,t,21000,5365857,,5000018,2018-01-30 13:45:56,138
0x1590b5acb02233d93ba6381915494247a2c250245d005438fd89a26f87d8b08e,t,21000,5386857,,5000018,2018-01-30 13:45:56,139
0xf035dfefabecb02b572860edcca57f972380233671a4d9861d472b823240e2ec,t,21000,5407857,,5000018,2018-01-30 13:45:56,140
0x0a032d437efaea8ef2139643f10068d93e9395fea2ed889f27ab5361333a41ca,t,21000,5428857,,5000018,2018-01-30 13:45:56,141
0xad300281a0f82de0079b8acfe8f253e2ab7066e55aa9d8ca1c6c1271aed7f557,t,76670,5505527,,5000018,2018-01-30 13:45:56,142
0x919333bec98ed207742eaf5740eb4da4ce0ed0ba64ce10368484ce554d7a0b2a,t,21000,5526527,,5000018,2018-01-30 13:45:56,143
0xb56dd3b20aaf2a6ad1579fae9403c36c0fd074991a9b8425f257b825bdbc720d,t,21000,5547527,,5000018,2018-01-30 13:45:56,144
0x49121c2eb2850da8d9025d74427ae7c098766dab0dde799b11a6bf2f16e30bd7,t,74127,5621654,,5000018,2018-01-30 13:45:56,145
0x4b5988403fb89fc7ac0206ff2b52dd5fb3d506b8ba9c27f25c7d11ebff62836e,t,21000,5642654,,5000018,2018-01-30 13:45:56,146
0x129f716dc42b88b5176068fdac71f3756df2e142c4c9f915c8beff8ed8276634,f,30000,5672654,,5000018,2018-01-30 13:45:56,147
0x2a80c21f5999cca02253625aa83f96d6316821c410456ee21c79cb66e6f974fc,t,21000,5693654,,5000018,2018-01-30 13:45:56,148
0x8b1a23870b5299450eca1c7310ec28c8b7268a4f209286fbdccf372659b2a71a,t,38005,5731659,,5000018,2018-01-30 13:45:56,149
0x164f75ca7bc193aa0b72339ccd6cd1305b9897684b8531bf07bc9474953bdeb1,t,55843,5787502,,5000018,2018-01-30 13:45:56,150
0x8c1ed6db396fb4c63c9532616c2fbd7643086cc2d49e41a4d18ac3149ae5a283,t,21000,5808502,,5000018,2018-01-30 13:45:56,151
0xaa95a546646301ecbcc42238f6118643451a1c7a261431d10739cb589b65e672,t,21000,5829502,,5000018,2018-01-30 13:45:56,152
0x76ed2fcda6bf375837825c71f7830a72e25391a845e124d0924b5b4c5146189c,t,21000,5850502,,5000018,2018-01-30 13:45:56,153
0x513d5982a6481ba822ec9c865d8de149e403316cfd531ca6c952917ab8dd56a9,t,21000,5871502,,5000018,2018-01-30 13:45:56,154
0x4354d0be390a4c1e501ec120397ab09e3cba333aa42272ab81a3a102cde93a89,t,1012484,6883986,0x8aae6B0d6541Acf25ccAf580b8cDC9D0d4741B1b,5000018,2018-01-30 13:45:56,155
0xbb0698afcc72cf35499db63b9c2447b5f389f1b1fb6ec70e10810ef9ab314972,t,21000,6904986,,5000018,2018-01-30 13:45:56,156
0x98ce9b86fe55d03b56850042dc809ba2255401ec231a2d46d677d673f63452b5,t,21000,6925986,,5000018,2018-01-30 13:45:56,157
0xa0bbede845dd2aaa94dfc9120f0eb342c0395187412aae7ae66cf1e7d87f6123,t,21000,6946986,,5000018,2018-01-30 13:45:56,158
0xe4c38c1e82a610307fa2c0d04670911f5013dae4cc59a976d7223f4333ca1cdd,t,21000,6967986,,5000018,2018-01-30 13:45:56,159
0xa405f51493c814e42b54728f492556df016f8d31b6e91596241d75c90f49bd41,t,21000,6988986,,5000018,2018-01-30 13:45:56,160
0x070aed1bc264f7f16ebe948fc6331432a1cb8f81d23537d034f787831aed1af4,t,21000,7009986,,5000018,2018-01-30 13:45:56,161
0xf1bd28219ce159e65715a2ec5d9af404badacca2b45092a0256cc331aa03a8a0,t,21000,7030986,,5000018,2018-01-30 13:45:56,162
0xeb677ca681e71ee2574033d2b8492a15f34d5942486b40e79718fd723eb5e3b1,f,24000,7054986,,5000018,2018-01-30 13:45:56,163
0xc09bfaf029195cc7dbea4fd8ef87181a3156bbf26b32170cc1853a2334c59f3d,t,21000,7075986,,5000018,2018-01-30 13:45:56,164
0xf5c40a800800fc4dad0960c9497e57edadc636ad2e68413b168728a74aaafd3a,t,21000,7096986,,5000018,2018-01-30 13:45:56,165
0xa17e28cb6854d188c31f78ba60075a688d80e33e5da4999d2a19aca7f7a43bd9,t,21000,7117986,,5000018,2018-01-30 13:45:56,166
0xe30d10a46589a2376be903ffbb2d54fea06a132c2d950345bac37f5bbc40a673,t,21000,7138986,,5000018,2018-01-30 13:45:56,167
0xdbb568a5236864b7c5ebeb8214dafff8b9b7b75fc18141802e04268f2da18d3d,t,21000,7159986,,5000018,2018-01-30 13:45:56,168
0x98e3a8cc28b70d4511939ba7d54d00285abd8f699b772c591a1b086f5e75046a,t,21000,7180986,,5000018,2018-01-30 13:45:56,169
0xab0fcb585d8d39b9402daaa080b22a40a5f9265aa4fac0dbc13fffbd7353aeaa,t,36618,7217604,,5000018,2018-01-30 13:45:56,170
0xd8c2c70b21fca2742733fa110f4ab3ee9bb33b79b9e8fa348c6013e35977b769,t,21000,7238604,,5000018,2018-01-30 13:45:56,171
0xf5372b0b02318a5c3ea9d191a2477b486d5fedeb6b117c710556fb72571aea03,t,21000,7259604,,5000018,2018-01-30 13:45:56,172
0x295fa899d733843381182751930d7b06270fd364ae4f5f9668d01c3c58d66c7b,t,21000,7280604,,5000018,2018-01-30 13:45:56,173
0x9a3f974a169e302690ace67ab8f15b12e7f84063466d332b317202cb4ca4ebd8,t,52884,7333488,,5000018,2018-01-30 13:45:56,174
0x5440a190ba69329c01e63dbd1401d4b58d61595bc87640e5bdaa29070b3753d9,t,21000,7354488,,5000018,2018-01-30 13:45:56,175
0xcdd1df0f11be84b7adca0dc8e5eddb803120bc12d384dbc9923ef7aad17077cf,t,37884,7392372,,5000018,2018-01-30 13:45:56,176
0xbec5dafb16ee7e4a519f64ec8e23e92b1b708b710f44b7973882ea1d04d07d95,t,21000,7413372,,5000018,2018-01-30 13:45:56,177
0x0bfb625a089e8d407cd25eb4d1ac46896e216bcdf8d4d8e5ca160fdc8da71e4e,t,21000,7434372,,5000018,2018-01-30 13:45:56,178
0xd3c240b30d8076a848f810b80ff0e5ebde6bc5b239d1e5ae1837d895ce2e8e54,t,36335,7470707,,5000018,2018-01-30 13:45:56,179
0xaec690808621e0aa10796f22599c6f1c2068ae0647277a17fe2b897504f5d88b,t,37571,7508278,,5000018,2018-01-30 13:45:56,180
0x6e6c93738f28238bcd32c25c06926f4d4312c2f166cd78ed9fb7b9353fa377cf,t,21000,7529278,,5000018,2018-01-30 13:45:56,181
0xc50948439ad9991a1c49730dd02f93d2ee3b3e63fe7354815306b942647a4895,t,21000,7550278,,5000018,2018-01-30 13:45:56,182
0x81836049f38245a95cab49dda231f831fed2dcb263c14625187488505f14ec8b,t,37049,7587327,,5000018,2018-01-30 13:45:56,183
0x35487221c8de316951e70a2dbd377a63da0179b60afbf6a68e1bc7c95c0b50d6,t,21000,7608327,,5000018,2018-01-30 13:45:56,184
0xb4d0f4438d085e9693599365111f17a26e5c26c7b9565ff29c8d9d5ac5e572cc,t,37577,7645904,,5000018,2018-01-30 13:45:56,185
0x19339f8a500d861009fcd3fbbbb64977acccd296138122670369e1716d37acc6,t,21000,7666904,,5000018,2018-01-30 13:45:56,186
0xebab29b114ad3d8be33962fd95e91741abc58bf10755d8e54b37650d04efe74b,t,21000,7687904,,5000018,2018-01-30 13:45:56,187
0xacf642d3f14d2dec3c392fbd5bae53c73e92a4eea9b58a30fa99a6ae1d80d358,t,21000,7708904,,5000018,2018-01-30 13:45:56,188
0xc6b18152571c66415441ff08ecff5d4127fed2681bf51650df047ae745eba050,t,21000,7729904,,5000018,2018-01-30 13:45:56,189
0xbdc442e1eb2ce522ceefb606d2be8be90b4fce99ed50eb126f611d7b2f178734,t,21000,7750904,,5000018,2018-01-30 13:45:56,190
0xafe736088e85cd6b563d4fb3f4e93b6aae65dc7b8966cb8e44432030f51af801,t,21000,7771904,,5000018,2018-01-30 13:45:56,191
0xc018d7b67ad244e803a7533aa59445b47e382425db02f583be6ebaca0640f09d,t,21000,7792904,,5000018,2018-01-30 13:45:56,192
0x111e8ecf14fc59eb225dc54fe425d31a500baca45c32ba4e27d639b1099bc241,t,21000,7813904,,5000018,2018-01-30 13:45:56,193
0xfcd0a265429df00ef7db0e0195f20bc7e8b6e5a8ce18416ad441021371b46033,t,21000,7834904,,5000018,2018-01-30 13:45:56,194
0xe57e3a8c3e810c292d0d25596d46a1794c04d54f716485f17a977434f6b6666f,t,21000,7855904,,5000018,2018-01-30 13:45:56,195
0xb9f24eb5e73e0d9b101690c97edd351be872ea7c536fd5d335ec1be0b16af21b,t,21000,7876904,,5000018,2018-01-30 13:45:56,196
0x2504a457e2fefb39dc20853cf7b255948613576650d598850475aec4a9320aa4,t,21000,7897904,,5000018,2018-01-30 13:45:56,197
0x8349297148d3fd108d938a49a86538e5a31ae9d5a360d2436eb0c01e7ba3842e,t,21000,7918904,,5000018,2018-01-30 13:45:56,198
0xc3618ea348a80ce39dc9d57110cf14f4c85de5731baf476407dc161e03f1e4b1,t,21000,7939904,,5000018,2018-01-30 13:45:56,199
0x6a3d83cf1f0af6a85b6204b4c6b6bb569952a9ca8881566401136c316e6a593f,t,26712,7966616,,5000018,2018-01-30 13:45:56,200
0xa680518eda775b545167bc9a2d5a3660f8238da25d6f16ddc8454a5d407a4c5d,t,21000,7987616,,5000018,2018-01-30 13:45:56,201
0xe84957b28dcda98e554c5f2f0b4b42738b4896648f683815595e110c2afdf071,t,21000,21000,,5000019,2018-01-30 13:46:04,0
0x04e87a023ca5c684046c2062402df62c47f1d886d0ddea2674268daf5447f658,t,21000,42000,,5000019,2018-01-30 13:46:04,1
0xa93b0ba37506918e354787b4d8151c43da7fee1de75e2daafbcb299ced47a25a,t,21000,63000,,5000019,2018-01-30 13:46:04,2
0xfc5ea93aa01a280d36a597180f97d19ae398c14b623f6ed48c9e4453f59bd3d3,t,21000,84000,,5000019,2018-01-30 13:46:04,3
0x3cd749e04e331bf37e34a579c95c727858dc37af8dc26093a3e5af5875cf115e,t,21000,105000,,5000019,2018-01-30 13:46:04,4
0x9e4edb316c55585ab90e8d0227201da2b0be7ca8437c052509838f2199cfc8b6,t,21000,126000,,5000019,2018-01-30 13:46:04,5
0x6719c96c6f17e9d6e84061a5a29a3cecdb9d3aa2af3aa1d2a7d6161b25ba724a,t,21000,147000,,5000019,2018-01-30 13:46:04,6
0x6e397732dcbedfa0f75e29da1ef3a4a0d79306e8e1bb375ec7e18ffdbf0319ec,t,52712,199712,,5000019,2018-01-30 13:46:04,7
0xff953d26395961fa23dca98eebea6df05b60830ff05d57cb6afb308f50f07e46,t,21000,220712,,5000019,2018-01-30 13:46:04,8
0x3d8ad7ec2f5ddef62d85216d70d953dfd160aef818c7b188dd149ac534e02e23,t,21000,241712,,5000019,2018-01-30 13:46:04,9
0x28e1e7f581dadf991a47982389289ee9f15bb2f41965c6e81d65b9b61e22de63,t,21000,262712,,5000019,2018-01-30 13:46:04,10
0x2063b80787d264a933860410d4f03dfc231fbb79387b2401d1512faae61effe5,t,21000,283712,,5000019,2018-01-30 13:46:04,11
0x094c0e1562b596a8a368c6ec4c6b2a6ad2cf5cccb6dc35ef86165bd2860c879f,t,21000,304712,,5000019,2018-01-30 13:46:04,12
0xa818000086373fea105461e40d5cbd06c1fa69961c9b90f794be97cccfd1d2ab,t,52352,357064,,5000019,2018-01-30 13:46:04,13
0x1b17fd9a7f82da03f9a183a76c7ab46cbc846fbbf27fda941584658e52c50166,t,22416,379480,,5000019,2018-01-30 13:46:04,14
0x64f81c661a72b3c14edc8b662d63ae3fc2dc1e675428dc0a6e698d2ac123cb1c,t,36606,416086,,5000019,2018-01-30 13:46:04,15
0x42a179bfd928e1f88dd4850e2bcfe2b450c0141e0913e05925258a9f2ec45253,t,21000,437086,,5000019,2018-01-30 13:46:04,16
0xd5f2d3ec122c61620b14212edc6bc4aa737b0c1abe4dec348cd6b3931da872d3,t,21000,458086,,5000019,2018-01-30 13:46:04,17
0x3742f31f3a43f17a9460799773dcf98099a3f23ea0d43400df5bdd7bc3010fe7,t,73647,531733,,5000019,2018-01-30 13:46:04,18
0x0482553f2f64b69757c06887261c3f007f6a7360544b0133814d589af825fbec,t,21000,552733,,5000019,2018-01-30 13:46:04,19
0xe4f04040df98e3e2562a0b15a516ed9d21057572be53a67b711fcdb0aea09d2b,t,21000,573733,,5000019,2018-01-30 13:46:04,20
0xaf5867596ea69077c32e719a7bea20ee1503b3ccd8fc28fd8668000e496c5632,t,21000,594733,,5000019,2018-01-30 13:46:04,21
0xbd1eb699eaa9287c798f59be34cca3c61c47afa7706dcb25f9c9a6ed02b21887,t,51618,646351,,5000019,2018-01-30 13:46:04,22
0xe8e156d2022d2e608853fc19ec6eed9593d1ecef9f0f80af32945315c97e1321,t,21004,667355,,5000019,2018-01-30 13:46:04,23
0xd9a446865d42011e7ac68504ee47974df8d5a4ea7500cad5e2d70bd52fae2ba7,t,54908,722263,,5000019,2018-01-30 13:46:04,24
0xe930fc816382a9a9cb50d616ddcda4fd4622f81b78aaf725ab96be370718b97f,t,52292,774555,,5000019,2018-01-30 13:46:04,25
0x54c84f1c940a7256a60f3218459b4ba089b552da64cc41f51b26ff31d52aae17,t,21004,795559,,5000019,2018-01-30 13:46:04,26
0x888ab93e0c7ed1ca7f29c2c7c9a1e4b374abf4b33539544278da6eca2fcb5e68,t,36725,832284,,5000019,2018-01-30 13:46:04,27
0xc639728c9fadc1b95ae8738e824deb4b0a0de95531631e1faadb066dac7a8532,t,26670,858954,,5000019,2018-01-30 13:46:04,28
0x4c4856fd91c3c503be4aa77476ace96f173a9083a5ff340dd395854f9acd1f22,t,44354,903308,,5000019,2018-01-30 13:46:04,29
0xd1d05f0de031f591f63eed6085834760663e2d384e551135301bbeac28ee56f8,t,53233,956541,,5000019,2018-01-30 13:46:04,30
0x46b2715743a3398c042d6a58373c10b113cd8de7a59efc0f73688b470261c065,t,21000,977541,,5000019,2018-01-30 13:46:04,31
0xe7e1f9fc0fb68c21bdd871ea55972a69c70631e8e435991a8de5191a05bb7930,t,52283,1029824,,5000019,2018-01-30 13:46:04,32
0xe148e68f659395c5d808b8340a50180acf78c499cff289ffa6eba8a582370ddb,t,27716,1057540,,5000019,2018-01-30 13:46:04,33
0x1ab362927bc54477ba2f528b37ef282bce237bc880c035d8a1770b98e43f7009,t,21000,1078540,,5000019,2018-01-30 13:46:04,34
0xf72a98c0faa85b7db24a6ccac5ff6a9abf197faa50496c9dafc0944e51617be4,t,21000,1099540,,5000019,2018-01-30 13:46:04,35
0x4d8be33b8530e77dd9743669845a95b0d09d488de0c4f0b3f375f343755e82ae,t,21000,1120540,,5000019,2018-01-30 13:46:04,36
0x5ffee41b33697eb1e38b13020a2e2815184e4eaf3cb98700e7a82fcc16a10117,t,21000,1141540,,5000019,2018-01-30 13:46:04,37
0x638a0d4f34beccb530ddcf2efa541189a4fcd3cd8457d234ee1293a92dd817df,t,21000,1162540,,5000019,2018-01-30 13:46:04,38
0xd3c72c223990383d43428bb14ce844d86a48975f339836ed278314b22a104ddb,t,21000,1183540,,5000019,2018-01-30 13:46:04,39
0xab5e813077995913d30b2cb48b202f570f4ea0a42bd386af560e0d3d4f4e69a9,t,21000,1204540,,5000019,2018-01-30 13:46:04,40
0x9d2f9c7c6597142f2d27a996db18dd6b94ae3d6f080c7f6278f894b43921e81e,t,21000,1225540,,5000019,2018-01-30 13:46:04,41
0x84875cf5a5243f146f5aef14671b64a0acec914c43feb09e2604386e2f968eda,t,21000,1246540,,5000019,2018-01-30 13:46:04,42
0xe027176fb2855eb053758325b1e68b2c3ccf3cc9553ceb978d22713e86dd54c0,t,21000,1267540,,5000019,2018-01-30 13:46:04,43
0x0e0965adf8c058357ad2fbc79388dc33bad42807169909a7bfde2e962663c1a7,t,21000,1288540,,5000019,2018-01-30 13:46:04,44
0x6836873fdd4a4c370efe183f0768bf671bd4c8f42ff8f7df5c848355d8c9bc65,t,21000,1309540,,5000019,2018-01-30 13:46:04,45
0xe9f287bbd9c59aa47efa373a93a116dd8c33b96537858bf6b97240785198ab56,t,127516,1437056,,5000019,2018-01-30 13:46:04,46
0x6f35ffae350f2c0f6ca9ea2340fbcb021b112934c5fb886ac602670f177ade81,t,36884,1473940,,5000019,2018-01-30 13:46:04,47
0x03fbe8d9fb8c55c91bfe16f0660f7ebb617a73cb48237562b7662ec47f6f4b70,t,40843,1514783,,5000019,2018-01-30 13:46:04,48
0x87575377af490e88956f39f5a7ece44f7dcbd1e4541eee0316703bbfd34fe936,t,37327,1552110,,5000019,2018-01-30 13:46:04,49
0x82ed4bdd5bdab637ae65ba25919b64f46c19cfa8c5c1ff033a2704265cad55d9,t,51820,1603930,,5000019,2018-01-30 13:46:04,50
0x5ccd1d75d3fb6e29e04cca2096987c527e9f490b685174a62cf1bd6f2cf8b395,t,38519,1642449,,5000019,2018-01-30 13:46:04,51
0xec74e1bccd664382a238a5a08a75e628cf58ddff7a13ae84f47852b01ff06825,t,55907,1698356,,5000019,2018-01-30 13:46:04,52
0x83294080f2f9d3604b2dd12058296cd04b7132b4b781ac5837f088dac1cda61a,t,21000,1719356,,5000019,2018-01-30 13:46:04,53
0x681d7f45c588e49fcfa06e4f4553494e71fe0f6add6da29f6cdd7b4aa3680f58,t,52886,1772242,,5000019,2018-01-30 13:46:04,54
0x5eaa9352598621c5c214d228f865a0dcd050aad6d9445e6b99cfc8d3f7c2cf3d,t,244829,2017071,,5000019,2018-01-30 13:46:04,55
0xb87df5f5c4113c3c00a3b4a661981aa68ce7cbcadb1af3bad5c0dad91d6a3711,t,36792,2053863,,5000019,2018-01-30 13:46:04,56
0xae94881e99667fe01e1e1a532103d4d731286c53708c091b3a5208572e075110,t,21000,2074863,,5000019,2018-01-30 13:46:04,57
0x2406e9921f8244c2b7970c84e60aae6d7d666ee03b5cab93dbb3c15726b4b1b0,t,38005,2112868,,5000019,2018-01-30 13:46:04,58
0x5ef6bf99eaf4c7b2910164cea35f80d6e4120387f340e1b00c0043e9e19d3f5f,t,23028,2135896,,5000019,2018-01-30 13:46:04,59
0x1ce81e4af3e71769a2dae359a7efde49b92c064c77c11d98649104d8d3e6673e,t,21000,2156896,,5000019,2018-01-30 13:46:04,60
0xc4401f09b834904da3710faca38d69e29e7b7ca183eff7015c5148046c36010e,t,21000,2177896,,5000019,2018-01-30 13:46:04,61
0xf67d44d5d3fd907431d22ea82ba3028663d90254a52189aecd99b732920081fe,t,21000,2198896,,5000019,2018-01-30 13:46:04,62
0xacfd1da1f5a911732d82e8fb18c83942b6ee4bcc68b02f6ca9c65236aa496e0e,t,36706,2235602,,5000019,2018-01-30 13:46:04,63
0x061061fd4cf57dd687ac7dc1ee50e8e285855168c608651ce9d8c0da3d44423d,t,21000,2256602,,5000019,2018-01-30 13:46:04,64
0x756c1f625f8abdc131fba92f7b71b935346fa2cb5e928bdcdfb3440f7bea79b6,t,21000,2277602,,5000019,2018-01-30 13:46:04,65
0xe5b6e469b14316242953ba91949875f6981e463398f2d93bd5add91b0413fbfd,t,21000,2298602,,5000019,2018-01-30 13:46:04,66
0xfd30f358ff9bf543812db2333d22ee0548c18fa2f16fea63ef71aad427867a2e,t,51346,2349948,,5000019,2018-01-30 13:46:04,67
0x61b696e1690395d5c3496d8b8de18f9bd83e11b489473ff9cd3cbb80f14c107f,t,39512,2389460,,5000019,2018-01-30 13:46:04,68
0xca3ab3a7200f382c62d3d6645e312a6380c346770281ebca016bc7d49990191d,t,21000,2410460,,5000019,2018-01-30 13:46:04,69
0x7bc067231c2a3b92478d5f591320ec26d9de2c6df6cbaaba6a95016706079f9f,t,21000,2431460,,5000019,2018-01-30 13:46:04,70
0x6da71146e38883e09e65b7b182a15e9876aa4ab68101c29acfa6ca9406e125f8,t,21000,2452460,,5000019,2018-01-30 13:46:04,71
0xc2787b245c6366fd82b1953cd2fbfc50f266795937928cd0c70f0bdd6f2804d4,t,21000,2473460,,5000019,2018-01-30 13:46:04,72
0x21cf247f8f786faae31b494ab31267967ad0bc6de74ca5d5931971de4f828991,t,21000,2494460,,5000019,2018-01-30 13:46:04,73
0x5d489d9992d16dd9cfadc255223418bc925e7916c7c6292057d0ef0ba3e3fdfb,t,21000,2515460,,5000019,2018-01-30 13:46:04,74
0x3565f3563eb49a7da33c1b634ee75df36fac5e35c4c84a2112066fa7bff6a43f,t,22155,2537615,,5000019,2018-01-30 13:46:04,75
0x711d8abf5f1183af00ca3e76c12b4969f5a13be90f10da4327229134b240fd5e,t,22091,2559706,,5000019,2018-01-30 13:46:04,76
0xc6c1817bf81b219137bae562427d7a6f5e237016b8fff478a7ebf70845f422b5,t,52091,2611797,,5000019,2018-01-30 13:46:04,77
0x282b61518726dccea8f639223e778615e5dd2f490fb6d2cc4d6869d3e6135e1c,t,21000,2632797,,5000019,2018-01-30 13:46:04,78
0x9e01b7332336648bb7af110df43b808ccd619d80d2b1a265f19e7850f72d098f,t,21000,2653797,,5000019,2018-01-30 13:46:04,79
0x08ced2b29fee029d92581b09e9b194e3b58b1aeded7d4a6301d17be2c5a5e88e,t,30327,2684124,,5000019,2018-01-30 13:46:04,80
0xc65b4b40e23d2534c6d7f5083298d3864c8f0143063ddd0b747524f31ba87604,t,21000,2705124,,5000019,2018-01-30 13:46:04,81
0xd21754713a848e8266eacec5de31746b4e8d08155a2eaccf2084a947c167abee,t,43970,2749094,,5000019,2018-01-30 13:46:04,82
0x6a08a5d2fb02f6afa0ca65e3e1bf26f7d6394c4e7ae4b0a7bd67719e1f8b8b16,t,279531,3028625,0x9d3C3A0986F4b9f54a232E721aBBD7240FE05D6F,5000019,2018-01-30 13:46:04,83
0x96414d06f0f8b4dcb17434ffb6d4af9b54bc1df4f2e17b3fe56e7e95682a4b65,t,21000,3049625,,5000019,2018-01-30 13:46:04,84
0xa081c00be4ef80f4fa98cc1ab14c61d4a9395e57a60d7650e1ddda8f4fc7d46b,t,52155,3101780,,5000019,2018-01-30 13:46:04,85
0xe66cf8266453a75997f8e6b1b5e6c6ca30c04abd514cedea3f0d03040ec6ce7a,t,22193,3123973,,5000019,2018-01-30 13:46:04,86
0xcf97aa1c35401a97e73546e43ea5d6bf7c8ebbfdfd4a16ba01284200db2f501f,t,22193,3146166,,5000019,2018-01-30 13:46:04,87
0xfc8a6bddc08132af086614d733e811975df2e610f92c09aec1d370d29485a7c0,t,4679396,7825562,,5000019,2018-01-30 13:46:04,88
0x2002b79fe9d2ef8a7dfb326e26039ef366d167906781f10b4719407d0cf9feac,t,52904,7878466,,5000019,2018-01-30 13:46:04,89
0x51fec35a94a00379ff4f838112fffa13b97191447ec610e0cc542742d4f76871,t,37571,7916037,,5000019,2018-01-30 13:46:04,90
0x2250a720b9ce94e564465394974b0ef361d5e4a1c4d358c0da7388066c6ddbc1,t,36857,7952894,,5000019,2018-01-30 13:46:04,91
0x6ae8b1f0f1ee11e8e26ce6a655163ee31d8ce667469e9e88a69d325b860ed8d5,t,21000,7973894,,5000019,2018-01-30 13:46:04,92
0x7ef14b479c57bdea9b31322bfbc40f9b2661f99c26f119c335cea4aea61e8bd7,t,21000,7994894,,5000019,2018-01-30 13:46:04,93
0x65a31f6f71b13a26fbfcf0073b5d4eb650be90cd8fae83b383383f4d109c1e72,t,21000,21000,,5000020,2018-01-30 13:46:17,0
0x8e5b346e65e32176bffd6fdc3a86a694527f407a21345ece83b73a6f04ddfb19,t,143081,164081,,5000020,2018-01-30 13:46:17,1
0x9e0368fdcd202a07618c537dd413e94bd1b37805307a56b29edc0a185d8bdf48,t,21000,185081,,5000020,2018-01-30 13:46:17,2
0x45722159d53d93c727a9bbb09c59164d3e64589470faf86b06ba66b715f41fa4,t,21000,206081,,5000020,2018-01-30 13:46:17,3
0x9e213e824f497af6887101c34dde174fdde980e337989a2829646852e06a0369,t,21000,227081,,5000020,2018-01-30 13:46:17,4
0x909f109cd4abda8b81e41c959f4a0132af24981f3b5aa756a17b166044396b64,t,21000,248081,,5000020,2018-01-30 13:46:17,5
0x448051aa6421992aa53c2ecb02580cb02f47f237b70adb4e920d92a1e27b8e35,t,21000,269081,,5000020,2018-01-30 13:46:17,6
0x3a329e915f98cfd430c7aba842a77a2ffc58b42c5327f2fb9878adad5e5ba45f,t,37460,306541,,5000020,2018-01-30 13:46:17,7
0x8a4030dc011c3e50f7d76fa76573a0be93c81ce952e13ec06ecf556da589741f,t,21000,327541,,5000020,2018-01-30 13:46:17,8
0x50c0a69a92ef053ee19de6189c074a065fdcfe90b6316456fa33f250baba9ffc,t,21000,348541,,5000020,2018-01-30 13:46:17,9
0xdb5d5f8b62b59dc11588382d01fff70d384ed7e3d610ab93edb12cb9fc16f8a3,f,21064,369605,,5000020,2018-01-30 13:46:17,10
0x3376abbc6f6254d439bb91fb8d118c527ec0e3e711a0dc199c65aadef651c270,t,23483,393088,,5000020,2018-01-30 13:46:17,11
0xcea8865734811c8faa23573e68475fedcbc29f1cc1420083a9452d9fcf6ef235,t,54720,447808,,5000020,2018-01-30 13:46:17,12
0x14167c59e4bc76be76744ddf0fd8c36fccae4932f9f526bcd2e5ee00696af70c,t,55971,503779,,5000020,2018-01-30 13:46:17,13
0x0337594c7ca65bf664fbc96ed0a58a7e92709a0385edbbbfa1af5082df9de5f2,t,36657,540436,,5000020,2018-01-30 13:46:17,14
0xbea95f62536c1efd7b623bcf50cca8ad7ac4f685f2c4b7ae73194f74c4720a47,t,21000,561436,,5000020,2018-01-30 13:46:17,15
0x6149fb134087a001ef87d67e2798c4bfe7aa3dc7c38f7426e8fb205021cab856,t,21000,582436,,5000020,2018-01-30 13:46:17,16
0x8e8e5f1c536880b25bbaa3aa85b82286ce128fb0be280b5637e00e589b6c1217,t,21000,603436,,5000020,2018-01-30 13:46:17,17
0xdfeca6d365e8792ba064e762b20bcebb89548dd2640ac8f45d75ff9f45810014,t,21000,624436,,5000020,2018-01-30 13:46:17,18
0x1697e2cba41b71bb49d62b9800cc10c1909a83160f0e046d4082d68a47e49e05,t,21000,645436,,5000020,2018-01-30 13:46:17,19
0x098e79df526ca3452e8fcb24af6c75d4015aed18e674d1909ba799a66f15d7f4,t,104678,750114,,5000020,2018-01-30 13:46:17,20
0xa871397dba7fd963d8c82d374c6f628098bfdb032d3cbdd6bca1a7fcd66f37a0,t,37013,787127,,5000020,2018-01-30 13:46:17,21
0x29b6cc331e1f89e392d680c8ef8c074048f28602436bd3e66ce12e206f80ae0e,t,21000,808127,,5000020,2018-01-30 13:46:17,22
0xe83c075b20c6df5f8445e04af691c20f593f644f0d2e882b7fbb20544e4c42d9,t,21000,829127,,5000020,2018-01-30 13:46:17,23
0x71e14d669171963454b4b6490d4dc01ee4f4deff2a572a1d6c8693b0a311e06b,t,37746,866873,,5000020,2018-01-30 13:46:17,24
0x1545950b6b80822a5ce1b85216b7be2c0dc268e95d0443b7c06536b1a237eb6c,t,21000,887873,,5000020,2018-01-30 13:46:17,25
0x0975ea96a35f83c9472d6af5efa0d936dfa668b015685fdfab9043ee347e6f06,t,21000,908873,,5000020,2018-01-30 13:46:17,26
0x4357084355d0ba20ab2339dee52e5f171a9db445398ad032e3bf628394dcfbf4,t,21000,929873,,5000020,2018-01-30 13:46:17,27
0x20069f16c81be3103921746745c5c94f3792f4ebe67f0cdbc19c9008fa89fec2,t,21000,950873,,5000020,2018-01-30 13:46:17,28
0xfff18fcdbf8c750f1556f466d7b422ed197bb972600454c54a8b7ad5c063453d,t,44418,995291,,5000020,2018-01-30 13:46:17,29
0xc7ce652d6fcf6f770c805a33235254c92079a7c8eea0778fbf93632176274d26,t,21000,1016291,,5000020,2018-01-30 13:46:17,30
0x1fa29d9ffbe47a6138e540833d2f288ac4d00a9d03a001f4cbaa5d25635f64a2,t,23028,1039319,,5000020,2018-01-30 13:46:17,31
0xb2f580b2898e8480fe1bf0e41801a24758bf125e812b8a8c651cfcf78a9ef27f,t,38318,1077637,,5000020,2018-01-30 13:46:17,32
0x7ccca5dbaa0f94404fab41b3c9dc828298b4ce32255be3fae528ffc687d29963,t,21004,1098641,,5000020,2018-01-30 13:46:17,33
0xba0c92978e793cf9013269970a3e6c1d97d41ec506b155fe7c18ca5512deb9eb,t,51789,1150430,,5000020,2018-01-30 13:46:17,34
0x387e0a3c5f7b0966689b3173793a447628f982156efa84a988e32d75bba8395c,t,21000,1171430,,5000020,2018-01-30 13:46:17,35
0xdb19296ed39b3b13c13776f08d104f2531180bebdff1b3c400e94210db8260cd,t,21000,1192430,,5000020,2018-01-30 13:46:17,36
0x098bed54b37beae72337bc9d14e48c12d965dc9e61574fe8b13c24d79edaeaff,t,22155,1214585,,5000020,2018-01-30 13:46:17,37
0x58459cb8af5ecae336ef91ab0d9ec87fe201ff6f3b3cd7b4e1a5eb8d09252af8,t,21000,1235585,,5000020,2018-01-30 13:46:17,38
0x54a4cd4f0c9dca618fa93fddd62a77c8761a7181ac2c0e3b74d8bad3f1a485ac,t,53233,1288818,,5000020,2018-01-30 13:46:17,39
0x629702b01f163bddbf42449a1dc16abfd84b83845d2dec7b1ffe1a78ffb840b6,t,21000,1309818,,5000020,2018-01-30 13:46:17,40
0x69ee13ea42c8bda77ea7ac381839973d3c02e1f4b83d0f8860689801ad4c7eec,t,21000,1330818,,5000020,2018-01-30 13:46:17,41
0x5b7387faa389ed538a22e944b559e350b8b8f4f32017eef434572f79a26d8ae2,t,52460,1383278,,5000020,2018-01-30 13:46:17,42
0x2dfc41f471620b92bea7551b727c014a179ccfada775e89cf0477bd4fb37214e,t,68760,1452038,,5000020,2018-01-30 13:46:17,43
0xa9edbb9c96b6a19806a6145cf65457227a408695e68329ecec9ad7ea98373abd,t,140027,1592065,0x87c7fE4fCDd184410640449FB3252D9201a1C5Ea,5000020,2018-01-30 13:46:17,44
0xd1cab6b0ee5ee0eaab8bdfe3867790bb6fb651eca1ece8f98223ad15dc57f3be,t,21000,1613065,,5000020,2018-01-30 13:46:17,45
0x6749abc4baf2a3bc92c256f256d98f170b0e58e95f1992dd030525b27c60b376,t,21000,1634065,,5000020,2018-01-30 13:46:17,46
0xae91271d48f0f977b36cd5a13048100619e7f98bc8298841d431d4da5e309e97,t,21000,1655065,,5000020,2018-01-30 13:46:17,47
0x52c32552f8a04d1b782c312d3e1912aa569f3c40e733b5693416dd2c6fd60368,t,21000,1676065,,5000020,2018-01-30 13:46:17,48
0xb90e95f3bc928cfffd50c02c7fd6bef896303e80d4282aae529b8f63524bd658,t,21000,1697065,,5000020,2018-01-30 13:46:17,49
0xe6483aa53e2f5543bf15b416130e2ceb2dcc385c3114f365df3677249e3b5ee7,t,21000,1718065,,5000020,2018-01-30 13:46:17,50
0x5e253f398b251ea0aaf37a21b689f051567a5f299dffd8e0587e5a6ac16e183e,t,91955,1810020,,5000020,2018-01-30 13:46:17,51
0x2b43b502bc2c54434f9b47b9ad28736f0180718b6e257f2f81ac78fbf9db7abc,t,242521,2052541,,5000020,2018-01-30 13:46:17,52
0x9ac21190085a2ee11efe35826330a8204496fb706874185befe80f8b4576c9c7,t,51752,2104293,,5000020,2018-01-30 13:46:17,53
0xcfe87212672039a0b8f022da853fd621b20c66b0e9ba5d8f71e348adc3766aaa,t,54771,2159064,,5000020,2018-01-30 13:46:17,54
0x5961a1c718ceab90efe54883ecfc93ec09493402f6d3624c934c7baa09a93efa,t,37109,2196173,,5000020,2018-01-30 13:46:17,55
0x8a141b5ce2faca6ec6de4a0f35c1f699022572b28a62139cc1e98706863cf14d,t,91322,2287495,,5000020,2018-01-30 13:46:17,56
0x90a4798c4008fd783c290c3cae0a664040c232bee2a971521bef6ad8a0e34257,t,73999,2361494,,5000020,2018-01-30 13:46:17,57
0x1454bfb1f0de3b09485d8c05f8aa961bf714f02ffd960917fa80aba8c3c4af50,t,98809,2460303,,5000020,2018-01-30 13:46:17,58
0x41ab440b0eb93686682c729161176d09af11dd928fa3df4c408c916118a39ac9,t,36757,2497060,,5000020,2018-01-30 13:46:17,59
0xa4477ad6979e5d9fbb744771403be3e6d2bc637c9cf5525e3a1d48165271345e,t,55843,2552903,,5000020,2018-01-30 13:46:17,60
0xd64518b464f0ede27fd87c169721e9da4bace6651cee0a4cae523d5aba10ef9f,t,51347,2604250,,5000020,2018-01-30 13:46:17,61
0x7d5a414e52e0fdd3d95a72818e897867f52d66f605ac5338de24930c5d2aa0f1,t,21000,2625250,,5000020,2018-01-30 13:46:17,62
0x7c48e5c70af68adaca657edf764544a24c99b58f39c20f4f7ed2d3666c988f03,t,51884,2677134,,5000020,2018-01-30 13:46:17,63
0x7c2fac5542f099a6d59ab045b9b1ee3543d35fbdc7618c64f74515580e4824a8,t,52886,2730020,,5000020,2018-01-30 13:46:17,64
0xb3b23a01912edf0989e1131c5df3bfa0ea404def861d0fffa95dcf340543eea9,t,27703,2757723,,5000020,2018-01-30 13:46:17,65
0xbb005d9f5351f37e60ffbf5cb6c28cd58c212c261cf573f02b062d773bc4b5c3,t,244829,3002552,,5000020,2018-01-30 13:46:17,66
0x88a7f1d5aa74ed33e90e35dbce149214fdbc3e06fecc2735c44fec316eedbe3a,t,36792,3039344,,5000020,2018-01-30 13:46:17,67
0xea03dc45fc1a94e9497e51ac30635b7188c02c45ce093ce501b6161c88b8e100,t,40907,3080251,,5000020,2018-01-30 13:46:17,68
0x464ab24ecb9353423e34f39c939381930be94fb31a710ff24a50030e12594314,t,22155,3102406,,5000020,2018-01-30 13:46:17,69
0x21ec5b3e122be226c5821c5e814854202f569d54c5419f402b611e5294c1d5c7,t,21000,3123406,,5000020,2018-01-30 13:46:17,70
0xffb6accf4304cdcd6047bdadaab8dbf5d2028ff2370db381d4172f28553ce75e,t,21000,3144406,,5000020,2018-01-30 13:46:17,71
0x28986a84b154d210c5411ea8f295ed3e13831dcae154267ebe357f5e21733670,t,21000,3165406,,5000020,2018-01-30 13:46:17,72
0x4708068e4b09da99913d1d99a2475483bf9a606811eaeabbf6acdddd5bd623fb,t,21000,3186406,,5000020,2018-01-30 13:46:17,73
0x6938525fa24c6546b983d9d22a56d1e5d956caef8ec621108a91907c627b5c45,t,21000,3207406,,5000020,2018-01-30 13:46:17,74
0x79a24843e8bb84485388103204bace3a41650dc46875e206ab5f9fb91290e6ca,t,40907,3248313,,5000020,2018-01-30 13:46:17,75
0x28b4e1d8719af65c52db86820459826c983dd98e18a870f6b943f1876e88aa14,t,21000,3269313,,5000020,2018-01-30 13:46:17,76
0xb513f3410b2b16cc7f3058b54b9589c377a339eeab5c074c66d38beb5332968c,t,127010,3396323,,5000020,2018-01-30 13:46:17,77
0xa6233429b7fa1b04911755bd4d35ced31b4e31d22ddd62d11cad5f7c424f1511,t,21000,3417323,,5000020,2018-01-30 13:46:17,78
0x3a4b395d2e8e2ed610d3f8e8ef1224b0ef2fa44a6ab9ed4cdf14211e9afe2f37,t,21000,3438323,,5000020,2018-01-30 13:46:17,79
0xc8a3b70ba691735568d1feab2537469b0d6ba889854f8d096ec2b9d33504470c,t,21000,3459323,,5000020,2018-01-30 13:46:17,80
0xf5c7e32ba7ecdd8f741f787a1a7d4c9df1e7fe4b4b6a17801248dcd67a016997,t,21000,3480323,,5000020,2018-01-30 13:46:17,81
0x3ae5287d1fd37064032f1c9223f9a2f9d460d2dc0d24dac44aea1c1d845dd89c,t,21000,3501323,,5000020,2018-01-30 13:46:17,82
0x498a59e7e90c0d964805db4a7847bcb19cfc33533807f612a69e33d89218de03,t,21000,3522323,,5000020,2018-01-30 13:46:17,83
0xac093082135c1cca5e53758d3a50b7f875eb16b76c93f9b53d4e616e37640d83,t,36813,3559136,,5000020,2018-01-30 13:46:17,84
0x7b3c8e43fe4cce36aac845ab60610f335dc61a4f5253d87dbdd0fa909327558a,t,52090,3611226,,5000020,2018-01-30 13:46:17,85
0xe5dfe08ba58be875374279a2b27069e176772d4024fcf99cf618f80468de9fc1,t,21000,3632226,,5000020,2018-01-30 13:46:17,86
0x1d7b6533f242331b061566ed2d5d32ea3cbbffd064c5c89e424458c0a9cba357,t,52090,3684316,,5000020,2018-01-30 13:46:17,87
0x52e6596febba94b8de5f70f54c5b7ddf1114dbc3697b64c3aa0a865dd5cdb4d9,t,21000,3705316,,5000020,2018-01-30 13:46:17,88
0xe323b1ef4cd74199a65fb04e7fe7e2918750dab26ded6ba33410a53ba3a9ec45,t,37524,3742840,,5000020,2018-01-30 13:46:17,89
0x1c6a6f720cf1213fb92fe58d7ac573570123605314b55691f9e8183686415ebb,t,21000,3763840,,5000020,2018-01-30 13:46:17,90
0xe41ccc7c30cf2972dc0d9d4a00250438bd02716d57f8fb3ae0d62be49ee6f1d7,t,21000,3784840,,5000020,2018-01-30 13:46:17,91
0x61848b02707797be850316d0848a1f34c8a460a3f62ff8695f4a6225e3b16af8,t,21000,3805840,,5000020,2018-01-30 13:46:17,92
0x13d891e06b93956118e8f4a54b3e3d0e19dc24a03c90e7a2b79062aae3852879,t,22524,3828364,,5000020,2018-01-30 13:46:17,93
0xa14a02fb05acbea31f412c89eedc14d3fc180d2e2f32e87d9fb88f662f3146f7,t,21000,3849364,,5000020,2018-01-30 13:46:17,94
0x07a0b8de5001e63c383d0bcf6500cb55374c2758a2021eccf11944496ec58f93,t,21000,3870364,,5000020,2018-01-30 13:46:17,95
0x99526e68f98ce1a78613484618ebabcd387325ad0afd78642701a3302492642e,t,21000,3891364,,5000020,2018-01-30 13:46:17,96
0xf246c56f3808b5f7cde18ff1585aa0ada0bde9f51869f2f2e1122cf67206dd42,t,51372,3942736,,5000020,2018-01-30 13:46:17,97
0x4cd631a9882a0c4af7dd7547fa940e944ba245a2e9f566a4219e3abf52e3de8c,t,21000,3963736,,5000020,2018-01-30 13:46:17,98
0x6e7b6006f9df3e22d493132ef12956b13a7562a58722f876ca1ddca4d9031c0b,t,21000,3984736,,5000020,2018-01-30 13:46:17,99
0xc349e02969b05ff55b1f328619843254aef9681b3a1cabcfb782d0ee966ad513,t,21000,4005736,,5000020,2018-01-30 13:46:17,100
0x2668da1ce543dcaa7fa701e07ba1526904085129bc59d5efe8f3b6a305c46527,t,52068,4057804,,5000020,2018-01-30 13:46:17,101
0xa5c455e8ec0677db3307ae2fa41408d9a66c58308ebebc8c313fd02e358a5f65,t,279531,4337335,0x96b15b9Ca85bb79805796E8cc85eF209c817f07b,5000020,2018-01-30 13:46:17,102
0x8cc6c6c4cecf11b4cc488b7eb43c854cc5a28a5fb97db48983c2791c723e4c2e,t,36779,4374114,,5000020,2018-01-30 13:46:17,103
0x3a6392a519f6ea691229ba239210f992c8b308beeffdffaa6f79f1084a0ccdbe,t,68543,4442657,,5000020,2018-01-30 13:46:17,104
0x1af1445b6e504d078923da129eb560451b0c6e82a9c1b86b10bf7f854119d8ac,t,51962,4494619,,5000020,2018-01-30 13:46:17,105
0xbc3904a942a0a01086def18fbaa2f0b84aeedff5beb62c14499cd84292a7de52,t,44310,4538929,,5000020,2018-01-30 13:46:17,106
0xdb6dd9bd42593c4c63cc0987270454dbd5ab1688a9593af65b0992182a39def2,t,45802,4584731,,5000020,2018-01-30 13:46:17,107
0xa9b93a08d14746301c261d295c2e958afcb687ed84ffae51ef7b01d48121db78,t,51606,4636337,,5000020,2018-01-30 13:46:17,108
0x4e9d1e66bd15d3a688dc71c040b022d045c38bb113b8948b2fd01e5ab251b368,t,36669,4673006,,5000020,2018-01-30 13:46:17,109
0x2de6e0093d50e9014fae5eadfe8da05697112416011373cbf247ea853ddb7744,t,48391,4721397,,5000020,2018-01-30 13:46:17,110
0x39ed1fe0b911c47d9f44ac8dfad460b43666021b5b5aa3452823d4a9c87aa459,t,21617,4743014,,5000020,2018-01-30 13:46:17,111
0x06f6d4671dedc7b797e43612869a78df65f9bc7630180609312adb6be4046ebf,t,23167,4766181,,5000020,2018-01-30 13:46:17,112
0x67a2cf13495184252178a7f64230716d5a4879867b2a38e6e5df373098ceeab7,t,21000,4787181,,5000020,2018-01-30 13:46:17,113
0x2c1d0b44bfa4f6f768440471ea9b1372ea831c95fd2abcbabf76e306fdc1d78f,t,48210,4835391,,5000020,2018-01-30 13:46:17,114
0xb46d895f091d9ba3e41d3f5693fdba05cb93a9814804579cf3e60620dc674764,t,36685,4872076,,5000020,2018-01-30 13:46:17,115
0x9981e91b3277435c805d4a26b9eb4a200f15d223d6119853a4f9f98b59617f33,t,45903,4917979,,5000020,2018-01-30 13:46:17,116
0x06ebb34c4740e49155c1f65c5e524460d67b57b88c6dc85c0b23d9350bb60640,t,22460,4940439,,5000020,2018-01-30 13:46:17,117
0x169876eb80bf94c7b74914b40de6f0c6a23e8e11eeadcc6062fdb897e703b427,t,22460,4962899,,5000020,2018-01-30 13:46:17,118
0x74feaf5927dd06bb39c6477ea57c1b8acca00314f468df6f579dd9e466c631e1,t,23382,4986281,,5000020,2018-01-30 13:46:17,119
0x4b565e4d19e7e1be3958fac72786fe06c143101660c84a79ac1c49f16cc77907,t,22742,5009023,,5000020,2018-01-30 13:46:17,120
0x3950672410986ebfad786b3e8dbc7f56a25796e763cdc77c98f6bbdb2a369722,t,23254,5032277,,5000020,2018-01-30 13:46:17,121
0xfdad8a42b287e733012a41009a8d8c8d262738179fc1b9fd4104d493ed5e29a8,t,22460,5054737,,5000020,2018-01-30 13:46:17,122
0x6e865018c5647ac136673a62e3ea52c6eb539e58f4765983c0c8bb69f7222621,t,23382,5078119,,5000020,2018-01-30 13:46:17,123
0xd0c55f25e54052d426f3b14e8d2a20d9c09d655345ab7bc388f32699551786f7,t,23318,5101437,,5000020,2018-01-30 13:46:17,124
0xe47ef322aad24604923c5cc7bfcfefed8b43b742d3d346378f596ab52cd60ea6,t,22222,5123659,,5000020,2018-01-30 13:46:17,125
0x84244c4ab7ee0e78ff0d407df6c820933c5f365d81d9558c05ee952613869ee8,t,23318,5146977,,5000020,2018-01-30 13:46:17,126
0xf1a75bed6f6d71120977a9296dc5445b6f52c66a218ae998041c14c2b1fd0ce3,t,23318,5170295,,5000020,2018-01-30 13:46:17,127
0xe30a1b0b01ff4b830980e5dade96b3a89e3c3e1afbbc707e9af25282464c2414,t,22222,5192517,,5000020,2018-01-30 13:46:17,128
0x65263498286fb3e51b42cc0e69c6d494b62e50f7fdc251ec7ad22db75cb5da83,t,23318,5215835,,5000020,2018-01-30 13:46:17,129
0x109d3418806ca7600fec3884a72843f857a1d525dbe4f64434f582893365f844,t,23103,5238938,,5000020,2018-01-30 13:46:17,130
0x89004c2a17aeb50e652538aab5778180083f7a5f89725ac01f6cc4a0b1246425,t,23318,5262256,,5000020,2018-01-30 13:46:17,131
0x02effabefd9a64d28487d6ff28380052a87af0edc2a2588e5914e1b2d25135d3,t,22380,5284636,,5000020,2018-01-30 13:46:17,132
0x8ec148c26c3e45cb8867a608f0c1603a8591beeffb222fc92adc12f91ff22474,t,22524,5307160,,5000020,2018-01-30 13:46:17,133
0x4c6a929d1a402c9f5e9870c091ed81bec4b5e4da2ddc64fd07ebc009faea9d89,t,23254,5330414,,5000020,2018-01-30 13:46:17,134
0x14fc88d7cc77a959928acab3cfbae805c58f57f48753a7d0e217851da0be5d3e,t,22460,5352874,,5000020,2018-01-30 13:46:17,135
0x1368e7030602d3c8836cbb1376eb6d8a7e860f37a73cb0139949bd6f727af095,t,22465,5375339,,5000020,2018-01-30 13:46:17,136
0x5e26fb031b0a651f135cf65857b7cda0469058785ba40def5842a738ed2aa1d1,t,23318,5398657,,5000020,2018-01-30 13:46:17,137
0x225dbd507d841e404f8e792088e114cf0d5d7bf3abdafc89c1592b827b086fde,t,22270,5420927,,5000020,2018-01-30 13:46:17,138
0xc9c22c763bfb04a01acdb201f728b4a3757b41ce8ee8e325c370a69a0bcdc19d,t,21916,5442843,,5000020,2018-01-30 13:46:17,139
0x33eeff66dc188902c57d49d8cb7e9242a7a2748649368cfe4c30b0aed482e440,t,21606,5464449,,5000020,2018-01-30 13:46:17,140
0x18eb14b3ae0520ff53d40851535657ee85fd65447b04cce83526412478a38eeb,t,23167,5487616,,5000020,2018-01-30 13:46:17,141
0xca7356bf2b00857d9dfd1397c53ac6a5bce8d02617e1944297b717fc033acbe8,t,22976,5510592,,5000020,2018-01-30 13:46:17,142
0x2d428f23087d40ea2a132f6f24d8152dde8a37ccf21c22403bf62cbb2bd893ed,t,22158,5532750,,5000020,2018-01-30 13:46:17,143
0x2a638ebfaecbf995bd9b886633c9d42a849049442b944a3f71e3c877c16f9a81,t,22460,5555210,,5000020,2018-01-30 13:46:17,144
0x8b04f4335dfd02cfdacb90f83854e761ce49e56d7112688ecbc25eb0d562ea44,t,22460,5577670,,5000020,2018-01-30 13:46:17,145
0xaa72ac1efbd0c311472c0e95770730eb407470418618de3d6caabcdde29172fb,t,23318,5600988,,5000020,2018-01-30 13:46:17,146
0x37313e818af7b093a8040597f15408c1ab8970b656194616de8cc96008aad376,t,22158,5623146,,5000020,2018-01-30 13:46:17,147
0x8ba375f0bfcd50c093ba78f2e8cc7568f9e7d2069f361a9b3783601d9fefe92a,t,22155,5645301,,5000020,2018-01-30 13:46:17,148
0x81ac6af7946a41528d6747b40d7fb12957da3114dfeb0a67f49dfc74dd182f27,t,22155,5667456,,5000020,2018-01-30 13:46:17,149
0x73ec73422996414588274d4fe698dabf60bbd36c964cd7364d175cd356bca666,t,23254,5690710,,5000020,2018-01-30 13:46:17,150
0xe619bb3df005bea4f4b669bc74b3d5314503a172959a40a04777c88f22cccbc4,t,22460,5713170,,5000020,2018-01-30 13:46:17,151
0x2f2811487ad4eb4cadbcfb6890f7d1d54b08b987ae8635442f1c049f024d2fb0,t,22316,5735486,,5000020,2018-01-30 13:46:17,152
0x3ec54b5f20bb878915dc3a9ec3bbce99c67a591b7eb5c360cf5fc045e1b203d9,t,23254,5758740,,5000020,2018-01-30 13:46:17,153
0x0b7b7ecfde92dd6583ea1480390b32e325901c2054a5006577875c9105b1e46b,t,23318,5782058,,5000020,2018-01-30 13:46:17,154
0xe2ee7460c1c39496c632d76adef39110dce95fee53648d69af60de277245e735,t,22460,5804518,,5000020,2018-01-30 13:46:17,155
0xa9f819471c7667822b5e85bef39c94305977c677f7c58e778ad7424e76d97cf6,t,22460,5826978,,5000020,2018-01-30 13:46:17,156
0x9f83acab6eb2b5d851bab9d5d9f58a7a692e7c4eb14bb12fd5609a9986514499,t,22316,5849294,,5000020,2018-01-30 13:46:17,157
0x55f952224e31eee6ef6e5ad931da6cc2d7d88b4cf68da6f879d2782633564988,t,23318,5872612,,5000020,2018-01-30 13:46:17,158
0xd893cf74ebc6eebdfb2a6331b91b6eec381f049b219fd2461e0b1da8ccf14a44,t,22158,5894770,,5000020,2018-01-30 13:46:17,159
0x3610e066e960320addce658c67143c580aef631d6b97ad27d7a512be205f0d4a,t,23167,5917937,,5000020,2018-01-30 13:46:17,160
0x421a512a4ef7fae54ed8e28a0be534168d3551af135aef9964b8abbc37e48200,t,23028,5940965,,5000020,2018-01-30 13:46:17,161
0x32f86846e4ae13c35385acf13361c3db8b3b9ed434295dbc67ead1bcb62f1def,t,40929,5981894,,5000020,2018-01-30 13:46:17,162
0x6aa2f5fd93fcef7c37a725672f0b6558e127121fca883533c975c7f200f95be1,f,25200,6007094,,5000020,2018-01-30 13:46:17,163
0x35a0bc8c4a60ba9460145f8a663266de3be8f647594d2a0e0ccedfd6cf2b4a1b,t,21000,6028094,,5000020,2018-01-30 13:46:17,164
0xf309869eb2dbaa0c043dfe88ec504a56d96b20fd4fdbf79ce6fae602ecdf8964,t,21000,6049094,,5000020,2018-01-30 13:46:17,165
0xd938017a83323b3daedc9477297be4dbfbef4b6922a9ed3a653151f954bc1b73,t,51967,6101061,,5000020,2018-01-30 13:46:17,166
0xfb65be1fb1e71fc35b3cc98ec3029b576a0fe775f0ae58530dddf3b3c1eba6ec,t,39899,6140960,,5000020,2018-01-30 13:46:17,167
0x9ca591da0c1a71691afe3c25291e31dc87a0eae776c3f4416ea42c53fe991c55,t,21000,6161960,,5000020,2018-01-30 13:46:17,168
0x487cb3f359b754c4098b897de9d25764eea4ea992c92cf585ffd983f6ad34168,t,21000,6182960,,5000020,2018-01-30 13:46:17,169
0xb55e26deda2d44f3e7b7213ec4e6240748f1628bb80f2a92e50a9ae1d7f396bf,t,112083,6295043,,5000020,2018-01-30 13:46:17,170
0x0cb470e9e1e4a686515cc05e7ad541341dc1de4dc7519047ed3550bfcebea7aa,t,59418,6354461,,5000020,2018-01-30 13:46:17,171
0xc8f435d07b798df23eb938d1a69a02422c567cf17827e4359298c196e8c555a4,t,38337,6392798,,5000020,2018-01-30 13:46:17,172
0x1c26bef4f51144deff69c727084fa472500a08d0db598a0cb91f034c26395f3d,t,44226,6437024,,5000020,2018-01-30 13:46:17,173
0xe60f44461310742f0f63ec3a8a68fc5b0ba40c8aeceeb028798ab1f653409737,t,21000,6458024,,5000020,2018-01-30 13:46:17,174
0xe9d8044972e4ace6cb496d1125d5534c290689d8a71de25ea440fd088f9c6f60,t,92410,6550434,,5000020,2018-01-30 13:46:17,175
0xa6f5b79512945a3e96eaf5b51707f45d58830b90564d6e9605b7f50a19fcc59a,t,22624,6573058,,5000020,2018-01-30 13:46:17,176
0xaa168cb8e5bceaae456e53159bd5f818e2ed5a96014bfb6de3bcde1a21988397,t,21000,6594058,,5000020,2018-01-30 13:46:17,177
0xb896ef8b204d9b1f326c3f93e7a4d4fbf15cee84d7dd90cc3b697b6221f0ec4f,t,45598,6639656,,5000020,2018-01-30 13:46:17,178
0x9c1cf3dd7ea9360467bcdea685ffaadd32953691183c7ae06cebd25279b96d14,t,21000,6660656,,5000020,2018-01-30 13:46:17,179
0xce2b487dcfed542343be5871b74a0872734533e585613f178b70b2d95ee77f94,t,29493,6690149,,5000020,2018-01-30 13:46:17,180
0x911bf36512795f6900cd72b1cd98bee155a3d8d908f54b451d68c948795a414d,t,43523,6733672,,5000020,2018-01-30 13:46:17,181
0xbe064bb13770d61e852129d46c2b53b19e9880fe032c504dfeeebf54b77bda75,f,250000,6983672,,5000020,2018-01-30 13:46:17,182
0x6f2bc3b8e6b2c183aacd60ab9ec21b8306679524e77e920bdf3c724c78b9df0c,t,21000,7004672,,5000020,2018-01-30 13:46:17,183
0x17caa9ed9e8fa845b45b53fa555d6b9ea1dad22ed475ad90113635ed230692f1,t,21000,7025672,,5000020,2018-01-30 13:46:17,184
0xc05f5cc7f20eebb225bdb9c89e8da0e7d84ca7368824e75473ac27bfc08e99da,t,37900,7063572,,5000020,2018-01-30 13:46:17,185
0xb88cc898031b410f08ecb8a45f32064dd17a951d468b9ff84412203e6f547ed2,t,21000,7084572,,5000020,2018-01-30 13:46:17,186
0x9b179abde870c48484dd3f1a3c15bfac3ab01ef6c9de9047b80becfa0569e1c9,t,108114,7192686,,5000020,2018-01-30 13:46:17,187
0xf947794f948cacdb1ea227c378d05b7221beafbbca07c6e7b96a4db85a13fe44,t,438426,7631112,,5000020,2018-01-30 13:46:17,188
0x1093f75344e4c8985af57e110d6693be911001195c5575d73d285d3d5d83627c,t,78050,7709162,,5000020,2018-01-30 13:46:17,189
0x4f292824dac8b416af2df3b0897549f6d9726f0c34825c125cb2705dc5951b7c,t,21000,7730162,,5000020,2018-01-30 13:46:17,190
0x6026516960529fb591234d9d66c5fbcaca492d078f0870c327e310837b25f563,t,54005,7784167,,5000020,2018-01-30 13:46:17,191
0x2ee9d687b814835e44342b47b9f1da6035d249fd38c81e1bcc6503265d037853,t,15537,7799704,,5000020,2018-01-30 13:46:17,192
0xcf9ffa7e801042255c7ee152c90ca9096abf4ab2373a5a0f708a50efb901cf36,t,15261,7814965,,5000020,2018-01-30 13:46:17,193
0xab0e7b7ddc1e9b7b7b3064e25701e17696fdae72339f0220fe9d93c0ec321dad,t,23316,7838281,,5000020,2018-01-30 13:46:17,194
0xbe5f62c14cb1142c707ab5b972ff395a0a2dbfdc59401de3ce6b09b72db44375,t,21000,7859281,,5000020,2018-01-30 13:46:17,195
0x24bb5c535f47be92d0a11f8648b509c5fd1edf6a0ce9fc5cdab5cafd49ee1cb1,t,21000,7880281,,5000020,2018-01-30 13:46:17,196
0x1b47d9db8a40289e8446b24e90eb7ca343b9d1a8f212eacc8b1655e8badf0058,t,21000,7901281,,5000020,2018-01-30 13:46:17,197
0x28af49ca4d7eaf3a10d3bc17663930cf62fc076091bd6c6299f768abe9f6177e,t,21000,7922281,,5000020,2018-01-30 13:46:17,198
0x40b4be8263e5b6eaa51d644751f0391bf0df7953c3fde1836c3d3a5ab8888c6f,t,21000,7943281,,5000020,2018-01-30 13:46:17,199
0x2d3343f3dfcf5b1bfebf7921ca2e4be23f6932ef753103d938632357e1507b6b,t,21000,7964281,,5000020,2018-01-30 13:46:17,200
0x7e096d354f8332b4600c5a0d09fe9c454550fff1560b2ea17c38aba070da4c31,t,21000,7985281,,5000020,2018-01-30 13:46:17,201
0x1957f5180509869e014700943405653bd692a4b3424ec76ea51573b095bd40c0,t,21000,21000,,5000021,2018-01-30 13:46:54,0
0x28ce6e1359703527ee16fe7a12d645df5ea1ecc7a5fa022379557d62b82f0040,t,143081,164081,,5000021,2018-01-30 13:46:54,1
0x45fdfab3be62c1462477fbe899862f21107eb969f9ee8c5d24f55eab5aef5150,t,21000,185081,,5000021,2018-01-30 13:46:54,2
0x6ab7d9e66a9b94ec5c8ddbb99aca082767bad8f07f1dcae56ec595e9b60d9784,t,52404,237485,,5000021,2018-01-30 13:46:54,3
0x3a091f5e5b689b7dc72e9e00271b4f3b258c5d4aafd8bdf704c5fad186059e1b,t,52373,289858,,5000021,2018-01-30 13:46:54,4
0xbf326e2851d3e8a75d1002deaa310040530085c4125fda4f4db9499fdb4b2cb4,t,21000,310858,,5000021,2018-01-30 13:46:54,5
0xac9f423eee7f09b85e443e8a379110413c681a1ad6efd8ab13b40b88fbddf134,t,21000,331858,,5000021,2018-01-30 13:46:54,6
0x618760c6f67e4a493c4bed78454d4c4f819636526ab72ee37fba7f18bf5951aa,t,21000,352858,,5000021,2018-01-30 13:46:54,7
0x8bd205665b4b5c5c25ac011532c1e02073f2ce077485fc61636798112292bdbe,t,21000,373858,,5000021,2018-01-30 13:46:54,8
0x5eb0c8c037d2c42e9a6fa8d623fff427356d0ebc49f78b785649f03424ed2909,t,21000,394858,,5000021,2018-01-30 13:46:54,9
0x947f7cadf30004c0806d2a2aca5ca63e54842dd5209d11c14ca38a67c5cada37,t,21000,415858,,5000021,2018-01-30 13:46:54,10
0xbc9c74d20969ac87a33624d085ccec121d53a71b23e66e8d3dc43292a8070436,t,21000,436858,,5000021,2018-01-30 13:46:54,11
0x930384832e436e15c1f0cb4dffb76625bd7d0b2368f66c0feff7945e48db594a,t,37336,474194,,5000021,2018-01-30 13:46:54,12
0x7d2e14750c9f67108a18bc389a1a446b82894d0329671786b28acce1b5c03a9e,t,40907,515101,,5000021,2018-01-30 13:46:54,13
0x21f7d333a6c352668ce54dc90e4d130b45ee092fed5792bf116ed8b8d18c3086,t,51458,566559,,5000021,2018-01-30 13:46:54,14
0xf9cdd3c47c685d19b8efaaf0fa1262cd433fbc977cd2595f64a0b43aa5c7571c,t,52848,619407,,5000021,2018-01-30 13:46:54,15
0xe5b4c0446a7292b4a5cac521e8d28d68495c98cc9b513a9074ea00c88ae47bbe,t,52507,671914,,5000021,2018-01-30 13:46:54,16
0x1d09de169cece9034a73f3d81c1805e58eb64693d0da486d5e342670dd0e8c34,t,21000,692914,,5000021,2018-01-30 13:46:54,17
0xe6c826ef4eb539526802510f84f0848e948984be4e4df9440f1decc432d8c678,t,21000,713914,,5000021,2018-01-30 13:46:54,18
0xef4af207637bd58dae617f3d8b61406b20497b06d4c1dc057cd1ab7369037557,t,21000,734914,,5000021,2018-01-30 13:46:54,19
0x7a9ffc7f5b4e47de12c7ee64ce849298efb2d40da5604c7662454f6fc36881ed,t,21000,755914,,5000021,2018-01-30 13:46:54,20
0x200984dec5f3b01a525a3a26bebbf0cb85a9829de88cac6dde035964ed60af0b,t,21000,776914,,5000021,2018-01-30 13:46:54,21
0xa5e42b056c87e7ddec510d8e4feb8400992ff49e4a986f1112e6775fcee14038,t,21000,797914,,5000021,2018-01-30 13:46:54,22
0xe495c222b4856a0808a6fb6b917fbb28948947e07e050e11eb65a10e02b4d719,t,52106,850020,,5000021,2018-01-30 13:46:54,23
0xb418ffb64d35313baeee274ce0110dd49cef3780b5a7114578c751f329c15f30,t,37091,887111,,5000021,2018-01-30 13:46:54,24
0xa6e3f5683b8d1e1915517fcea0665f355cc90eb047e36351e3442427604ab2d8,t,52571,939682,,5000021,2018-01-30 13:46:54,25
0x6d72e39bf15e207417e626dbbce871662df70648b9314de105baea362020f0e6,t,21000,960682,,5000021,2018-01-30 13:46:54,26
0x25d46370b94e59371c2df866630e577df6dff76dfe90e2ba8a7cffce3e548a31,t,21000,981682,,5000021,2018-01-30 13:46:54,27
0x51f6e2031655e918a208dd5bc9088b82e2db5c8c34a07ce42676c7587f523b87,t,21000,1002682,,5000021,2018-01-30 13:46:54,28
0x71f1406fa7691f60b33805b60d03c0f07a314b7841feaff7515dbb896167e184,t,21000,1023682,,5000021,2018-01-30 13:46:54,29
0x0fa4dcf170a5a732a7d86358404bf954df66a6bbcbf81a8154c18cbdb66ff7b5,t,21000,1044682,,5000021,2018-01-30 13:46:54,30
0xb91dc8e97edae64d09e00038441e5efce19061c03a517a1a3f3851e0c4320e29,t,21000,1065682,,5000021,2018-01-30 13:46:54,31
0x6bcea8b9a510c8f98f59b2c7789f5c1b3828b01a4f8c052f887f7b012137c4e5,t,21000,1086682,,5000021,2018-01-30 13:46:54,32
0x67334457483ffe37e980b3496ed1cc38b8acc6c39d01fde9d3d53c7b648e51ab,t,21000,1107682,,5000021,2018-01-30 13:46:54,33
0xb62068c6bc7cd2397e5a2ff4f149675af1a9c91a8bd2e38e525f61428fe6c0d1,t,21000,1128682,,5000021,2018-01-30 13:46:54,34
0x3a1ad137a388cad91bb7408faef94d8ec91b8c95ece4b699276e8f82e424eb5e,t,21000,1149682,,5000021,2018-01-30 13:46:54,35
0x3b652300de7d58cbaf9aac95e7aa9d898e21a579495d4de89063b703d9bc56ac,t,21000,1170682,,5000021,2018-01-30 13:46:54,36
0x613e7553712bbb3dd882db6b6a62ba98c13da3376207f8ae2ace5a117cb1b61b,t,21000,1191682,,5000021,2018-01-30 13:46:54,37
0xfc83ecda72d50845652ef43d9bffd101034a1c1bab5f02f14540d74948f8bb3c,t,21000,1212682,,5000021,2018-01-30 13:46:54,38
0xbc50ea2b74fedf0218122d4541d8067f76136f1adc929d2907e0ce7e47722f44,t,21000,1233682,,5000021,2018-01-30 13:46:54,39
0xea76c2b3a91326dadd50b8241ca3b089b587926bbf61b9ec86a007962cafe7a6,t,52578,1286260,,5000021,2018-01-30 13:46:54,40
0xf4fa4828997bd1f61748bb5f3f6852e40bd3428ee0af1785035de25f7728effd,t,53285,1339545,,5000021,2018-01-30 13:46:54,41
0xb9319f7f946c1c5f7551f53901184a5ef21c7d7ad1f4e6de959126c8cd67795e,t,52323,1391868,,5000021,2018-01-30 13:46:54,42
0x53516be68c940ac02279766be246531590f199e619a93bc4f73fe325516096e3,t,52155,1444023,,5000021,2018-01-30 13:46:54,43
0x03bf7a301d311b05d3280b096cb23384da1cb5778aa54456ac2fdf5ee26edfd1,t,37531,1481554,,5000021,2018-01-30 13:46:54,44
0x0d8ded8ac257ddbea39ad663255a7fb6e60c143b5aa71b50c9d1c86de322d2e8,t,21000,1502554,,5000021,2018-01-30 13:46:54,45
0xe427b9d3e5309cec436daeb85c00acff544516c1b9443b7b06e08cee9fcd3b14,t,21000,1523554,,5000021,2018-01-30 13:46:54,46
0xf6dde04c707975b6ae7c7672ef92b6dac41dccada1b7d51ad2d248025c8472fc,t,21000,1544554,,5000021,2018-01-30 13:46:54,47
0x481881a0c9277307b1cac174348b32744805f8b64457be79f6f74c82780db2c2,t,21000,1565554,,5000021,2018-01-30 13:46:54,48
0x51692e0d67d9aaf247c9e746e1008b1decdab417b350c7b7c9f6705a2eb7f0df,t,37087,1602641,,5000021,2018-01-30 13:46:54,49
0xa27941cb359e64890cebd51ea95431ee82d8b88194449a1c4427591bef78d451,t,54707,1657348,,5000021,2018-01-30 13:46:54,50
0x70d3910a414ab8f22994b93316ab4db76265ee62b734e65face58516bbe81453,t,21000,1678348,,5000021,2018-01-30 13:46:54,51
0x4b630e7bd9a70700fdc6c198c0d2fc4ec86bff1c7bedabc7920fa3e4478f32cf,t,21000,1699348,,5000021,2018-01-30 13:46:54,52
0x5208f8727f47c693cddcec49d23d911ee777f1c69af5108654f1a02dcd03db71,t,21000,1720348,,5000021,2018-01-30 13:46:54,53
0x8c12ca3865c22f5570e682682667b9cd5a64f3074949cde30654ddcc743b9a16,t,52321,1772669,,5000021,2018-01-30 13:46:54,54
0x70aa578cc1655a86030f9404f63d0153285cb9c35869107fc60ffa5608a59caa,t,52321,1824990,,5000021,2018-01-30 13:46:54,55
0x30a767cef5355cfd5e61ebdea1ce5f49d9737782f1320e1e8dc4f4f82d6ec97f,t,21000,1845990,,5000021,2018-01-30 13:46:54,56
0x13e8237a8fcd3e833822e01f49006d6dfcacb6506b37f4b0634d43811c8b154a,t,21000,1866990,,5000021,2018-01-30 13:46:54,57
0x6eec3f1fda21d67821b6b6f8df5292ea4e93f208a15ce15a224422d53b035436,t,21000,1887990,,5000021,2018-01-30 13:46:54,58
0x235f9f86e115636640f72f8ad47ec1d2d6f65db373bcd743a21ca0765c516fcb,t,21000,1908990,,5000021,2018-01-30 13:46:54,59
0x811fee91e88cad3b1ceb727ac16183489e47d313e768a9348dc3feedb8b38ba2,t,21000,1929990,,5000021,2018-01-30 13:46:54,60
0x040dc0fdeb39b429d75ab41d42c54e2b2ce87b3119de2381b0c7fff25b2a34cc,t,21000,1950990,,5000021,2018-01-30 13:46:54,61
0x0a3a35e6799f95473b4fa0751761a429dc68961b16635fd81be04c5757f3a9fa,t,21000,1971990,,5000021,2018-01-30 13:46:54,62
0x0191ff5083061e82b8e6cde48650b0aaa556083f7430fa0bc0b24e5d08a98720,t,21000,1992990,,5000021,2018-01-30 13:46:54,63
0xba0ecbdd981893c50879220f1b7ccbbbac29813ba924944f88bd5021b6b2c069,t,50057,2043047,,5000021,2018-01-30 13:46:54,64
0x2b19469bbab53c0aeea33811dbb52b95dd31079d2e235c2ae1fd192a8518e848,t,49993,2093040,,5000021,2018-01-30 13:46:54,65
0x946979de06b9e0c5a632f5af789643e5e82fe734d3c003c2666a15f16e74c04d,t,49993,2143033,,5000021,2018-01-30 13:46:54,66
0xbcfe35166435aa1c09f5daa40782d6b617a2fe353469ae319235da2e0ea9d451,t,53526,2196559,,5000021,2018-01-30 13:46:54,67
0x2e0498fbb2f3e711fb7cfff7e65903886521fdce9bf5665260bc6fe85b33a994,t,49993,2246552,,5000021,2018-01-30 13:46:54,68
0x22b9290168fbbe16c293a8e605e290506a811365dde40a9ca0b6af5728852013,t,49993,2296545,,5000021,2018-01-30 13:46:54,69
0x0cf0c8492490f558bb49b4064dc5b327970e3dfd176aed5b7991960c412cb985,t,49993,2346538,,5000021,2018-01-30 13:46:54,70
0xb1844b7ab96d8170811cfbd7412eb03824bd2e64a0bd839455473e0afec8dd37,t,49993,2396531,,5000021,2018-01-30 13:46:54,71
0x8118be2977681d4498d4623c83376f79b52fd484765eeb7bf04ed80fb766c5a0,t,50057,2446588,,5000021,2018-01-30 13:46:54,72
0xea64e9407396f6b2996c42655c3857c1afb258e9cf1fad5ebf785a23f8216fe8,t,46807,2493395,,5000021,2018-01-30 13:46:54,73
0xa5c3207697ea0466d3e5a435293e590a72d3a5a68bada25bda7ccf7fdf27a114,t,37155,2530550,,5000021,2018-01-30 13:46:54,74
0xe506596ef870cf0d3d1ffe2257df785b3224b25d5a2df3f837d1d570d40a9d64,f,24156,2554706,,5000021,2018-01-30 13:46:54,75
0x3084722984c5da9a942d07cc98f31a4b0177021789bba92e2dcab798470ec4b8,f,24156,2578862,,5000021,2018-01-30 13:46:54,76
0xe40936d97913a341253eee79b44d3b42b39d3711289de69cbbbd9c4b4721da92,t,37948,2616810,,5000021,2018-01-30 13:46:54,77
0xc8e58bc820e1bceea91d2335617ff5fa7eb6a314b028c19aafb2ebce1ff489b0,t,21004,2637814,,5000021,2018-01-30 13:46:54,78
0x5915f802a62f3a1c95071322e01e84f9da752983ee69397c446b797488e488be,t,51545,2689359,,5000021,2018-01-30 13:46:54,79
0x42155f2b031dfd07d1b6d6b0c7531293f6859e6b85a005a2d103095827078bd9,t,92026,2781385,,5000021,2018-01-30 13:46:54,80
0xa8d4fa03e3e0f90426d020f1055658c1e1eedd987db9e02482fcd2e37d5c030c,t,37819,2819204,,5000021,2018-01-30 13:46:54,81
0xe4fcaf18627b4ccf70a0e0c6fea87f52c459358f23cf985877695691437699d4,t,21039,2840243,,5000021,2018-01-30 13:46:54,82
0x40755b8ed17dae3f9a380405790b705385bcfc78df68f451b6418ce515eb2c42,t,21000,2861243,,5000021,2018-01-30 13:46:54,83
0x9fd93c2daf6bff5c3328b17ce566bf82e74b1ce6195b6a9373eb7d92970e1e64,t,41490,2902733,,5000021,2018-01-30 13:46:54,84
0x2e499ef04ca9539f786d53c74dd326c4abf94160bfecd4bf1d9aa7179286ba23,t,52249,2954982,,5000021,2018-01-30 13:46:54,85
0xbbdbcdcbda61aa90a7f6dfee4202c9083a02a6f4809247d10c1ad7e0b9da1b01,t,21000,2975982,,5000021,2018-01-30 13:46:54,86
0x35ada3848a224cf897b014c5b3c29fa370e0bd94fdd72f32e5529c7ff49c2494,t,21000,2996982,,5000021,2018-01-30 13:46:54,87
0x4d1db221cf2e01a2d232de4411e517a3675fe9a9ea3fa5873e2325338e5e3181,t,21000,3017982,,5000021,2018-01-30 13:46:54,88
0x7b862803d63174f0349ca78018fb46ecda67369343957d968ee3f0f847b27db2,t,21000,3038982,,5000021,2018-01-30 13:46:54,89
0x2b9821648e10ae98a1f37308c9f20df61b704a6c8206349f9d01fbbad614e1c8,t,21000,3059982,,5000021,2018-01-30 13:46:54,90
0xf3e4275b122a9d279c9cf3578d8634591fb0773ff6043cc06a38e92dfc6aa845,t,21000,3080982,,5000021,2018-01-30 13:46:54,91
0x878241bdd3b1fc3eb83139fa6b99955ac7068d64513c039891e5c3ca284578ef,t,21000,3101982,,5000021,2018-01-30 13:46:54,92
0xce17fd18c9ce099c67b8b41eb716b7a91ed04e77193bd9aabcdd88d75f0a8555,t,28633,3130615,,5000021,2018-01-30 13:46:54,93
0x977aa7bc7abe50c100ef60e61820f549fe2d5323132b6eb655462f353af7aed3,t,21000,3151615,,5000021,2018-01-30 13:46:54,94
0x10d866e7b38ed76788ff9d09ea7df82e92965ac77574dfe9b97c2577125c0d68,t,21000,3172615,,5000021,2018-01-30 13:46:54,95
0xb50d76f38691023259cb4fc976fa346152a7cb5fde27f2de36e56927ba84acfa,t,21000,3193615,,5000021,2018-01-30 13:46:54,96
0x96a3011a591cf2bc9f142284b300ad25916adaa4f11f41d920984b3e6e04626f,t,21000,3214615,,5000021,2018-01-30 13:46:54,97
0x8a0e2f9cf727d007d31f9599cfad903ba7bbc9e0bb1fb9a12a66c5d922635e4d,t,21000,3235615,,5000021,2018-01-30 13:46:54,98
0xaae9520c6059114fd6a74162cb7695acaaf19e85c8868c0d8dd618e5a31642b6,t,21000,3256615,,5000021,2018-01-30 13:46:54,99
0xa7a59ae552f0e9bc37a67d27a45592315494d4d9bb22fd398f415328f80eb151,t,21000,3277615,,5000021,2018-01-30 13:46:54,100
0xb77956092e8733ea94045367508cd8cd6b19d44e45ea8f15b623b4f59e816c78,t,21000,3298615,,5000021,2018-01-30 13:46:54,101
0x28034f0a52baf5cc70d4c6d06089aaa47034fbc68c1d1d29620a2946a44d7afe,t,21000,3319615,,5000021,2018-01-30 13:46:54,102
0x35801fa1324ebc7e9dbe8ad0f71c0c4f218ee3d05de27b12d16dc0a26c0a0278,t,21000,3340615,,5000021,2018-01-30 13:46:54,103
0x66e10557bd614a7e6bbce5b3722ab330c1a46e05b8116a6319147fbc38b5c243,t,21000,3361615,,5000021,2018-01-30 13:46:54,104
0x82d975ca44d1d8584c7c5c4ded3a98082ddaab11c50e0cfb61514d9e16cd213b,t,21000,3382615,,5000021,2018-01-30 13:46:54,105
0x12267eab4f38452f98ffe5ba05c6db50f4d2581fe592eb7d7439e78a6af6b194,t,21000,3403615,,5000021,2018-01-30 13:46:54,106
0xb6dfc477b184ca44a4c7676d224e016883f496b45cb436fd81a32872d639c67c,t,21000,3424615,,5000021,2018-01-30 13:46:54,107
0x0c509bc966d9412ee4c2867e232fc04e190f9e042037f671a88947871113f33b,t,21000,3445615,,5000021,2018-01-30 13:46:54,108
0x8ef13ed7fd454ba13b0095919d3081e432bada2f2a13c689203a6adbfc67a067,t,37507,3483122,,5000021,2018-01-30 13:46:54,109
0x944a15006fcdc53394072c8c7c03dfead1ad3c555b49ac783c4a8604c5b7f09d,t,21000,3504122,,5000021,2018-01-30 13:46:54,110
0xc232d5676394ed05f42c225784e7e725bf6aa1e8402fc298cd834cfd53beb003,t,21000,3525122,,5000021,2018-01-30 13:46:54,111
0xe2b45331f2b1ab85e5a17a3a90ed57f25c05b58845e5f6edf7c0674ea29430b7,t,21000,3546122,,5000021,2018-01-30 13:46:54,112
0xdf4ee2cbbf91861ab56f2282bae3b167236c16e6b1b0014cf1fc8f98b0cd8a07,t,21000,3567122,,5000021,2018-01-30 13:46:54,113
0x6ad3cae0b906b88686aafa4f048d0b2de1c0eb6a0e8aa5648cde4f1c7958d846,t,21000,3588122,,5000021,2018-01-30 13:46:54,114
0x07ebb1093a9f9587a3a56f02c936d5d97e5b6f78841da7a3ee55cfd2b0519b68,t,21000,3609122,,5000021,2018-01-30 13:46:54,115
0xda1b94398b8fdb84667904629e5080bc4b7eaab7c37ee6fface668cc506d97c7,t,21000,3630122,,5000021,2018-01-30 13:46:54,116
0x2c183d679e68c9d131721193038233ef0679991925b090b2ea2a8eec6a28fc93,t,21000,3651122,,5000021,2018-01-30 13:46:54,117
0x3fd6eb67e0301dfd5409828bed56c7dd0af74e15a4245d2cf7fdc358acedd7cb,t,106449,3757571,,5000021,2018-01-30 13:46:54,118
0xffc8affd5ee55fbb25a516b959fedbca02707d1b398a8c2b48fd47daea0de131,t,21000,3778571,,5000021,2018-01-30 13:46:54,119
0x85c562e678d6afc07a35bd3553851a5d1fbfeaf2e184f2e6c825bb625e683f9f,t,54835,3833406,,5000021,2018-01-30 13:46:54,120
0xe69ea487b33e0b0e17aa83798139150f5610fe86c51f11274993e0b9ccef9a1a,t,21000,3854406,,5000021,2018-01-30 13:46:54,121
0xdef55199d35b2e23131a7ed6b8090fa91b2044b885bde4a5a5fdda5d2d05302d,t,21000,3875406,,5000021,2018-01-30 13:46:54,122
0xb2514100648835d41194b23d6c729a8f6eb33b6468429d6866678a1a1958e2af,t,64725,3940131,,5000021,2018-01-30 13:46:54,123
0xcf01ce08e009217d4dec9b2cd7b64067e051229cacef6b2a6503075f1e2b574a,t,21000,3961131,,5000021,2018-01-30 13:46:54,124
0x7b64f9b72bf47d4f55c5b0fd5e6bad1509860505fda0619056502623655d2ee2,t,21000,3982131,,5000021,2018-01-30 13:46:54,125
0xb7e3120c73e9bc42cd737101fa674d39cb93d58e758c2c2e66376f5d4e705385,t,21000,4003131,,5000021,2018-01-30 13:46:54,126
0x4475135b4d80c2f90c1fd86bf2a23af03fe30d9e9033c78faabd214a6088d1f3,t,52153,4055284,,5000021,2018-01-30 13:46:54,127
0x1ebefafb428c0d22176926f3ac1dbde0e69bd172639f4e455a8189e1418b12b0,t,36388,4091672,,5000021,2018-01-30 13:46:54,128
0xfd0c5ba1ff8b6650c382e2a7633e0c986a8f7ed2a4a617d2588afc7b4381569b,t,36388,4128060,,5000021,2018-01-30 13:46:54,129
0xd71e86ee064978cbad9a719c9e4877cb63291073a8a942663b7a35408136377d,t,36452,4164512,,5000021,2018-01-30 13:46:54,130
0x4bc315e0b4a9bc38e7a8f7468b513d7b7a96d6e540fc2ba425cd7e9ecbf343a1,t,21000,4185512,,5000021,2018-01-30 13:46:54,131
0xd7938e7d93fe3dd1eee5b144045e201bd4b3cbec33a817c2a8e5a3e1cef3da20,t,21000,4206512,,5000021,2018-01-30 13:46:54,132
0xb6b49683ba2159210ed26e0499806f9f9e7594f30f72d43b64f0339fb973dd23,t,21000,4227512,,5000021,2018-01-30 13:46:54,133
0x0bb58cc97931a88b41e9dd9a9c44cd521106f31d1b6d93fe8a841190247c72ce,t,21000,4248512,,5000021,2018-01-30 13:46:54,134
0x947c276337308598171b3804236f9e18ff04938eecd1d45fba7c44cd14665f40,t,21000,4269512,,5000021,2018-01-30 13:46:54,135
0x92eb2cdc9d46b67c4b2544089cf354ef105f3f1cea4f6763b8cc9412eda116ca,t,21000,4290512,,5000021,2018-01-30 13:46:54,136
0x4b6649f01989fb57af891f141ede7ba0dd4762b6c0434c71b763406dd593c98f,t,21000,4311512,,5000021,2018-01-30 13:46:54,137
0xcd23208f0e1abd31000b65a51fd78cc3cd32b023acbdb9baae95874e79674757,t,21000,4332512,,5000021,2018-01-30 13:46:54,138
0x2773ce18d06a0c13b236b35d4b50a9ef94d6069e47c338563b642d2e9f0f6d1c,t,21000,4353512,,5000021,2018-01-30 13:46:54,139
0x00a24415be3b2eb0e551910ce5edeba8ca86a08d8a53abe6f26589c92cd44220,t,21000,4374512,,5000021,2018-01-30 13:46:54,140
0xe5c74b9d3c36aae67e5edf909cfabf1427e22c87bad92123bfae28aaa844d752,t,21051,4395563,,5000021,2018-01-30 13:46:54,141
0x37e767fd68433ed86eda19bb458ed0045d96a32433e640abeff81f1a4db54b3e,t,21000,4416563,,5000021,2018-01-30 13:46:54,142
0xa2a90591c2321f13df9ca6eda514bebc95ff31784fcbb73f5fd743938ee50750,t,21000,4437563,,5000021,2018-01-30 13:46:54,143
0xb3c52a5156da7195c0c9adb7c8547f11e762965d6b7cc78770c52e6fe795fb99,t,21000,4458563,,5000021,2018-01-30 13:46:54,144
0x3e028c375805c0eb2af47b55ea70c60ab571d0dfd413d4ed6225f663d05d2704,t,21000,4479563,,5000021,2018-01-30 13:46:54,145
0x360903f512a6882a375372ef4b8201daeaf5ba4140e351785bf0f726a52c1bc9,t,21000,4500563,,5000021,2018-01-30 13:46:54,146
0x0764d013a332c16ed965984ba3712fb095c8742c03dd469c5e700cd77d2ee7de,t,21000,4521563,,5000021,2018-01-30 13:46:54,147
0x230baf641f6c63aae7828144a6fefee3d33d0ad3bd3cdf37ac9d7c135c4129bd,t,21000,4542563,,5000021,2018-01-30 13:46:54,148
0x62dc53e1c588b5fa3c5e85f4e1a16ee7d3ae76e9ffb441fc60a7cb456adedf5a,t,21000,4563563,,5000021,2018-01-30 13:46:54,149
0xa817a59c047ea60a93b815d724a854495a702ed64562c7bc87a70d6f1043a0a1,t,21000,4584563,,5000021,2018-01-30 13:46:54,150
0x6d39364867a0ce516558f4161e1b453ba6795b725f6c6fbb2cc1fbbf49537ede,t,21000,4605563,,5000021,2018-01-30 13:46:54,151
0x2d8d05384cb3e09eafbd6800f49418291c1541a7b35762bf693159fccdf8e8b6,t,90402,4695965,,5000021,2018-01-30 13:46:54,152
0x24e00e193344ea990923664d0c223860f5c998739f3505da45470a3b6d6586a7,t,59290,4755255,,5000021,2018-01-30 13:46:54,153
0x0496202800d5f9012712c97bbc81f1c1119e7619782027542ce9f9b993d7967a,t,22042,4777297,,5000021,2018-01-30 13:46:54,154
0x3ebc9c1f33fe9b04fadf3a627ba878f7d1753f3cd9830e813117e4f6755101cd,t,51789,4829086,,5000021,2018-01-30 13:46:54,155
0xf945217080061be045568f0fb98bcaa046788a8da32cddb05d10221bddd06778,t,53028,4882114,,5000021,2018-01-30 13:46:54,156
0x662093ff385adb1b60e1f8c52c5067d64ef0d18f4eead9dd025c4f579cbb0f44,t,21000,4903114,,5000021,2018-01-30 13:46:54,157
0x84231a23f051b00c3c71d26453254a4aedbffa417e1d3fb57c66824348910f57,t,38382,4941496,,5000021,2018-01-30 13:46:54,158
0x71340f3f305d86ccde26d07ca20ce4f7e4774c44a30e08b2cebcb8aa3233be89,t,51820,4993316,,5000021,2018-01-30 13:46:54,159
0x741cce09c8964f01dfcadc29b046f0a310d38a8c44e83a754c5138779c31e801,t,21000,5014316,,5000021,2018-01-30 13:46:54,160
0x7582e8090d3fe6578a4174c38bf186075d015216a6317b62965dd966604227fc,t,21000,5035316,,5000021,2018-01-30 13:46:54,161
0xde675882ebd8933bf0a275639e5a0a46edd5a193d3e8710de2fd9843473c429e,t,21000,5056316,,5000021,2018-01-30 13:46:54,162
0x1226d11cc58ab12b25974d78eb9b6f2f481baf3f5de77a5f6bbaa5d38a2f51ce,t,21000,5077316,,5000021,2018-01-30 13:46:54,163
0x37fe4fc1236851407f592462c8f20ab54eac927099473d9b74696b7340294659,t,21000,5098316,,5000021,2018-01-30 13:46:54,164
0xa1fbb5c11b23ddf1a2d3ebe4a98d08fb74f6d637c97f7e06e82a10c99f99602e,t,38318,5136634,,5000021,2018-01-30 13:46:54,165
0x88b90155e7bc81821494463c2ef976b3c0f96a7b804c904b9fa72fc8826c822a,t,38318,5174952,,5000021,2018-01-30 13:46:54,166
0xf80543cdc4f9e40de3cf0157d6c8fb3a828e6666f176a93f1549fff35af1650e,t,37356,5212308,,5000021,2018-01-30 13:46:54,167
0x0d76dacf74d9248ab10f871c0bad912d26eb9acbd69c44d3b67420bcc6b7e872,t,21000,5233308,,5000021,2018-01-30 13:46:54,168
0xd83ec3290ff03ab71aacd7378f4732f58d7023fe5c56bae1eb47b7d73714cdcf,t,37065,5270373,,5000021,2018-01-30 13:46:54,169
0xd3b2997b81397c8b662d3e925bd89b604e1aa27be8835ed5f199030c4bac32e1,t,38748,5309121,,5000021,2018-01-30 13:46:54,170
0x66296cc3863f17768183f2653565d5025a7cca2601a083c05c6cb7c4ecde9687,t,21000,5330121,,5000021,2018-01-30 13:46:54,171
0xce7243b7bff9b31d2a677aae11a2c492b3210fba1233cd639cb6ad4f0b409d5d,t,21000,5351121,,5000021,2018-01-30 13:46:54,172
0x55ba1f880b424f56ab03ce6019fcc110bc220de2d7958eb0b1d68645765ef7f5,t,21004,5372125,,5000021,2018-01-30 13:46:54,173
0x2f2fff60f5c01829fb73fff41f3de84465234d88ac6e4c8440b5789b563c3b4b,t,21004,5393129,,5000021,2018-01-30 13:46:54,174
0x4a66fd1979c7de8ded81b1649a99af32cda2583476962a7fcf1a7a180696f3b9,t,21004,5414133,,5000021,2018-01-30 13:46:54,175
0xb42f5015cdc213e985c0cfb1422121e3a22d81f7413a640f6630581e25ce00c5,t,40971,5455104,,5000021,2018-01-30 13:46:54,176
0xa6bae31bae35e853cac757cc3fde04ead6ebe1bdd0d3420524ccbf26cf16e41c,t,21004,5476108,,5000021,2018-01-30 13:46:54,177
0xfb81a4c13887ee10dac253ef6a38cd6f58f6c279a2712e04acdf06ab0ae38fed,t,21004,5497112,,5000021,2018-01-30 13:46:54,178
0xfdc14b0d83d2d1d394da2ee88402ff98ca873235ac6bfe1c30645d49d71a60ad,t,22094,5519206,,5000021,2018-01-30 13:46:54,179
0xd2dc33e4529015f98aa29b8b6c9d371071e18099e0f0e556427bdad186d7afe7,t,22091,5541297,,5000021,2018-01-30 13:46:54,180
0xe03140c7e53c50cfc9794a6111be63c7aac7b7fbf94c4d6966f540be622b44ae,t,21000,5562297,,5000021,2018-01-30 13:46:54,181
0x10ed797f9a2ebd5583cfaad50ff58f1fff6291c7191bd47803b044185d7616d1,t,52524,5614821,,5000021,2018-01-30 13:46:54,182
0xf628f84f878bd5f427dffb23f955a6ee57b526aa287279bcaf939e64b4debcbd,t,78862,5693683,,5000021,2018-01-30 13:46:54,183
0x4c581e1946681e4b21cd114e6bd64857265a3a4a6dae3101af513010fed26227,t,21000,5714683,,5000021,2018-01-30 13:46:54,184
0x1ef5ae4c2c6f9f6eacd38a5237481e50875b0eed29f9e4c788faaa460a6f262b,t,53233,5767916,,5000021,2018-01-30 13:46:54,185
0x9a91ebf7888c95b8ee99cbe4d336dd7b80fef32bb230a6721a49a98fcafffe92,t,53233,5821149,,5000021,2018-01-30 13:46:54,186
0xf04e3f4aba5b8a4eb6c1cce694c0fbe68316e6857b95ddd2754da5dc538c000c,t,53169,5874318,,5000021,2018-01-30 13:46:54,187
0x6e6e2cf787af23edbdb47445b93d659b279fd200cb7f05f820ec619de028e5c1,t,102934,5977252,,5000021,2018-01-30 13:46:54,188
0xc7222ea4ec4ac466c788032e5883c255bd7a8940c92ce280e2de61b50185ba9b,t,93178,6070430,,5000021,2018-01-30 13:46:54,189
0x22b31e3c0f7e56bba22f2dbe5815a6b8a71cd1da8cca862c45aa4acc71f5d2d5,t,21000,6091430,,5000021,2018-01-30 13:46:54,190
0xdb97cff0a9af6fdd108427d652a0229ac89777fd9cc039cecbda4170fe8368da,t,21000,6112430,,5000021,2018-01-30 13:46:54,191
0xba8a418c570675dc36cce2348257e72bd5c5d318bef9868f7c6cfc5cc98a16d2,t,611504,6723934,0x7C58A96F78fD1283DEA98BAc2d5164f894e7EB00,5000021,2018-01-30 13:46:54,192
0x2db2aaf7959fc174e96850aa9528273d048a3341af5fcfe7b6b6c65548111906,t,21000,6744934,,5000021,2018-01-30 13:46:54,193
0x4fbd298f60be0aae6a24cb8f00fb674cb4fb555922b6a22fcd6c38991a99779e,t,21000,6765934,,5000021,2018-01-30 13:46:54,194
0x246812f61a749c188c0761d0f3e0a0ccc7389c4ff41771ac7b46c5cb6d5342d9,t,21000,6786934,,5000021,2018-01-30 13:46:54,195
0x5d00d800f8ab042c17d684773a5e2273c4c785f886b0c108a5e503c11f7590b9,t,21000,6807934,,5000021,2018-01-30 13:46:54,196
0xbd90e7a79342705744fa929b11f9e0e485844922aab01da595f69daa47838afe,t,21000,6828934,,5000021,2018-01-30 13:46:54,197
0x16e7423a4366cb1e06be011f9e3015db9dac3f60e9888f539a422b6fcfd53ca0,t,21000,6849934,,5000021,2018-01-30 13:46:54,198
0x4cfd97357c1121fede86601b02758eba669f2c3e254661ec51e32fc09e249aad,t,21000,6870934,,5000021,2018-01-30 13:46:54,199
0x3c0a903478f904a25e9e9ad0711d95f46328700934f079f6c4a87f092ba0bcd3,t,21000,6891934,,5000021,2018-01-30 13:46:54,200
0x0a7e125261594da512ad0e7f3e26e8daea9879b7eaf85be1715888d6352bcc6d,t,21000,6912934,,5000021,2018-01-30 13:46:54,201
0xe29970aae34abcdb0e1326b7b8421231168c7fb15f1c817c0a681a59863c6834,t,21000,6933934,,5000021,2018-01-30 13:46:54,202
0x15a75329519b82d3d8f12d8047b1eabf4fda75b3092e498fd43ddcdabf040ef4,t,21000,6954934,,5000021,2018-01-30 13:46:54,203
0xec2f3144302028b1cd35f574a4b94192ac8ec78ae35cce53ead106ef5db361aa,t,21000,6975934,,5000021,2018-01-30 13:46:54,204
0x054c704909a4dae9eeac67af3c17b832190836b4d8b67fcfcc6e133382641320,t,21000,6996934,,5000021,2018-01-30 13:46:54,205
0xf05682a745407fcb6a4f9b18b42512d25ddf936c40230946e62f3de914090682,t,21000,7017934,,5000021,2018-01-30 13:46:54,206
0xe933eceaef77afe699d40a46fcc1aa8d4f44d7ea1d6a4948396db60de77bc38b,t,21000,7038934,,5000021,2018-01-30 13:46:54,207
0x07016854b1bdeec446ac16919f832f83bd7c22d2330d961519e5c426f7a49229,t,21000,7059934,,5000021,2018-01-30 13:46:54,208
0x7adc6ace93d4455a3f66593f948b8d8581a736cb8dc27bd16e3c90ee8253c951,t,21000,7080934,,5000021,2018-01-30 13:46:54,209
0x517181a3507ccd167d74091b2c6f6ee7a7171cbcf36fe2c33dac426b8f3fafd2,t,21000,7101934,,5000021,2018-01-30 13:46:54,210
0x91ba5e4d671db7258c36c81078e76ccb68f3bfe28ed0f219c9be6edade78332b,t,21000,7122934,,5000021,2018-01-30 13:46:54,211
0xd130dbaf52cc435a27a73a7f44bb4f906bafaee46a9c3ec0b30ff9042b244622,t,21000,7143934,,5000021,2018-01-30 13:46:54,212
0xdf5ba812fa031ce2ea0023f13cf0d9984615c9c58653dfad5eda4fcce337a035,t,21000,7164934,,5000021,2018-01-30 13:46:54,213
0x6f033a912b054fe53b19d9f1927bc08bcede1d41324e60dcb0a48e737ac0e370,t,21000,7185934,,5000021,2018-01-30 13:46:54,214
0xf7b497ad01265218d211b800f3b27edfbbb5f4f164e801a349400442d6dc1ecc,t,21000,7206934,,5000021,2018-01-30 13:46:54,215
0x82ff7c81bcf34dc069175516516754b1fe67e0e6e679b21c494b0436566589bc,t,21000,7227934,,5000021,2018-01-30 13:46:54,216
0x541bd7061105a7915c2d4e7d63b33a1e9ea8d910356d553898fba85c4ec464c7,t,21000,7248934,,5000021,2018-01-30 13:46:54,217
0xe9090e7537e4110c2591a0b03d7d909f92e9c8f4da9916a8dbcec2b1ad0c4352,t,21000,7269934,,5000021,2018-01-30 13:46:54,218
0x8c180cb6f03f564d358fddff0a75191563e136367be0b9707ce72497ca4bb38e,t,21000,7290934,,5000021,2018-01-30 13:46:54,219
0x5871d7849375584cc91582a3f7e40eeb50a7add7f9f8c7ec7fb0fc8843d68f01,t,21000,7311934,,5000021,2018-01-30 13:46:54,220
0xf6e95d4d6a5e157282afafbde5ad6758d6fa0fc89b2528f554814d19890b1724,t,21000,7332934,,5000021,2018-01-30 13:46:54,221
0x06351b9a33d892aa851c77e07ebfbfe9bffe9f747dd8cfe7f3ffbe534fcd1f6f,t,21000,7353934,,5000021,2018-01-30 13:46:54,222
0xc01a0500ada3c34080861ee6d99ffbb21c8cb2023d5fa1704e02c34ba6d6c4fd,t,21000,7374934,,5000021,2018-01-30 13:46:54,223
0x5ee700e7e5149d3f3324544c0a561848c060f98e31d0998f9100faef22324fba,t,21000,7395934,,5000021,2018-01-30 13:46:54,224
0x0ffb0de2ef68be89d2b326e4ae9c2782754aaa573cb8cebd3b705731bb482d68,t,21000,7416934,,5000021,2018-01-30 13:46:54,225
0xc9fb36c035f2b91fa3590731687e546a0d2ebdbe51980b8796b8b10ed57ded84,t,21000,7437934,,5000021,2018-01-30 13:46:54,226
0x318e3f6097120b39e05c607aa06074cfafe32ede0a5e01285248a1d224bc894d,t,21000,7458934,,5000021,2018-01-30 13:46:54,227
0x21dde8dfc05cae86f156368eb74cbce9bfb66f1581a9758c43cc80e418fb45c2,t,21000,7479934,,5000021,2018-01-30 13:46:54,228
0xbc52f2187904658fee90474b3f0668d3d25a1765631e63468bbdefb3fa05ac5e,t,21000,7500934,,5000021,2018-01-30 13:46:54,229
0x12b5816fa9ed08c0f5c862f253a3486f09b588d752719f3d265d341307ff04a1,t,21000,7521934,,5000021,2018-01-30 13:46:54,230
0xd28697d0ecb755b906e756c42e785254aa1eab31f37e300ac6e7b695bdad824d,t,21000,7542934,,5000021,2018-01-30 13:46:54,231
0x4fc9f1e12e2a420046d2d304b556302b6141e88be98ff3dcbb25cda905b96f8c,t,21000,7563934,,5000021,2018-01-30 13:46:54,232
0x5ee8d28868c79a10f717e594e45c664c56a423e7fb1f30b628bfe78bcf0a3f58,t,21000,7584934,,5000021,2018-01-30 13:46:54,233
0x782a1a7af28710bf7da35ffac67184e9b24941e661441d5c886e35a00b43e773,t,21000,7605934,,5000021,2018-01-30 13:46:54,234
0x7451bb86b0293c5387e9d7425b3bd7dba3cfa059f0d1a87af710424550a79709,t,21000,7626934,,5000021,2018-01-30 13:46:54,235
0xfe82e117be93b3407ac9f1b5b4ff2833aa62b45684ba3f913a9e20f52533de39,t,21000,7647934,,5000021,2018-01-30 13:46:54,236
0x7ec9123cb1fb31ae4ae303786d7db8f0454f52d3b830cde9702050851837c26c,t,21000,7668934,,5000021,2018-01-30 13:46:54,237
0xd7f6186631d47cd988c2bdbfc19b95a2624b1772ce808aa4fed50ba57112c8a4,t,21000,7689934,,5000021,2018-01-30 13:46:54,238
0xb67ed89965f67006817a5ecfe1404a4424bc2f3c909f642fdfca118d0a609d33,t,21000,7710934,,5000021,2018-01-30 13:46:54,239
0x6ef0339acfae0d5b0d323c3c4848c40336bec28efa52e97a1ce533f719d173d8,t,21000,7731934,,5000021,2018-01-30 13:46:54,240
0x8e603450d046b34ef8107611c360b1e50a69976c6cd3693a5d3b24dd6818dae0,t,21000,7752934,,5000021,2018-01-30 13:46:54,241
0x14fcb2556d9e1301bdb622c0ae3bb4e25d19ec28cc906783ebf068970d8548ce,t,21000,7773934,,5000021,2018-01-30 13:46:54,242
0xa73cf7da10452e6c6538377e30f21791f9820aaac9bc49f2319493626583c924,t,21000,7794934,,5000021,2018-01-30 13:46:54,243
0x1452cf93cbdca5aa5fa7cb3884586e0b6cb4bb5f28d248f542eaa1b0028f8edf,t,21000,7815934,,5000021,2018-01-30 13:46:54,244
0xa49ebec261d5f1ebf982f6935d2963dde57bbd3d8a461e6e46e4d39526628454,t,21000,7836934,,5000021,2018-01-30 13:46:54,245
0xa605fdc730a5c91ea22776d6b4085a693fa4804ab8d8e37d9b5214c07c2c57e0,t,21000,7857934,,5000021,2018-01-30 13:46:54,246
0x9fd7f3d275253dbf978e235841b8f25e3ff95e24f2b4bb7276f7e6d6f7822433,t,21000,7878934,,5000021,2018-01-30 13:46:54,247
0xa0152d3430c8e51115a8830296c3e5ffb642271ac40253c3517c07ae5121603b,t,21000,7899934,,5000021,2018-01-30 13:46:54,248
0x03d35a0f80189cf09375dbf8b92fa082b68a8dedc4af88b9c7ec6dcdebe3bfe3,t,21000,7920934,,5000021,2018-01-30 13:46:54,249
0xeb078ff48c47087cff4d92e917a7b83e1332b2827ba81e33ace3443ca3203843,t,21000,7941934,,5000021,2018-01-30 13:46:54,250
0xdf0a8f7acbbcb39444528d6d517ad8a1760c716ae806dfee1fc1ef14adbd5918,t,21000,7962934,,5000021,2018-01-30 13:46:54,251
0xc5a87cac6ab0ef7c73c6f1740a06ac3bab8fd69e074c8e0f6528f8f0c086458b,t,21000,7983934,,5000021,2018-01-30 13:46:54,252
0xa3d3117463d7f964da867ff3820a86f5a2bb40903584fc71eff1eaaab0dc8b18,t,21000,21000,,5000022,2018-01-30 13:46:57,0
0xdaa330ae1e7a7576e2a213d45b30cf042163a78968ae8fcbf174c5daa7c1d30c,t,28838,49838,,5000022,2018-01-30 13:46:57,1
0xd602218816143d2e2ba2e201517b860437c122eff43c19c6771a516515a59773,t,21004,70842,,5000022,2018-01-30 13:46:57,2
0x1b3e1f6a3b560403387547198bc5def76160e45b95bf9e3906f9370bcd90d1b0,t,21000,91842,,5000022,2018-01-30 13:46:57,3
0x44428b6e483dc90675c19688cba114bd2626b7e8574fb954dfaca05fafd7f045,t,21000,112842,,5000022,2018-01-30 13:46:57,4
0x362dd226b696b5f2a2b0cf45fdf36eec65a668d597c3af4225e91e8e5da29a59,t,21000,133842,,5000022,2018-01-30 13:46:57,5
0xe954579b0d8bad075eef7b3b7a6f83814487f647a62aebef85f12783a70a8943,t,21000,154842,,5000022,2018-01-30 13:46:57,6
0x790af41c0edec48f2b69013e6d3c932e874b7d775fcdfc1149e23871ef4524e6,t,21000,175842,,5000022,2018-01-30 13:46:57,7
0xc589b88eb61fdf2e9f35537a83a8c708378e5c4d1ddb9413596235f8a133fd5a,t,21000,196842,,5000022,2018-01-30 13:46:57,8
0xe8ea6346a35b64ff0f103228324cb8374580b99ced27cb9afe700ca0d6cd8cff,t,21000,217842,,5000022,2018-01-30 13:46:57,9
0xac7474d0dd1f30547122b29e0b8ab04ba965d4e7f9b77975932321d901be1fc6,t,21000,238842,,5000022,2018-01-30 13:46:57,10
0xa1fb714aefccff08fabf2064cda5494a8309b2832c1af34ca4a92470f260789a,t,21000,259842,,5000022,2018-01-30 13:46:57,11
0x9ca9008253a62415ade05b5f8405e4b59d32bf231102cde5cda5b8ffa4c0c6a2,t,21000,280842,,5000022,2018-01-30 13:46:57,12
0x311beba10184ec1db0f3ca4d0fbcaad37e73a92ef83179aefe9c430799457052,t,21000,301842,,5000022,2018-01-30 13:46:57,13
0xaeacd268be7944455b885fbacc21eb73db89381eecff755322aa9437bd8d3399,t,37065,338907,,5000022,2018-01-30 13:46:57,14
0x4a6102953cbcf86c576a588bef076682c5f874ff4c9657899eb8b2a16be6f6ff,t,157516,496423,,5000022,2018-01-30 13:46:57,15
0xe3907a6b52c98650fe0a3cab81e15b653f6d0487fb15e3d0b5fcdf858dfc7650,t,59985,556408,,5000022,2018-01-30 13:46:57,16
0xbbc45a9a3a8f78c9bd6827848e4782ea13e20bb1df148015a37c342c7d39e589,t,21000,577408,,5000022,2018-01-30 13:46:57,17
0x5f8a2532b1c5ee2ec84436e3ec8dd38d0dc2c236a5ad471c39525cd543565cc1,t,38040,615448,,5000022,2018-01-30 13:46:57,18
0xfdf237da6d12c0f614eeb47f86840e517be130dee032437fb5d2e5c6eb62d3c8,t,53519,668967,,5000022,2018-01-30 13:46:57,19
0x5232e93a1626a0550f837ffc4943d0ff45cfedc31c79318654505934c6bb4233,t,38583,707550,,5000022,2018-01-30 13:46:57,20
0xa4660051ba06c999747c861a3b61d4c036ac88666c6e221c6f346e18506ad19c,t,55843,763393,,5000022,2018-01-30 13:46:57,21
0x7b3d3479b0f4434132a3d23b4804abb69ed5316de36cbb5a325a4bf6fc0824f1,t,52312,815705,,5000022,2018-01-30 13:46:57,22
0xc4ba557a09b3113258a06962134dfd0085abfa5d09a5c0310d1cd43775326f29,t,37380,853085,,5000022,2018-01-30 13:46:57,23
0x513adbdb98df58df1d6843fb921e2fa5da3e5579780514dca753333ffa2581c0,t,36715,889800,,5000022,2018-01-30 13:46:57,24
0x4b9a26d5335566fffc34570dccc61a637fcfe7b3620def39636b45e3816bd22c,t,37158,926958,,5000022,2018-01-30 13:46:57,25
0x7ce1b657e54640a5894ac728223f2a20cf48bcd8574456ae85cc1df3fc186b24,t,91794,1018752,,5000022,2018-01-30 13:46:57,26
0xfc3b0fc512bf8e37d9e288278a2e9c2d34329ee114cb383be1d72061ff9d6bb5,t,21000,1039752,,5000022,2018-01-30 13:46:57,27
0xcd4f5c38491f1e30c22e10af7a9ef88789571745fed46f1e2c99c8a041d31301,t,21000,1060752,,5000022,2018-01-30 13:46:57,28
0x11755fd3ae18a7ede1cf761d7e07dbc32fad4505549695f0b535b757814c9444,t,176885,1237637,,5000022,2018-01-30 13:46:57,29
0x3802b5dcd7f84a835ee2efd01baed83c9fba9feeb26815602d7bd1b9bc1c0da5,t,21000,1258637,,5000022,2018-01-30 13:46:57,30
0x05799305c33b2449b9d3057ed6e98ea03852b8acad4ca25111f91eba77a6b155,t,21000,1279637,,5000022,2018-01-30 13:46:57,31
0x4ff1f58969c424f395dde6e19c6cf3aabf0f37a5f89433c5d02359f67b217fd9,t,52886,1332523,,5000022,2018-01-30 13:46:57,32
0x0a8c547f79fc108b899137c55a3d20a59076eb6fb52b937012ebbef5e44897fa,t,26607,1359130,,5000022,2018-01-30 13:46:57,33
0x0afe5fe4a17cb1b38132ea41c14eb30b2f8409e9835c2f410438def25f0e8490,t,244829,1603959,,5000022,2018-01-30 13:46:57,34
0xc74309da4389613ced9f615cf15fea36686f0770bb302c45efb396cd52929e4f,t,36792,1640751,,5000022,2018-01-30 13:46:57,35
0x7c3dcdf293ccd7cbe6204ccd64730debf81ad8259ec5469d72f3c0dfb1a30614,t,21000,1661751,,5000022,2018-01-30 13:46:57,36
0x46c15fc0bc37102e032544d678f61b8b6676ce9a3823a8b883198c5d21f40e95,t,21000,1682751,,5000022,2018-01-30 13:46:57,37
0xda94e3e3d41bb6e8b51fab884cf8dff2f35ea3188fcb1ada584d4089c5e7098c,t,21000,1703751,,5000022,2018-01-30 13:46:57,38
0x5ba07251aef26875c3b2a00d732e1b282d86dfc3505a7209fa003c609b5d8876,t,21000,1724751,,5000022,2018-01-30 13:46:57,39
0x27810479c0db640a962ea3e00f705b7c8eb8b41513a48dd135fe8fd2b1339723,t,21000,1745751,,5000022,2018-01-30 13:46:57,40
0x6fd5e3507f212060904c9657c8717fd6c4fd37a31d01483bfec80a46cc02c526,t,21000,1766751,,5000022,2018-01-30 13:46:57,41
0x8a2b31116edee61b37f75868906a3bbd5caf81bd06ff96090f88a1b8c4d33c92,t,21000,1787751,,5000022,2018-01-30 13:46:57,42
0x7b117f0861721486311b6eab8f16e416d6cc2305b4c35d87922238bc52ae3253,t,21000,1808751,,5000022,2018-01-30 13:46:57,43
0x3b590137aaa76a4edd00a4bdab5d4b9dcd877a9b777b2686e9271f3ccdc14e3e,t,36938,1845689,,5000022,2018-01-30 13:46:57,44
0x2959df25c68220b99af71f659601abf07d2637642acaf4c507b8bb523bd3641d,t,38005,1883694,,5000022,2018-01-30 13:46:57,45
0x8b56569ceb3a60f3f0250c147c9438fef966f2fc6e961673aa951b809a326bd7,t,21000,1904694,,5000022,2018-01-30 13:46:57,46
0x88ea73ac450a91133259377c2fdaf923508949f2a7c03657a007fe81c009b51a,t,21000,1925694,,5000022,2018-01-30 13:46:57,47
0x4a47c7fd52afabc963a8d59d97e74a961c579c7718b5c0004f83fc7040c9341d,t,21000,1946694,,5000022,2018-01-30 13:46:57,48
0x6cd65e15b62dab6d8221ec20eee92b40d296e278f091b1d88722abd83e5b63da,t,21000,1967694,,5000022,2018-01-30 13:46:57,49
0x4c52097e993fc051662ff6bd6465eb93a328523f271efc45f4a60e8282c563e2,t,21000,1988694,,5000022,2018-01-30 13:46:57,50
0x3763eee47dc0b5691eab41190b02622e1fa5546eae0742ec8eddb9ff17f71d25,t,52175,2040869,,5000022,2018-01-30 13:46:57,51
0x0d4fb5fef9ce0760510e018572aa24895c62cb83a9112f3a5964cb2144cf105e,t,52904,2093773,,5000022,2018-01-30 13:46:57,52
0xae98a059f22ab80d06109f523d600e5af8bc19fccceed513b9403b84d8311884,t,39512,2133285,,5000022,2018-01-30 13:46:57,53
0x945ff267929a894ca389a473a76ad9dfc4c7fa490c8b0b4f20a8a8e4c5d8ece5,t,21000,2154285,,5000022,2018-01-30 13:46:57,54
0x63cff54d6dce28ea903044dd288134e420711f1a0df308c44a6974ff1a909ea4,t,21000,2175285,,5000022,2018-01-30 13:46:57,55
0x3ec0c087dcf8586d6c90d7091af586c233e2be96c29d09808f10626b4a9cb89f,t,21000,2196285,,5000022,2018-01-30 13:46:57,56
0x410b8b42e9f33b894106ceab70e2b0e4f2f2ec85bc22b355047cf18398e70679,t,38455,2234740,,5000022,2018-01-30 13:46:57,57
0x1f71f85969a1e151a5f5b68eb20359e3bc8abafc1add8cd4cd5363900f264179,t,21000,2255740,,5000022,2018-01-30 13:46:57,58
0x088556c5864ab61e85d185a8c980bb4947e1762cf905e04d75cca4469bc1d0be,t,21000,2276740,,5000022,2018-01-30 13:46:57,59
0xe09f124e6381a7d5131e6a694c29e76168770c43387f7beaa691c6d9e209c378,t,37246,2313986,,5000022,2018-01-30 13:46:57,60
0xf28338b5cb831b3543106005918c5277fca4c1ea8b1223bf885c209adc34a975,t,21000,2334986,,5000022,2018-01-30 13:46:57,61
0x9d92bdbdabb2aa1e5baf802ff903fdc370496a107092385f6315f64b1a513588,t,21000,2355986,,5000022,2018-01-30 13:46:57,62
0xfa2fc530934596789b23ed5b5cc59977f030b30516c66e97136e6285264715a9,t,21000,2376986,,5000022,2018-01-30 13:46:57,63
0x222d4a03018e55526d26f32ef0aa016d5317e8a553d893785335095fcd791176,t,31005,2407991,,5000022,2018-01-30 13:46:57,64
0x8b12eeff84b98a9491a03801cc60c2427b3904b52cd3a2f357ebc71b2f98fd8c,t,21000,2428991,,5000022,2018-01-30 13:46:57,65
0xb0265b3febaec8deafdbfd223e1d4dcc8f2275a23c5411bec8981cb571386ed7,t,37900,2466891,,5000022,2018-01-30 13:46:57,66
0xbc5814f72183410e5fd7d56ce0ee830f4682b7bf93745bc8c6367f1bd664e29b,t,21000,2487891,,5000022,2018-01-30 13:46:57,67
0x3edccd76b4c9c9508d2d42a5c4175ec69138388805776366d6e5700b9e5b544c,t,21000,2508891,,5000022,2018-01-30 13:46:57,68
0x1af51d5189eba39eecbbbc0130a1af56fd6f954cbc8ce5ac3583d2de4273dfa5,t,21000,2529891,,5000022,2018-01-30 13:46:57,69
0x67a2d72ed459127bca2538973afadc6c6d70e652bbcf5667067d3a261c98d83c,t,21000,2550891,,5000022,2018-01-30 13:46:57,70
0x939e99c062dd46b127f38f56cd643f94a6ee6ed36c9dc9888bc6fa1ec34318d3,t,21000,2571891,,5000022,2018-01-30 13:46:57,71
0x08590e86a2ccc23a14ad6ff6131db541aa12b55386144ad47cc374e66ba7f34a,t,21000,2592891,,5000022,2018-01-30 13:46:57,72
0x35bc8fe41c1a37febd5ba60e703a3b4310757cd3ed3076bd28128ed5ac0cb7d1,t,21000,2613891,,5000022,2018-01-30 13:46:57,73
0xe6ad41355de8acf71a76ef59d75075f803aab60721d17232d7ca961612e82071,t,21000,2634891,,5000022,2018-01-30 13:46:57,74
0x58dd02a3018561698fa7ae20b2e0fb76be4263471388f0ce71521f810fd84142,t,21000,2655891,,5000022,2018-01-30 13:46:57,75
0x2127fa6184336ab736d5a4688eb7f7bb476466dcf3075d7fdb016f73f557247b,t,21000,2676891,,5000022,2018-01-30 13:46:57,76
0x996c8ac8dda24b7b94d2b9b7a845d8404965580484985319ff44e8a370765cca,t,21000,2697891,,5000022,2018-01-30 13:46:57,77
0x793f04708bd242e6abe344fd225f29a3b15bc33fa2ad6a179334861002671a8c,t,55843,2753734,,5000022,2018-01-30 13:46:57,78
0x642c913c4f35226d27052c30ec804f69b01085deb5d32b024beebdd6eff24bd6,t,21000,2774734,,5000022,2018-01-30 13:46:57,79
0x184658c22ed36851a765de79b4d93f67cb7cb1217d613b112d98ba965bd9c6db,t,21000,2795734,,5000022,2018-01-30 13:46:57,80
0x682dea9d107d8cb4e11f92d17942d456879e6430365b2b57f3c28d521d818652,t,21000,2816734,,5000022,2018-01-30 13:46:57,81
0x7d05ed1972ba76eca7325f53036a52513d90d0ae98e3be1e69f0aa4e921622ae,t,21000,2837734,,5000022,2018-01-30 13:46:57,82
0x1e5bd40e11e59a96a7d9cf7e3dc3cb4f14e1959000a71ea42374af945aa2c9a7,t,21000,2858734,,5000022,2018-01-30 13:46:57,83
0x94fff3e92d82c8ede6b588b1aed646cc7ded1ef742a5783ac2feaaeb50a23e2f,t,21000,2879734,,5000022,2018-01-30 13:46:57,84
0x93552d83272d968080d5e1a71c803082660a594da93e8f298abe59c0904b4ef9,t,21000,2900734,,5000022,2018-01-30 13:46:57,85
0x269478a4c040b339211a9505be50f3d3a526f0e4bd50180cc92f978af9729892,t,21000,2921734,,5000022,2018-01-30 13:46:57,86
0x25f710b48948d72c9fb54c377678d8768551daec94cce0eaab4a21e506f06547,t,21000,2942734,,5000022,2018-01-30 13:46:57,87
0x75311d5d243cd03467b0aba627ba54598a64db18109359cfce9ff4804b8b6d09,t,21000,2963734,,5000022,2018-01-30 13:46:57,88
0xd4be6454d41cc6c5166eb9889f566b43b80bd2af61dd8a1a947761bbdfb479e0,t,102998,3066732,,5000022,2018-01-30 13:46:57,89
0x498879f25b858b9ba4d67c503aa011805cbfd8e53f4a61fb323324126324e7dd,t,21000,3087732,,5000022,2018-01-30 13:46:57,90
0x39c22cd56aa8ee1e2800d29b4447ef4d82f1c46a261be4628f1256e024231b72,t,21000,3108732,,5000022,2018-01-30 13:46:57,91
0xb3947bdd8d8a2695e4b742cc6621023a4c63f3f4f85e38a1be7baadb690a05e5,t,21000,3129732,,5000022,2018-01-30 13:46:57,92
0xb43bd49c37561738a3deb6f15088b5b27ee71ba59fc917a3ee03da7c331d3855,t,21000,3150732,,5000022,2018-01-30 13:46:57,93
0xe09579d57e4c6503cdefd9ef1abdb06114e5caa976fbd4db5794b2f99f4fc13b,t,21000,3171732,,5000022,2018-01-30 13:46:57,94
0xea1eb6aab3276e35ea0f32605351b5cb9a140bcbd795bbe95ac40a8c896c0782,t,21000,3192732,,5000022,2018-01-30 13:46:57,95
0xf47cf3cf162c26a795edbbd34c3d7166ebf5f63b2bbad96c9f35d0306f1c9154,t,52084,3244816,,5000022,2018-01-30 13:46:57,96
0x118dbe33709cfadf022058bd535cb0444078cfeb3e034aa566d3892308b01b55,t,21000,3265816,,5000022,2018-01-30 13:46:57,97
0x218246f1264865584eecc3747c4925add54e30758f22c62bb930d5ede044a9e3,t,21000,3286816,,5000022,2018-01-30 13:46:57,98
0x5b9fdcfe3889a5bac3c795c1f53d3589516dd8ec1eb5485f752273c97d81ea28,t,55669,3342485,,5000022,2018-01-30 13:46:57,99
0x517dcd16eac76568fc054aad4a4a5e0c6a0a348127b2a258cffce71556981ff0,t,21000,3363485,,5000022,2018-01-30 13:46:57,100
0xf1513a1fe4fd2b7208344ea312e631b516cd29ed2a771654928966c4312c26ff,t,68232,3431717,,5000022,2018-01-30 13:46:57,101
0x6214eb456fd3383620d926728e599c2a7eb969fb43082ca9621c69a0a3364c9f,t,38233,3469950,,5000022,2018-01-30 13:46:57,102
0x22914b914f7b5944d1b80b000261eac4f3c1f5e56ef4fba58a1df567a91c1d1d,t,164716,3634666,,5000022,2018-01-30 13:46:57,103
0xdb72cbeec93afd9bee7b591a95c048e652fa8d9399c7b454f0d1afa90bbd606b,t,36606,3671272,,5000022,2018-01-30 13:46:57,104
0xd344086551dd195149a4959f11f267dd70f183b9f7d51f3755b3154eddf2278f,t,21000,3692272,,5000022,2018-01-30 13:46:57,105
0x4906870e1404b7f50d891af4b9111bca3e760fd3a46f41b487ce1717d8b4dfb9,t,159007,3851279,,5000022,2018-01-30 13:46:57,106
0x7a730579540a4c7b475e901c2dc66a64af89bc63b86344a0523eaee2aa6a4ca4,t,196340,4047619,,5000022,2018-01-30 13:46:57,107
0x9186f56ef6bd579f5ad4b05907d8e5364bd997e4b37ec6b275d9007ff7acb9ce,t,52460,4100079,,5000022,2018-01-30 13:46:57,108
0x0ebd1bbd4b2387be6deff553d90f936063a03257da1ba898dce20c66d4316af6,t,279531,4379610,0xD15ADce50E9511327aF6dCc9F5956FDCb78b4D1e,5000022,2018-01-30 13:46:57,109
0x47898e1465d24597df343753cff7bd23a3a88cdc461bee289f64d3cacf5b2a69,t,37068,4416678,,5000022,2018-01-30 13:46:57,110
0xdee0ceb7b52910563dd837620dcb66966dd04586ac95b04fafc842b9ff5b5105,t,77538,4494216,,5000022,2018-01-30 13:46:57,111
0xcbae313986342b67f42172e299172ece093f844d59b546dba8e74eda44ae39e1,t,36544,4530760,,5000022,2018-01-30 13:46:57,112
0x4367077c28146a2b42d5fa9077cef7706cfd68853dc5d8f6573e6fc32cb952d1,t,21000,4551760,,5000022,2018-01-30 13:46:57,113
0xf063ac0d751f7b35a5df7c23f2156304bf661a09341b04a9a791e065d247aa35,t,52507,4604267,,5000022,2018-01-30 13:46:57,114
0xa580d54fc022bc22d8734716aaac5b9122e7e6519ca7daeaedcd730d86608148,t,21000,4625267,,5000022,2018-01-30 13:46:57,115
0x8b229acf166a1679cdbb687b6fc40b64b9ee73bb084caa5bcc58e5be802b7fd2,t,140404,4765671,,5000022,2018-01-30 13:46:57,116
0xab939f02fe959283c89d202bf9cb8ce4b93320cde8682100b88f9bc79104fe02,t,77922,4843593,,5000022,2018-01-30 13:46:57,117
0x35fb27d9a70734ca251508c1df1da4a88993d298fcfd687b9469f0d53b2e8f60,t,51606,4895199,,5000022,2018-01-30 13:46:57,118
0x488e187d22338af64442ce4d129e0c2f008c82da84c868a6ffb18f2699708cc6,t,140047,5035246,,5000022,2018-01-30 13:46:57,119
0xe1623d9bb687e597b4e99968b8e253d870b57448e7dbb33375f544b63b0deccc,t,43940,5079186,,5000022,2018-01-30 13:46:57,120
0x8b71ab55dc8948c32ec295f89c97009d610fc72130985b1fc083b767c9cca223,t,140260,5219446,,5000022,2018-01-30 13:46:57,121
0x15fa0b96e649eea982aff4c1f2c5d9f7c52ec5a12d5fc28f1b108b077b5e68e2,t,22316,5241762,,5000022,2018-01-30 13:46:57,122
0xb8fb05aa64071ddc03edab0ef10d5c868feba177217b3bc57a5f715f3f7c40f1,t,37596,5279358,,5000022,2018-01-30 13:46:57,123
0x1be549a9f2d79a97442b46e8cea68c5e151f90df7a09bbb3d1b483f8dc3e2b82,t,22460,5301818,,5000022,2018-01-30 13:46:57,124
0x9c6e930df9b5285a2937df71e616858ecaf836a4a082627dc5787a29a0361de8,t,22270,5324088,,5000022,2018-01-30 13:46:57,125
0x882d4a97c0bad9aa49d3751299a5d59e2261153be93bb0b25cbc6a06609797fd,t,23254,5347342,,5000022,2018-01-30 13:46:57,126
0x56d14b1878b1f295621f2698feccc8815fcc22422c09ee671e6b87e1cbd28080,t,38254,5385596,,5000022,2018-01-30 13:46:57,127
0x0f37a620bcb6f00f4abe6220b11da423f58fcf166d5913311365421f78bb57ea,t,22380,5407976,,5000022,2018-01-30 13:46:57,128
0x7b32304057f234269d994dd66fb884a6bb0ff4f35feeb2116011cb2a7ceb563b,t,22313,5430289,,5000022,2018-01-30 13:46:57,129
0x2e14cbb568d0eff0c3ca8ad0eeda5f1b297fe253b07a311a73651cca83bfa051,t,22460,5452749,,5000022,2018-01-30 13:46:57,130
0x70313df0d3c5feb0106dc0b9b0b42217fe5a79a0f8a7209e8460a2d622ba6c54,t,23254,5476003,,5000022,2018-01-30 13:46:57,131
0x9da77bfd676e8a0ad9b494f201d25e8d6cfaa81be0ff974933d7118a92989d66,t,23254,5499257,,5000022,2018-01-30 13:46:57,132
0xbc39a2a427f1216768a3d65e156b4ffd2c35407668d2d045f29ce17085060615,t,22316,5521573,,5000022,2018-01-30 13:46:57,133
0xc95bbbe7922b83b2c274e853aef8b3ab74ef4417d5eb15f3d9978b9406504dbe,t,23318,5544891,,5000022,2018-01-30 13:46:57,134
0x9d4bd1295cbd5a03e14a3f6da7c0f664f1f1b613e71f46b0e733cc49cc8fe323,t,22237,5567128,,5000022,2018-01-30 13:46:57,135
0x2e6910a7dcc72b5bcca0458c1485a54b0ef8ac9a306736226568783ef9a1d184,t,22222,5589350,,5000022,2018-01-30 13:46:57,136
0x25593b036bd3f072695cae7b6985f1b571cc58f00121580afb64b3bcbd0c4132,t,23167,5612517,,5000022,2018-01-30 13:46:57,137
0x9acd28d0367a26a57680a6d2481d3c185d4183ec3ab1da508048664a572d8b80,t,23167,5635684,,5000022,2018-01-30 13:46:57,138
0xfcee2695c2c12a39e864723114c82bc89baa42107dbe6cc892d1d056cb420943,t,23690,5659374,,5000022,2018-01-30 13:46:57,139
0x8f931ab80a317782c73558c0f5452ed3901ecc532006ce4eeb487a94e782b482,t,22316,5681690,,5000022,2018-01-30 13:46:57,140
0x6cdc14bbc34fdfbf79e7c07462ce40158e6bd3ea7a2242aaf10b8579e55afaea,t,22460,5704150,,5000022,2018-01-30 13:46:57,141
0x3be7795e9c375d5dc48b354151d990b0ce3dc64be29cb673177d053da6df00fe,t,22094,5726244,,5000022,2018-01-30 13:46:57,142
0x60dfe0659ef72d2ea5ac1b93d4329cf27630fc7d612324719e62ce723fefffa0,t,23254,5749498,,5000022,2018-01-30 13:46:57,143
0xe49f539ebe129e818a07e06d8e94e156ed9ae129617df6337b7e807e3da862f5,t,22075,5771573,,5000022,2018-01-30 13:46:57,144
0x484c9e0c6709552e8c96e4b86dffa4c0a85810953a8ee97e0747129bfe3b8dbf,t,22173,5793746,,5000022,2018-01-30 13:46:57,145
0x0a3876eaf4c11d64f3d7a8d8ef0ccd6773d4fe2bf5d626eec20ffc70273d90af,t,22976,5816722,,5000022,2018-01-30 13:46:57,146
0x9d9fe6243947830037ac559016da71cfa45e2f5d44fd2b2762b0b0d12434c01e,t,21706,5838428,,5000022,2018-01-30 13:46:57,147
0x361d5cc1ea6b02a2eaac4940fb325cde65158b382c1402d0daeac9de6ff9ddf1,t,22173,5860601,,5000022,2018-01-30 13:46:57,148
0x5f880288ae4f338486f93398c24820367ea694da17fd6b69bc45ee7bf0fa76f5,t,23318,5883919,,5000022,2018-01-30 13:46:57,149
0x1dbccf1810d9723802ba7a2faf30d6b6364d14a75e22e8035abf9792e357e6ff,t,23318,5907237,,5000022,2018-01-30 13:46:57,150
0x686ac4b0bda03a8b59ec85b29f736c7d8cbbb57b027815aa489a13f83f28d435,t,22316,5929553,,5000022,2018-01-30 13:46:57,151
0xd6bdc2e14d266f7fc3814818c6540d644ba114f69ac866f3d6fb56f80fa4e19c,t,22173,5951726,,5000022,2018-01-30 13:46:57,152
0x54636556ce7b909ac98b62204cfecf5e1ca5cf689cb1c416efefb1cced1624b3,t,22094,5973820,,5000022,2018-01-30 13:46:57,153
0x6a706ebcdd7c9a3e21cbf9d4d658f8f26f00e333b01ecc2d122eb86061ce635a,t,23040,5996860,,5000022,2018-01-30 13:46:57,154
0x04cf942d72222a12d558b001d7f15141f19bcfe39372627f666b1900fc4f51ea,t,23318,6020178,,5000022,2018-01-30 13:46:57,155
0x7a00736a3925ce42e8c0e46f38fa3f8a448b0ea5693aefa51639b1480fd75b78,t,21000,6041178,,5000022,2018-01-30 13:46:57,156
0x60f28cba2b3832b1167093a9b3a02067d88e1f70a440a144d75f0cf43234d7a7,t,23028,6064206,,5000022,2018-01-30 13:46:57,157
0xaaaa13cb361f1004e1034b069b694230d639d11759e5b28e43318ee54ff6f719,t,21000,6085206,,5000022,2018-01-30 13:46:57,158
0x2381fd82c3d2e0ae87f259e05f733ad51d1e993f4b1769e88831d5c506ce6880,t,21000,6106206,,5000022,2018-01-30 13:46:57,159
0xca8cdffadd030c324d2432a25ed9bdbb3c15be68a0f2d4d8628d457ce1609a5c,t,48211,6154417,,5000022,2018-01-30 13:46:57,160
0xde40f57c6af375b9342e2b5b9030f87c70524787d580dcbe55ce6f48bcd8764e,t,21000,6175417,,5000022,2018-01-30 13:46:57,161
0x8880ba1ac28fe7ce2504809ab6e7b98c9b51ffb214af590c9c45bf502f2093d9,t,59226,6234643,,5000022,2018-01-30 13:46:57,162
0x58d5d1801a6a0c6bbbdde0333be956dc84f00b70cfe29cfad775a7055fc3b03d,t,59226,6293869,,5000022,2018-01-30 13:46:57,163
0xf8c0cc8e4cb63e241632698d6c2ab81499c8ee1e362c5ae67f1f93ea682f4f3b,t,44354,6338223,,5000022,2018-01-30 13:46:57,164
0x07bb3943522a6ce0bad8c6bbb2ed310ab143438cd56eab3cc39206871b8320de,t,21000,6359223,,5000022,2018-01-30 13:46:57,165
0xc603f504918c94c32fbcadba9e6d98c08e5baa946f68f56c9039a25b6c5b7dd6,t,52935,6412158,,5000022,2018-01-30 13:46:57,166
0x3d623132f12e31a44d8aba20665e9e453af04ad295d1fa9e847fb68aae00e2f2,t,38467,6450625,,5000022,2018-01-30 13:46:57,167
0x084e50ff72930ca1b0462b7eaec841059b20c1fa48b3e1f9a0bfed2094173336,t,167231,6617856,,5000022,2018-01-30 13:46:57,168
0x7e6624514c2eb3d5f8431fc5fc0fe933fa38121964cdaaf8d7237aa655250b9a,t,91909,6709765,,5000022,2018-01-30 13:46:57,169
0x5c2bedf4477a8dd805a9655d451ce50a45025efdd4d38ace6f9a418be6a3e56d,t,51560,6761325,,5000022,2018-01-30 13:46:57,170
0x087566bbcaec177a15477f2157eb9ea322d50401ed181ba06b5d17ffb47cc5e6,t,77858,6839183,,5000022,2018-01-30 13:46:57,171
0x9684a853b12d54d5eb33da46070fe47f6966e2e4e6bff93e53eb421302f6b3b9,t,21000,6860183,,5000022,2018-01-30 13:46:57,172
0x17ffa984f4925b3a85f2c6f9e5b5d857260f081d7b4bf52df445e90497723190,t,174591,7034774,,5000022,2018-01-30 13:46:57,173
0x769910b4bf65c0b7cf7236f844ec1e9d15ce59a2484a7b3873411f4fabb56066,t,108114,7142888,,5000022,2018-01-30 13:46:57,174
0x916961ed17c63115d2ad02dd2ab86e070d229af6f0472705c46764987079eb48,t,21051,7163939,,5000022,2018-01-30 13:46:57,175
0xbe71e68353145f9d27e731fe8b7c1e1762f7532f93800c579ef270adb22e42a2,t,68932,7232871,,5000022,2018-01-30 13:46:57,176
0x444918855d8263b53dd62f5ca0897d721da855b1b4b51360b14b859ab478abba,t,93434,7326305,,5000022,2018-01-30 13:46:57,177
0x9516ef1c7da63acf2fa00ab3402ae601a0f741d3f3cf32fe29d0a358fb769476,t,22964,7349269,,5000022,2018-01-30 13:46:57,178
0xd76d512cf712d40f4f069f0a6250484184af59b27b30ab0ee7e72e6e1cf10dbf,t,77794,7427063,,5000022,2018-01-30 13:46:57,179
0x55e935d540a60ab092a95400169af48ca496ac0f339fcea2e73731532cdc8190,t,21000,7448063,,5000022,2018-01-30 13:46:57,180
0xa99d96e99ef11dc0c07d4a1e09dd0b9c3cfca907334aeebd7bb778f60524c52d,t,21000,7469063,,5000022,2018-01-30 13:46:57,181
0x4049d3c07af54c8a672e04da64ab3d127d9661e114b9c0138776c89e4dec90a9,t,37900,7506963,,5000022,2018-01-30 13:46:57,182
0x9ec0a22ef10daef90d537b73313f4d185e0426d14dbb81ffcbf0237cf3f0b394,t,21000,7527963,,5000022,2018-01-30 13:46:57,183
0x9d1e4242c0e33dd54f536f8dadba30adec9cc1cbeb8baa5ed9257b4c99a5be98,f,250000,7777963,,5000022,2018-01-30 13:46:57,184
0x2475aa44f61fe128f4010b24c564241e5898f3a72df981b02d8161599875010f,t,21000,7798963,,5000022,2018-01-30 13:46:57,185
0x5bad0d792e29c7cf88de67a783927bc980a1cde026f37657b98a59a3fad6df35,t,21000,7819963,,5000022,2018-01-30 13:46:57,186
0x76d80408929f64d8fa128a10f6b6dc2be81594f669cd5473d04454972a6f23ac,t,21000,7840963,,5000022,2018-01-30 13:46:57,187
0x9abce8df501981322a3a7beda5053c27bbcbb7e5683c807d7fcbc352854ab2e9,t,21000,7861963,,5000022,2018-01-30 13:46:57,188
0x133be03854c3bf969630fb94dbdeefde5fb14fdc20dc5943b3039205139dd356,t,79985,7941948,,5000022,2018-01-30 13:46:57,189
0xc9ff204abfcde1ed1a412e6c5d88d974180ba88d984ee6112d231b3782186c04,t,21000,7962948,,5000022,2018-01-30 13:46:57,190
0x4dd7921662b8c2d98ad55024f058c0cfd9875e41a570cde29eca44336a1b7658,t,21000,7983948,,5000022,2018-01-30 13:46:57,191
0x63349fa4fd5be87bb00d964282d5af6ad0001e7733dec2dbab2b12715e09bf70,t,37272,37272,,5000023,2018-01-30 13:47:09,0
0xf7bf095baf2001ff2ed551b7f38a9f191648af89099b42929a85ea352280fc9c,t,103638,140910,,5000023,2018-01-30 13:47:09,1
0x9259ebaa89994b0e6a985d4dba893b51a5a0e1f358b6dfd528005a1b568e75e3,t,36979,177889,,5000023,2018-01-30 13:47:09,2
0x14d12495368c3eb6cf7f725b41d60fd5fbbf068fc6697d304dafe7214c2d529e,t,52215,230104,,5000023,2018-01-30 13:47:09,3
0xf9c8c7839c2f93915d61fd16b48775313704831e3906116ac7ebc15e6c8de9dc,t,21000,251104,,5000023,2018-01-30 13:47:09,4
0x7b3c39f3c50a1a070dd4613dcb22df297100cbc9911e13141037ef427e659531,t,102998,354102,,5000023,2018-01-30 13:47:09,5
0xe5475d0a29bc45e245a6ae5e592d85815f3329f386826a950cebe26d5d86d60a,t,21000,375102,,5000023,2018-01-30 13:47:09,6
0xc134336a670dec33c94a0ef6130bd7f6f587f279561aaef7c57a611f0624eb82,t,21000,396102,,5000023,2018-01-30 13:47:09,7
0x7978e3f03a00503136f65ef12085194c5fc4ebfef52837617884d6c1200411e6,f,300000,696102,,5000023,2018-01-30 13:47:09,8
0xcf38e90b21f988d660595da620fc9ebc009957fef4dbd363b6ab2aa5d996c79e,t,102998,799100,,5000023,2018-01-30 13:47:09,9
0x505f3e5868299cdd30a78cb0f263fdc5d989a2423d2c8884c180f73068ba606d,t,21000,820100,,5000023,2018-01-30 13:47:09,10
0x7b37dabdf55ea2e2f49593fd6e9d311f082a3d3ebcc3a0ed877d5abd0670e9cb,t,21000,841100,,5000023,2018-01-30 13:47:09,11
0x017b440ac0c4a6aac4d2e2a49aaf3ca0278f1c83f630a0d0fe30fd85fcd3c3ea,t,21000,862100,,5000023,2018-01-30 13:47:09,12
0x7aecff8b2a29712a3b762bbbaa6f253d44de016e220f310cf08e77785f11dfe7,t,21000,883100,,5000023,2018-01-30 13:47:09,13
0x1a22b7f5b4bfa72fe247f22cc68fee3b28267abff5c278ddf739a690655e3895,t,21000,904100,,5000023,2018-01-30 13:47:09,14
0x9d2f67c6b3e56a995ed291aaa345654db59bd65a2b551d9fabe1dda9ac5e93c5,t,21000,925100,,5000023,2018-01-30 13:47:09,15
0xe7412eb8603a7c3034fa97e275738b4d50eb78c5fa2f77781108df525ea799ae,t,82244,1007344,,5000023,2018-01-30 13:47:09,16
0x834f45b5debe83bd1665ab9d8cdb7707cf62f0c0c2409b406e065e8438bd62d7,t,21000,1028344,,5000023,2018-01-30 13:47:09,17
0xcfa20efc111c315db2084c23fd65c9e398befb1741379b8e9010c5b5596aca6d,t,21000,1049344,,5000023,2018-01-30 13:47:09,18
0x62ad6aaca81bbc72460d695086662c4f8c040c9a8616e4b8e476f94f4b482bce,t,21000,1070344,,5000023,2018-01-30 13:47:09,19
0xdc714c81953e13ccdb59ec152e5386b4edf1b3fa0373a9e36b0dc0a2561af6e4,t,21000,1091344,,5000023,2018-01-30 13:47:09,20
0x7706c5ea027054faabe4b6345353d013a360822b246a081c93f5c53c0a579662,t,51807,1143151,,5000023,2018-01-30 13:47:09,21
0x3cbe3dbd873c95ce5d33e102bce4517e7e01f0d1b0e35ac5d96f85d0276fca6e,t,21000,1164151,,5000023,2018-01-30 13:47:09,22
0x3f742fbbfe056dc63c7efc93c246be9d346819b237261656f239382f050a970d,t,28838,1192989,,5000023,2018-01-30 13:47:09,23
0xffa95bb6782282852556dfc298546137bd8a84a0e3bde3be4ef0c18e40fa3abc,t,36542,1229531,,5000023,2018-01-30 13:47:09,24
0xe6e568789f5ce0136580440020261b4e09caea4046e1f09e70dc853c094e85b4,t,37122,1266653,,5000023,2018-01-30 13:47:09,25
0x93b71cdba1c5cd3ebe71e79c8cd640b79bc516611e42ec39937b77c948753f21,t,52589,1319242,,5000023,2018-01-30 13:47:09,26
0xf3ede2593aa65c519c1109f8fa821fbf0c1211ccd2e82b52e6a54e347829e48c,t,107858,1427100,,5000023,2018-01-30 13:47:09,27
0xc15101aafa876e456227184f93b96d2c337497c8c0a630a7cd9a84d478517488,t,21000,1448100,,5000023,2018-01-30 13:47:09,28
0x228c3bb933f3f45bd81cfeab90d94956a54868856517fb28a056644e9f6a5ef4,t,21000,1469100,,5000023,2018-01-30 13:47:09,29
0xdf64d721f57d6e26d03c9a95719e2d9b36e7f069c58ada963e39096f206ab866,t,68632,1537732,,5000023,2018-01-30 13:47:09,30
0xb8e1706a88720112f961d3446afe809bc7ee6b95a9955ab7d2911f364cd4b928,t,31444,1569176,,5000023,2018-01-30 13:47:09,31
0xe4ca84d988382eefb59e4dac0ba2070a272f9a2b70a6a177263a1068c59bc837,t,21051,1590227,,5000023,2018-01-30 13:47:09,32
0x66784690150ed808580de4d942825a9742ea47a5c9f1cb0eb4fca5d1c6284b70,t,27786,1618013,,5000023,2018-01-30 13:47:09,33
0xe4f37e78fd0a679903e32827115e1ac64cbb62fd3eebc39ac4c49802c4de2a35,t,21000,1639013,,5000023,2018-01-30 13:47:09,34
0xcd5f35a8e81d8fe65f9626b5261d3eb4b89c267c6760d2b9940faf1010d42904,t,21000,1660013,,5000023,2018-01-30 13:47:09,35
0x4722eee1ebd0a3458b58132a6986aaef606351944959471dac9997d399632bb2,t,21000,1681013,,5000023,2018-01-30 13:47:09,36
0x18dc61240e6c961862d6e7021c09ec238c07d099e6d264bb01a4eeb360cee0ac,t,21000,1702013,,5000023,2018-01-30 13:47:09,37
0x59acbc5339c7596b55271a1e4439149ff05b3fb91221d81783bdfafad0f817aa,t,21000,1723013,,5000023,2018-01-30 13:47:09,38
0x509906db3d69672e4a1cc99babc0218eb7083470a14a1f018d5be4d06b75cb20,t,142324,1865337,,5000023,2018-01-30 13:47:09,39
0x78f082a1bfa8ba706608b0c085091438158209d4ff1f1d66559daae6d6f57503,t,21000,1886337,,5000023,2018-01-30 13:47:09,40
0xab9d15b2eb48af4e80ce2c02390a2864d9bbfde1c1d9a30c3da1dcb7567aed8b,t,21980,1908317,,5000023,2018-01-30 13:47:09,41
0xaf06a08638bb57ee3903e0607381a94d123ea2b54d74c4c8e55b0657c2f59b70,t,21916,1930233,,5000023,2018-01-30 13:47:09,42
0xe4b65ccebb174a46705de883ad585b6610699019bcfb3b4cbb2921b36940af0b,t,30327,1960560,,5000023,2018-01-30 13:47:09,43
0x17cdf4e1a46a808491272cd682bbef76f580b35619e8f136f59fe20acd7928b3,t,30327,1990887,,5000023,2018-01-30 13:47:09,44
0x929392d8dba5f491fb7e7909996571c6b434e9327a0dd5eaebac2d7b27ad6d93,t,52316,2043203,,5000023,2018-01-30 13:47:09,45
0x070039869d5eaa5d05358cad6df77feb06b8d4e6f137615c13db117767e22086,t,55907,2099110,,5000023,2018-01-30 13:47:09,46
0xa4eb53180be68ac3119beac62c122619f9efb67b5c7bae93cf899cb891281268,t,55907,2155017,,5000023,2018-01-30 13:47:09,47
0x7100206e84346766b6a532a66b33a47de4ea319b987024d2493f4d1eea89a47d,t,52976,2207993,,5000023,2018-01-30 13:47:09,48
0xd2a357114b800202d32d55a82cf4079aeaade44dc028bfd1881477014d06ba58,t,98809,2306802,,5000023,2018-01-30 13:47:09,49
0xd428540526149fda9791eec274b12dada048d339b61a5cbf3f5c6448fe05ccc1,t,53104,2359906,,5000023,2018-01-30 13:47:09,50
0x2cc86208baa6bc2068d69f0220f9051d1f9db897a89b2df5ef6e67197330ab3b,t,51948,2411854,,5000023,2018-01-30 13:47:09,51
0x29f52dace942b9cddd3fe5c7dcb41a4e6724315cf28098ecf9816f9cb3fa6671,t,53754,2465608,,5000023,2018-01-30 13:47:09,52
0x3cd7547f0404703ce239f5c90586635690bc5683dd8a83ba971b84e773a35b5b,t,55843,2521451,,5000023,2018-01-30 13:47:09,53
0xe45e261c0bed930e7020c3b9888207d4e6e8770b4f04ee37e6f045d7965df7c9,t,140972,2662423,,5000023,2018-01-30 13:47:09,54
0xde9aab90157f4c915577d8cbfa0c85800de36a7536b1d22f58ba73f753a62946,t,52886,2715309,,5000023,2018-01-30 13:47:09,55
0x0dbd548e7491c0792fc215f2704483a722f87de3ecd4fd78b4c3755f2b86db44,t,26607,2741916,,5000023,2018-01-30 13:47:09,56
0x34aabe28847ed67c4c9e6f00239bc0c638f545c8a29a9241878ef0a7603fbe94,t,244829,2986745,,5000023,2018-01-30 13:47:09,57
0x62a1b282ba8320e7ea02648f04adc440f5e6c221c1ea045b2ba191ce54d1da18,t,34060,3020805,,5000023,2018-01-30 13:47:09,58
0xebd965a17f3e8c0586570d3734399c2e49bbce131c49a66813816e7cde928e58,t,36728,3057533,,5000023,2018-01-30 13:47:09,59
0x45ffa287856dab84939a72d7e01489f13102c0cc0d105c3cf65b4e38cb7315af,t,21000,3078533,,5000023,2018-01-30 13:47:09,60
0xbc120c82946df0189af0beafb20f8a6d9dee443287c98097b5f5679b244449de,t,21000,3099533,,5000023,2018-01-30 13:47:09,61
0xf429b75d95ae791e2e0e8aaec80525a91ca61075cd5764715f00603e402382cd,t,21000,3120533,,5000023,2018-01-30 13:47:09,62
0x15b21dab0c37db4275cd764450919cf65a6daf736abff4cdc1354657ab6fc47b,t,21000,3141533,,5000023,2018-01-30 13:47:09,63
0x48b373e16d284cf733ed093a8ec55d225f230412b31a5d55d823a6175a7d2fbf,t,21000,3162533,,5000023,2018-01-30 13:47:09,64
0x8e3ab60614d8e2fa133008886622ce794501dfafe7903e76ca4d6f77b4122f8f,t,21000,3183533,,5000023,2018-01-30 13:47:09,65
0x1f850a25073e7bd506ee3a3c3a2273e5dcda3c628487007499097fc458a7d4c3,t,76734,3260267,,5000023,2018-01-30 13:47:09,66
0x534664ec256d064ef32b89b7cdaba6cd2686284a68551ced138bffe8f5b8f00f,t,21000,3281267,,5000023,2018-01-30 13:47:09,67
0x9a6de94c27c82a4168a1565a81dd0bd3abc2f6f6a566c09d18a2d044de8eb320,t,21000,3302267,,5000023,2018-01-30 13:47:09,68
0xe9167397dff9dfbc903784a3c93649ed045fde01db08ab9d8ace141bff6c6687,t,21000,3323267,,5000023,2018-01-30 13:47:09,69
0x41063e9d3c99bc6e6f494bdc03705dbd80e91c84f31fcbc08769cd9fc9933401,t,21000,3344267,,5000023,2018-01-30 13:47:09,70
0x69bc092234dfbe72224f18934977d83e60cfc0cdef1b50c666bffbf1bdeb48e1,t,21000,3365267,,5000023,2018-01-30 13:47:09,71
0xf11c09a87a9a7fa4035e93e77512cab4b04c3d2ae783dbc8baa8176c7064e527,t,21000,3386267,,5000023,2018-01-30 13:47:09,72
0xf9c08ce8b4489d89218c49b517d4b3db86f8b40d6c12a8624a36c0572192f5e9,t,21000,3407267,,5000023,2018-01-30 13:47:09,73
0x975db99088b6ef512793d0b197911775a936bd6e072decdf5accf563e3c14235,t,21000,3428267,,5000023,2018-01-30 13:47:09,74
0xe6c67d84797be66a93ba171bb86267256cb71b43fa27147e8c88f8bc5c46225c,t,21000,3449267,,5000023,2018-01-30 13:47:09,75
0xda678cd87dc3e98f366ea76f0205a28a389c4d85c4f68c9c450be53fad8269dc,t,21000,3470267,,5000023,2018-01-30 13:47:09,76
0x05fb43380b02cff5c01dc6364f804a20b9b8857d7f1f931ec74e873f55889669,t,21000,3491267,,5000023,2018-01-30 13:47:09,77
0xe747096b782666687b61d94ed1521ce431da7f6b2563f876a42e53bbdfae928c,t,59226,3550493,,5000023,2018-01-30 13:47:09,78
0x92975c10c0590ef4ade4fc68334bea2211fc1716ca5fe430b28dbbccc40bb992,t,23092,3573585,,5000023,2018-01-30 13:47:09,79
0x53937ecb62597cced0625e397abca5e9508a45af034920ffcbff2b42ce37e27a,t,21000,3594585,,5000023,2018-01-30 13:47:09,80
0x90c6dea795d2ca6122b260402307318eb50f6f1ae2c60c79359666a73e3a8887,t,44025,3638610,,5000023,2018-01-30 13:47:09,81
0x7fb968720dfa486fff99778dcf538dbde36872d6145b9dab014d875a9d07e461,t,22465,3661075,,5000023,2018-01-30 13:47:09,82
0xf5d8167ec0da64b9e7af0fd054a99da3efad9fc45d3c29297260acdfccd3e053,t,22158,3683233,,5000023,2018-01-30 13:47:09,83
0xf44540e01d6c292dd1c8350fe41d4143445f2a037d2a208fade0bf4ee36cb8d6,t,37173,3720406,,5000023,2018-01-30 13:47:09,84
0x7886f81efaac4a0ebeb425db0748beab1c09648fc4806a8212a8c901ab6fdc45,t,36989,3757395,,5000023,2018-01-30 13:47:09,85
0x5e888b16209238d56c2a2410166dc69d63b01f7f38dfc3d0cdf675accb7ea8a3,t,45981,3803376,,5000023,2018-01-30 13:47:09,86
0x602c7addb1925561d91a99a9725ac8f12800c3ba892d1e03df69dbad4222828b,t,59290,3862666,,5000023,2018-01-30 13:47:09,87
0x159eb2453a5c0dacaf9ccc4d4efe148808cb3d7c5ba53c1af42555d318f0a19d,t,37964,3900630,,5000023,2018-01-30 13:47:09,88
0x016468c7294cc372ca173ef3c0489fa55c836ff302e9ba80d10ed4f6039dbccc,t,108114,4008744,,5000023,2018-01-30 13:47:09,89
0x4a56dcbe689fe62d0e54cd4686255c6e2f7e281f6b70c3c700a59c7546c76327,t,448187,4456931,,5000023,2018-01-30 13:47:09,90
0x1004d2e3181875fdad3970cf64eccb1e6769dfde357e47dbc954e9769d75bb61,t,43714,4500645,,5000023,2018-01-30 13:47:09,91
0x97616dc000ee43af7e35a5dfcfc8a63f94bc85675e7c486557dcd2c3246ac2eb,t,33444,4534089,,5000023,2018-01-30 13:47:09,92
0x4e8acdab8fd3518bb6ad799d552fc9289465d4993824a57e2f981b549fef774d,t,44354,4578443,,5000023,2018-01-30 13:47:09,93
0xe87143d45c5dfca68718978b14e05542b15811061ec0e093303b14d3225d408f,f,250000,4828443,,5000023,2018-01-30 13:47:09,94
0x16570b99a12e672aa94dbe0e2407718c06c8400bb0c4a7cf1b3d95236f647c79,t,21000,4849443,,5000023,2018-01-30 13:47:09,95
0x1b9d02d31b29cfb0a26b30ab715c3a69c8701171acde2111a78fc9b7a3dfd0f0,t,44493,4893936,,5000023,2018-01-30 13:47:09,96
0xba714a207eb95403f43fba82c4e4f7841042745e83cbd3d728f54941d38e7618,t,164716,5058652,,5000023,2018-01-30 13:47:09,97
0xe732804012bae3e515aeb006ef15e4737509110b451e61622e899a59b92ce253,t,23316,5081968,,5000023,2018-01-30 13:47:09,98
0x76bc536a48c287914d6aaf73c32f34090c0d4193ba7d8d30522181eae51e84f2,t,29493,5111461,,5000023,2018-01-30 13:47:09,99
0x1c130656278244f86bf959feb4c782a7dae1520c2c61e7518456f031050a33e2,t,51980,5163441,,5000023,2018-01-30 13:47:09,100
0xbd269fc1725dc022ab169d115147ad78686007b237939b8a279aa3f6f5b4a4d5,t,21000,5184441,,5000023,2018-01-30 13:47:09,101
0x4ba73e68fc4d5e4fd122d721a5b5ddbc908c05c8af8adda604f4f080253ead67,t,21000,5205441,,5000023,2018-01-30 13:47:09,102
0xa446dd3d5dbca6d20ae29a02aa6418f2c8847deaff37340523425a2658d24176,t,52087,5257528,,5000023,2018-01-30 13:47:09,103
0xb551f24a95c07a57285bf9a2e241e16996e7d90bb5c404158e95db5f59d5e756,t,21000,5278528,,5000023,2018-01-30 13:47:09,104
0x2de77fa7981c5951e19fa788b2d63aa0f30071b15d4d63b585bfb8460585a785,t,21000,5299528,,5000023,2018-01-30 13:47:09,105
0xf3ecf92ec6ccced767f4344261eb36f6d304555f2d6ecbc8ce930f8808150e43,t,21000,5320528,,5000023,2018-01-30 13:47:09,106
0x13eb363332483ea9609292d45475b8dfd87e2d3dcd6c637844d1264ae8d1e862,t,21000,5341528,,5000023,2018-01-30 13:47:09,107
0xa2703e5e2d9866ec98dd4dca095849c0a90178342921f650e38d33acffb3702c,t,78161,5419689,,5000023,2018-01-30 13:47:09,108
0xc009dceefe87330235d0707dee9a0602276efc4f835740c924646535fce76afd,t,37019,5456708,,5000023,2018-01-30 13:47:09,109
0x3151e4d33e0713fa14e5077f0f3b723cfa48dba530da439ce8d9ef631a9025d8,t,52391,5509099,,5000023,2018-01-30 13:47:09,110
0xe9f0572e6468aa41724465e2f4408f044eded4443f407d4d0b4b36218181ce1f,t,52263,5561362,,5000023,2018-01-30 13:47:09,111
0x576685c4931514b6e51e55cf3f7b23ea9d16933b01d15d750517b80d00f3ca74,t,51848,5613210,,5000023,2018-01-30 13:47:09,112
0x6f4ef1b7d89983e9c2389ac051209e82a37589149f4cb3fa0f88966986230781,t,37237,5650447,,5000023,2018-01-30 13:47:09,113
0xd1555bd9765fcd988854a7e2287613fee8e913fd5140480e11bde313d15b4a7f,t,52071,5702518,,5000023,2018-01-30 13:47:09,114
0x74da1e17c0ae1def2c77bac5f817e3f790e1cff5ea66a0a9b9e3e970f0c2890d,t,53104,5755622,,5000023,2018-01-30 13:47:09,115
0xaf827c424f7abc1542e543d2fd796c8f86af930614baa36956e5c33ae51781cd,t,52886,5808508,,5000023,2018-01-30 13:47:09,116
0x40343685f01ce88ab8c7fed9456ef83607524133895cd68e259fe69b4b91167a,t,26819,5835327,,5000023,2018-01-30 13:47:09,117
0x9bb4d17f0e3e178e8fe25e3064058385a8b6ffdf8333e4afbb88dbd054a54883,t,244829,6080156,,5000023,2018-01-30 13:47:09,118
0x2534883f7725ddc00b41bc1586bc342931bfc9fc3f0c1db2891f16079d634b4a,t,34124,6114280,,5000023,2018-01-30 13:47:09,119
0xf53a0d3da1fc3d2780b24bebc7f16b78a1834b4cc25aa76537ec0580c7ac769b,t,36792,6151072,,5000023,2018-01-30 13:47:09,120
0xd21097a3aa44f150e34da8543189e3080208ce1c10db806936d3a0d98b197371,t,37132,6188204,,5000023,2018-01-30 13:47:09,121
0x011da012e94d176a9256e45298a2d541162f2f0270947e3ea4db92661173e44b,t,38255,6226459,,5000023,2018-01-30 13:47:09,122
0xa9e2677393a786a8159901f1a5b16c3ba926d65c771913d9641b6687e559e4d4,t,53698,6280157,,5000023,2018-01-30 13:47:09,123
0xc3629e3ea6fadf0f9d0344b9104627ff3bfbc5d246cb948f6647ee70ad2f03b9,t,44354,6324511,,5000023,2018-01-30 13:47:09,124
0x475ed7c894bf57c18fe4a9de42bc684935c0cfb903a8982d543d4c51ec15c1c8,t,51915,6376426,,5000023,2018-01-30 13:47:09,125
0x1ab276a4f06c22bddf8eff7d95e1b0a8ad2733c051f30fe73b7e4f627de2be1b,t,21000,6397426,,5000023,2018-01-30 13:47:09,126
0x6aaabc44e8c9655ca9726692568d9682388d3f2a8815313a2d71bcccdd8bf0fe,t,21000,6418426,,5000023,2018-01-30 13:47:09,127
0x75d9aec11a84336b4886ec2fa145685f4f557a8e379665a0fd32660099e6aedf,t,21000,6439426,,5000023,2018-01-30 13:47:09,128
0xc6571180c06ef5b51268b07b7588a6879c93202096b21a7eeed914234ab18604,t,21000,6460426,,5000023,2018-01-30 13:47:09,129
0x8ddfc63f7b822b875023e078922d5b9e07cfd3f3621ca0cd93f1b2433c8c5b66,t,21000,6481426,,5000023,2018-01-30 13:47:09,130
0xac7055e6ee66f3e057ba38e1f0c59bb8c9da1c670c0286529429296864f3d2da,t,21000,6502426,,5000023,2018-01-30 13:47:09,131
0x4e426b86cadcafcc199a2ce9da04b8d8d47c05d00ab910522981d54cd8728901,t,127708,6630134,,5000023,2018-01-30 13:47:09,132
0x4138fdb1ce2147a0ae9f3fedf0f065a6939d0df7ccefb035f12a7e22097f8e7e,t,38754,6668888,,5000023,2018-01-30 13:47:09,133
0xf06ede2a1d5ea73b700985e66c9c648e9d60a6c230482480b01329a1e5386379,t,40907,6709795,,5000023,2018-01-30 13:47:09,134
0x5a9abcba34f30bdb16f1d9789cd8f9b58d0ba63fcdb0618b56f089311033f7a3,t,55843,6765638,,5000023,2018-01-30 13:47:09,135
0xbd4a1c9a3c54808f71fee819f479d50ad64734b09b64f83d0ff3738e21337c78,t,52312,6817950,,5000023,2018-01-30 13:47:09,136
0x36c9a013c264b1732cf08693ce2262c57ebef636b4a21ecd6a4c091ac228398a,t,52886,6870836,,5000023,2018-01-30 13:47:09,137
0xbaf1f81866f8863d904f1c66d0ed6fc49aa88fc8c6c15170a7891d0a4e1bc7c3,t,26726,6897562,,5000023,2018-01-30 13:47:09,138
0x08b99587c79883a01e241aa8ae9525d3cb79296d15efa52f824c05dbc8d93f97,t,244829,7142391,,5000023,2018-01-30 13:47:09,139
0xfc02dce908c98f0105b361e31029beb98ee1c3d02b9ceaf20319b4741e225fa6,t,34124,7176515,,5000023,2018-01-30 13:47:09,140
0x2d06722555f85e8ded6c865c8af896d819481b65f0371fef5282b753685ddd8a,t,36792,7213307,,5000023,2018-01-30 13:47:09,141
0xf85df8608adce9447fa77b00dda783ced2f527442e927c3a6859cb16d8466f98,t,21000,7234307,,5000023,2018-01-30 13:47:09,142
0x5e8b1c89c9ed76e20290c9135a591206264f0c006790dd08d1d53ee8a73b2d93,t,21000,7255307,,5000023,2018-01-30 13:47:09,143
0xf89f2b192a6c3d7d09479e682a1fa60a0c4e21f34d633d0f400a03cbebb1e349,t,21000,7276307,,5000023,2018-01-30 13:47:09,144
0xe294b446a436f3c384ec034e709ababb43f4c4c6f8f0707f17302009535aac3b,t,21000,7297307,,5000023,2018-01-30 13:47:09,145
0x072562f158f9411ef65209387bdf3987635b361ffb4fff6080c53a5e172ed904,t,21000,7318307,,5000023,2018-01-30 13:47:09,146
0x9492e63d181b5278e3489562c7fce4135ac40c7bb6014a3a372a99e9b8de93f6,t,21000,7339307,,5000023,2018-01-30 13:47:09,147
0xef7ffe85d9aa3c98a8b18bb079e59d6ddefe762dc6baded8e4b11860631bf8ae,t,157580,7496887,,5000023,2018-01-30 13:47:09,148
0x8d1da0996ea4e090bee977c756561266605a7774012121e0196410950d80ea07,t,52327,7549214,,5000023,2018-01-30 13:47:09,149
0x0107c58de29fd28bc8e192a446cae467c9386d33447c3c5801bc936b58f01a9a,t,52884,7602098,,5000023,2018-01-30 13:47:09,150
0x56cccd08cd94c73c80a2edc4ca53c19eefb1747002ee8639d3edbe2164a7f29f,t,52886,7654984,,5000023,2018-01-30 13:47:09,151
0xef3ef31d171fb292a29640b5f60b8c43e375dcb562ac506b0b086e3018bfc0aa,t,34124,7689108,,5000023,2018-01-30 13:47:09,152
0x7dfe3d61453d3ad797eaaf29dd8764c3cc6550a281a30a6d300eb05b3140a384,t,21000,7710108,,5000023,2018-01-30 13:47:09,153
0x9b3fdd9b3d6f49e786d60da9d98d8d29793bf51cd6b635aa2acfa187c4963bd1,t,21000,7731108,,5000023,2018-01-30 13:47:09,154
0xc10df637c05d42306a69cdc162d90364b5dbbed2c1678363dd547259ac26f401,t,21000,7752108,,5000023,2018-01-30 13:47:09,155
0x8c1180ed92dc963445a93a61bcea7aee3658604ea1cf416809f3b3ca0c688b32,t,21000,7773108,,5000023,2018-01-30 13:47:09,156
0xf7ad09336452bf741b22c7fa951d02ff687dc6532db093bb128fdfff56eba22b,t,21000,7794108,,5000023,2018-01-30 13:47:09,157
0x4b1da2f04087db00202aaa1b0aa90193dd0c1dffc23625036a9c78531687dc47,t,21000,7815108,,5000023,2018-01-30 13:47:09,158
0xb26ee4da6f360408d6c1ce0144f4e2b6cd009fa443037b7ec63beaf29cda9186,t,98809,7913917,,5000023,2018-01-30 13:47:09,159
0xedd17941fb7e30a846dff62f0e26fe11dd6f1ac6dc84f67bcb2d55e540d2b5f3,t,21000,7934917,,5000023,2018-01-30 13:47:09,160
0x4175aaeb9188e9f2425a257118b1696b9e24f5b33d99501217b74f58463e69af,t,21000,7955917,,5000023,2018-01-30 13:47:09,161
0xafc231173717c3a49ec76cd317bcf4a92bd038eec52c3a874268270fda2e41a3,t,21000,7976917,,5000023,2018-01-30 13:47:09,162
0xdac2ea3bc1764600b8e085a13f133c87ed35fc8dacf62acffebb5ddb7c3b2858,t,52848,52848,,5000024,2018-01-30 13:47:19,0
0xaf634882684ffd1853ce49f81eef31d1e129f61119f61f7e78ffd1be10fbcc84,t,21000,73848,,5000024,2018-01-30 13:47:19,1
0x2df524d3a1ab56377365cb19cb4e91561b31e2fcc1d30b0f0823478608682fed,t,21000,94848,,5000024,2018-01-30 13:47:19,2
0x06058a360e43fece376f21fe43624cbe41aa06c1e57127dea65214922284a127,t,21000,115848,,5000024,2018-01-30 13:47:19,3
0xd95d186d516d5563012e5036c966484ad6061ac1cb67158223e851c65aaf79be,t,21000,136848,,5000024,2018-01-30 13:47:19,4
0x1bad61c12eb2800d471d332b154da2a4a3ee70c57b730a9ff1291d6f9eb3d512,t,52640,189488,,5000024,2018-01-30 13:47:19,5
0xbab21c75eb01df09f797e74db9a247f3f2ce6b0b013b9ceefff235a2a5f3928c,t,21000,210488,,5000024,2018-01-30 13:47:19,6
0x3eb41dc5dd91f653ee1e42db5a2b181883df9292491cbf9066340dc6a158a63b,t,21051,231539,,5000024,2018-01-30 13:47:19,7
0x32cb80fe6747484d75944f76118fb74864d374b24a31650b96f08dc1b59583fc,t,168236,399775,,5000024,2018-01-30 13:47:19,8
0xf5c953324d1abf70654c398f597298f58f84d2a1eede42c562ca0606a74a38eb,t,21000,420775,,5000024,2018-01-30 13:47:19,9
0x7e730961169d1b5a6a867b8770eeeec7fcbc7661f7274648e3ebac019270686d,t,21000,441775,,5000024,2018-01-30 13:47:19,10
0xe09f8ff0b6f7c7a545f1623c3d9ba35d7ef0c06a846d76bbafdb4df7da92b1ce,t,26937,468712,,5000024,2018-01-30 13:47:19,11
0x5092581b03d3305dd8b041eccd540f952fd2178fa5157a5a61d66cfb5f15ea26,t,33665,502377,,5000024,2018-01-30 13:47:19,12
0x9ab2b6a15dc2db4685b65c6563a3e1b143fa0f985e43a4e3e3b9cc6fabca8b46,t,21000,523377,,5000024,2018-01-30 13:47:19,13
0x4264f3cebd09b00de9e99353f864756c2d4c8fad3a5c4e560dee6a17820103f1,t,21000,544377,,5000024,2018-01-30 13:47:19,14
0x0b6411348caa0444424918fc30bd256a1f2c03d0e0bec076d35c9ce0db9cd620,t,21000,565377,,5000024,2018-01-30 13:47:19,15
0xb89e0a314c51c4c2673185e23c6e7cc32b474b6e91c59fcfaa843c4945049ca7,t,21000,586377,,5000024,2018-01-30 13:47:19,16
0x7680dd2d3aaf1c8ada22be3511fd851969a2259d73151618c052467633bbddbe,t,21000,607377,,5000024,2018-01-30 13:47:19,17
0x4b612e5a339014273896e2615bce91e9c0138d6217e13ef6e8ddc1309fdd2b16,t,51188,658565,,5000024,2018-01-30 13:47:19,18
0x514cc5b3de6cccebb06a6f92b50a1fe6846bfd76eca23f1b6358a8fa3d6086d9,t,21000,679565,,5000024,2018-01-30 13:47:19,19
0x224f6d718ca7dee5b1eb72bdc5cb09f3dc1ee7347f6dc5c7665506f0220b0205,t,21000,700565,,5000024,2018-01-30 13:47:19,20
0x0e1466935f92fdccf01667adb68f2bdf211bc26229a20fb522b3d553db1f45c1,t,21000,721565,,5000024,2018-01-30 13:47:19,21
0x07640935b854796ee4a8f364598e68d5dbe5899f268842e2cc676a5d477b1b93,t,22640,744205,,5000024,2018-01-30 13:47:19,22
0x5f415ced7e5433e3c8e52eddcdf2d5f6604cde2a3a0c9f2c1c583ebd22f7ed45,t,21000,765205,,5000024,2018-01-30 13:47:19,23
0x25d5eff1233ff24be762b196e67738f12c34cd3ba413f10dc2f45e4897cc16ff,t,53233,818438,,5000024,2018-01-30 13:47:19,24
0x3c47d1ac2d70c020d7663e11630a7153a3c30a334e0dcf67f436849aed3ae4ab,t,92986,911424,,5000024,2018-01-30 13:47:19,25
0x903bf7557fcfd679761c4920f964e37431834e6b976f0420f8deab06cc0a8caf,t,59354,970778,,5000024,2018-01-30 13:47:19,26
0x00a70a4d745fb94ea09c377ad74e01236e933fadb339c0166b4fbe8394edda93,t,21000,991778,,5000024,2018-01-30 13:47:19,27
0x2a61b6d5649c826a1b65c98be4b20bc8a75d09b9209bca3167c8087c354dd7ac,t,21000,1012778,,5000024,2018-01-30 13:47:19,28
0x8a00c413a255e732fc4d923901b0153ff0c8117f0b0a5111a5312addd8700933,t,21000,1033778,,5000024,2018-01-30 13:47:19,29
0xfcd3fc53c569cd9decae94595d0f477fa4e02afee7eec98b621529df1ce4253e,t,21000,1054778,,5000024,2018-01-30 13:47:19,30
0x7bed892d5d5527a1cf568dd5485469223cc3c7acf74167c97ce5521e911e98b1,t,21000,1075778,,5000024,2018-01-30 13:47:19,31
0x239f290d2868359f9c66f7585c27683320057754c6a36d8580484fe59eac9b8d,t,21000,1096778,,5000024,2018-01-30 13:47:19,32
0xf78d0e3598fdc0da056c7eab989a804626ddc7a8c9e698788066250f8576b96a,t,51752,1148530,,5000024,2018-01-30 13:47:19,33
0x9a5b9656d198cf5337044aa182a5f4dde27b8ae8b58d4eaadf1b5ea1c5533ed0,t,52173,1200703,,5000024,2018-01-30 13:47:19,34
0xf110311726a277c4fffe4ba807684714052d2fa6364f3b053576baf1ed4c532f,t,37158,1237861,,5000024,2018-01-30 13:47:19,35
0x54e9940bd5984acad21457ea9c5692e8c71f06d66f9891520cb3d9f198634261,t,21000,1258861,,5000024,2018-01-30 13:47:19,36
0x64332f816e2939b201723e47f6885e95d5e703746bb2cfc784058c5f0e8165b4,t,52886,1311747,,5000024,2018-01-30 13:47:19,37
0x308a4c668b43c457ea044ad562460202858292e4abcf253add4bd8a061dc3424,t,98441,1410188,,5000024,2018-01-30 13:47:19,38
0x7ada7669d92d7a7227ff6c1951ed3954acff60859cfc57ac02578ed5f5f16795,t,67597,1477785,,5000024,2018-01-30 13:47:19,39
0x52931980a42cd9f4e31bf910c9c56c95943b36500a8102aa233627d49c70b7b6,t,34124,1511909,,5000024,2018-01-30 13:47:19,40
0xfcbfddb9cd556aec89115bbc87331700272a57d497bae8e9ec288791ba3fb149,t,21000,1532909,,5000024,2018-01-30 13:47:19,41
0x459618fcc2593160d9dc664f3256ae0ef454d262ccde4626ce5c6ab15f751a80,t,21000,1553909,,5000024,2018-01-30 13:47:19,42
0x32bc9b69fac20a55b2d370240090239651e37e077d271e5c8384d6744a4d2d28,t,21000,1574909,,5000024,2018-01-30 13:47:19,43
0xec79c949951d3a1a8b13dde36e7c76429ebda77381473d15b53eec5a721db923,t,21000,1595909,,5000024,2018-01-30 13:47:19,44
0xe39a090a9349ef01ebc93a8c3e448215a5e5479b9191534e48dbb51038abc3e5,t,21000,1616909,,5000024,2018-01-30 13:47:19,45
0x7cfdae3b1858420827b007cbf5c1de0a078c9988954555aa65a1d99dc5d3a26b,t,21000,1637909,,5000024,2018-01-30 13:47:19,46
0xad101328f0e50804326324068fb702867a14b03101d19234cb7862e12aea705c,t,52251,1690160,,5000024,2018-01-30 13:47:19,47
0x84995554d3e19b2cdb6e108784b348476e8f21e472bf25aba8ffc7c89dff86b6,t,21000,1711160,,5000024,2018-01-30 13:47:19,48
0x9072680007c348964e163fdbbbe5225081fd5cc4d5c97e65dd440bc74e995022,t,51783,1762943,,5000024,2018-01-30 13:47:19,49
0x16e99c8f750e07ed59c0537e9a390ab9a414edce402d7c0d779f949d77541729,t,21000,1783943,,5000024,2018-01-30 13:47:19,50
0x98774c4d4dc3049c43c1d554a7262555f5824ea3d470d978c833aa95f82d20d7,t,51606,1835549,,5000024,2018-01-30 13:47:19,51
0x00e5f05a5f163dc76a9554dd11def008375f70ee7cd70bebb271b7f338ee937d,t,21000,1856549,,5000024,2018-01-30 13:47:19,52
0xaf7922fefeed80d808f67cb1625e689d4f0a173d3e1a6cdfeb133cea69a192a6,t,21000,1877549,,5000024,2018-01-30 13:47:19,53
0x9783ace970a3eded69cd279af50a9a4917a42596734da4224bb79a18c48cdb26,t,21000,1898549,,5000024,2018-01-30 13:47:19,54
0x1a7753305d0724903a88f101a8919e5dea8201e710fe64084d0e1764bd62516c,t,21000,1919549,,5000024,2018-01-30 13:47:19,55
0xaed638babe3333573a60614f21d35f95761ef20052ade7f7291db79660b33d7c,t,21000,1940549,,5000024,2018-01-30 13:47:19,56
0x372be3c3884b1900df900fa5511f188a3f2c6a8c336cbd0b4a35b43ef04b4197,t,4649204,6589753,,5000024,2018-01-30 13:47:19,57
0x9a62ffd9b483aa07712765acf9c48ef459a45ed10707d0a0ac7a1791b9662b0f,t,21000,6610753,,5000024,2018-01-30 13:47:19,58
0xadea2cfd2398374fd8baff0ffe924e47ae0dce817fccf16110ecd70ca1cddfcf,t,21000,6631753,,5000024,2018-01-30 13:47:19,59
0xbf0fbce3035fdac69455e47b2682a80d665e193d7e9b3d8c9a4ce62348148603,t,21000,6652753,,5000024,2018-01-30 13:47:19,60
0xba5a4dc516c090b8306f5f05a3e59369af34cdfcfcb01f397d308c2da09670d7,t,21000,6673753,,5000024,2018-01-30 13:47:19,61
0x1408bfc938a142666df9e70a9fc420ce514d91304fd258d30852a8cbb778e28e,t,52380,6726133,,5000024,2018-01-30 13:47:19,62
0xa1dc0b497ebf11ae000c82f82fa6ab171e0515d0d510d6668c2666fba329435d,t,52886,6779019,,5000024,2018-01-30 13:47:19,63
0x03e062ddba2860ef678c356342bb4942667f5831af43797faa7adcee5de08b56,t,244829,7023848,,5000024,2018-01-30 13:47:19,64
0x142684a4d678d7ae196ed184127bfa37a3b8b78b930df15d7b0ea70ec33c8135,t,34060,7057908,,5000024,2018-01-30 13:47:19,65
0x801cb6b626e9fa51225114c66462aead426636a160926cc6c74a315777c6e69a,t,21000,7078908,,5000024,2018-01-30 13:47:19,66
0x819a1734ecf3653686e7d7dfff49f94d67feaa616735c99eb254f514ff2c9910,t,21000,7099908,,5000024,2018-01-30 13:47:19,67
0x216c4a555b07da4c7e76907b07d29d18f3f9164df56b6efa52826b88e50b6ef4,t,21000,7120908,,5000024,2018-01-30 13:47:19,68
0xc7c79e86fb17ec9d8013bfed5b2f0827634359f6499008772adee1b900d98848,t,21000,7141908,,5000024,2018-01-30 13:47:19,69
0xf8db05665ff7e64b62f0e758f622913da2b723cf3a7b4f58126e147f52032563,t,52886,7194794,,5000024,2018-01-30 13:47:19,70
0xd548d712159411575863b3e65603fd93e7ea7308462dd819a334ae714ff984ae,t,34060,7228854,,5000024,2018-01-30 13:47:19,71
0x87323c9adc9f23b82faf5dfda6452a80d8a51179c23130b65ba08437bdfe8868,t,67605,7296459,,5000024,2018-01-30 13:47:19,72
0xa058d2c67ac65b3bdbe52a6529dfe4e35b8b20c128ff51587a01c574a030b7d1,t,21000,7317459,,5000024,2018-01-30 13:47:19,73
0x45711dbc4259fdac67cc4cf5dfc906cdc670012c9f34a80899c0205dd9faed62,t,21000,7338459,,5000024,2018-01-30 13:47:19,74
0xdc91786343ffe39083ef78a3c311ec3995fe740509c03dca1f8bc76bdd1c20dc,t,21000,7359459,,5000024,2018-01-30 13:47:19,75
0x81266056bcc4780cd9bbdac05cdf9d6c6f894e1ae0b6d60bb37b85622602a891,t,52886,7412345,,5000024,2018-01-30 13:47:19,76
0x07813b38bf73253f35214eed91f8908782a645dac70b77f9d8058097a6de6df0,t,34124,7446469,,5000024,2018-01-30 13:47:19,77
0x554d860bf9a88c6f31be8fce066029c408df0cb348d9f865bfa4fde3b5f5f1f3,t,67677,7514146,,5000024,2018-01-30 13:47:19,78
0x2fb7cece8bca7dbf60083557d9a0496a82460540e0593ca96779a0433cc5e803,t,21000,7535146,,5000024,2018-01-30 13:47:19,79
0xc9e3bec8614870c8cb8afa8be8a4c071c7207fc1dd90a2901c130a051a5febe1,t,21000,7556146,,5000024,2018-01-30 13:47:19,80
0xc2947fb2f0398b1ae7ed837db5998fe18141dddfd1701bf110f256922a5f271b,t,21000,7577146,,5000024,2018-01-30 13:47:19,81
0xa08a5301ce8dfa1c72aaadfa53c5a059dd6f9f0b42ab7dfa989e629edb06047c,t,52886,7630032,,5000024,2018-01-30 13:47:19,82
0x88e4926d5c2872aa949766d07bfab9b7f73665f6b6dce53a94bf33c52adf6122,t,34124,7664156,,5000024,2018-01-30 13:47:19,83
0x36a49c0b56d457a5dd8b38e904770dd30eaf7c1eee65ccf7bff7897bf0c561e1,t,21000,7685156,,5000024,2018-01-30 13:47:19,84
0x865444d8484d7f5a069f7de6a1c13962711d5a950bb2a0040996b77fe97d4353,t,21000,7706156,,5000024,2018-01-30 13:47:19,85
0x21f48030049bffc4c69f57c8c8fa2e0eccbcecb03260b3f4bbfe173719a62a32,t,21000,7727156,,5000024,2018-01-30 13:47:19,86
0x51b745c39e46a8b341593a951ed0abd8d0fdadaf1b036930ab4b10a1768aca37,t,52886,7780042,,5000024,2018-01-30 13:47:19,87
0xbeef4d4770adfb832f481dbba7283522b38f1e41b44600e8a7ff1dd0f67669c7,t,34188,7814230,,5000024,2018-01-30 13:47:19,88
0x30598d39443ad1376c5ff5548a51890a2136039d679f0e72d4aa8a37193a468e,t,21000,7835230,,5000024,2018-01-30 13:47:19,89
0xcb66f56941614f6860a1ada0c12b90f85ae94809b5aaee1245213de7a539aa5e,t,21000,7856230,,5000024,2018-01-30 13:47:19,90
0x11270ded6999fb284ff43eb770bc00e33100ecc7281552872bdf0982c666f044,t,52886,7909116,,5000024,2018-01-30 13:47:19,91
0xc7433fb7f31a6f624efd7f32e38845d7015f6c42827fe5d7a1f7d64f607c388c,t,21000,7930116,,5000024,2018-01-30 13:47:19,92
0xeab49f6155a524dde96efd37d27b1c28619186642d6df98963380905336ec9c3,t,21000,7951116,,5000024,2018-01-30 13:47:19,93
0xe9a17bc0dd858990a9b97bb371281fdb214ed3267a7f4f8261e7fa08b4411ee7,t,21000,7972116,,5000024,2018-01-30 13:47:19,94
0x8262c9070dd27af3267d8495eec16a0970243a69284f4538ba9f13b45f5ba299,t,38679,38679,,5000025,2018-01-30 13:47:26,0
0x2576a6d697c2ca3974f629e617fa0ea3c1e18d39d2a73838afd2a21244f1ad8b,t,51545,90224,,5000025,2018-01-30 13:47:26,1
0x7dfb133e6f4ec4001b3ee12c329a493bfeb92a822093c58b5b71261e30ec6db0,t,21000,111224,,5000025,2018-01-30 13:47:26,2
0x6f38d628d3b0db4b1eefc9e35a2d9059d22c19e4a78f207615cb7f60262b1d08,t,21000,132224,,5000025,2018-01-30 13:47:26,3
0x1892f42073e2dfd3e70e3b34dd3c9c111eaef90e28d952e5cbee4d8a4d49c588,t,21000,153224,,5000025,2018-01-30 13:47:26,4
0xdb17a1b05a30b841de7e0cb787690956aa0525f4a4293d4b878f090bf9ba4df3,t,52327,205551,,5000025,2018-01-30 13:47:26,5
0x24c46ef4846e9d919df2bedbccf4924af9b72d72e89aa9c4fb1cadaac3d13536,t,21000,226551,,5000025,2018-01-30 13:47:26,6
0xc661bbc8509b1800fdfae2f7cf03173bf935ee78369cca5158ee650c831dd3b5,t,21000,247551,,5000025,2018-01-30 13:47:26,7
0x9df1826e2a01361183a289f3d545d3bdf04c30586ec635a56d9e944b1cdfcf84,t,79783,327334,,5000025,2018-01-30 13:47:26,8
0x6a81731204441626b35461fbb89ea3fa9195692197cf27905be2139ee4fb73f4,f,21000,348334,,5000025,2018-01-30 13:47:26,9
0xf88349d48749c645ac32f43f42b8ab12ba4cbe08d8aa9a10dc334712be277d90,t,21000,369334,,5000025,2018-01-30 13:47:26,10
0x29c77c634b1525df1f96ab26cb3a593af5b659ad1fa639bff66412d8a0b05a26,t,21000,390334,,5000025,2018-01-30 13:47:26,11
0x7e7ab5e0ed7262380f18f8a8afbc1b3dc921218c4ccf621dc0d3bf720a1bc940,t,52155,442489,,5000025,2018-01-30 13:47:26,12
0xb35d5b8bdb8a1b150ef25e17c87153b3339808e5bb0b31a0a0f1bfbab5beb88e,t,29016,471505,,5000025,2018-01-30 13:47:26,13
0x276254e1b0141f20a67dae108d0326979c7b6f38724dc55d0cadadbcf886990b,t,21000,492505,,5000025,2018-01-30 13:47:26,14
0x74f667a3f376346998fc9547e3b0b17bc628e373485628469e9dcb86b8574a1e,t,21000,513505,,5000025,2018-01-30 13:47:26,15
0xc6bdf1498f28b9bceda54e0eaa9174d8def23d5bed0c69898d2b35504d0f763f,t,104678,618183,,5000025,2018-01-30 13:47:26,16
0xd02c508676c475067f985f9f0aa5c3ea1d187d506ef84f1b9c01dfb029c751d2,t,21000,639183,,5000025,2018-01-30 13:47:26,17
0xf252a341965597aac35c218137c631bd640c337cb6e9b3464ec24987a83dc3de,t,51654,690837,,5000025,2018-01-30 13:47:26,18
0x12434a237a339984f396c20d5e57ccaa60369a66be84f83fc4e0cf31a1b2027d,t,21000,711837,,5000025,2018-01-30 13:47:26,19
0x1d8da59afce49f6690c9df5d38d8eff65287e821c2ec2e6a8ac44b66ef68db25,t,68632,780469,,5000025,2018-01-30 13:47:26,20
0xc3c8a3ebfa8915f5af61ea433ed16936dbd51272ab0e85b0f17259d0a1143da6,t,21000,801469,,5000025,2018-01-30 13:47:26,21
0xa2a108acbbf7bdc19637baaa46b4098ede6024ead480ecb44a81b18e11f70b92,t,21000,822469,,5000025,2018-01-30 13:47:26,22
0xf6fdafe1bbce0a74781512dee911c5858c17497abbd1a0a53b50452f41fe7cfb,t,127708,950177,,5000025,2018-01-30 13:47:26,23
0xe7191da8d9631486da0e03779e718616e6ab5fb1f1a74326117ac6d775f2ac85,t,52316,1002493,,5000025,2018-01-30 13:47:26,24
0xa4863925f1e5965b13a3b5fc09182b43f1040fac8e44fb03fd45053b1fbab49a,t,52228,1054721,,5000025,2018-01-30 13:47:26,25
0x214adae4cd908753afd1f5e775e80bb2be7609cf40d072161d718dbe35809f38,t,36708,1091429,,5000025,2018-01-30 13:47:26,26
0x98e3ac81d2dd6250a5034be14e746c892d61eeef2279fc3b6e6b47bd0886f6d3,t,21000,1112429,,5000025,2018-01-30 13:47:26,27
0x965c3fb24b1a3ba23b2ce5e9f9393ea4650919c83810265ff9d4f3c40a61741d,t,36642,1149071,,5000025,2018-01-30 13:47:26,28
0xf0e7702441a7751fdbbcbb7f9113f4d65086ec74da10244b2cbb8baeda23047e,t,21000,1170071,,5000025,2018-01-30 13:47:26,29
0x7afaa10deaec29478028be7521e564939c4188e1b6c911e0a4c9e5679dce21eb,t,21000,1191071,,5000025,2018-01-30 13:47:26,30
0x29bdcc65e31f41ac14047985ca4a04070b8a66645fed2fb516f1d850e95edd9e,t,153784,1344855,,5000025,2018-01-30 13:47:26,31
0xda8edfb822efceab376a2ed4bce9ead4444e3a44bbf5a0af1ff42490cb716887,t,21000,1365855,,5000025,2018-01-30 13:47:26,32
0xa2b982cec52ae18a0484c7cdc7cb276537ceda16a4e7346842172003a0b2cb53,t,21000,1386855,,5000025,2018-01-30 13:47:26,33
0x9cf347bde55262a1f4ebed6914f52fec4a35571849a0738f339b598e987f609b,t,21000,1407855,,5000025,2018-01-30 13:47:26,34
0x22637ee2806791b01c5e5cb3027d7810892aa0f4a6b140b0e95e9e36f5a9268b,t,21000,1428855,,5000025,2018-01-30 13:47:26,35
0x50ff1cecc98e793ae34c5ddad88ab6494682aad323413651895440293f504493,t,21000,1449855,,5000025,2018-01-30 13:47:26,36
0x35f346a5c3578996b6a087b7323a70f681499cbf32b69bf9b740ad8853e3e5e5,t,21000,1470855,,5000025,2018-01-30 13:47:26,37
0x3534e579218115a4f41b9636f4632b49246c5e7bea7f9ce164245318a3c591b7,t,53803,1524658,,5000025,2018-01-30 13:47:26,38
0x0d902aef0da125006f00f94e2c8fc9493bda9ec4905f95b1fe609caeb034808b,t,21000,1545658,,5000025,2018-01-30 13:47:26,39
0xc0ea949575bafc6b745b0988de33005a2a7d1fb78a9aea93997fd0b8ecc9c0e7,t,21000,1566658,,5000025,2018-01-30 13:47:26,40
0x6104af3b4b40d978b3996127736ad86d88aa6ed8a83c6f7bf2d781fdc7a4bef4,t,21000,1587658,,5000025,2018-01-30 13:47:26,41
0x65b30ae9aa7a0454ebcb38f46d7c7e40cb45caebaf09db5fe7da98717dd00b4c,t,21000,1608658,,5000025,2018-01-30 13:47:26,42
0x5ade513ed9d43718d69c62fe634e427af5d3529819c375b0f16f767cf4143aaa,t,73999,1682657,,5000025,2018-01-30 13:47:26,43
0xd9f6a784f55794515a65d2e7b8a39026d56a355e65b505e1127327ddbf3283e2,t,21000,1703657,,5000025,2018-01-30 13:47:26,44
0x3115334d11f2f502118b198a0f75ea46e7d75fb556145693013f5faebf7633f4,t,21000,21000,,5000026,2018-01-30 13:47:49,0
0x0fb5aefb92029b2c56ac342643755f5760733574fd10c0e247add420bde25790,t,21051,42051,,5000026,2018-01-30 13:47:49,1
0x9d5131bcc8118b28692744b3c9df064da69c92b19732df33a8ee4c4ef7e81cb6,t,52190,94241,,5000026,2018-01-30 13:47:49,2
0x4a3df0124134930c28e1f9e91710b72b9a11f2e138bc0dbde8a2d0c50f3651b5,t,55843,150084,,5000026,2018-01-30 13:47:49,3
0xfa23f71150670808abfbbcb8e2fa7042de06d9b69157308837ad188e7339f1f8,t,21000,171084,,5000026,2018-01-30 13:47:49,4
0x8561b16098f2ce966622e250187a23ee4ef951807bf5936bb802d3c192675ea4,t,21000,192084,,5000026,2018-01-30 13:47:49,5
0xc93d838b502ba24aac6feadf5117af8469df4bb778f953669fa3cf1caf40c181,t,21000,213084,,5000026,2018-01-30 13:47:49,6
0x88fe60acb9a3e1e8f9405ceac11bf5b1999d14b715fc2960279d047ef40fc67e,t,21000,234084,,5000026,2018-01-30 13:47:49,7
0x5c16b4128a5b88721ff0694484bec63bc13a32e2aeb5f179b0353f20abbb135c,t,21000,255084,,5000026,2018-01-30 13:47:49,8
0x8f037d38a67a481c2f9202fd01d277ddda3df74e15fd782a88da3910993e5895,t,21000,276084,,5000026,2018-01-30 13:47:49,9
0xf73f7867288a1aff32682cdfb01e096252ba1445790f861813acd25add2e2cf5,t,21000,297084,,5000026,2018-01-30 13:47:49,10
0x491c27eee8237938bf3c570f00e06688928adeffc7215e956baac9ba75f18176,t,21000,318084,,5000026,2018-01-30 13:47:49,11
0x66b0876f014cf3e2b55471f8a8ba5183a2110ad5e806bddd880db245f9375c08,t,21000,339084,,5000026,2018-01-30 13:47:49,12
0xab1b599338062d8bff46531b799379613c0c1054da53a457c97e3dda2f0e5d8c,t,21000,360084,,5000026,2018-01-30 13:47:49,13
0xbc2e2d922004fd55e5a032a7d11e06079974fa84d10e25e41188cd1fb945941c,t,53233,413317,,5000026,2018-01-30 13:47:49,14
0xbbb7154137dbf43aa0fe30fe0c4c1164b00097111eee221b2d630ecd1b3b1af0,t,21000,434317,,5000026,2018-01-30 13:47:49,15
0xc664099cea1834966bd49b9fdaa5229af9cf463150eba011fa65a9e69e02c3c6,t,102637,536954,,5000026,2018-01-30 13:47:49,16
0x16d107dc1cecb9ba3abe13b294dacca30940f73dbe364a796442b62ab2483139,f,23197,560151,,5000026,2018-01-30 13:47:49,17
0x71e4243a78ee565c4b71a6ce27a4d01b1b9ec5385fec70980d7b72962eb051d4,t,102934,663085,,5000026,2018-01-30 13:47:49,18
0xcba1de365db1b6f69bd355262945f72ef1c942a950ebdc2215cfee3801d0d811,t,21000,684085,,5000026,2018-01-30 13:47:49,19
0xaeca388a18f839c65fb593787e587da00a673d4c34f52db68f52535b6e0219fd,t,21000,705085,,5000026,2018-01-30 13:47:49,20
0xb28354a35fc11d00acbad5390aa27f5b1b789d80178626ba868ed1f41e92499c,t,31257,736342,,5000026,2018-01-30 13:47:49,21
0x6398a3288544b09ecd5da2f2a3387898c3f54904490f040d3d85f4f59dca4589,t,23176,759518,,5000026,2018-01-30 13:47:49,22
0x38b4f81d39575f0ca66612d843fe6bd9b5a98a965814e8dd9dcf58f25e15d67d,t,21000,780518,,5000026,2018-01-30 13:47:49,23
0x93b11740ee9f990c360a0db5ba17bf5cd8cce36385408daf8ab4d76f356c18d0,t,21000,801518,,5000026,2018-01-30 13:47:49,24
0x2665f6fa5e99ebec182f2e80a126c4d7c3e0f4c4ec3306cce37bd3715054dcfb,t,21000,822518,,5000026,2018-01-30 13:47:49,25
0x4dd7c8c88aab38d104967cd1b483cc0712569c8bb13c68b3b5aae4d286632302,t,21000,843518,,5000026,2018-01-30 13:47:49,26
0x4efc5baa4e1736dd82feea128f5f261cb9babec8d041ed0e4f5171cdd7e24cf0,t,21000,864518,,5000026,2018-01-30 13:47:49,27
0x3e1defdca8bacafd4bdacfba40544f89c1bcf4052ae5821e3c902202a3433ee3,t,51721,916239,,5000026,2018-01-30 13:47:49,28
0x410cb6f3c59abbb5c930878c4d8f11080f26813772e79bb17fe74a24a8f1a2c3,t,21000,937239,,5000026,2018-01-30 13:47:49,29
0xafec771b10d1511cf899f58af169307e85e65f4b3ed3af99610817ea9afdac8d,t,36669,973908,,5000026,2018-01-30 13:47:49,30
0x5c21eb934fd7f62bf13e89f6be149a852833d041c9b374d326ba70ec4cea7e99,t,21000,994908,,5000026,2018-01-30 13:47:49,31
0x35879f8d125841f0a8f06b649322a1c911610cc3d47295e14962ab90bc9125e7,f,23600,1018508,,5000026,2018-01-30 13:47:49,32
0x61c85583941e224ccd1e87224fc1d87df208f00dc78ea085a1afd27210dafbdd,t,21000,1039508,,5000026,2018-01-30 13:47:49,33
0xbcaebc78829cf3fda700265345342f4d39b02853756a06980dd7804e08e203d3,t,22588,1062096,,5000026,2018-01-30 13:47:49,34
0xf3c39efd6066a6d4c8b69f03efd6a875563716d4b080b03850ed26e1563497ea,t,52321,1114417,,5000026,2018-01-30 13:47:49,35
0xd2ee071ec8bfbd74acca0701c7c400607ac235d4bfe6000e01d2ad58884cc14f,t,21000,1135417,,5000026,2018-01-30 13:47:49,36
0x71a2cdf36cdcb2f37d86ebaa02ac8a0c8fc53db66b7ddc094ed2a33db00ea9cf,t,21000,1156417,,5000026,2018-01-30 13:47:49,37
0xcde655752ea54c2861820ba2085c0a4a3bdffe1b4c53159c2a644f539fba7683,t,21000,1177417,,5000026,2018-01-30 13:47:49,38
0x6f1d3c8387dcbb5dffe4c8fa0b42203bf888371f6b2be01073c6a94f2ed96800,t,104678,1282095,,5000026,2018-01-30 13:47:49,39
0x5898e5fa1be4d1ec32f9accc117d9ab341c2d8338f9fb43009ead24944d83618,t,21000,1303095,,5000026,2018-01-30 13:47:49,40
0x9851bf79d81885918075dec137342fd63707847a8daab8d066353695cdc6197d,t,37460,1340555,,5000026,2018-01-30 13:47:49,41
0xd9dacdeaf7caeb51708ad66a6312ad4c4999816a960117ff523ef23ad4da0d04,t,108242,1448797,,5000026,2018-01-30 13:47:49,42
0x2cbfbd4b27ca7c589518fdddf6e1f522a600756b5832389cc46a05de1e97dd5d,t,21000,1469797,,5000026,2018-01-30 13:47:49,43
0x75bfb02466e65ebdcac9255391f39b300266d89465b4958ea71d46ec04c1d2cf,t,38382,1508179,,5000026,2018-01-30 13:47:49,44
0x27133356636fc7c71629088b325beeb90f6b59c28414c2b1db40f1063911b1c4,t,51787,1559966,,5000026,2018-01-30 13:47:49,45
0x6e8a651ca3e129494f46d4f79910751f491ab0c648ddb4b00f66f7079c815f28,t,21000,1580966,,5000026,2018-01-30 13:47:49,46
0xc9ce465492935c863974009876597a5d9b319a66cd64d72ba732f802cd909b12,t,36948,1617914,,5000026,2018-01-30 13:47:49,47
0x937fe9a60c58ea42c392dcf742f32e665670cd0d845b4a6a110e31b1e2844762,t,45735,1663649,,5000026,2018-01-30 13:47:49,48
0x9dc0ba13c23bdd84811690129010f11dd36e518208b46ea129e153b24a02c01d,t,63240,1726889,,5000026,2018-01-30 13:47:49,49
0xe34ab135c7db63fe962a65a9b464b602b76e7f5bc0c6d1079b8fba62d01fe3fe,t,21000,1747889,,5000026,2018-01-30 13:47:49,50
0x0408d1b4077ea530ed5f7a6f7c2ecf27fa978fe1593b63f5fa7772e963b53e0d,t,21000,1768889,,5000026,2018-01-30 13:47:49,51
0xec93f95123eb98774609df0fecf102ff9b19059bc367d845576ecae75c9761ef,t,21004,1789893,,5000026,2018-01-30 13:47:49,52
0x9ddb9cfc741987d098c152fd33983a97c004352b5f39ee348ef94f311c847d13,t,22088,1811981,,5000026,2018-01-30 13:47:49,53
0xb8de95e3735b9d3f9f8606c65f948122cbaa46b9b56cba15c279f4bf2f3a4d36,t,45735,1857716,,5000026,2018-01-30 13:47:49,54
0x18d6d75566f37aab451ce7ce1e8f4c9ceb48ed4e08f21e40c1ad568cee09c6a7,t,22027,1879743,,5000026,2018-01-30 13:47:49,55
0x888bf820c3c1a904e4e159580c79f398fc1a245a58b3c928ce1d742db346328e,t,21000,21000,,5000027,2018-01-30 13:48:00,0
0xbb5c4fb048e116ec3f6ba8b2105d699401dd20f6f32383df5a24d48e23641f96,t,21000,42000,,5000027,2018-01-30 13:48:00,1
0x53d4bdaab8ba2144db14cd514297388a06200d8be3a1262a54c1fde291328139,t,21000,63000,,5000027,2018-01-30 13:48:00,2
0x681a7d06069a052031a29c2fcefdca7e56d2ea2b26092a44ee3fa0ec52ab1452,t,38047,101047,,5000027,2018-01-30 13:48:00,3
0xc8c2105d1840a83649151b299a48c42413090006350c824ef35aeff8b8d3efc9,t,21000,122047,,5000027,2018-01-30 13:48:00,4
0xa37220e9eb9b2d1f8ede5439b08c2da7087a227d2d9ac8e9f7fe8180d9814372,t,21000,143047,,5000027,2018-01-30 13:48:00,5
0x870b0599fab4ee12f0c298adf107de2dc5969be8c4f804eea7e48e1de259d7e7,t,54771,197818,,5000027,2018-01-30 13:48:00,6
0xd4f713d62843a3d7e8c5a1ea7ada9f6ef8de1f4dc637ef9934694fe280347a39,t,21000,218818,,5000027,2018-01-30 13:48:00,7
0x807348ecf91311dac7d348e2484974a58bbe4ea4fdf0514a53295f5c3a46b170,t,60109,278927,,5000027,2018-01-30 13:48:00,8
0x59a1e5e91d03dedbaabdc0613a5ce3b3e3a5967c52280462d5f5dc8c6e945891,t,21000,299927,,5000027,2018-01-30 13:48:00,9
0xc849cb70c4202d055660fae449d1fbe82452ca9252e9b7a7406dc379cd347389,t,21000,320927,,5000027,2018-01-30 13:48:00,10
0x23845cff9fbd6d4e6d90c619ce8cda151618dc4c5597bd35923af142f23ea1b2,t,37571,358498,,5000027,2018-01-30 13:48:00,11
0x62ddf51a8e6412cf04a44f91f3aaa662e5208a9f179f88f91a1df4796c745884,t,21000,379498,,5000027,2018-01-30 13:48:00,12
0xd34b224391d40c6b463453872b51cde1295bec7d0099b4fae70dc304cad16b24,t,21000,400498,,5000027,2018-01-30 13:48:00,13
0xc1f12f151a5afcde88203202dc38317f0e0020f381bce8a00e2b5f965e46ccb1,t,52874,453372,,5000027,2018-01-30 13:48:00,14
0xfab0d5410d883cdf788b26df840133f7f5623e1a4a668a413e4003e8dde383e2,t,21000,474372,,5000027,2018-01-30 13:48:00,15
0xbaf5e811b358bfaeb8971d03ff85bce2b876ac9c5f1bed1b440e0cc57f8b0ff4,t,26065,500437,,5000027,2018-01-30 13:48:00,16
0x967f3183740e52b8b946d9fa123b2f69eaf0e8586683359e05230dc1e36f9313,t,25963,526400,,5000027,2018-01-30 13:48:00,17
0x44d2843af46aa2c85402e0c6dbe09d8d8f07d2f3efdba664eda2faed2c12cc95,t,21925,548325,,5000027,2018-01-30 13:48:00,18
0xd5202eb29511e7582648f62f1c7e086c265b862ee39381f4150c3bc63fcbbbb1,t,59354,607679,,5000027,2018-01-30 13:48:00,19
0xda8119a95be70d6d0ac30fb10073b98bc93395f2940d58a275ac15ba0c556688,t,64725,672404,,5000027,2018-01-30 13:48:00,20
0x72206e88828668b37411114f1c3d539540d0e0dac40e2cffa3b5c783c12b08e9,t,21000,693404,,5000027,2018-01-30 13:48:00,21
0xfaa2091200a34e97ef236ee208b58c8ab314d0f8bfc8bd41332a0d09ebd1d0a5,t,52488,745892,,5000027,2018-01-30 13:48:00,22
0x5c89b8f587e93531ea8784a2bebb05f9babd95ba91363f279fb9092a1c8827bb,t,21000,766892,,5000027,2018-01-30 13:48:00,23
0x9b8e522d1a97620abf776bba9eab652f2b29d8a8f6914df5d92a6825080074ac,t,22027,788919,,5000027,2018-01-30 13:48:00,24
0x9b64a8daf4f67ea48761843fc4b4d4d1a2523fc974fc03439c326492f2198277,t,21004,809923,,5000027,2018-01-30 13:48:00,25
0xc4d7538d7438204b6d9a39dbbfd47a79f43337de75c6dd8fb8ea4f06d402c87c,t,51654,861577,,5000027,2018-01-30 13:48:00,26
0xd7628274d5431f575c63f7b36a631c17c29c9daa23ece093c713206962a310db,t,21000,882577,,5000027,2018-01-30 13:48:00,27
0xc642405f8a34425687157d4ec5fe66bbcca536ba701e55ad22d4251ed515cf7f,t,53233,935810,,5000027,2018-01-30 13:48:00,28
0x3ff8b9ec6e34476cf763308e5f2aa9008c44468807520a21bc593d489229fbc1,t,21000,956810,,5000027,2018-01-30 13:48:00,29
0x1d6f7671718fd92532f76addde2aa584d9f92b2017931f0175218cb7ca6286de,f,50000,1006810,,5000027,2018-01-30 13:48:00,30
0x20779432530bf55af07252c980bb809a7d0f2cf1ed3f95c32ae2391df09cf6bd,t,21000,1027810,,5000027,2018-01-30 13:48:00,31
0x5abe57f58a3dee16f8490bdaec5174887ddead68063019d4079c16179c44fedb,t,21000,1048810,,5000027,2018-01-30 13:48:00,32
0xa69e66996488432a15021f74938c0bb0c0b8d010477227ee07c3fae91a978c69,t,21000,1069810,,5000027,2018-01-30 13:48:00,33
0x88bc4073f9693412d7ba09ebc720ba9059a0c8d83baa0a34fc90bf093d455d8c,t,21000,1090810,,5000027,2018-01-30 13:48:00,34
0xf0c93fb02e147fb38d7acf2c00d593633e5edae6aa10f545bd7c137c7e273fc7,t,21000,1111810,,5000027,2018-01-30 13:48:00,35
0x673672bc8a6acf182d908b9612f11b5a2558d855b0d48c581eff66b0c3cceaee,t,21000,1132810,,5000027,2018-01-30 13:48:00,36
0x6822518ac0dd7cbf08399d3484cc54d61bc39d1a86b342b539ef103f98f105c4,t,21000,1153810,,5000027,2018-01-30 13:48:00,37
0x70640ba598a86e9d1537abdce787e57b99a73feaa6573cad6bfcdbf332718ea0,t,157580,1311390,,5000027,2018-01-30 13:48:00,38
0xd326cef5c36625dd994c232549356d12bb3099a9c69e5eccabe19210828446a4,t,38005,1349395,,5000027,2018-01-30 13:48:00,39
0x1db5d7f6536c6391ae5e04ffc861218344cf8d1fa41e66ef1dd4c74e55485895,t,51955,1401350,,5000027,2018-01-30 13:48:00,40
0x4c971a90a9d033d791825c95c762dd408a327f5488bf2386cc4ccf6ff4220f6d,t,52611,1453961,,5000027,2018-01-30 13:48:00,41
0xb9f4a3dc4c0f8463cd4cba836d235225d8622f67bdb0c3f6b82f61346c802481,t,53167,1507128,,5000027,2018-01-30 13:48:00,42
0xc2389caadefd9c4edb24ab8826a1f448dc039b00f28cdf0c21d703f18d4e7210,t,21000,1528128,,5000027,2018-01-30 13:48:00,43
0xfd82c4328ff36c68e09e7bd70b8416486dd1946eb4f27f046980a71ace983999,t,52912,1581040,,5000027,2018-01-30 13:48:00,44
0xb255a7d63069460dcc705e5ace0ea13236e6b3b2c5d72b5be2a2ed7f76d0a49e,t,40971,1622011,,5000027,2018-01-30 13:48:00,45
0x7a86acf4ff17d30344731485fe8a1924f6cd7b735c455d8b2c0f26a03b020c7f,t,51820,1673831,,5000027,2018-01-30 13:48:00,46
0xcc0bc8868db7bd9e4c238fe9e6616d427564dc05fafa1fd7a5ee0db5495e685f,t,21000,1694831,,5000027,2018-01-30 13:48:00,47
0x5170e98dbac7acb22dc75755dd35892c80d85e8954036d9848babf2e2b62fce1,t,87425,1782256,,5000027,2018-01-30 13:48:00,48
0x678841ee5d7a4cc9c256bae5586f40794e95a9d3ecb37e113232c54ea9e113fe,t,26712,1808968,,5000027,2018-01-30 13:48:00,49
0x0867abd55f3fa50fcb1fae189cda0dfb8b15b5fb0483c43605ca52c71f203121,t,51852,1860820,,5000027,2018-01-30 13:48:00,50
0x01c0b6a5a6f50e8f7267113cabd19056a24119c9043d8655b6b700e73ca1e2de,t,21000,1881820,,5000027,2018-01-30 13:48:00,51
0xa50ac438052d183d32d4bcd6951885c86b84e33bf8e2657af3615113f90ab45e,t,21000,1902820,,5000027,2018-01-30 13:48:00,52
0x1a7d2015efa1eaf4ab9942c9a98e6701ccb0ea8b3893519dac4ef4023b910988,t,253854,2156674,0x5FF492DdD4e44863a7e5688ff7B161F109f3E0D1,5000027,2018-01-30 13:48:00,53
0x472030e0b010f45a37d2803d0b6d0e7922cdf0b48770f7875118eb212ab2c9fd,t,67685,2224359,,5000027,2018-01-30 13:48:00,54
0xbc866a1bd8ecf734bccca54f9bea7e314e7b98e2e23637e11ae237684855915b,t,52886,2277245,,5000027,2018-01-30 13:48:00,55
0x9ab04e9705b48bbbe6571289320adb81cd276c516c64e34b65127f93aafdef98,t,21000,2298245,,5000027,2018-01-30 13:48:00,56
0xa1d67fdd5350b34440df0902d585ed844705197bdc999612441d0bf1397977ff,t,21000,2319245,,5000027,2018-01-30 13:48:00,57
0xeb384749700814a05818e07db822fb32408a176db7efbf5ae7619d8f12c30497,t,21000,2340245,,5000027,2018-01-30 13:48:00,58
0xe7b50289f12977e44bc1c3ddc39081c01a6d8c15a1bdd0a5cfc7d128daa89d28,t,51955,2392200,,5000027,2018-01-30 13:48:00,59
0xc4933f275b3fcd7d0286e61f97a4ec7a270a85ba551cde34dd233b9ad86bcced,t,21000,2413200,,5000027,2018-01-30 13:48:00,60
0x7b68064b1062d63300c776d8f09746b4264a5123e4ccac5c417c2f301bb90371,t,21000,2434200,,5000027,2018-01-30 13:48:00,61
0xb5066069a6d1ca9ae300c09432bdbe606270f349b6312644dcbdcbc1452fbf63,t,36542,2470742,,5000027,2018-01-30 13:48:00,62
0x2ca638093d49734c77678f1c33ab550050628ef7a832dac89f11d1e3315f1511,t,36728,2507470,,5000027,2018-01-30 13:48:00,63
0x5d5216d596385fe67fb34f777a8c034b9f5862533b46ca113ed911a255b0d2b4,t,51845,2559315,,5000027,2018-01-30 13:48:00,64
0x8b5bfd804f5d2ff986dae558664c7f2001f3aed4b8fa3e7484f1fc921dbe29d1,t,21000,2580315,,5000027,2018-01-30 13:48:00,65
0x0db54bb79d3b5e2ddaa4102f50d1475833872f246b9bcbbcd299af40cbc44dca,t,21000,2601315,,5000027,2018-01-30 13:48:00,66
0x1959c0093871d9461e3241f0c9e87311563839aed4ae491a5077e547c9d63eb2,t,21000,2622315,,5000027,2018-01-30 13:48:00,67
0x28ea65e0cc23013c69244e2f3200581c819ec57ad7dff26f3a7ef36c339bd799,t,21000,2643315,,5000027,2018-01-30 13:48:00,68
0x39ecff4efdc7547c6a771bd8dc38e645b6aaac6d166a164f046264e3ce884721,t,21000,2664315,,5000027,2018-01-30 13:48:00,69
0x85fcfcfc023cfac9689c1a79eb4311dbb1adeeba87e99159ad95e6c07aeb554a,t,21000,2685315,,5000027,2018-01-30 13:48:00,70
0xbb65cf0dfde9eba18321a8430712b9511ca3d8ca20fc9a64ec070a2f672649ba,t,21000,2706315,,5000027,2018-01-30 13:48:00,71
0xb12ca59799a5f88684cda1185cb239d3439f9c754062f9e1b6668ac742cec885,t,21000,2727315,,5000027,2018-01-30 13:48:00,72
0x98504933da66336fc6fd8c73c525bc618090fd0d15c58c39b363a7bd79c99683,t,21000,2748315,,5000027,2018-01-30 13:48:00,73
0x0529fafd4e34e9ab3a73dff0266aa21b4f08b61f62181b6a6a9c7536379e374c,t,21000,2769315,,5000027,2018-01-30 13:48:00,74
0x1635e165891426ece1721a458345f9932b8f80b812842f1aa481866822feb07e,t,31005,2800320,,5000027,2018-01-30 13:48:00,75
0x8eb1c92de0800fdf41a2f64647aa1e2e99eed2387dae1eaa19bc486af791b502,t,21000,2821320,,5000027,2018-01-30 13:48:00,76
0x7cee09dab471ecbbd907a9ed14d8cefff6627d7990698caefc863a8b901f9209,t,52186,2873506,,5000027,2018-01-30 13:48:00,77
0xc5fcfdaa51231beabfab385415e46000cf7b245ef348d6685a918bc814753ef9,t,38722,2912228,,5000027,2018-01-30 13:48:00,78
0xc81233adab0aa3301a5debd3025ce42f53fb5c244ebfa6992aa83398e7bfda64,t,37507,2949735,,5000027,2018-01-30 13:48:00,79
0x81a53c2b6f94f331747bd6eeb5f000a8afc92c716d36ab120a9ac264126389fc,t,21000,2970735,,5000027,2018-01-30 13:48:00,80
0x018cf2426685c66032aa1ced62082049714a301f8098f2a52f62fe18b7aa7ee4,t,21000,2991735,,5000027,2018-01-30 13:48:00,81
0xb07471953be7b2b6e8baba16048d477d615b6f99577307b135187908f8230e2b,t,21000,3012735,,5000027,2018-01-30 13:48:00,82
0x5d1be57bb929cf2736c581757ef6a90a3082c18f4a3e63cd82a88009dc9d4c37,t,52460,3065195,,5000027,2018-01-30 13:48:00,83
0xb5a8dd787d51185ac04281b00c8bba72f16e9dd18131a73044da907e20d2f72a,t,21000,3086195,,5000027,2018-01-30 13:48:00,84
0x4e6e476dc51cd92e3eb0b2714f10aae5526325b2c1d2794d389820f794697d8f,t,37950,3124145,,5000027,2018-01-30 13:48:00,85
0xc3ad550e70359c1102ddb75e20d16e21bb9a03e570d01a7273fe5620c1f401f1,t,52468,3176613,,5000027,2018-01-30 13:48:00,86
0xcc85ac1d5058cec8430b1eec860aa0da146a50d32b9dfe7ebf4dfaf789a13faf,t,21000,3197613,,5000027,2018-01-30 13:48:00,87
0x762489d69cc4e23e17adc9af1d8c8fd4c47a0ffcad4a73cb48fa748a5267f0dd,t,76670,3274283,,5000027,2018-01-30 13:48:00,88
0x788a0cf451632a0b3c696fd442adfc863219b8f90ffcdedfad45a9a21843bb6a,t,21000,3295283,,5000027,2018-01-30 13:48:00,89
0x17bd08f49a9f3feabd98d810a9da827af4ce1ff1e71691dbc2df5905757ed759,t,21000,3316283,,5000027,2018-01-30 13:48:00,90
0x096c63d426358e47bc23a7062bd6db50c2995d88ebae01605f117a1dfe9e38c0,t,21000,3337283,,5000027,2018-01-30 13:48:00,91
0x578d384f65ee28fb88cc9d5d0298ec56fd150ce485d75666c98252e6260a258a,t,21000,3358283,,5000027,2018-01-30 13:48:00,92
0x5cce9f652e94e071f4f72c1658f5da7acd0f02fd5133eb0ce5f64b7034fee1f2,t,21000,3379283,,5000027,2018-01-30 13:48:00,93
0x6eb426cd12f9f37c9ed8d404b49b159b5789d7f7ef312ac54777dee9b6e3d5e0,t,21000,3400283,,5000027,2018-01-30 13:48:00,94
0x47debc0d22cb1975d546aea9bfac26f31f3049a1b89575c34bd1c57d270b044c,f,116070,3516353,,5000027,2018-01-30 13:48:00,95
0x83b555bfc67273525ceb0ee63c3a9a8f20cd39ce49eda3dd21458b30d1388403,t,21000,3537353,,5000027,2018-01-30 13:48:00,96
0xc9f7c3069c056d270c7f2df1f5f6b9c17e26aa50fe9d899edd7fd24fce67faec,t,21000,3558353,,5000027,2018-01-30 13:48:00,97
0x5410d204eb319a41e237c2d6537efd405580c522cf69ad7ca97c0843ae8d64d3,t,21000,3579353,,5000027,2018-01-30 13:48:00,98
0x18bc12562ce660ccf204306087fcedf895371eddf8fbc2301f36949694d06393,t,21000,3600353,,5000027,2018-01-30 13:48:00,99
0xccf18e2d39630f2492f25552113e34330a21bf3b1ac4adb68a306b9c719f2fca,t,21000,3621353,,5000027,2018-01-30 13:48:00,100
0x29f06f82cc58d235ba02da6911439aa89ecb4fc4445f290f3cc801fc82ec75bf,t,21000,3642353,,5000027,2018-01-30 13:48:00,101
0xac47046fca76a8b7d0344ef6ed50ac29c471ecf794600d3632006ffc599d81a6,t,52336,3694689,,5000027,2018-01-30 13:48:00,102
0x40c074f19c845e4062b7902d8bb16edd364007ed24b2d1d4ee7e48e730caedf9,t,21000,3715689,,5000027,2018-01-30 13:48:00,103
0x58c67a7f0aa12427c79b672461f2d4a4a08bf72a6de761f26a78dc2ac49f249a,t,21000,3736689,,5000027,2018-01-30 13:48:00,104
0x66c29d6774be42740b691ddcea7b1fe5114d43aa6cd1dfc4b9926fcd06630777,t,21000,3757689,,5000027,2018-01-30 13:48:00,105
0x0588393b3a8345be64966b3c43be1bfc512463b74b14205eb2208d5d33b5e3a9,t,21000,3778689,,5000027,2018-01-30 13:48:00,106
0x2b4d536517a4039ac2dc724d7aeb0848c9a0f052e5086b2afae7f22114927f06,t,21000,3799689,,5000027,2018-01-30 13:48:00,107
0x19122571a4d17b9897d257f68d48b1509dd90372c22fc110fad197df8aa549a3,t,21000,3820689,,5000027,2018-01-30 13:48:00,108
0x90dac94b4d1d775321685885fc05094082394d1958a685bfdc530c8703bd02cc,t,21000,3841689,,5000027,2018-01-30 13:48:00,109
0xe93348d202137b1d9ac75e0c24d39140e37c73fda20c1a0966febe889fc0f6a1,t,21000,3862689,,5000027,2018-01-30 13:48:00,110
0xe65e7c385d0699bde9d6520bb3cf87a47cf799ece6da4f434cf6d4cbd6973aed,t,21000,3883689,,5000027,2018-01-30 13:48:00,111
0x48371f8e4fbd5ad66cc8f627e430c161b3cd6c1effbeead3c4fa751dfe9fd205,t,21000,3904689,,5000027,2018-01-30 13:48:00,112
0xd7a534af51dfca600d8b927f387c8a69113bdab49cc94f95d783703918850384,t,21000,3925689,,5000027,2018-01-30 13:48:00,113
0xd14ea38b8f10596d2c3c88ad8e9027560425e50cb2e33694b2a3c9c452417985,t,21000,3946689,,5000027,2018-01-30 13:48:00,114
0xb4be18086bc51520f0895b5477d3d6bc130c349f6981daed9ca588e5f9a1eabd,t,21000,3967689,,5000027,2018-01-30 13:48:00,115
0x6c1dca690c3469a4e15205b829eb1a8714f98816219e2890c7bb233e0739c3a7,t,21000,3988689,,5000027,2018-01-30 13:48:00,116
0xf1eeb3ad0730f7b88fda085096cedfe5bc6cc8814c59979742517c64e1d30d89,t,21000,4009689,,5000027,2018-01-30 13:48:00,117
0xb6da02c9f633351bc894f37a175a32e61f6437668560ba3c874e4dd04a73a950,t,21000,4030689,,5000027,2018-01-30 13:48:00,118
0x9457dd20074e07e55b7fa633e43ab577aa9491397bed345c796c4d3bf88bd193,t,45948,4076637,,5000027,2018-01-30 13:48:00,119
0x8fd81bfb67701c826c2eb41145c4647c65e19fb36c941c14be447861bccaa606,t,21000,4097637,,5000027,2018-01-30 13:48:00,120
0xa2473b6ba039ab85e6d5d0cd861c9635b5a288f1ae1d13c32bf8b1a1ce0b8d2d,t,44493,4142130,,5000027,2018-01-30 13:48:00,121
0xc06c1065ed6d3b6812c351040bfea6e4c6a3068797248e08cc3612a3d6a1f569,t,92666,4234796,,5000027,2018-01-30 13:48:00,122
0x81344c2d17d59b5db06634d92a61baa195aade456225272f089470b515105f4b,t,279531,4514327,0x78153f8abb4d2C141A32Fa57bF8781d52814edf9,5000027,2018-01-30 13:48:00,123
0x452095d32f0c8dddff0c2dd03394ffb730b578f2d0165e1300244bcaa4cfc9f8,t,78114,4592441,,5000027,2018-01-30 13:48:00,124
0x2277bfb8dedd285243fee2c2d36126274498a76f463fbfefda347b57122fe081,t,21000,4613441,,5000027,2018-01-30 13:48:00,125
0xd08a68cdeb041e68a1c127d42420647d573f2c11a260b498d06b3d5a2685ed8b,t,54379,4667820,,5000027,2018-01-30 13:48:00,126
0xef1bed51f2ec9bcf5eccb2c3f79536cb853d69b41b01bd697a47b1711309b0ac,t,23316,4691136,,5000027,2018-01-30 13:48:00,127
0x401d1dfd1bab280cfd75070a4a98e3935b29c14dfb710d92b62d67f74de1e471,t,23167,4714303,,5000027,2018-01-30 13:48:00,128
0xcf553cee02e0056c0a1f2716bf6923c7982fe9ce2264f792f8f209333cc01b50,t,22106,4736409,,5000027,2018-01-30 13:48:00,129
0x68151e81581a6b4df1a8e4cc6d116f0d25c33ca922f7ac3e2f173dad96398ce5,t,105247,4841656,,5000027,2018-01-30 13:48:00,130
0xbeaf78bfdc8896bf7134741e20dbd14270a853e7025e56d5d5015fabde184255,t,38028,4879684,,5000027,2018-01-30 13:48:00,131
0x724288b71fc235ee9ddd6ded21029bd5fa54c1ad4cf960513959aae7ae3176ee,t,23679,4903363,,5000027,2018-01-30 13:48:00,132
0x544ff6dd2529209506267b63839ccd3ac7a94edd82a7bd03f1e39290069f0d24,t,36685,4940048,,5000027,2018-01-30 13:48:00,133
0xefbd61aa6bce4189bbc2f62caeaf3043391be55eb60db98faede78babc3ad6f9,t,21000,4961048,,5000027,2018-01-30 13:48:00,134
0xbb9553e772f16f382050722b693f3c8f949a05d906186f5bdb1c593d0c7157bd,t,21000,4982048,,5000027,2018-01-30 13:48:00,135
0xb88b7fa01f59c299f7fd4b6a365e873391aba68ef86769e77bf89ff92402c6d7,t,34254,5016302,,5000027,2018-01-30 13:48:00,136
0xc2f0a9fc901a47ad2988fa0e3d18c837f9790606aa3a6c24680b2dbabea2eeeb,t,22460,5038762,,5000027,2018-01-30 13:48:00,137
0x3718db05c556e3e85d48c5792f3252553cde3d103e5770f939c39e24058ef318,t,22158,5060920,,5000027,2018-01-30 13:48:00,138
0x2ec5c754c6d4b48b1bb805acd66c850dee987fd91e7d47b5ccd70ef5e05924d2,t,22524,5083444,,5000027,2018-01-30 13:48:00,139
0x9cf36d810dd909dcf01e8dbe1b66c1d938b6df047e5f4fe8427e843aa108c891,t,22524,5105968,,5000027,2018-01-30 13:48:00,140
0x4a30fbc11286e226d2f69fa9a69a1b0d388a811612a87b3b85cc47e865109902,t,22316,5128284,,5000027,2018-01-30 13:48:00,141
0xef4de4e4b282b833d994c6ad00b31d4e131337a78b7a27d055c697cb78241cdf,t,22678,5150962,,5000027,2018-01-30 13:48:00,142
0xb46ee89bed25e170a1a8759302cb44fb08eafa10d093a506949e09a6993c41a3,t,23519,5174481,,5000027,2018-01-30 13:48:00,143
0x64ab27644a203d8fe144dd41b4fc5df5756b06abc191cd01466b4bd1b03cf8a9,t,23583,5198064,,5000027,2018-01-30 13:48:00,144
0x8f705e027f6c60583a03654a505e1a38a8c5d9758d214b06ead3ec34c1e9ecb5,t,23103,5221167,,5000027,2018-01-30 13:48:00,145
0x4725dd4f161bed04ecc34a7f7e6f8290ccdc14e8f6c5ce7b51b601bd747b663f,t,22237,5243404,,5000027,2018-01-30 13:48:00,146
0x9a64dc4b7d897d56a548d4fd85c9ca383028132acaa28ef8c558fc9715fd9e3f,t,22237,5265641,,5000027,2018-01-30 13:48:00,147
0xd34c2bb3844e553591a2b10cbab45a9160521e89d65d01eeb59512b6dacfee9f,t,22143,5287784,,5000027,2018-01-30 13:48:00,148
0x12637616be339264749281505144b39e370867d46fb9cf490c0faa564ba6353d,t,22158,5309942,,5000027,2018-01-30 13:48:00,149
0xb71702f71e56c76150de3f76df7f000898fad1e3328b98d7bd597705bfeef4ca,t,21770,5331712,,5000027,2018-01-30 13:48:00,150
0x8f9b5d42799eed35af657141aab47019c317f9fbb34266d8d87902a46f346974,t,22524,5354236,,5000027,2018-01-30 13:48:00,151
0x066bd27f4a066e73fe56a7d71b6b9a942400e804ff9426598a051a71c43b156c,t,37678,5391914,,5000027,2018-01-30 13:48:00,152
0x6ebdb053e97bc9715421ef6ff47bf0850015321cbd46bd4f221fc368b51b1eef,t,22460,5414374,,5000027,2018-01-30 13:48:00,153
0x025959c3a6ba06d57ebc27fe733c8ce04ee08db7838e0c1f12a4deea1ae07e0f,t,37071,5451445,,5000027,2018-01-30 13:48:00,154
0x1fa0f6afd4235d993fe4da0ff480a8e119d957b7f9b615509a405db9624c4291,t,100076,5551521,,5000027,2018-01-30 13:48:00,155
0xcce90153cff532142da67877ffbab3d6d3c75dc446c9f2df9ba3edf866795d61,t,453146,6004667,,5000027,2018-01-30 13:48:00,156
0x45c878072f37fd852e9d4d437941dd99d974bd37a94ccd0ca00d631bf454fc69,t,51401,6056068,,5000027,2018-01-30 13:48:00,157
0x10aeb2fdd75764b59d92c32b8f1afce37d3806b31f333797b48652cf4e4461dc,t,29493,6085561,,5000027,2018-01-30 13:48:00,158
0xc25b2b5d2a4cf8a986c8972adb68c283485b42d7e1ff76146922335665e22c19,t,44162,6129723,,5000027,2018-01-30 13:48:00,159
0x1ae56860c2656fa4ce996bd996b5c732f548fb5016043c4fc3b24c73193b9a8d,t,140340,6270063,,5000027,2018-01-30 13:48:00,160
0x7354a67e64108748088248bd343f6b8aceb05c7c5c2b199c13090b0bd656b1e8,t,21000,6291063,,5000027,2018-01-30 13:48:00,161
0x9294880003115b2cb16c4d7e21c4cb7e52044d4f5cad0107a11df9c8517c7f3a,t,36772,6327835,,5000027,2018-01-30 13:48:00,162
0x1b753588a2e0c379693a8d9aa752482b71128065cfc6c4dffff284a7505b5eb5,t,53288,6381123,,5000027,2018-01-30 13:48:00,163
0x56d23ad1cd6da6bad46e22fe89401f923af1c3c236ef9192939808c4a154ea06,t,26543,6407666,,5000027,2018-01-30 13:48:00,164
0xc8b9a4cfc93ec80e5c114f667f23bfead8524148bd0e355931a5d4f5f376f88b,t,45566,6453232,,5000027,2018-01-30 13:48:00,165
0x83bf89096929bb88bea101f603149afeaefbaf5fc58a75057ac5ee5874df05e9,t,149115,6602347,,5000027,2018-01-30 13:48:00,166
0xb81eaac308f2b7b4ab196d8813090bac0b7717016da50b113e4d84a23e542762,t,21000,6623347,,5000027,2018-01-30 13:48:00,167
0x8c56e09496315ed00c9713e3a0c8091bdecdd5c13b54504b011371f4fc4e4746,t,45574,6668921,,5000027,2018-01-30 13:48:00,168
0x3646ae5a22c8346633c752ab2131dd90c18c13541bfaf05749b95bbdff20f0fc,t,174591,6843512,,5000027,2018-01-30 13:48:00,169
0xfa8619e4f0a5fd5e375e301339ef2097a6732659a716015193e4e2dd9e837616,t,21000,6864512,,5000027,2018-01-30 13:48:00,170
0xd45db14c7b98d2ea46b9837ed500c6142f2c8aaaf033625dcb565aaf8eb10bf9,t,44162,6908674,,5000027,2018-01-30 13:48:00,171
0x2a784014de6440fb470b10c2ce380c7043db84c796eed5df42354af99dd88a3f,t,44354,6953028,,5000027,2018-01-30 13:48:00,172
0xf3881e4e6ae5fbc9f36d8eec97cfb861b763426d93e470c09c6b1b56539b7df8,t,21051,6974079,,5000027,2018-01-30 13:48:00,173
0x941ab33c400b5aefeb1ffe5308db9c48e35c387a50a0dcb4581f104aa845320c,t,63640,7037719,,5000027,2018-01-30 13:48:00,174
0xbcff20b8f2eeb2fa955e0e4218052b6686885bee75bd7f0d6a4a689f4468966a,t,29493,7067212,,5000027,2018-01-30 13:48:00,175
0x94845a68ea9b2f3ffc8e0c17ae4884333cd81b311b06036d806fd9d6ea9998d6,t,107986,7175198,,5000027,2018-01-30 13:48:00,176
0x6030bd6fccd36643103fffe749d08064632ed763725e348b199c6283d69deb9e,t,33939,7209137,,5000027,2018-01-30 13:48:00,177
0xabd09f78b4bb00bb1e24abb11b7e979e048f5c69dbd57b0bafbae8ed0d1cd80f,t,45318,7254455,,5000027,2018-01-30 13:48:00,178
0x0a32b37da33aa6f36b0afd9871f75ee23d5a25b5089025b83509d1e1c7bd8c8c,t,21051,7275506,,5000027,2018-01-30 13:48:00,179
0xfbd58bba614f782059c1d26fc16af7227fa5188d67dcfa233b12288ff14a010e,t,37900,7313406,,5000027,2018-01-30 13:48:00,180
0xe6ddc9d22ecb2c5acf79348701003509b3553c2a9b08764c682c4217bda0055f,t,50384,7363790,,5000027,2018-01-30 13:48:00,181
0x4b091920e6454679831a6da7ead09382036e503bd24600e9203414cdff2f3fc3,t,37900,7401690,,5000027,2018-01-30 13:48:00,182
0xbca58dc05fd70c4b058ff4c77b2caf649671e9ee2aa5db9a17acc142dadbe79c,t,51496,7453186,,5000027,2018-01-30 13:48:00,183
0x2e471723a896735c629be37e73731274993a89134c241807583e9c58b7d19608,t,93306,7546492,,5000027,2018-01-30 13:48:00,184
0xd035c09a012556f8c4cc5ebd10f095326609077b4354a493bea2e727fb113b33,t,107730,7654222,,5000027,2018-01-30 13:48:00,185
0x2a10cc034a250ed9bd0043ab5a64801e4a6f51850f0f7b2e00ec5300822af68f,t,21000,7675222,,5000027,2018-01-30 13:48:00,186
0x8073fe0c800639a28ac435715c001ce65ddea0cc75145ee471d8e8bd2fda5e11,t,45611,7720833,,5000027,2018-01-30 13:48:00,187
0x0188ed6c2464c2c99bccac0eac40ca21c03a62980b9a053ab0225946888c6a0c,t,108050,7828883,,5000027,2018-01-30 13:48:00,188
0x5762547fe84b0316cda529365fa314789031f862f41ed5d0d5dfbbe53daca58b,t,37746,7866629,,5000027,2018-01-30 13:48:00,189
0x74bdea18e3a695c65e45d54caae058214faa736f871017e10e83357ab7094e11,t,51782,7918411,,5000027,2018-01-30 13:48:00,190
0xc668a64e3515329f031a49b4a9b3461d12efca0963a9f03d8c6862c775039de6,t,21000,7939411,,5000027,2018-01-30 13:48:00,191
0x32c152d54e1f568b445ad421ac7db2db832d270488be1e6dc4db85b36b44aac0,t,21000,7960411,,5000027,2018-01-30 13:48:00,192
0x62ccd2eeff1c9575bd8798173c3e6609b9472b48ada92f666f0dd227d400d6f1,t,21000,21000,,5000028,2018-01-30 13:48:05,0
0x2d87f26d9ccec5e9cf3d5ba92ed25fb6affe681f3a23a7d6d4b13a0d59d7f239,t,21000,42000,,5000028,2018-01-30 13:48:05,1
0xcf850d0f998e2e5dbee99cf45f8693fa67f1a45a9a433cb0a617fc91e96c2d28,t,21000,63000,,5000028,2018-01-30 13:48:05,2
0x28b5772e2c2cb188539990b45cf58e6c5617362785f86fdbec291c660d757f0e,t,37155,100155,,5000028,2018-01-30 13:48:05,3
0x5ca721f99a5e4a1e6ba9adea6a6ab07deaacf682a9cc43959c997f66b81687f3,t,52222,152377,,5000028,2018-01-30 13:48:05,4
0x3d5e5dddca094b7f836ce8ad93dcc709811024ea6a043a50b2658226a25f5e25,t,54771,207148,,5000028,2018-01-30 13:48:05,5
0x7e8c8f2b577ddf58f39dc8888a1bcb7f9e37489eef9966ab755300ec65a86320,t,91372,298520,,5000028,2018-01-30 13:48:05,6
0xc8ee6f497672a9dfb59dbdaac52e4ac2c06e08f405dc6ace3756245d9e3009cf,t,51915,350435,,5000028,2018-01-30 13:48:05,7
0x987799dfc2b551ea18f17e593cc479bc9f7e93b31d389d05d73d6868551001c4,t,50057,400492,,5000028,2018-01-30 13:48:05,8
0xaca087e8e7be0c82775abb5dcf82c9a82b1733b6d8e148843233efa016d9681c,t,50057,450549,,5000028,2018-01-30 13:48:05,9
0x3ba4d0d7352055bf46c9b89b7ebc350fc4e584a85191cbbbca0ec1757da44682,t,34470,485019,,5000028,2018-01-30 13:48:05,10
0x55273d1ed383e52b7baf65b8b79dd6272635475eee1cc9c888e819c0b6d6e854,t,21000,506019,,5000028,2018-01-30 13:48:05,11
0x4a912514c2aa71ad2803b410869af4e363cb5aec9cb6c7c5dd2b81ef30a8f89b,t,51225,557244,,5000028,2018-01-30 13:48:05,12
0x4bff091f0efb005c3b29d73ed8afafa16a50e2b72d4474c46ca7913c7294ea05,t,21000,578244,,5000028,2018-01-30 13:48:05,13
0x17396d1ae13d7356b8779848ae3caee8a167c363226313c986fd03b5398e6a25,t,21000,599244,,5000028,2018-01-30 13:48:05,14
0xebba26778680d858a8fc04e68e4ecd83b335df8902d15be6acc472c24933fb64,t,21000,620244,,5000028,2018-01-30 13:48:05,15
0x79f8c6bdee33fe1c436e205ab6a34da3b39c1234d3a90360901695f3ed8c69b0,t,24574,644818,,5000028,2018-01-30 13:48:05,16
0x5e99307f39caf61c19b7f7d19894072750d1dfc4736749784232403178d4d25b,t,64725,709543,,5000028,2018-01-30 13:48:05,17
0xc4b1c3546355711be3f6cf9e661f5dfd53b06fa1bedbeb06a229a0098ea43107,t,21950,731493,,5000028,2018-01-30 13:48:05,18
0x0783e7bb761b65cc968d7253a61cf439e2abd08e83f1a5de74dfe8e844456a8c,t,51715,783208,,5000028,2018-01-30 13:48:05,19
0x1e7a5ccc539f5d245d3e2b76093a13e7104af33ad0bd4e5d6c9083905ef66bd3,t,21000,804208,,5000028,2018-01-30 13:48:05,20
0xf75b9deb394f9fa6414ca66461aeb59da44452c255de6294ddd9d8a50ccc8d2a,t,21000,825208,,5000028,2018-01-30 13:48:05,21
0xb8b72f8b349f6b399c222a633d2ee63495de4c29531c8778dc9fcdfab3570bd3,t,52155,877363,,5000028,2018-01-30 13:48:05,22
0xc4cdb538e4a9ad2f5b1c4f7fa9b3b220a23fc01066e97d110d89c1ff0a6ae4a5,t,21000,898363,,5000028,2018-01-30 13:48:05,23
0x3cf7b9d09a588ee4e68913466ea418f1e519af7d92a32e08e9c42e2cffc2af60,t,21000,919363,,5000028,2018-01-30 13:48:05,24
0x3f6fc4e5d6e33062ed64ee427ce7d1df454e6602bc41252fe4880f7761be7a91,t,21000,940363,,5000028,2018-01-30 13:48:05,25
0x35b5e71c19e6a16943001e1160d2dcb20d9681af0ac1e78ea2cd45a217342917,t,21000,961363,,5000028,2018-01-30 13:48:05,26
0x01cf48a9fa98fa590b6943f62aad412b078dd7691e11e59a85144e1314be210f,t,21000,982363,,5000028,2018-01-30 13:48:05,27
0xfbe24f95ef94ef899580624720133a81a7f1ab2cf84dd82c7ec41d5ae24c0d06,t,21000,1003363,,5000028,2018-01-30 13:48:05,28
0xf3be43cf86b40f5bd3bc2465ccdd021bd0ed8a429f270cf8fdefb9371abc0070,t,21000,1024363,,5000028,2018-01-30 13:48:05,29
0x5b46842dc94541efbf02de6f0038b665516a2c17699f5a2a30811e37568d63cf,t,21000,1045363,,5000028,2018-01-30 13:48:05,30
0x90f3247f1f6169497fb3696d4937bbc44206d86b72df8d64efacf8f4795748df,t,21000,1066363,,5000028,2018-01-30 13:48:05,31
0x113dea2372351bca4f5c1240f1af1187a36728979db6154b95be830f7f919daf,t,21000,1087363,,5000028,2018-01-30 13:48:05,32
0x1dd5a8650726bd46100caa30bbce8637b91d8398f55f584b63c23ff58f92c6e2,t,21000,1108363,,5000028,2018-01-30 13:48:05,33
0x0a513b1f5dd9816e961aa2b2281f92471f3c09eb7c46933f23e4c31f9c377b02,t,21000,1129363,,5000028,2018-01-30 13:48:05,34
0x3abe41d6505d7f8a62e9a41690612a5ab3152be672add861b56ff23c51060961,t,21000,1150363,,5000028,2018-01-30 13:48:05,35
0x53df028b01ab21cf4b45233a16daa00faf6531e6fdf67936926a9ccf968a1a14,t,21000,1171363,,5000028,2018-01-30 13:48:05,36
0x5a91a06812a4d08ac42b03ada9e2a7d30df4a7d1e6f9a06de54fcb0b077a806a,t,21000,1192363,,5000028,2018-01-30 13:48:05,37
0x6c94ccad33a10355dd4439e8656c4d722f26dd554bf7c0902519bc83e4ef7f22,t,21000,1213363,,5000028,2018-01-30 13:48:05,38
0xfbcc1d9547838bf0bf497fa942822b9c28105855d1a5f41d30aa70fc1eea943a,t,21000,1234363,,5000028,2018-01-30 13:48:05,39
0x6485ac6f8b525375cc510a74a9a5b0ad3db11c912e83a8f495191d395fb08ff7,t,21000,1255363,,5000028,2018-01-30 13:48:05,40
0xb333569dd26081ad074df56680bb50ebf5c436d33384106a899d30a40555bfe2,t,21000,1276363,,5000028,2018-01-30 13:48:05,41
0x7219a22e91ff71b285f20f4413f355796c91afdb3d6b241950ef2bba8ddbb2cb,t,127452,1403815,,5000028,2018-01-30 13:48:05,42
0x386d69c9988a0c585e6b43cf25b32ae9ca01ba236b47e3db6ff5390ef9a5e50f,t,127516,1531331,,5000028,2018-01-30 13:48:05,43
0xa4c1dcbbf06bd9088aa3170650546c421ad7eb58b307f0c45ad5b88386a19153,t,142836,1674167,,5000028,2018-01-30 13:48:05,44
0x0ca15e7553b5d250f603f34e0f6cc59f28b4e62b1c8b5acbbb481d22da2828b9,t,127900,1802067,,5000028,2018-01-30 13:48:05,45
0x75b437d696aef39657394bf888f0c96824c4ebc6a9b418bd76a056121927b73f,t,142580,1944647,,5000028,2018-01-30 13:48:05,46
0xc6266bbfdea96df4c19effc33aecf9232a1f5834616910702317b586e459f271,t,127836,2072483,,5000028,2018-01-30 13:48:05,47
0x9c308c88a7ef23215941d26d92e01ac637c3a5dc8ee728668ed195acdde7590b,t,127580,2200063,,5000028,2018-01-30 13:48:05,48
0x9dc9f42107fab635f119cbf66dfeadee1c47a94ee272744eaa748e40a845a925,t,67877,2267940,,5000028,2018-01-30 13:48:05,49
0x5bd3aa8b2f8d7ef4336c18590b84c428c64db60c14acb355003b53228af564b6,t,157580,2425520,,5000028,2018-01-30 13:48:05,50
0x17bec1eaec0315cbd23a83f14f17b5c5d9330e9f8a718e2193c424e1bf22daa8,t,142516,2568036,,5000028,2018-01-30 13:48:05,51
0x7c3c738353b78343276ba11b9ae261b5a9389448f6fb63655be919d450c5d12f,t,110406,2678442,,5000028,2018-01-30 13:48:05,52
0x24e2a5cd828055a3751228cc57eb4cdc8f2f689abeada68258aab0fedb0c4655,t,55843,2734285,,5000028,2018-01-30 13:48:05,53
0xbcadc4357bca217368ddb1103917aa912ec85e16693ada54892f8ef6be170625,t,40907,2775192,,5000028,2018-01-30 13:48:05,54
0x731d8b4cb097ad167b346d2aea7d614d55d312c1d88f5bc29cfe2d640d91f3c6,t,52228,2827420,,5000028,2018-01-30 13:48:05,55
0xa7028afdf2edbbc748f4bf09649e3d53321a4cb75138367c1ecf2e01740ba235,t,24771,2852191,,5000028,2018-01-30 13:48:05,56
0x9ffb6b5a61eddd14a5850e429e87b0f96215ba76cbfc77f0cda85b910f9f48f6,t,24835,2877026,,5000028,2018-01-30 13:48:05,57
0x7cd6f9f5a9d48617d087102187237905f85ad6d7c7936ffcee1db0711b0c3064,t,36948,2913974,,5000028,2018-01-30 13:48:05,58
0x45bac4940dc8294d685e16d27c8d79aa7691923a64325b80961d55821bd56017,t,36955,2950929,,5000028,2018-01-30 13:48:05,59
0x4213ae2010a2083b517dac3d8ecf75ac2001082d4d86fbb44baaa8785b7221b3,t,36955,2987884,,5000028,2018-01-30 13:48:05,60
0x3510c299ca404e5ded503148afa710dd87a1df1c46ad577315b4274f56c5c732,t,21000,3008884,,5000028,2018-01-30 13:48:05,61
0xc37cf07fa3113354efbba7e1c845e84b4097bef00ee88b2931e40b11281da040,t,55327,3064211,,5000028,2018-01-30 13:48:05,62
0x9a9d275889a642cbe36055db56fc398d9f010c00beb27896568ba9320ae9abb1,t,36606,3100817,,5000028,2018-01-30 13:48:05,63
0x6de447eec51294076004bcf34a407d5c9284cd8034e037c10685165880bad943,t,55907,3156724,,5000028,2018-01-30 13:48:05,64
0x90127f7b50712b839e213f8c780867d90467b90bbeb741bc9a48b3352d9a0af0,t,52316,3209040,,5000028,2018-01-30 13:48:05,65
0xe4f520df31e37864eabe6318dd1c0da463bd21685bc9419db2c166cee0e80245,t,21000,3230040,,5000028,2018-01-30 13:48:05,66
0x84b1510b1d542fabfc84549327adc9b73bf83167b0b511a123ebe55e0ba4fda8,t,67613,3297653,,5000028,2018-01-30 13:48:05,67
0x44f38729c85daefc36c64aee0e16e86705c1b7b9362ce8839b1b54e149b0e78f,t,92549,3390202,,5000028,2018-01-30 13:48:05,68
0x14e9e0bfe533cf61a90e363af0a89c1ed142ad5ae194ef60849626d98cd063a8,t,67621,3457823,,5000028,2018-01-30 13:48:05,69
0xfe9a4453a32505c1380e42d85e209ddcbd7de4c97b690eada9b1e184fb0c5d5a,t,21000,3478823,,5000028,2018-01-30 13:48:05,70
0xb379135d65c053d9088883c030f16beb87f3cca3499c36fca192209257f6e210,t,253854,3732677,0x0693c975627961B57695818d792071315e2ea92A,5000028,2018-01-30 13:48:05,71
0xa69eddc51608c579b0326674085de79ac24c4d3f304042c94efacdc16206ca3d,t,253854,3986531,0xd9F15cD0edf2Eb61990f1Ab29be0F22400c84273,5000028,2018-01-30 13:48:05,72
0x5c051349136ae2558ae4c948ffed98331cc62923f1beb0c7476e442f9500491b,t,253854,4240385,0x035c0f9C5B49303B2C1efb8019B6FB3Cb7D1BeAb,5000028,2018-01-30 13:48:05,73
0xc249602ae950c593e2042f588099374d56db50f09f3ab7123518a0d148a3bb14,t,253854,4494239,0xd418aBfF7d66612e03cc3bF9294E653397Aa3A3c,5000028,2018-01-30 13:48:05,74
0xc68200ec66794b765de2843096975c093b85ca5cc79918216cc4aab9fe039430,t,253854,4748093,0x49354eF2c2503CA15991fB721187D31D7301Ebf7,5000028,2018-01-30 13:48:05,75
0xd86a360d19a1a0d4e905a6d832f430ade57b8ba9b1a8fa4fc834283de05b27b1,t,253854,5001947,0x4C79c2467590567eF3e63AeC118857d4b698b13b,5000028,2018-01-30 13:48:05,76
0x275a6355da03982dcd752a70e22d50d9f4acc03b3ec6b3f6e405a364de30159a,t,253854,5255801,0x7A009bb093168eA712A1A12a5D4f8D12e24E5e56,5000028,2018-01-30 13:48:05,77
0x7277482788f7c0922173291b22d8451d7ab3f6e4d30020c54358f7fbdd44e66a,t,253854,5509655,0x22b4399BB4ae246597140c8ceB77e9cfF945f43f,5000028,2018-01-30 13:48:05,78
0x29a2a28417297b73bae7e1ff1f67f91d99fbf4e949cf29a76b5b769f1061acd8,t,253854,5763509,0x8D84944832C2417d4727c87296D516a345916fBC,5000028,2018-01-30 13:48:05,79
0x5d7c92560b33908eaf3da9bb0e18a8e949566d79ef63afb09b146fdffc8be50a,t,21000,5784509,,5000028,2018-01-30 13:48:05,80
0xa75ac11dadbce01a83338892a92d4264e558271c148a5dfcbc7a05096308066c,t,21000,5805509,,5000028,2018-01-30 13:48:05,81
0x77f5c63c590b244a54da97f819e74fcf70f515bb9fd31b18e25ee4f03c30d303,t,21000,5826509,,5000028,2018-01-30 13:48:05,82
0x7e54c572b9edd465e5e67a1759e32741cb4d19a91e23de6169889eccd184a4b1,t,21000,5847509,,5000028,2018-01-30 13:48:05,83
0x968f86825be59473d1df1d00675ca916db194260b654810454bd9cb502e03507,t,21000,5868509,,5000028,2018-01-30 13:48:05,84
0x2eb122968852333c7dc7e9a73f2f0ba38a86cd190b7c7e9c5d643d9219d21384,t,21000,5889509,,5000028,2018-01-30 13:48:05,85
0xc23791ee97e06015077f1ac5d165038a9f891873486d36de192ca5a908f856d2,t,21000,5910509,,5000028,2018-01-30 13:48:05,86
0x19676b2918124fd158da1a08ca3ec71de9e2952a646b35618f150f3e777ac34a,t,21000,5931509,,5000028,2018-01-30 13:48:05,87
0xb395ba9292f91305a02f2dc747518a479a6ae6ed11bb1cf63f50789eb8613b3d,t,21000,5952509,,5000028,2018-01-30 13:48:05,88
0x6449ebf4de31f21b2c1434cfaf6dab96f1a69dda58a3cc2eaec756a87a78d5ba,t,164716,6117225,,5000028,2018-01-30 13:48:05,89
0x5d333620e294e77b7549632cbc5bfd23b0f66f87f9530617cb9d41f014a7025a,t,21000,6138225,,5000028,2018-01-30 13:48:05,90
0xdd53db86abd6ac160656a26a75489504652175b6a9247b5e4bf29e84df4a5e5d,t,21000,6159225,,5000028,2018-01-30 13:48:05,91
0xa67e342f762ace43f2585ad5d195d9cd290c64c3c0cc540ff4418dafe61b04d7,t,21000,6180225,,5000028,2018-01-30 13:48:05,92
0xfc025d6081f2a6fc33e4ef922d6e2ee48ac3067f9f3dad62ab720d48822efca2,t,21000,6201225,,5000028,2018-01-30 13:48:05,93
0x69b58d4f176707fa4811850cc540ccd879eb9ae8444b4f803711bfedeef54fa5,t,21000,6222225,,5000028,2018-01-30 13:48:05,94
0x22f590b3e22ca7da159a20037bc366b6f190fd75c0b1e83794893578a5b79f0f,t,21000,6243225,,5000028,2018-01-30 13:48:05,95
0x55b68bb6e4be5cc4197d772673ecdc7bb52f61162b575d3652d2c90d3d1fa8c0,t,21000,6264225,,5000028,2018-01-30 13:48:05,96
0x0829ebf4c5049c7d56e3f3878132ab9a6b89fb18bf2b8e55f8d6ba0f5fb0048f,t,21000,6285225,,5000028,2018-01-30 13:48:05,97
0x2037e3ccb3b45043ca7e7173236adaa4cc194e750a101c4f4a306c568e0eb081,t,52886,6338111,,5000028,2018-01-30 13:48:05,98
0x2107916e635c63d066c8100858c54339b3f53b7f591bd538065784a27ba91185,t,52886,6390997,,5000028,2018-01-30 13:48:05,99
0x652c86bca2d11a569d825621566a61de19e0b0892c23ae023bce75f3dab5d6fe,t,52886,6443883,,5000028,2018-01-30 13:48:05,100
0xc31639eb7142ec0c7c98abcf46c4ba478b8a2b11e3dc0de705163fb801f01be5,t,52886,6496769,,5000028,2018-01-30 13:48:05,101
0x9294194e5791985d864b91bc5b68eff1dcf5e211ff4ed0f3663da75eb609b256,t,52886,6549655,,5000028,2018-01-30 13:48:05,102
0x287fcd36cfe3fd21b79e8495e32de0056c0cbc4a03e90361cce5df893841eae3,t,52886,6602541,,5000028,2018-01-30 13:48:05,103
0x28f4a6c8395e2d02400a15bb9382c4e21ce62a8ad34227659ebf0d3f066c848b,t,52886,6655427,,5000028,2018-01-30 13:48:05,104
0x88892b51b1eeaec72de4c1a09c818a2fc74813ca167b35c83d651caa232b29da,t,52886,6708313,,5000028,2018-01-30 13:48:05,105
0x8ae0e4134992d5a25751c8e3c0bdae46d3ba4626310eeb55de45cf750ff244fa,t,52886,6761199,,5000028,2018-01-30 13:48:05,106
0x358ec8e0052289e21b8b6ff6d7f1a713d890f027c2782505da9497448b481934,t,52886,6814085,,5000028,2018-01-30 13:48:05,107
0xfce26730bf536e1cd86ee3fb4ca9e8fc2b26beb545cb44fb95b7156582de8f33,t,52886,6866971,,5000028,2018-01-30 13:48:05,108
0xd4c533a07293142bcb489d9d81b481f976a0ad8049acbd266638861b112ae961,t,52886,6919857,,5000028,2018-01-30 13:48:05,109
0x350608513c4ec0483c0b0bb87c1bfaf73e9210b531c213b52b825b931e5221c5,t,52886,6972743,,5000028,2018-01-30 13:48:05,110
0x2cf8206a51783f2bc2ad812e758026dc7551e7144b36097e53853da5f3eb9449,t,52886,7025629,,5000028,2018-01-30 13:48:05,111
0x3706746503acd17752383af7bfb781f4f14cd6842f108bbf0278e7df7def9569,t,52886,7078515,,5000028,2018-01-30 13:48:05,112
0xc9ee32a89e7ae8117b637bbb29649daf847b22f4cfd79dc7cedd66088b4bbc3f,t,52886,7131401,,5000028,2018-01-30 13:48:05,113
0xbb37d62f30d90c745ed2daa6e5e66d335eac0dd983e9e6d9bbd9eb5a6646a52b,t,52886,7184287,,5000028,2018-01-30 13:48:05,114
0x26b6bc05ffce90eb284bf00db52fd7bb2344b4379f407d6fbd6c961c04964f7e,t,52886,7237173,,5000028,2018-01-30 13:48:05,115
0x2adef794674a310fdfe445e34461159d0b64238b942e3959dc0ae532c5956dcb,t,52886,7290059,,5000028,2018-01-30 13:48:05,116
0xe2430b6b19ec4b928472208419ce94de54e580cf40afd1eb1f09fc7ea663c71f,t,52886,7342945,,5000028,2018-01-30 13:48:05,117
0xe5c03a4e80e11f77ec934b90fc3575bbef7a94c65776e2cf6ea59922efd46ed7,t,52886,7395831,,5000028,2018-01-30 13:48:05,118
0xe1343ff0bae6855faf920e4346349a9e7c689827556c05a37187d289dfa6396d,t,52886,7448717,,5000028,2018-01-30 13:48:05,119
0x3884dbfe52468aa12ccd50868e4547198011698ef0e719abc081ac67e878f2f5,t,52886,7501603,,5000028,2018-01-30 13:48:05,120
0x0366799908fc8345ef19c53a0fcdeacd8e237167a9e42c2733bdb28d92af1cfa,t,52886,7554489,,5000028,2018-01-30 13:48:05,121
0x290678a73e8335ad0771a34635029f4d6e3b36f0af6dfbf6997fd9fdefb50dd0,t,52886,7607375,,5000028,2018-01-30 13:48:05,122
0x2b17c19c4ae8bf0eb57ebcaf72f9497ac0c2f6de3bc12685f8e191b550a7b1dc,t,52886,7660261,,5000028,2018-01-30 13:48:05,123
0x30bfd42bd2963e58c331502731e118d3276bc7f9a6104078cd56a33fd7d7b2aa,t,52886,7713147,,5000028,2018-01-30 13:48:05,124
0xbb7d95e2832d1240a6c657e6c31d50742082db32aefef2098aa44dfbc41c3805,t,52886,7766033,,5000028,2018-01-30 13:48:05,125
0xc613b7507662c4d13b104a27e07e81505e0e762440a474b7f51994f3c9682d67,t,52886,7818919,,5000028,2018-01-30 13:48:05,126
0x70c7a3e8e3a7df088ed6c1f4e33d28e8a753cfd7441c2c6ada5f5cf6fae68a42,t,52886,7871805,,5000028,2018-01-30 13:48:05,127
0x1f52978c467d46497e874228969cfcdf522f7c9984452d8041e2bd7a4de5a5f2,t,52822,7924627,,5000028,2018-01-30 13:48:05,128
0x5bc09cf9390ef5e3be44fae6c5c961fc8a48609e02f35df982dfb06602fccf06,t,21000,7945627,,5000028,2018-01-30 13:48:05,129
0xa37991f80b1ec79b56e553617af70fab662eb80e9245909825b081aed6886488,t,21000,7966627,,5000028,2018-01-30 13:48:05,130
0xc386931e3409eaf613c66e5b1a567755b43b2b33e09bd35ff140ed4292d6b1c0,t,21000,21000,,5000029,2018-01-30 13:48:19,0
0xc0aa8fca15629d848ea2bb9dafbaaef0cc39a38d86b3f5321942520e11872f6a,t,21000,42000,,5000029,2018-01-30 13:48:19,1
0x596559092e68391f0f50f1128ec921bf7439e0af8c5fa78ff74f5c48c1a22416,t,21000,63000,,5000029,2018-01-30 13:48:19,2
0x3c1478ece512ef6074b5cae51fc0704738013d90ab4987db741cc1b663877f3f,t,21000,84000,,5000029,2018-01-30 13:48:19,3
0xf79cc2061d37d4e91a08e70956150c6b254393ee2aef31d0b0845d61a0b0baa0,t,21000,105000,,5000029,2018-01-30 13:48:19,4
0x61c9bd1ba7b33ea09a772afac1891ea6f820924ea1227663d1f9b36b19e23022,t,21000,126000,,5000029,2018-01-30 13:48:19,5
0xf7bc14a44d91d435d83948c6ef0bfa8f8f046a9a49c44231a0e58f2059383a82,t,21000,147000,,5000029,2018-01-30 13:48:19,6
0xa4d28944447bee4ee9af656a83172004694525994b5bf7c58c6daccf19c11b35,t,21000,168000,,5000029,2018-01-30 13:48:19,7
0x78ba65a7c0112f3844e9278614ecc99aecfe4e3095cbc8fb7c28e02d9a86fe39,t,21000,189000,,5000029,2018-01-30 13:48:19,8
0xaf7bdacb3cd30250f6f39f17b088d82e95e34e9e8b42b8e9c87a1a571ea0648e,t,52373,241373,,5000029,2018-01-30 13:48:19,9
0xced7719433b012c92a22826bf81891931548a03080806d17f54573be36b7daba,t,21000,262373,,5000029,2018-01-30 13:48:19,10
0x3bb48426b0640d8fe542a1a27edf9df018f515eb05ca7b7401ffddbc99640483,t,21000,283373,,5000029,2018-01-30 13:48:19,11
0xcc8753ef9ede2f0d5f4d62c36d2950109ddce2a6cb1600be2d0d7359cf0f2349,t,21000,304373,,5000029,2018-01-30 13:48:19,12
0x44e0aefeeb42b296784d25fd44b1083172e65856e7496c443a17f7d936329679,t,34470,338843,,5000029,2018-01-30 13:48:19,13
0x449d49738dcb0d998ee025c0f32bd2c444d8d96bae19420203fb4cb61a02ee69,t,34470,373313,,5000029,2018-01-30 13:48:19,14
0xd8bc32a42ebba69f091cd9f65f9847b6056ec48ce1a85a8230ef056e110e62d3,t,50057,423370,,5000029,2018-01-30 13:48:19,15
0xfaf4c7f1f266e9402e1906ed5b67b89af9238cf30a83927bfc4f90eec0147deb,t,34470,457840,,5000029,2018-01-30 13:48:19,16
0xb562c7843e0a1211f633037b12a23c23c42542b4f91c474f0d3d6b3ab3f6f132,t,34470,492310,,5000029,2018-01-30 13:48:19,17
0xdc4d0c773f2b029e86f142e10990bd44ba2a0421affffea1df3163b59d379a90,t,34470,526780,,5000029,2018-01-30 13:48:19,18
0xf26a7685cbcf061192db8806209f162055433c4f16edfd8150720b489ae01e68,t,34470,561250,,5000029,2018-01-30 13:48:19,19
0x77a1e26b6875b01add636570d9557e18d154f3af15e907c439d040094cfa59fb,t,37384,598634,,5000029,2018-01-30 13:48:19,20
0x55cbb93736a126a6c4066176105b5ce682cd2972c1988788a45a8dc4093adb96,t,21000,619634,,5000029,2018-01-30 13:48:19,21
0x09a176f3c0d9a2cc2381a9fb0c6ff7b8456bdaec71b63076f1918061b07b3098,t,51545,671179,,5000029,2018-01-30 13:48:19,22
0xaee264eea87a3d8d3c12a482b7622296155f59ba37af3d645f92af94be2f31af,t,21000,692179,,5000029,2018-01-30 13:48:19,23
0x909bba9bec9aae72db92446cdc67f7e77d1869b736410f204a1a11be787cba7b,t,21000,713179,,5000029,2018-01-30 13:48:19,24
0xee84f6f5f3469888f527a7ef663e1b5ac5c4a34e54ddbf88ce8e8a7ea6f3a5f8,t,21080,734259,,5000029,2018-01-30 13:48:19,25
0x7afbc777ece556e412f8964d85d0b88f088a8999e649c888378cde9ef077d2d8,t,40907,775166,,5000029,2018-01-30 13:48:19,26
0x27778edc416eadc7c9000fc3eaaf12d2936e1581c94f744c374b2b7a16f11623,t,31257,806423,,5000029,2018-01-30 13:48:19,27
0x283fbadeba6f027dff04c036ab2bcc1042e514fb11d079970baf13b756bdc1d6,t,21000,827423,,5000029,2018-01-30 13:48:19,28
0x60808def02b86003c02889b60006e219c88b04427d98553ae6f03c7c621fbc51,t,23615,851038,,5000029,2018-01-30 13:48:19,29
0x931458ae5df53abf6be3311ba0d30c0cabeb77984baa9f51374c81a7b5b146a6,t,22078,873116,,5000029,2018-01-30 13:48:19,30
0xeeb66673fc0e7bb0e1d8626956699c130aec115168ed95f07025cae2a99feb80,t,21000,894116,,5000029,2018-01-30 13:48:19,31
0x948986511f96cb0bf82ae33400c883d0412bc574ed545083fb300f640f222626,t,51453,945569,,5000029,2018-01-30 13:48:19,32
0x2ee7374cc59e4d610b783945ea5dc29f8ff0694b4a26acae0de0e85b2eb954b1,t,21000,966569,,5000029,2018-01-30 13:48:19,33
0xe6ec745ef281ca64aff8aa02f30b4f30d92e9a5b54dafbd5356d8538e099af3f,t,21000,987569,,5000029,2018-01-30 13:48:19,34
0x3bc4a2133c37d92bb44a36c921ba0af1cc7ec96e483f691474b3ced6779e8eb3,t,21000,1008569,,5000029,2018-01-30 13:48:19,35
0x978ce094910c72ef9bab5131b19ae61504ea0fe17a896c74b065888f953f0cbe,t,38004,1046573,,5000029,2018-01-30 13:48:19,36
0xc391a31cc05be8a7a8d8e13f3cebceab062ae9e2a26c11033b62c5a63d796aa1,t,37704,1084277,,5000029,2018-01-30 13:48:19,37
0xf5044941ffd090806749115e298b7ade719a422d6d79e113d4def93d7562a1c8,t,21000,1105277,,5000029,2018-01-30 13:48:19,38
0x93e964cb63ec323f69b7e3908aedf58c694e95890a04f7d73c247ca0341f24ea,t,21000,1126277,,5000029,2018-01-30 13:48:19,39
0x71f940df181bf3e2c14fbf6d9f4c70b347b49b41c9c9bc0d4f456032aaa9202d,t,22091,1148368,,5000029,2018-01-30 13:48:19,40
0x14ee3a84ed0e36a0c35ce189e658e969d03c61cf222d29cc858c5a4f734bd8d2,t,21000,1169368,,5000029,2018-01-30 13:48:19,41
0x5fef72282962f4c2c32d435dd26f0ab00ad574dcb00661a74554b8d84a54e699,t,21000,1190368,,5000029,2018-01-30 13:48:19,42
0x0780b93e37e3ce74a3d32dfaefc435f58f31db05b41bc87514d243c25e209594,t,86624,1276992,,5000029,2018-01-30 13:48:19,43
0xc388db70e57bbb561b3cf3d90d7f32ec9ae016f22745d5794a5665faf7b36be8,t,51609,1328601,,5000029,2018-01-30 13:48:19,44
0x1221d21a2c58722f7cb8eb8ad0fc1e0244052cdebb16a461605864fbc06902e8,t,21000,1349601,,5000029,2018-01-30 13:48:19,45
0xa29c868c4b69c090c692c06d0c3d2060c6799cf56e696c0fbb37027d870959b8,t,21000,1370601,,5000029,2018-01-30 13:48:19,46
0x9de56db7bb175e135fd5aeaa32948193bf7a65ed99a231dae006481f2dacea3c,t,157644,1528245,,5000029,2018-01-30 13:48:19,47
0xd6262046ac85750be9a524e9db1546e578efccb314e7521b9788cf618177009d,t,21000,1549245,,5000029,2018-01-30 13:48:19,48
0xb4d0681cd344fcce8efeb8b40c2b4241dbf88ddabec9549c24fe78582d47a12a,t,21000,1570245,,5000029,2018-01-30 13:48:19,49
0x5db32b0a49a8786e27c2025e57f9019a977ca4f86ed691257798f10451212714,t,74063,1644308,,5000029,2018-01-30 13:48:19,50
0xae0cc53d5f495e91f81b815d430b0675f642e2391d9a3a8e1f32a3a46296529f,t,36708,1681016,,5000029,2018-01-30 13:48:19,51
0x65db849b140bd5d851f926684cf693b210405ca999249cdad50695c368b8062a,f,22078,1703094,,5000029,2018-01-30 13:48:19,52
0x6881454d11dc13ea6db137283df944a8dd515577bebc26568f5f24353dd0d617,t,21000,1724094,,5000029,2018-01-30 13:48:19,53
0xba63dfcd9fb140c910ea3a541e2ebd23bbf50c0d4f5f80d4d2ace3b081f0c60a,t,21000,1745094,,5000029,2018-01-30 13:48:19,54
0xc27e768e36f1f859218b57443b1858e0f64f0e404eb3633872fe161f71cbd43e,t,21000,1766094,,5000029,2018-01-30 13:48:19,55
0xd7101afcf135da5aeb7127f0ee4aece56b20834a37f72d0022e8b8caf2b61893,t,51792,1817886,,5000029,2018-01-30 13:48:19,56
0x1998bbf3b348fc0bf459524b779caf2bb5b37e8e8e2e1c6b50e087946cbe3440,t,21000,1838886,,5000029,2018-01-30 13:48:19,57
0x60b2b90c7f56624925b373a21ea4c535013e7287b8b1e8e6408cd888ddeb0fd3,t,21000,1859886,,5000029,2018-01-30 13:48:19,58
0xf8dd29a462b74e79d0e60f3a3727fbe023b0c3c3c961c8ffb9d0d58114736e08,t,21000,1880886,,5000029,2018-01-30 13:48:19,59
0xa07ca7f711ed9f2496fb9c3e9a2a15d901ae06b6500f5a303ec0e637981b93ca,t,21000,1901886,,5000029,2018-01-30 13:48:19,60
0x791a199ff38ea222eea836f9a9629586d04d58d7aa1941c2fe39bb6099a67332,t,21000,1922886,,5000029,2018-01-30 13:48:19,61
0xb479a3a2489bab9f512a73544ea1754dbad96aa0eeb3681ef0306c6e6cd758d5,t,21000,1943886,,5000029,2018-01-30 13:48:19,62
0x5cea5727b9a23e5d433aa0fecb9f41f9bd75c6ba54cf20cc8121e176f7af6a92,t,21000,1964886,,5000029,2018-01-30 13:48:19,63
0xeb39db8ffb56729a8455b61c06d56b60637f810b198c4201cea3c71f9724264e,t,21000,1985886,,5000029,2018-01-30 13:48:19,64
0xd6347aecd1d158cc84d2b8603a68a8d086054191964c53dc871eea8539b66bb8,t,21000,2006886,,5000029,2018-01-30 13:48:19,65
0x22c31e28ec88857858baa5622fd52d84bae093ddee7f110668d232268c074cb7,t,21000,2027886,,5000029,2018-01-30 13:48:19,66
0xe8ae1d368d4dd77eb06791f023c3ab222c3b877611de91a7409933e109ed6f86,t,21000,2048886,,5000029,2018-01-30 13:48:19,67
0x0b8c97cb492843519f08f2ad96a03e1eaee4671554da296115e01893682f7577,t,21000,2069886,,5000029,2018-01-30 13:48:19,68
0x65f668587e5303e4aa483208ecb1875cb31780fff78253159b2828f6de4d2d68,t,21000,2090886,,5000029,2018-01-30 13:48:19,69
0xa43c1f6aa24947a24f178ce010c9621eb5908aec308456b53cd8a4c53fdffdde,t,21000,2111886,,5000029,2018-01-30 13:48:19,70
0x5081b8a6d35485251a92300b69a6cf0fe1a7f5a136f768cc6f1677e79a574665,t,21000,2132886,,5000029,2018-01-30 13:48:19,71
0xfe06459dc630010dbe387020fc3a278c678f8cd74f765465eec2aeaef87de91b,t,21000,2153886,,5000029,2018-01-30 13:48:19,72
0x119e5085288087e36606e06d273228e148b246f00529a96fd441e43f6bd16f4c,t,21000,2174886,,5000029,2018-01-30 13:48:19,73
0xc68a1d8c0055ca1be641fb7b049c30e225058531482a3f99b7831ef525ec90f0,t,21000,2195886,,5000029,2018-01-30 13:48:19,74
0x685d270cafc0e4cd009c513ac7294ab194f8130187c55ff0bbdc1c8b3562c8ba,t,21000,2216886,,5000029,2018-01-30 13:48:19,75
0xf11075f80d58dd1c064e0a7cb7056a2d7fb8c320b0c03255daa9e1398f566f84,t,21000,2237886,,5000029,2018-01-30 13:48:19,76
0xa8fa73bfb9266b7c2dc3c519307fff89390d11a0e06e40110f6ad60527f60648,t,21000,2258886,,5000029,2018-01-30 13:48:19,77
0x06cca9bd293310bb9546bccdd387112b96a3761484c22cd84d2f1664ba085c59,t,21000,2279886,,5000029,2018-01-30 13:48:19,78
0xa4c8e5c54aa4d5579a4bf38c642fcf8570807076f7db22890915de371cc99689,t,21000,2300886,,5000029,2018-01-30 13:48:19,79
0x525112cdfde44886ee7071a3d20c07d492ec7c938ac10efc4d6e55b63e43ef28,t,21000,2321886,,5000029,2018-01-30 13:48:19,80
0x38abf73cc813c8c1ed55b8e503b5f1d403515aa073c1e771c351f44a3553bca9,t,36606,2358492,,5000029,2018-01-30 13:48:19,81
0x35ae747e7b143e56044b24fd09c237b52824d690f46c312458695ee9b7644c1c,t,21000,2379492,,5000029,2018-01-30 13:48:19,82
0x67c6bba155cc7cab368b8e2e827cc1b1c386e348a4164759ff45eb0f39634a32,t,21000,2400492,,5000029,2018-01-30 13:48:19,83
0x2f9d1613d5da48f2e022e574a0649121075efce52fdbc12d1c9c37673071f3d5,t,21000,2421492,,5000029,2018-01-30 13:48:19,84
0x1a6c3ad31165e7bbb63e71da2e74ba9d5eefac8c728e6e8101602ae40ef45291,t,21000,2442492,,5000029,2018-01-30 13:48:19,85
0xe42b86505f7e3f99b1f02e34e46f224e8ed391ed5e3f9a56c2b7c460ef91f2e4,t,21000,2463492,,5000029,2018-01-30 13:48:19,86
0xec8971c8eb31e5bb89dc6b5894d06806111223f908cb4dc7a4b69158463aae16,t,21000,2484492,,5000029,2018-01-30 13:48:19,87
0xcd0191444b617c4b040b2aece423b02441197b49a4e3e2e16d78996e3032501c,t,21000,2505492,,5000029,2018-01-30 13:48:19,88
0x4a2bedd181f34ec4d8c2747ecceb44cc3d1eb2bf9272e061525acb701f51a4d7,t,21000,2526492,,5000029,2018-01-30 13:48:19,89
0xe4c63437ccda1cc0961f4095a9ae90553456aaa841748c3a981b92908015aa99,t,21000,2547492,,5000029,2018-01-30 13:48:19,90
0xd983053fffa1c8ff56d96af1f5bd4a44ed05576ab4de849a7d7b6c0653fd6e09,t,21000,2568492,,5000029,2018-01-30 13:48:19,91
0x648b1d5f01ce481b774dc910941abeff8bdffc8892f72dcf80bf6b82f3e6c664,t,21000,2589492,,5000029,2018-01-30 13:48:19,92
0x92870ed7f44c5caee5a1d0cddb4279b1ec5a4f33cb3e8640532b57577a99c9f3,t,21000,2610492,,5000029,2018-01-30 13:48:19,93
0xcc2b199c5c5013c51b41d6408285ed441b4b792f4df2ff26ceb6c239ae604fd6,t,21000,2631492,,5000029,2018-01-30 13:48:19,94
0x15ed666a2e6e7716614b19b7af7b1aeda75ddb6c753b7156af04bfa33440d93e,t,21000,2652492,,5000029,2018-01-30 13:48:19,95
0xcbdaa42b2787b47c357a15ddd84dfcc46a7b8d1c68ced4dcafbe697f13bff1df,t,21000,2673492,,5000029,2018-01-30 13:48:19,96
0x1c084307bb668a39435184e4e18d4f548813373691ef177a836255e19e5fd217,t,21000,2694492,,5000029,2018-01-30 13:48:19,97
0x8dcb9c076d369ece417e7daaa5385d9fcc07157d32783e48a2d8f6e14c138c38,t,21000,2715492,,5000029,2018-01-30 13:48:19,98
0xb51e42212c6d5acbba0a0abe5f3999fcb54166cb817216608026696c0edbe712,t,21000,2736492,,5000029,2018-01-30 13:48:19,99
0x9c96c51a184814c6eeefd03032a84f279047a51cc611b9d08ceb3fb656edc49b,t,21000,2757492,,5000029,2018-01-30 13:48:19,100
0x0c7897415301e6bf2beddac8b6d3e8c148736927032e9b74c7808913590057ee,t,21000,2778492,,5000029,2018-01-30 13:48:19,101
0x954deb476428a5298a3c5dfdc0d4428e84e4c14523c4dd0ebfd4746fb0d032cb,t,21000,2799492,,5000029,2018-01-30 13:48:19,102
0x8d9938c246a6b3d93498503577fbb51f420df4648a1622a0759674ce7eecafb3,t,21000,2820492,,5000029,2018-01-30 13:48:19,103
0x1441fbfd38d7aa46c97f98071f00b838d149ae16fa92dab0d3052c28b236a415,t,21000,2841492,,5000029,2018-01-30 13:48:19,104
0x95318f88cc03d0665a504fdef0336da731abdea422dc92e3a53422d9732f8ebf,t,21000,2862492,,5000029,2018-01-30 13:48:19,105
0xbdd1e40a67a64af8fd1ed650ab4627676b442ae65ccc4e7f7be6750477192bfe,t,21000,2883492,,5000029,2018-01-30 13:48:19,106
0x5d5d9c2bea6f21b97b21b8a02f9f851330bba08f2e39c13b030bab2e57e2e478,t,21000,2904492,,5000029,2018-01-30 13:48:19,107
0x420e985dd9b01b1a8108c8084fc32e46f858202ec02fdc9cf9d2ab56239e8d46,t,21000,2925492,,5000029,2018-01-30 13:48:19,108
0xa78b2467858272135b904226bbb9cd19b7bec9abccc01ed698a06507b5cb888f,t,21000,2946492,,5000029,2018-01-30 13:48:19,109
0x2b0fc7c6718fdd4dd0aec56760144160904d84003618fcfc847663721460bb2f,t,21000,2967492,,5000029,2018-01-30 13:48:19,110
0x4a6a34b701615978e304da133a32ca984e2472f78da6a26c44bf46ef36501c5e,t,21000,2988492,,5000029,2018-01-30 13:48:19,111
0x48028f8a8dfd86d4f615eb5c43e2a31b8d2c7dd3cb1557270fb86096bd0ae9a6,t,21000,3009492,,5000029,2018-01-30 13:48:19,112
0x305f51baed9aaaa026164de4ef49a149a0fd8e032f9628603e4ee0ea4dd67531,t,54784,3064276,,5000029,2018-01-30 13:48:19,113
0x83a1cb430949e78c8a0f2e862527831cb354cdf1b132ba31e4d8f1fd50d5dd01,t,21000,3085276,,5000029,2018-01-30 13:48:19,114
0x931b5b2d2deacb5da4b540eb13885a3772d05d613df09d18d51f17a4d6c1f29c,t,51609,3136885,,5000029,2018-01-30 13:48:19,115
0x80f5d8b995951f854346ffd7b0d2e922f8e1194e20ac052b58c8cc56e90a7dad,t,21000,3157885,,5000029,2018-01-30 13:48:19,116
0x028b5e5b40ba549eaa6d8895f4d4e8c2079304d8d293555c1018bcaa468b8600,t,52460,3210345,,5000029,2018-01-30 13:48:19,117
0x853f85a5d631300a59ae1f512c69ff3694dba6c9ffa705c4196ea2ba9cf9fd3b,t,21000,3231345,,5000029,2018-01-30 13:48:19,118
0x7387ecd49bed215c19349784aba42f240b2ab70cc45f930ca96e6f5c04d9a699,t,37380,3268725,,5000029,2018-01-30 13:48:19,119
0xfd7e923999323aed74577886c7b3f37ca7c91b51a6c5bbc9e67bf33c3b66811d,t,37218,3305943,,5000029,2018-01-30 13:48:19,120
0x7ed5f210f7b39348e1af5ce40657bfd800f75efab4bd4597764f33dc3d56b01d,t,51481,3357424,,5000029,2018-01-30 13:48:19,121
0x4d99fe86adf8b86ccdb148738725810de51f4e44b61d09a36f719e69ba897422,t,51347,3408771,,5000029,2018-01-30 13:48:19,122
0xae122ba8c323faffff777bf8be457e55258070df45919c7883ca35f5d9ccf62d,t,21039,3429810,,5000029,2018-01-30 13:48:19,123
0xb85b912d28c8699c53e2bf87880e777a7ca1444ee9b254aee7ec06d7deeb81f6,t,22460,3452270,,5000029,2018-01-30 13:48:19,124
0x8a08cac162c933f0b02be4642c6b6e3151384cdd42a13acc839a210f7de99d35,t,21000,3473270,,5000029,2018-01-30 13:48:19,125
0x1a8e7930e45a2cac169c6770ac76577f50631fc5b87ed354033ec236ba7ee0d3,t,52148,3525418,,5000029,2018-01-30 13:48:19,126
0x487a359cc7f47a52b10c58f7b30ebfb366d09b385843ddd2f1cf6353349f3b32,t,21000,3546418,,5000029,2018-01-30 13:48:19,127
0xcaf2e5084d7f8847cadb0b71f65154ff45901513062b3a18ad8ba1bd87279ce8,t,67677,3614095,,5000029,2018-01-30 13:48:19,128
0x00401ef83185d1d474e334dce166d01d0bd79d055869ac2e92218a5ef8feb7df,t,21000,3635095,,5000029,2018-01-30 13:48:19,129
0xd013f82dd61b44b52ed146736576b7209d0fe5a00c130a2b63e27ae835f4e6d9,t,21000,3656095,,5000029,2018-01-30 13:48:19,130
0xce37f9729c28a314d47392942f00aae824f8824eb09a97f160964d75363d0067,t,21000,3677095,,5000029,2018-01-30 13:48:19,131
0x7e8927d325a1d36f42dd1b12a44cf8d7d755a9b81025f80d7e65dbc21cce7b18,t,21000,3698095,,5000029,2018-01-30 13:48:19,132
0x6376d285f5db2447c4eb3908b11e3e9e6313bd95d692241892aa279612a40554,t,21000,3719095,,5000029,2018-01-30 13:48:19,133
0xf0306bc75ccb091f888f5ae4ffd9cd93b99186b620cf20a56b3bb43883dd098a,t,21000,3740095,,5000029,2018-01-30 13:48:19,134
0x92e691c258c2a4cba8495848677d2917f034a9e0a31fb664c97d369c14c23769,t,21000,3761095,,5000029,2018-01-30 13:48:19,135
0x3ed9d70d88f163b5669add9abe4d44890e076519200b702df0a9c60076ea4148,t,21000,3782095,,5000029,2018-01-30 13:48:19,136
0x8f72a1fe45ea3a8695c525d6b8994fcb91d3f2fe331fa04302fd83c453119c49,t,21000,3803095,,5000029,2018-01-30 13:48:19,137
0xe5fbcf6ea23d69dc28bc9380566a2575a9bdae6c30a852fb37dd3fd268130989,t,21000,3824095,,5000029,2018-01-30 13:48:19,138
0x1622a24ca3ba79644c91f75a533ae1f589cb5027c8252d783b910dd0c9e0d6ac,t,21000,3845095,,5000029,2018-01-30 13:48:19,139
0x0f8839b393cb8db862e349eeac0d29f5145fe24a5f8ac3185ec10b574c29f0dd,t,21000,3866095,,5000029,2018-01-30 13:48:19,140
0x07ec25b43da2b5a6edf7b187f8e3c24615d149edfca7b6d72311198e786da5cb,t,21000,3887095,,5000029,2018-01-30 13:48:19,141
0x1522008a6bcda6dce4c14385f8673801ead208245b8d6a893368e8465bc9403c,t,21000,3908095,,5000029,2018-01-30 13:48:19,142
0xc39124ae0ef691f04878d50932d3ec9104a64dce9b667bab3fec34641cdbc46a,t,21000,3929095,,5000029,2018-01-30 13:48:19,143
0x431afe9a8e24e61d9ab13ed9545a4459a68538850f5fd4d05fbaec1c335a7c62,t,52249,3981344,,5000029,2018-01-30 13:48:19,144
0x1d50c4d5ca9a1bd31771c40851e7d20b0001ba614ff926f85ac0a4abf6ee5a43,t,21000,4002344,,5000029,2018-01-30 13:48:19,145
0x13ec89450f2b95729e900b60cdc97c96f9a8c2dba1a3210beff87d198df9f33b,t,21000,4023344,,5000029,2018-01-30 13:48:19,146
0xc7d2226df078fcf005506503f57df85880d4f5c9d3859d29e9fffc1729d59117,t,21000,4044344,,5000029,2018-01-30 13:48:19,147
0xa0650536cbdac57466c408516d7488052ecb2d19a8fe7f7b7e8765831b4383a4,f,250000,4294344,,5000029,2018-01-30 13:48:19,148
0x376e951eaea0dac6958a60b8a4b893dc78a4912e191b1cb2665c0a4d1351fb94,t,28402,4322746,,5000029,2018-01-30 13:48:19,149
0xa25e101a289d3c5a8f7943f98dd2abceec5a8d148d260aad903ffbcc5d2b2a19,t,36756,4359502,,5000029,2018-01-30 13:48:19,150
0x42bf308d74d0ae8e1a3e3fa255bc666234fcb9dc4e319b46cbcfb5c7e43bf10c,t,36511,4396013,,5000029,2018-01-30 13:48:19,151
0x82e2bf8b0a21af8a70df08befd276b331abaa91ccd308dd73d1f29b85a7f95be,t,36964,4432977,,5000029,2018-01-30 13:48:19,152
0x9db15c612905fa5f24b3edcfaf4451deb24be096a9a5c638081804452e3204e6,t,52886,4485863,,5000029,2018-01-30 13:48:19,153
0x25088623405576c101eb678d036be7917d8b4a07c4c91cea0ee1da3a42166076,t,21000,4506863,,5000029,2018-01-30 13:48:19,154
0x5c670f03436e67dec3f8952ad30aa3ab7d1754329afb29ecac1c0405932fca08,t,75183,4582046,,5000029,2018-01-30 13:48:19,155
0x22e38b47c1dab44841a196cf0f9e0b4844c5f585dc1b4181b4842ca07eaee4e1,t,44290,4626336,,5000029,2018-01-30 13:48:19,156
0x4fa65b37bdae393a38d72cc29369e2fde394cb08fc69ba560204735e20922a47,t,37257,4663593,,5000029,2018-01-30 13:48:19,157
0xe97057bfd9d7ff73e8d8cb9d88eda9bc398cf5cf535e538ea8a3fbc6cce7cac8,t,21230,4684823,,5000029,2018-01-30 13:48:19,158
0x1d0a17bdf35661fa6520b4b9bec268ea5ebc46b45458eeac44bffb08cda375b4,t,21000,4705823,,5000029,2018-01-30 13:48:19,159
0xd45ed1f9f27ee8462c5a856d1b9705d6add92e973649b89378a1f6b49892817b,f,24270,4730093,,5000029,2018-01-30 13:48:19,160
0x34c50149485074d0d2cfd8a607c60975a9c56c956efae6fd810707af22893ff3,t,69568,4799661,,5000029,2018-01-30 13:48:19,161
0x7c63f3f80f3ab115b234af1c33f55156e5dff4ed8e8e800ddea8bd687a86ee4a,t,21000,4820661,,5000029,2018-01-30 13:48:19,162
0x862776be78c8c8a3d48559e0a303ec50a07d221ead4e833ea6c0ee8e3b1f1723,t,78050,4898711,,5000029,2018-01-30 13:48:19,163
0x9db9e25dd147d4ea4efe68f103fdcf639f5565e514848e7a9be4bc87d3c9afdf,t,133467,5032178,,5000029,2018-01-30 13:48:19,164
0x4789f19d9f4c75e089b516c6e8991d3d18c800aec763ba364cdeed5fc9dc2eb1,t,38478,5070656,,5000029,2018-01-30 13:48:19,165
0xa31bd292193ac219f9ce3d208140932559beb9504f12d1823cd8e5a179f82e85,t,66316,5136972,,5000029,2018-01-30 13:48:19,166
0xb3ec3cf673adab095e333235dc5bf8a340cdc63c6046d29bb2c233ba43ae5e5a,t,52917,5189889,,5000029,2018-01-30 13:48:19,167
0xf3dbba252b2df017ea02727893d12f38b00118dab917563b5d36894747d6c37f,t,44354,5234243,,5000029,2018-01-30 13:48:19,168
0xbbc73adf48a06de3e404eca0ef614ff32f95087fe319889d850bf84e0b22eed0,t,117698,5351941,,5000029,2018-01-30 13:48:19,169
0xcb7dda6ba48f304083bcbd13aecb23570617e202282cb3fa886fbc5f668f4faf,t,51560,5403501,,5000029,2018-01-30 13:48:19,170
0xd15181815d76dea73594dd2f4c5801e72af5e21b2849cecdf3b875dc9dc4ca2d,f,250000,5653501,,5000029,2018-01-30 13:48:19,171
0xd5032abc7e00439ff7151264c18d6f962363133ecfa395b66ff92464a575a82f,t,46118,5699619,,5000029,2018-01-30 13:48:19,172
0x348e14b105419c3f68403fec8d5988bacc250226fb3f911bf340adef3358a5ac,t,44418,5744037,,5000029,2018-01-30 13:48:19,173
0x8214cea1e2411dd8232b39e1d68f4f9fe98c5c457396abd01640a21969c24509,t,23252,5767289,,5000029,2018-01-30 13:48:19,174
0xdbbd5b34734ab24fadb35bce0cc9f87db2fc919b6535e95ab02fe33a479c3007,t,46083,5813372,,5000029,2018-01-30 13:48:19,175
0x53c6e19f2c9a64eea9afb502364aad29ca775b537d0aff26d8f5a3de89f56b51,t,21000,5834372,,5000029,2018-01-30 13:48:19,176
0xf87f8af709da34ce02ed8280f44d42459545246a8ef2b747f2b1f5cad8e0fb23,t,174591,6008963,,5000029,2018-01-30 13:48:19,177
0x11675bdc719890b12595d28af678f296d47415fe05d8c16bcb8ebfeca4d92411,t,79940,6088903,,5000029,2018-01-30 13:48:19,178
0x8f365da2cac6caddb71499463b0d112114e2001e28b0bd70b649f23b17f80541,t,93178,6182081,,5000029,2018-01-30 13:48:19,179
0xfa0f65c809921375b1888c820bf93f12fcea52d16d28e420264309c650b08887,t,38108,6220189,,5000029,2018-01-30 13:48:19,180
0xc8d15b8025e62f619471cc9ad90e83a66953c9f5280d86c0816e462f8c36fa36,t,44290,6264479,,5000029,2018-01-30 13:48:19,181
0x32174c20732081ed706e57aaf895ff0464b509ff3e2b02b98e54cf3bea08a22b,t,78370,6342849,,5000029,2018-01-30 13:48:19,182
0xf21c74f664a5dd5fb383f1b104ecda7b3e06cdb70de38dc86deaa94756fe5cd5,t,52155,6395004,,5000029,2018-01-30 13:48:19,183
0x61d6eb0155f5bf4ae524a9b240cfce5028fdd3bc857e4066521ca1c5c6225efb,t,50057,6445061,,5000029,2018-01-30 13:48:19,184
0x6b35c9ac67e1a36f855414c3f46f1d82625256810de2725d48b0e34a9fe28676,t,21000,6466061,,5000029,2018-01-30 13:48:19,185
0xd5ecc6d5614257c925f5dfc52061a689c7fc16f5d40be84b06cc81bd46c298c9,t,21000,6487061,,5000029,2018-01-30 13:48:19,186
0x8d0a7916e396f166855dd855c30894c8a31f23a7aa1ca07048c3639f7fc64fba,t,21000,6508061,,5000029,2018-01-30 13:48:19,187
0x493d32b0cef14a8c47acecd1e3fd23eb94c429971315e6650144f71f9c1112b7,t,21000,6529061,,5000029,2018-01-30 13:48:19,188
0x0665d145923a66942ef0dbe36d9670a1bbe10f50cd155de20313fad8bff5ed96,t,82749,6611810,,5000029,2018-01-30 13:48:19,189
0x07f03bc838d159ca596617856c4617de743470eba4a8547a91f1916f0e0ecacb,t,36792,6648602,,5000029,2018-01-30 13:48:19,190
0xaf9013e71803ae409c820209ae0dfa65c6c796d90016ef20753d773f6c511106,t,21000,6669602,,5000029,2018-01-30 13:48:19,191
0x82a155b9c7264bfd1c6daab5912c70121b75d3d2aabf2b4ff414199e121dd15c,t,21000,6690602,,5000029,2018-01-30 13:48:19,192
0x328ec96b4eaa529f26c3cb5d3509afc610eff90be905d1f1c00e2ffeace8352f,t,21000,6711602,,5000029,2018-01-30 13:48:19,193
0x5ed4030ad0ab23ffe4587fc80afa7b876076fa4acb471662958161818c6e5f13,t,21000,6732602,,5000029,2018-01-30 13:48:19,194
0x54cb548b65add6315f37120d987a95caca7f6fb80b56f8ffd89489facc15cd4d,t,21000,6753602,,5000029,2018-01-30 13:48:19,195
0x4c4e796c5568325e275f079696fa0e7aa7f89edb69e7b463db4aebf0531e7a68,t,21000,6774602,,5000029,2018-01-30 13:48:19,196
0x9b6cbeb46bcdbfde52b3d8cf503dc437c53a53e967c0e9135996e8327fdac8c0,t,21000,6795602,,5000029,2018-01-30 13:48:19,197
0xed24d7118e33952ffdd6d0138eb6b8ac23124c4856924139a7ed5b5b25eb297c,t,21000,6816602,,5000029,2018-01-30 13:48:19,198
0x64d95108f2ee9ba80001a486d5dd3fd0f4fe153f6959a45632abaa0b5c5b3a92,t,21000,6837602,,5000029,2018-01-30 13:48:19,199
0x1718dbb16dd666629766f43596ea4ca793d267fa44265eb47ae5d3d3a8447d16,t,21000,6858602,,5000029,2018-01-30 13:48:19,200
0xa5342bb691187f1a793c6eefb0545945393e45f742141dfbdd216a47ae974f7d,t,21000,6879602,,5000029,2018-01-30 13:48:19,201
0x52b21dd982702fbbc229ef590b6d24784375561e73bd099caadbda86c2fc2e52,t,21000,6900602,,5000029,2018-01-30 13:48:19,202
0x892b8e4aa46cc0c739227c8071d16a3c7c128e7eef72482238c25a2f4a3f0e34,t,21000,6921602,,5000029,2018-01-30 13:48:19,203
0xcb83d2df0591254a6b0979eb3c11cfc1e0454206c3b281eec8a908403230553b,t,21000,6942602,,5000029,2018-01-30 13:48:19,204
0x1e5fb6d7978dd63b9c642e94a9aa2c68d00dab010124e9bf0c071e937411fe1d,t,21000,6963602,,5000029,2018-01-30 13:48:19,205
0xbac7554db10708525bed21c2d71b9f7c6b311e0e711100c0785d50b40cae5fa3,t,21000,6984602,,5000029,2018-01-30 13:48:19,206
0x95d1694d83c1667e74fbc881df3455857e22ce9193ab4c4f30d3372934612baf,t,21000,7005602,,5000029,2018-01-30 13:48:19,207
0x34861155b1a713d7cdaa11a4a485871a19ddf4ce64302552fb50e50ddf700f35,t,21000,7026602,,5000029,2018-01-30 13:48:19,208
0x7783e8b80fbe980e2699e5889ee6fcd73e1d162f066cc7670868804df456454e,t,21000,7047602,,5000029,2018-01-30 13:48:19,209
0x87e0d1db6589004018e5b11cad6f1e577c7bfc654d4c02a8dc9d7cd9f9754b6c,t,21000,7068602,,5000029,2018-01-30 13:48:19,210
0x73bd5255b58aa1467dc344a2548d9e2cb676a4ec4372fa21398ed450e6aa0009,t,21000,7089602,,5000029,2018-01-30 13:48:19,211
0xa6b994f6671f07e58f67ba78b007257031827f711930611776906955d179f556,t,21000,7110602,,5000029,2018-01-30 13:48:19,212
0x63d1faa765e5bca4a396ac65ef574725f0a2d547aabfedb116a4624e1ec995d1,t,21000,7131602,,5000029,2018-01-30 13:48:19,213
0x0061615d15f59ae6ece9f2a100ed224638a23e01f76e4470f01a6538c4a3beba,t,21000,7152602,,5000029,2018-01-30 13:48:19,214
0xe26014fbb99a76a42f4a8c50828dae1782ec245841e3832cc8040e09d3170ba7,t,21000,7173602,,5000029,2018-01-30 13:48:19,215
0x41c70ba6539067bdff134deefe686cb52cf648ae23b196fd6c2c668238bcf682,t,21000,7194602,,5000029,2018-01-30 13:48:19,216
0x84945e351de213dcc6bc3d5fbc4d207ab9037c7096e76e70e10694849276567c,t,21000,7215602,,5000029,2018-01-30 13:48:19,217
0x61128d9764c8908342a98473728018fdecc4c04855adb6769b4717048856b1d2,t,21000,7236602,,5000029,2018-01-30 13:48:19,218
0xad85ef2f750f791a180a3f13a6d3fbf8193de18b23ed2c1a61da791703501114,t,92613,7329215,,5000029,2018-01-30 13:48:19,219
0x9efc47b3154a39fd3b109a50e3a33123b0a098cf1388d5cb14f129db0676f1a5,t,21000,7350215,,5000029,2018-01-30 13:48:19,220
0xf2287cc4fff976f6dcef558d4dd3d46ca3b663f077756d1fb6c224cd5e22bf1b,t,21000,7371215,,5000029,2018-01-30 13:48:19,221
0x305cbb05d53567ea423d887db57799f8a6ee0ea62510ca3bcbea21a9721179fc,t,21000,7392215,,5000029,2018-01-30 13:48:19,222
0x73bf0cc72aa0e53debfe775b0b634a1001a3beff46c76b4ae57c54471a21c120,t,21000,7413215,,5000029,2018-01-30 13:48:19,223
0xce514c4c37bdc01a6ba7f3de787dfaacce38d5b994fcf03c94a812d41a4db5d7,t,21000,7434215,,5000029,2018-01-30 13:48:19,224
0xd133655cf22e9fd04de9366a67b175c408d43f493682411ce61510821728a265,t,21000,7455215,,5000029,2018-01-30 13:48:19,225
0xae4b8ad52dd170db133a9961988e41ac763acb48d323bc88b6b8e75966a0cdc4,t,21000,7476215,,5000029,2018-01-30 13:48:19,226
0xbba692ffb30f187255e302980fa9750fb64f72b437a49e203e0f5c7cd56726b0,t,21000,7497215,,5000029,2018-01-30 13:48:19,227
0xac3dc766749c4f1907a207aa5540cce10d11f8cafcf40728e9a6147276e5d81e,t,21000,7518215,,5000029,2018-01-30 13:48:19,228
0xc636811f6babf67ee81c95ebaf52161d79bb99ec0666b83dc19c1c91e79539a5,t,21000,7539215,,5000029,2018-01-30 13:48:19,229
0x0755ef552322ddcdf48ff1d87afa58f1c2c109a9a911644d41b3f96bc1bc136c,t,21000,7560215,,5000029,2018-01-30 13:48:19,230
0x8dc51fc2d0f8cc5e869c2a1ac8d425fec86a8af386069a26d59fe66acfff16cd,t,49308,7609523,,5000029,2018-01-30 13:48:19,231
0x6d2b0e9036bc744ced6255024c8428c17f756fb6fdd52f12d0e3e3c9c0251b7c,t,37647,7647170,,5000029,2018-01-30 13:48:19,232
0xa41fa91cfcccdbeac55fe0a4abbc9fce410f8f54a336774c8b8b5c00fd2cdcdc,t,52155,7699325,,5000029,2018-01-30 13:48:19,233
0x22897ab6513beb8176d3efc50cb99d42d82fb4462618910e43dea458af7f638e,t,49993,7749318,,5000029,2018-01-30 13:48:19,234
0x88a7aae896eacf7fe4b7d5cd43b262c39f7f91c29985433d9a43212e167fa7f8,t,21000,7770318,,5000029,2018-01-30 13:48:19,235
0x8f3083616e68c6402d12ac7ea54eb7c2b30265a58a9428cf8938348415391c66,t,21000,7791318,,5000029,2018-01-30 13:48:19,236
0x5cdc09c4bca38cdf6805684df4da70d8045552228b29ff89e2e2dd5ead046fa5,t,21000,7812318,,5000029,2018-01-30 13:48:19,237
0x9ea2fbd2a6d66992ebdd04187713b2e52d9df8f7b44cb93f52ee26cf33ad4506,t,52094,7864412,,5000029,2018-01-30 13:48:19,238
0x163c656583490aa8f903d2dbcba84c3d3cadf3aa2335b0e90eb9ad1deba44a9c,t,37151,7901563,,5000029,2018-01-30 13:48:19,239
0x37f7e68daa188e43eaab982f509746612307590d4d95fb6850f39df19dc84ce3,t,21000,7922563,,5000029,2018-01-30 13:48:19,240
0x9377b591d4549a3519faf609c7fb112d4942d77a7e52a483c83afffa19f2416a,t,21000,21000,,5000030,2018-01-30 13:48:29,0
0x45614a47196f3449f4a5912d0052263afd1d64ad6612379cad9d816b88f3d53a,t,21000,42000,,5000030,2018-01-30 13:48:29,1
0xd55a6bd057fc6799aed504237d15cae2a87c037e7cda5b4520745add85798c37,t,21000,63000,,5000030,2018-01-30 13:48:29,2
0x5cc9465a0960935fbf0596c59d68fc7337f3b19c8e1f621ba9c98abeacdbbe5f,t,115594,178594,,5000030,2018-01-30 13:48:29,3
0xa4d051d457da71bab597ca5df65ab8fb88b24a3c2825451787eeb1077837d544,t,21000,199594,,5000030,2018-01-30 13:48:29,4
0xcce003051c4946ea24cb67600311b8cdff6effdcd3facdb9275400c08ac70227,t,21000,220594,,5000030,2018-01-30 13:48:29,5
0x8f13ee6ef731c2ea0fa8b92a49f445b3bc4ee42a3ddd5a1680a3feec7ee3044e,t,21000,241594,,5000030,2018-01-30 13:48:29,6
0xf06274daf6f7b7b390ff00756d3c777cec6b4c85a091778cafae814a82b926dc,t,21000,262594,,5000030,2018-01-30 13:48:29,7
0xd2784a77d99b1b146b9880755dacb75e77c64a921252f07ab7812d24c5162bfd,t,37687,300281,,5000030,2018-01-30 13:48:29,8
0xf1ebe04dd660e06fa0cc288fd36a5648b3f50d84a00056094e32b4e2308b2147,t,21000,321281,,5000030,2018-01-30 13:48:29,9
0x2cfd6e5070777b0e92b56dca75e4d8cc7d9c72d37678d173df449126ac5cd363,t,21000,342281,,5000030,2018-01-30 13:48:29,10
0x4fde0cd1a4a51bf3e066d3920a6a03bbe7d7185804ef1ea073d8d95f863fd67a,t,21000,363281,,5000030,2018-01-30 13:48:29,11
0x0db9dd4cb2b9980faa22b58a77c7b71f464c5a9a4b2176e7aa252497459261bf,t,21000,384281,,5000030,2018-01-30 13:48:29,12
0xc4012475e2d21220e43f4c5664daef33081a50362c517d7044c91d1913361d44,t,215038,599319,,5000030,2018-01-30 13:48:29,13
0x3939e34ab783f70cbb1bfd25929672896d3a9f303de3d2391901867715bd8356,t,36772,636091,,5000030,2018-01-30 13:48:29,14
0x75cc904b8aafc6f16088ad39100e2ad77575169f2c78f868c5c7c277b3a23019,t,43842,679933,,5000030,2018-01-30 13:48:29,15
0xc23027ce4ce214afde8b8158929d668db7103c212d9572dcf93c8ce98fbac857,t,50281,730214,,5000030,2018-01-30 13:48:29,16
0x0ee324e3cffb4caed9f0ddafd6ea5807fdf242f4870dee42d3c4a604832e2073,t,21000,751214,,5000030,2018-01-30 13:48:29,17
0xab4958c7fe9a998d316475b5bd9e4a8dd706f881c10b376a6acc483648ba5f87,t,59290,810504,,5000030,2018-01-30 13:48:29,18
0x13e07cdf91fcf5f87a4dd27e33d864849d959267090cef7ca178b239e53b0fc5,t,312891,1123395,,5000030,2018-01-30 13:48:29,19
0x40a9559b0749aaddf128447fd0d5c9f8f25be53288af32978d540a2e1ae299ed,t,44095,1167490,,5000030,2018-01-30 13:48:29,20
0xf2217f3bd55d108d4be3b6303ab87fbb71e5944503d30a1bb3a30fef1490a5c1,t,21000,1188490,,5000030,2018-01-30 13:48:29,21
0xbc2c99c683b47e5c32e24ec9076caaf807cc294ac5cc63e58c8742f8cc51b17e,t,21000,1209490,,5000030,2018-01-30 13:48:29,22
0x5b61ed2ab6875a1369071f21a14e4681f067b10935b4a390fdda8ddd378d3a3c,t,21000,1230490,,5000030,2018-01-30 13:48:29,23
0x438a57ffc72e40cee95f907e1837d72b9a3e803fa6880a54d84f98fb2b8d06a7,t,21000,1251490,,5000030,2018-01-30 13:48:29,24
0x848cb6484820551052f60751e2d0c1753fedb319f953039cfa276729d1de23a8,t,21000,1272490,,5000030,2018-01-30 13:48:29,25
0x095badc45a7c091014afec0a24707533f5ac2c81e97feaa2a8a7053d621b3081,t,21000,1293490,,5000030,2018-01-30 13:48:29,26
0x536a61a3eaed69748a14e1e5b5b4ce2fb4e530a4ba5021d33e1f9737b7eb88a4,t,21000,1314490,,5000030,2018-01-30 13:48:29,27
0xc360a65a0aaa02062b35d522d9c2273624c9843e3b5944c32e1b15c9909a67b1,t,64725,1379215,,5000030,2018-01-30 13:48:29,28
0x62c74c9b4f8d4ade82839c62974428b392d5af4021f41be3430939c36e5b833a,t,52158,1431373,,5000030,2018-01-30 13:48:29,29
0x32713f70a01c596cfdfbac8db97fbb0ba25c5b286101123bff6fae130b285c69,t,27077,1458450,,5000030,2018-01-30 13:48:29,30
0xbbd93bfd0a687848153db6e75415fa3342fef83782e81aa11016f79fc36ffd39,t,38318,1496768,,5000030,2018-01-30 13:48:29,31
0xda403703dd72f415a5c7ef810a4d14b7a88dc4a2d8898ef5f4e3575d41027bdc,t,22027,1518795,,5000030,2018-01-30 13:48:29,32
0x8174b28af37b189039cfb082dca80ce80dfc142838d84cd62d8fe2a890447cdd,t,22091,1540886,,5000030,2018-01-30 13:48:29,33
0x13cf03bba67f9949d096fe32af26a14ee700efb59b38aeb2fc33a600d3ff46d1,t,52155,1593041,,5000030,2018-01-30 13:48:29,34
0x40415314877f65b86430167fd02052bbe70a4589f101238a3852dd593289974a,t,21004,1614045,,5000030,2018-01-30 13:48:29,35
0xf87a3a5dd944ee7d111c9193e34c1bb894fa74695234ee3221be4ca3c0cd3cfd,t,93178,1707223,,5000030,2018-01-30 13:48:29,36
0x24ba3241a1dd29d9f97a71d418e5ac58676cdfa4b5c945fb67a9804182cb17fa,t,44854,1752077,,5000030,2018-01-30 13:48:29,37
0x3c894b2fe8ec3b482e083c9e7bef51d25b061df969360c6e25c32f70fa52b1e9,t,38233,1790310,,5000030,2018-01-30 13:48:29,38
0xcf798947bed96f623cf9afcfc420c694fb80d5dcdc90d29c462ee752b25d14d9,t,52460,1842770,,5000030,2018-01-30 13:48:29,39
0x72cd4ddb89554a8144cd6cf12d153287a5e6efd35af21c173cc509d17624c728,t,54844,1897614,,5000030,2018-01-30 13:48:29,40
0x4f85c1cb984921791097f5045f73b2563d9fe46dbac4c2630394eaf003938d2c,t,51670,1949284,,5000030,2018-01-30 13:48:29,41
0x3ebaf342711f2191d701f958e78e73b087222cd16eab53d920eb198601ea1bc5,t,51289,2000573,,5000030,2018-01-30 13:48:29,42
0x5d046be7e59bb3e85809e17e8398156db6396f0b66f084e06261ddc480ff345e,t,21000,2021573,,5000030,2018-01-30 13:48:29,43
0x74a40aea2527fc046545c1d5e9c46807edf1d3de58da224a4023ea934495bd9f,t,21000,2042573,,5000030,2018-01-30 13:48:29,44
0x8a739dc555db376743aea31bbbea0ce5586b4631c395620e63e72ac2b1144a55,t,21000,2063573,,5000030,2018-01-30 13:48:29,45
0x7420ec6abd9029476f60693214f83e6a6e93a403e137f11578a3d3a10e510925,t,21000,2084573,,5000030,2018-01-30 13:48:29,46
0x8c35ec82c0c01bdd222d65ba5790edf52734308bf96bb46bf56e8beb3057f04a,t,21000,2105573,,5000030,2018-01-30 13:48:29,47
0x0b8763a476352615a761077816deeb02d77f70af8adb4b41533afbe191a55825,t,21000,2126573,,5000030,2018-01-30 13:48:29,48
0x03d84f5d2d2530c50cc9ddd42e42359a3f7575a4c2e29ebda4348d598053bd54,t,21000,2147573,,5000030,2018-01-30 13:48:29,49
0x642631f5f7bd8a176948a12739fa07b07164c150f4d5e32c56178f41c7bbf732,t,21000,2168573,,5000030,2018-01-30 13:48:29,50
0x47ec80872f57a854adf5a54191807ac91a6d275eb1939fcc97767155c952a4c9,t,21000,2189573,,5000030,2018-01-30 13:48:29,51
0x3d45edae83f5cfc9549a46ae0d952bef71b0724a9b9f852564f779a29233189e,t,21000,2210573,,5000030,2018-01-30 13:48:29,52
0x75ddfaff84b05631c20e89fc6b3bb586e03f5f068ec47c093aa527dfed4c6bb9,t,21000,2231573,,5000030,2018-01-30 13:48:29,53
0xcb05bcdcac5f9f6e95fed60d459e875bd0c1b706b6eedbbf6f1aa498669c97fd,t,51938,2283511,,5000030,2018-01-30 13:48:29,54
0xf9cce2cc2b877f1459bb2a561564ef8e446554c42938fe59136c0fce71ca41c8,t,21000,2304511,,5000030,2018-01-30 13:48:29,55
0x64440043b79952421d7cebec9ae65065f3954e96c6bea07b860f896b639c4fc4,t,21000,2325511,,5000030,2018-01-30 13:48:29,56
0x618f341c597f8f2fb174bd9221bd1e9364eb4af19580c45916d491d3e15a1ec1,t,21000,2346511,,5000030,2018-01-30 13:48:29,57
0x885f8e347f20d5cde6b923dd97b369a60cb99d4a3ca7467530f6a7122bd2c17c,t,21000,2367511,,5000030,2018-01-30 13:48:29,58
0x87ea2e9f0402f665d94aa8e9a20d784830926c3b7b1dfaced0bb9579ad6eef06,t,21000,2388511,,5000030,2018-01-30 13:48:29,59
0xb968a71a68d7f37f6336fcfe121a44b32c1a02bf64e34d8199a99b03de0e6d51,t,21000,2409511,,5000030,2018-01-30 13:48:29,60
0xd7fd41261ef71dfd9e3ff402204a99104d4f0d3b7476e79014ffe95fe72c709e,t,21000,2430511,,5000030,2018-01-30 13:48:29,61
0x87cf3bfea014c5d4c2d770c9dd62410986d4db693144937952efc2b632e0ee10,t,21000,2451511,,5000030,2018-01-30 13:48:29,62
0x14c3087dfed1f7f1574cb9a1a278225488d6f586c1a5c0f070cb23b516a1e6be,t,21000,2472511,,5000030,2018-01-30 13:48:29,63
0xf52cc91e77779cd09c571de7f810f838c47fd7d2bdf0721809c0198198f7319f,t,21000,2493511,,5000030,2018-01-30 13:48:29,64
0xf0ee8f379d5e3859cd3e904fb35b5f6b2a4fad2e29834035f4d9cc78a1c0fa2c,t,21000,2514511,,5000030,2018-01-30 13:48:29,65
0x600a95b465a61451895e35b8905edb00c3a21f591bd3e2e2acefb22af16b6ebb,t,21000,2535511,,5000030,2018-01-30 13:48:29,66
0xef723785942f90097a16b5173e455c8158d112a3d73ba03e28dfd564b66449c8,t,21000,2556511,,5000030,2018-01-30 13:48:29,67
0x61146db5b902e7c4f543077d49a286697c7fa6e5dcefaba2ae44b2be0abcd2be,t,21000,2577511,,5000030,2018-01-30 13:48:29,68
0x417ed83b355b5f94eed2368460545137950058501b953106abf4ded4d1401bc4,t,21000,2598511,,5000030,2018-01-30 13:48:29,69
0x52a80f8fbba754d73869fe605629f1fa992c7b831688e5cfe466d5dbd54ee002,t,21000,2619511,,5000030,2018-01-30 13:48:29,70
0xeadfa8764a539c873df321b9d13f5d1e15008947f4ecf264a65cf55863b5a4a3,t,21000,2640511,,5000030,2018-01-30 13:48:29,71
0x0937f013f7dbdafcb9d2bf0b844eef17f7af4bbcadd513d2044760d892884235,t,21000,2661511,,5000030,2018-01-30 13:48:29,72
0x835dc703de737d3dae34517b1f08daf33574310607dd2dc532a20ad00e687a17,f,24178,2685689,,5000030,2018-01-30 13:48:29,73
0x731ef9273677ff10ee132f641af049acca627e645c6910dd38cf380bafddab0f,t,21000,2706689,,5000030,2018-01-30 13:48:29,74
0x41047b3c41fb9141bc76ceb79aa5147308b77f165acd9b3215345b3550583257,t,21000,2727689,,5000030,2018-01-30 13:48:29,75
0xf61a0ac78bbc3b70c64f79ec682e0d7296103ecf2ede4f377a7d9baed68cbec9,t,108748,2836437,,5000030,2018-01-30 13:48:29,76
0x327d3c91278159da101dbfe131ed28bdd3658ff4deada429872c15a444b06a87,t,21000,2857437,,5000030,2018-01-30 13:48:29,77
0x797786927000a58ece83c0381a1402834accd6b276b30005ef207a42ec7ee2f0,t,21000,2878437,,5000030,2018-01-30 13:48:29,78
0x49c06546630a2307d544a97a25098963c3acd8f60f482baeef93ef9447a80eb8,t,21000,2899437,,5000030,2018-01-30 13:48:29,79
0x4fd25b2b0271da5024ae7bf2eb85acbb329b4870da6141904f22c0a7181315d0,t,21000,2920437,,5000030,2018-01-30 13:48:29,80
0xb06ba194d37fe111885c9cae9049a69604c865447cd881546ed08eaf0a200196,t,21000,2941437,,5000030,2018-01-30 13:48:29,81
0x8b901025ec4999b116348adc25fe07a289724bc34d52dc52430f5d1ad3c172e6,t,21000,2962437,,5000030,2018-01-30 13:48:29,82
0xa2521e3f59021c0dd900066a4f39defd8a8e0c93c09bff2e6b1170508e12b3df,t,21000,2983437,,5000030,2018-01-30 13:48:29,83
0x5236e3f016aa3b4628fa65e08c8308d958fff0004a8d0dc08c509621c00b5552,t,21000,3004437,,5000030,2018-01-30 13:48:29,84
0xa2e1bd53e71e7fae6d191cae96f2de3fdcd2dc9a3681b3e8153cf90c326cf955,t,21000,3025437,,5000030,2018-01-30 13:48:29,85
0x48d6166b06ff7731c23e371800de52f4ccefe8767825bb6aa4b7bd419be2ded1,t,21000,3046437,,5000030,2018-01-30 13:48:29,86
0x260efd74f0169b7510b8e64158a78dc446ba9a608b5a52f35c43ec23a8a447dc,t,21000,3067437,,5000030,2018-01-30 13:48:29,87
0xab8ec8e39c6cfa13cf0c17b3aad2b577e6cfdf5149a7cc9301a2f6df9132b2a5,t,21000,3088437,,5000030,2018-01-30 13:48:29,88
0x11b4fe1257d0bc5a8c55d41a9dda3835900178594dd3b0b43da4919f573372bf,t,21000,3109437,,5000030,2018-01-30 13:48:29,89
0x3b850e467da054662b9ee81fce7e5ceee96ca6c589bf71cc3691be9fa2ea75e1,t,21000,3130437,,5000030,2018-01-30 13:48:29,90
0x60fc077b31566e73654ae0542a5b002826c95d8c74d5b5ec8b9fdbd83b189ddd,t,21000,3151437,,5000030,2018-01-30 13:48:29,91
0x6262b5d12c7e26960761b5cb2fa7fb382b23c4fe8a3bdd84b6199038d1c03663,t,4663948,7815385,,5000030,2018-01-30 13:48:29,92
0x6fba5dac9ddf0b868be37df3834484be839c631ff70768032431832db9b6d1cc,t,21004,7836389,,5000030,2018-01-30 13:48:29,93
0xe43f1ac6f68af892b05e9dc155286f3a472e4c493db40447d35024f761201d69,t,21000,7857389,,5000030,2018-01-30 13:48:29,94
0xbda3b4b3c6b324fba0e91661b96952d51f0a79565d2cb28e63331aca12a5ce9e,t,21000,7878389,,5000030,2018-01-30 13:48:29,95
0x7dd29613b4dab55cb883c2034365178d1808d3200bc13f0260a01a698e9ab1fe,t,21000,7899389,,5000030,2018-01-30 13:48:29,96
0xbf9da807091bd4b5dc51cf48253ab645c68e74fd203e9ee0776665a02043fa8d,t,21000,7920389,,5000030,2018-01-30 13:48:29,97
0x345c657d163d2f0f27f5b0a688b11ff538dea574af72e6b4642dd5764c4a5da6,t,21740,7942129,,5000030,2018-01-30 13:48:29,98
0x79fddc81c9fb3c16f11c8c7ccc56573a6928f7e2fa6da812218ca48657f91efa,t,21000,7963129,,5000030,2018-01-30 13:48:29,99
0x8b1dac4788cddd81b605c611f1835063213bf51cea4b29d1ef112e3cd0cf3731,t,21000,7984129,,5000030,2018-01-30 13:48:29,100
0x1b00beaab62f8a1cd75afd80e084e8c4de75460064dc79e00b4483bb7c9abda1,t,21000,21000,,5000031,2018-01-30 13:48:55,0
0x825c6edb3569725b4df86eebc8fe21ffe2ccde7aeb9251379c57f3f55801115a,t,21000,42000,,5000031,2018-01-30 13:48:55,1
0x6ec23c7dffe158fba6b52663c720ccf0818002ca0a22223ad2dce79f62d2011d,t,21000,63000,,5000031,2018-01-30 13:48:55,2
0x4b72d8222d07658e50182fc6322dea67d1f443f8b2a27884c59bd3d59c162f8f,t,21000,84000,,5000031,2018-01-30 13:48:55,3
0x77e8ea5be72fa9b3aae65615dc245046dac530aaf0c4e87d458f36c920643368,t,21000,105000,,5000031,2018-01-30 13:48:55,4
0x14e4a6cfb68c271e931c02a40d3350c2ac21b5a33721a52a768fc1617dcd7e3a,t,21000,126000,,5000031,2018-01-30 13:48:55,5
0x4f7046351f38e68c52d6a4045e36a4af7a47b1022d2792bc7af74537861b4f12,t,21000,147000,,5000031,2018-01-30 13:48:55,6
0xd4799b22637e4b962d3f8f8292c243bd5596a7d5dd90192e53aa98acfe4066ed,t,21000,168000,,5000031,2018-01-30 13:48:55,7
0x966d7b272873cfa8b68665e9c2192c7486ca0084571b6f4942d2264c143eebdb,t,21000,189000,,5000031,2018-01-30 13:48:55,8
0xef350272ef3e5286ea397d8874ff5d3440d78813136320b20c1c8d7f3da4ffec,t,21000,210000,,5000031,2018-01-30 13:48:55,9
0x31366895fcd5e97615c253e988b67fe8220ca859ae8c926a88d64f1a97864de8,t,21000,231000,,5000031,2018-01-30 13:48:55,10
0x9f79a4d046fbb1f5da952a04a5247093eef4e4692a9aaa1212ae5f5f0e4250e8,t,53416,284416,,5000031,2018-01-30 13:48:55,11
0x79365c72733651b48a262227903fc4ba14f131719855242d5cb1696c0e4a3261,t,21000,305416,,5000031,2018-01-30 13:48:55,12
0xaebf8f1f91f134a30da97673e24872811ec26520405f74d823f3a919fbe84bec,t,52155,357571,,5000031,2018-01-30 13:48:55,13
0x24ec6fb8a1fe73f6b6f9794506ba3c4cad80408e3ccefad5046714787063eaea,t,52158,409729,,5000031,2018-01-30 13:48:55,14
0xfb76478108febd9d34d71a077214fcafcf8364e03a13f576b61e8e16cb7ff3b3,t,52155,461884,,5000031,2018-01-30 13:48:55,15
0x3b15cb78cdafda7df324a5f39d3224dac20b7a1ae7d4e180ebf7d9f9a452a8d3,t,52222,514106,,5000031,2018-01-30 13:48:55,16
0xe9b70b387fd54754faa76c3680efa682f070bac5e42fbf607cafd8cc0239661d,t,52155,566261,,5000031,2018-01-30 13:48:55,17
0xcda033c644d50057bcc472f307a5a8a9a09e440a3f3274dc020b3e0ce7077591,t,52481,618742,,5000031,2018-01-30 13:48:55,18
0xf8917db0ce15f58299e6c81f288d2042122a3a1e39fd658101f5a37e41e4cdc0,t,52545,671287,,5000031,2018-01-30 13:48:55,19
0xccc553d9122f4fb76679b368bde2c9a971e643024678e066641f05537796234b,t,21000,692287,,5000031,2018-01-30 13:48:55,20
0x376fc5636d8a1d1308afeb4b700be33f06844acd3c12bb60e90c992a007d5dd4,t,21000,713287,,5000031,2018-01-30 13:48:55,21
0xfd665801cad676cea9eaec85bdbb35ce42d6f230822e25766d48a4765e4a7fbf,t,21000,734287,,5000031,2018-01-30 13:48:55,22
0x76a870628440132a94049a6bb689dd4e06c7aaf6c926076415464ede51ef0f12,t,21000,755287,,5000031,2018-01-30 13:48:55,23
0x55812f3937e6e886a0a25040efcd093027d9b377a13a6fbcd59c5616fa88ef65,t,21000,776287,,5000031,2018-01-30 13:48:55,24
0xfcd273b216e4e1f9d7c2693a1e6c28d83a897643fc3c90d4e25b89322a924366,t,21000,797287,,5000031,2018-01-30 13:48:55,25
0x7279fc5e6dafd9ae10d3e235cf9828986a377623c8cbe6770136279454ea912a,t,21000,818287,,5000031,2018-01-30 13:48:55,26
0x3466d0739649207d5848c54bfe86456481db809c88a2f792c7d8616c6350b91d,t,21000,839287,,5000031,2018-01-30 13:48:55,27
0x1920a6d9e851b4440824573ca45ead18d8465d12b05561e9a3bf1d6392ba7be8,t,21000,860287,,5000031,2018-01-30 13:48:55,28
0xf00da2332b4733dd08fd9cf55e646d83461bade9ac818e23e4097c8dfbca848d,t,84317,944604,,5000031,2018-01-30 13:48:55,29
0x266202daff4d5514c59f62e6e19725a66a131ba7771dd6b13bc399ee764e823c,t,21000,965604,,5000031,2018-01-30 13:48:55,30
0x2fa522b6a51e0fb58e535b5e693fb51c684b32390332443253c6ed34a5d92551,t,21000,986604,,5000031,2018-01-30 13:48:55,31
0xdebab52b99b84ad5b5efe406f69966692acd36c0c3c8fd61e21d9f97407835c5,t,21000,1007604,,5000031,2018-01-30 13:48:55,32
0x18a929f890323f524b336da34893b5e3c999c2eb59375ad2fbe72da53f6f5058,t,52169,1059773,,5000031,2018-01-30 13:48:55,33
0xc899543b355cb0fc6dc7dc36250cbb31ab8e155e2fd71164f45484ce3f85b6da,t,54267,1114040,,5000031,2018-01-30 13:48:55,34
0xdd0794fa805f5c6db79531c52d193c9e0dfa449a0b76d3c6d906b825da81309b,t,21000,1135040,,5000031,2018-01-30 13:48:55,35
0xf37402852a2f147598906a30ff5fef22755e5512a62a6534bd4b60da5a94f131,t,50057,1185097,,5000031,2018-01-30 13:48:55,36
0x57b07c22a22a5b9a5d0c077c9a7dc98043f7d3575bdc4b21d7449f5a956695ed,t,50057,1235154,,5000031,2018-01-30 13:48:55,37
0x8fdd808b6867dd6d879e19b6946d2b462f31c92d2911dd678e026d91a9bea0d7,t,50057,1285211,,5000031,2018-01-30 13:48:55,38
0xb8e9fd356c31fdc2d92aeccdf92ea8d5d74cdf2f1fac5deea29b2d81ce029dfb,t,49929,1335140,,5000031,2018-01-30 13:48:55,39
0x426c9c85988f58fd0cd53b5264a45d024a93acb9e42d479362f89ca27d1b6b2d,t,50057,1385197,,5000031,2018-01-30 13:48:55,40
0xe800577cf05001b8c0d75a4ee7876980901f33671989e8f046ae53aaf24abe0e,t,50057,1435254,,5000031,2018-01-30 13:48:55,41
0x223599060ecbea86916a1f0f0b413ff263e94a2f792d4c240f37ad7339cf11b9,t,52476,1487730,,5000031,2018-01-30 13:48:55,42
0x83774cd859f2a45749c10543f3a15ba1594b0133fe96e92dafb9b95e3288cd28,t,47425,1535155,,5000031,2018-01-30 13:48:55,43
0x6a4933eeac678a7b62f841e33643f026d257864f151cbd71ff71b9212e6fd0eb,t,92434,1627589,,5000031,2018-01-30 13:48:55,44
0x1324e9537f410ddd1eddce14f5a416c4adf9894f41a034d6ff3c15f7b9404f20,t,21000,1648589,,5000031,2018-01-30 13:48:55,45
0x8be4a304609487a6e80b7cdcdf20fbf120eb653b01ca2e7f15e135a4f43a6997,t,21000,1669589,,5000031,2018-01-30 13:48:55,46
0x515295376463b8ad04d83bb6b13d9754a61311eb1bf435c3b858d5ad5527f9ef,t,53318,1722907,,5000031,2018-01-30 13:48:55,47
0xc7010e75bd3ec79e66305feaa0812d1084b13665581afe115c822f496503ea75,t,150164,1873071,,5000031,2018-01-30 13:48:55,48
0xe397af16e26c89ea9522786d5acd311a1b90f369becf7319155fe63551b2619b,t,49359,1922430,,5000031,2018-01-30 13:48:55,49
0x879d613987cca5ca05c07593ee635565f6313e2e233d14bd8591cf52cb70ad8c,t,39538,1961968,,5000031,2018-01-30 13:48:55,50
0xbf0b0aba1fcf7f3c0e17713ae6721f8a6329f59452d801b22c51229a905575b9,t,21000,1982968,,5000031,2018-01-30 13:48:55,51
0x7345afc3e89a7c11c3f543abbe53eaf8e5bb81aea304b57e8ec16f2f667c9562,t,36762,2019730,,5000031,2018-01-30 13:48:55,52
0x935db932083404dc7aef8e33fb9a1a012673ccf02ce30b66e51eb5e829fa8478,t,21000,2040730,,5000031,2018-01-30 13:48:55,53
0x2e906e57830ba21f9f23de39d10ea41cb268e37db0d67cdc72b1b1913807c95c,t,21039,2061769,,5000031,2018-01-30 13:48:55,54
0x7bee6f00694890b52a2a6f0400e3146230c773c5704dcf3c2ce3a844d7e0bcae,t,52004,2113773,,5000031,2018-01-30 13:48:55,55
0x0192eac0c794548c4a021d36cae0f24882ef31548890de4d1985460dc0445336,t,21000,2134773,,5000031,2018-01-30 13:48:55,56
0x11a8daeb94b63df7142144e2c6f871e08e8c7099366aa65036d8c15d85e7a80b,t,21000,2155773,,5000031,2018-01-30 13:48:55,57
0xd06366fd80f9edbe0bd8e5e31d5a86a28f57f6edeb63b35daf57a13f57a27165,t,21000,2176773,,5000031,2018-01-30 13:48:55,58
0x80e74dc13700e26e3ec0b7cddee1d2e2572bfd76052b86d6defc6c5525354532,t,164698,2341471,,5000031,2018-01-30 13:48:55,59
0xd8a82fb3693f89c6c86d59cb59c7ae6d76c1710b042d55c11f5e0c85ca4efa37,t,34213,2375684,,5000031,2018-01-30 13:48:55,60
0xa89fdca503fa936de18b402f0ef2dae5ad91dc405c17de1a7007fcd5c9506871,t,21000,2396684,,5000031,2018-01-30 13:48:55,61
0x1db49358b5439ad0b1e54cf90be8c40c8ba0be1fca930637a379deb80363b247,t,21000,2417684,,5000031,2018-01-30 13:48:55,62
0xe8cea4807e4bf4997e41421dc76de8e95e6e210a7d297303fb6a367dc0d0ba46,t,21000,2438684,,5000031,2018-01-30 13:48:55,63
0x94906872ed7baae7ed645369df03611578c0605a556b33b963f00bec85f9bb65,t,37912,2476596,,5000031,2018-01-30 13:48:55,64
0x1eb6050be7051c2f25f810d77d1070458507ec71cd477dbcc4830b189ab503fe,t,63240,2539836,,5000031,2018-01-30 13:48:55,65
0x30c5c5d79945cb9d4f51cf71b2ab655c2a801f1f2692652105f5bf7d1c55ff2b,t,21000,2560836,,5000031,2018-01-30 13:48:55,66
0x9e5aa3fb593027a64bd12b4af16154c2a94eee80460e224f544cf6e00d9af1c5,t,21000,2581836,,5000031,2018-01-30 13:48:55,67
0x52b78c3e6a6e71326da2221586240dcb5def84ed687128c4cb737e10a53416a6,f,25616,2607452,,5000031,2018-01-30 13:48:55,68
0x30520e093990c7da875852427c847fc6c99825daf5002b9cf44d20953adf5a78,t,63240,2670692,,5000031,2018-01-30 13:48:55,69
0x22cfe938c5c1c8987aab5f8695fa307c5c4435f3d9a26edb88a945d06819e898,t,23236,2693928,,5000031,2018-01-30 13:48:55,70
0xc53885ad5a1ccdf5902372dd5c2659ed6dee2856f04391fba6a7cfcd3d0e805e,t,21000,2714928,,5000031,2018-01-30 13:48:55,71
0x5abe200e65e5085a037ec1d176690bef6ff8ec28e4d5bfff756a2a6036b94b34,t,21000,2735928,,5000031,2018-01-30 13:48:55,72
0xa821d2364f70fcb8e5e4e5d5ef59ae2d0a2cfa2ec99f340f89fcec74d7a39758,t,21000,2756928,,5000031,2018-01-30 13:48:55,73
0x36e6656bf312fbed8246393fb6f1febaa8005e609140c3ac2965ee8ade89ee81,t,21000,2777928,,5000031,2018-01-30 13:48:55,74
0x072a5257d45b85e40003471e770a21b235c31c78006c09e4ab466f13ea2b53f3,t,21000,2798928,,5000031,2018-01-30 13:48:55,75
0x2fd8745a3187395833f91cfeb20c0748217b26738c81db70bbc6628d726b7eaa,t,21000,2819928,,5000031,2018-01-30 13:48:55,76
0x1bc5235a0334bdbc1ad0d1fe9080d27f4b7f66fb5871e3e0ac7140a93e1985c3,t,21000,2840928,,5000031,2018-01-30 13:48:55,77
0xfed538c4ce3e7ea0de9d61c2d809860b21324fc8c4296e1528bd06ed203570be,t,38002,2878930,,5000031,2018-01-30 13:48:55,78
0x07ece91a6201c450e3c0b2cd9b5d06a8eb3271b27568d8577f8beba5a99eb013,t,21000,2899930,,5000031,2018-01-30 13:48:55,79
0x02cf5c0a8ff6be3da280148214ab278e20c7ad01ac51cba5a34b56b78514673b,t,52923,2952853,,5000031,2018-01-30 13:48:55,80
0x82ddcb3f2c7e4359ffd7f313998595b10080e2df8035b13b1a597889c03a7b42,t,21000,2973853,,5000031,2018-01-30 13:48:55,81
0xf49fc5cd6c9461167f4cb00ed296ffc15e6f210f055ec6b5b5cae3393b54a93c,t,21000,2994853,,5000031,2018-01-30 13:48:55,82
0x89051d04d85f9d67768496749a546938fa138cd0d0a245764a4542bb30b246d5,t,21000,3015853,,5000031,2018-01-30 13:48:55,83
0xaf10f92aaacbada029049d9344ca1e51ed6a8bedf5d4aa08f11b03fee0e69af7,t,52011,3067864,,5000031,2018-01-30 13:48:55,84
0xe20128524f9476a09889de243ece6e672990f1a086841faa58cb79b1ac6fe892,t,37151,3105015,,5000031,2018-01-30 13:48:55,85
0xa7d65b0435312bb71c8edef96281f80ef4fb300b7de7e15973630e4b96612da9,t,51779,3156794,,5000031,2018-01-30 13:48:55,86
0x4b91bda8cd60b8b670ab9108b7ac9ff8e9492f65140cfa3985e509f0c304a389,t,51452,3208246,,5000031,2018-01-30 13:48:55,87
0xda042d203f6fb47f6854b56c0ef8e59f2e3530680775f6bae3cbb851ae817ab0,t,21000,3229246,,5000031,2018-01-30 13:48:55,88
0x91032fbe6f9fa46be10c53c9c2e8fcf8f0754456f968d7299bbc086490c01814,t,21000,3250246,,5000031,2018-01-30 13:48:55,89
0x844570c959984e6970d271ed3495ba6aff82365003c715a01b0baefb4041953d,t,21000,3271246,,5000031,2018-01-30 13:48:55,90
0x22279029eff1efbc4a8245158ee2303ed95b174a0b961724a9b94f7bbd95a188,t,21004,3292250,,5000031,2018-01-30 13:48:55,91
0x0529c67c87a530e0ee0bada0c073aefcab537bf9fa6b425d7de6eeaf037c9532,t,21004,3313254,,5000031,2018-01-30 13:48:55,92
0x030444b64a97e5cb665ea0ef6c61e8f151b068b83c50d1d9a83147d922b6a244,t,22091,3335345,,5000031,2018-01-30 13:48:55,93
0xc4b4e4ac6253e6e59c2b7bdf44a8e3e35af9a292ec3b4a07178fb4aead304076,t,21000,3356345,,5000031,2018-01-30 13:48:55,94
0xcd247f9cce9a65f0f4a21e0a04a35116dadf8c2e3b80e64331d49e37029e8937,t,98873,3455218,,5000031,2018-01-30 13:48:55,95
0xedff6836582e77b5d2d1f0570c15d06ace7863351a109d5aa40a95170dbd6091,t,52257,3507475,,5000031,2018-01-30 13:48:55,96
0x5351c23eb7c88387d17dbbf71a9224ca75b6f7abd1f152e2f859cc127467e79a,t,38002,3545477,,5000031,2018-01-30 13:48:55,97
0x9b42e5a14ef16db65c3af1c7866e7528f1b11744f153c7cdb50c1ee9c1353f83,t,21000,3566477,,5000031,2018-01-30 13:48:55,98
0x85a5858858ee1568140686a0048bf944079bacf3f8b606acbd3813acba33c5db,t,21000,3587477,,5000031,2018-01-30 13:48:55,99
0x099e9a97544227b879a45657f610ac078c27433198cf90c88bee36ae010d71d9,t,28757,3616234,,5000031,2018-01-30 13:48:55,100
0x2fab8aafdf2a69c5796031220105c0d443dda6a1b0906ddf2bb7b5cb99b29522,t,21000,3637234,,5000031,2018-01-30 13:48:55,101
0x9c6bfbabcd7f4e54060c04d8021511b31dc5f0cd1d07c7e80c533d49a2123ee8,t,52524,3689758,,5000031,2018-01-30 13:48:55,102
0x737106aca4e8989092a338a857544a1b2f5c0f6ada0365c5936235c5064df5b7,t,98113,3787871,,5000031,2018-01-30 13:48:55,103
0x4de7a659ed1dcac8e391a929847ee7cde442b1e11c71d1e487d11c5915a7e10e,t,53233,3841104,,5000031,2018-01-30 13:48:55,104
0x0fbf092168429b21ac1f7df33556f1cb48053c79862181b13e339675c4165ef5,t,64725,3905829,,5000031,2018-01-30 13:48:55,105
0xd5a914e027fb1196cf218c05d545b49f5f551a278d8da5c469c04802819400c2,t,51782,3957611,,5000031,2018-01-30 13:48:55,106
0x12f9d2f0731d26f318641fe68f419d35cd52a95d660e72cda5525696bee0a4bd,t,59290,4016901,,5000031,2018-01-30 13:48:55,107
0x65f081d8d441e4843f97b44fe760daf7833028ca9124809d6c8606ac39fc29c7,t,21000,4037901,,5000031,2018-01-30 13:48:55,108
0x058f1b85597ae52623f2b38b8b2e665249fedff49a01d2aee56ece3129db13ce,t,21000,4058901,,5000031,2018-01-30 13:48:55,109
0x5ebbc351a32d703653f39614b8532ce0fa70c4708646b9f63951580d962b68a1,t,21000,4079901,,5000031,2018-01-30 13:48:55,110
0x88702b0109541b3ff71fafaf81d0f3be09eb9bfd952404719f567d9193fc5e1c,t,21000,4100901,,5000031,2018-01-30 13:48:55,111
0xb4ea2767ae2c64fa824215367c7b6aa997dafcc8e67ccb81a52bc249485c202e,t,21000,4121901,,5000031,2018-01-30 13:48:55,112
0x9013e90729cc3d5eec49496f153686a9b650f92939cc49fb5b07bedd58380186,t,21000,4142901,,5000031,2018-01-30 13:48:55,113
0xe6f00e49ee9d8560ad10731767024cb37791430d9df86313fd459a6eb6d2e20c,t,21000,4163901,,5000031,2018-01-30 13:48:55,114
0xb7fcffd9253fe6baf4cf5b41c5db2bc34fb124382cbd16b1a11da61b056effdd,t,21000,4184901,,5000031,2018-01-30 13:48:55,115
0x878dc4dd9ba74d15022817bf4c7fe58d0af2b2624b1439f12feca132fa62b205,t,21000,4205901,,5000031,2018-01-30 13:48:55,116
0xd6f9fb1c1bec992786ae376a92f0c0ca1ce7f166bc073a8da9d85f806253b184,t,21000,4226901,,5000031,2018-01-30 13:48:55,117
0x5132ea47b63294e13b7b4f0b1244691327dfec622d9498d7b401f6ec795b3984,t,21000,4247901,,5000031,2018-01-30 13:48:55,118
0x5c03e0a3892509623c5f37c5b1f2b937f5eb9f197c7d32a6e4c5979b81589d97,t,21000,4268901,,5000031,2018-01-30 13:48:55,119
0x6d896eeed646f4aa0b6be2083f816a13382bdb940c4535bd038c61823335cdcb,t,21000,4289901,,5000031,2018-01-30 13:48:55,120
0x54ba8fe1844bec1746f03cfff9cbf84c0ad40c7e3ac468ecc741ff32f0d7ec9d,t,21000,4310901,,5000031,2018-01-30 13:48:55,121
0x2cd2fdd113e799715b3989b9a05568369b60b108fb17dbeb0c534eee5e8dc0b9,t,21000,4331901,,5000031,2018-01-30 13:48:55,122
0x4e69c209c1e587ec4d48a97e7d955cfe75e108dbb8d013a8cd00bf3f5dfece4b,t,21000,4352901,,5000031,2018-01-30 13:48:55,123
0x8fc197ae9567aebf5215bdaa99031483c16abcad6805b41ecaf785ae1af745cd,t,21000,4373901,,5000031,2018-01-30 13:48:55,124
0xd5e1e93f459eeca5f65543a6e3f1df37551ef26f83bb3f163e5c90fc4669fbcf,t,21000,4394901,,5000031,2018-01-30 13:48:55,125
0xcd7fa5f7939cba57e5606183deff085f4439f89ffcbddbb7587a83883a2ac531,t,21000,4415901,,5000031,2018-01-30 13:48:55,126
0x7b10ea253dde71f5faa5d24bb6c996f354aac3de72890bf990e5ed1d841e4ff9,t,21000,4436901,,5000031,2018-01-30 13:48:55,127
0xb126227d5c3f0247680b0131cd540af1b81bf0a928f43bf312e983facc082f10,t,21000,4457901,,5000031,2018-01-30 13:48:55,128
0x1d6fd5d04801c7ba7d7ee4628cc21e8c917b49f71c50f5f664f18380fc79a2c3,t,21000,4478901,,5000031,2018-01-30 13:48:55,129
0xc5504ef4b5c50469270fee4a154357fee5f526533a4780de728ade981e166106,t,21000,4499901,,5000031,2018-01-30 13:48:55,130
0x749445ff5107bc6e90bab5e80ce3db2e42500bc6c897ce4abd9f6bd9db6ab03a,t,21000,4520901,,5000031,2018-01-30 13:48:55,131
0x2e92dc829643cc2b3b0e1f6b5a72f753b0b9393aee8c0dbc63509eb46139423a,t,21000,4541901,,5000031,2018-01-30 13:48:55,132
0xc6434e5c446a86ffc497b84018b7a631eec075dd444c4b8f42d2b9b78e66e191,t,21000,4562901,,5000031,2018-01-30 13:48:55,133
0xa788e501ecb56d5d544ce0e6092fa2452ff60bbc4f6c24e14b2323924e72d7e9,f,52186,4615087,,5000031,2018-01-30 13:48:55,134
0x13e17e8ddcad49f1db8a0686d5dbe5b0d54cd2c1ddd3d7c5f45056950f14a80c,t,157452,4772539,,5000031,2018-01-30 13:48:55,135
0x8b148dfc39b5e0f828d26f47de60ac44148553e4b7e4aa53a86965d0f96741d9,t,142580,4915119,,5000031,2018-01-30 13:48:55,136
0x016be1f8b856b10c878e1be28a00d83d9b269c1b63c237537963760752845b49,t,92376,5007495,,5000031,2018-01-30 13:48:55,137
0xe6f81f1280fdae5d59ddcfc5186f2705181f5127d8b57a62b3304c5fd76e86dc,t,157708,5165203,,5000031,2018-01-30 13:48:55,138
0xa1211ff8b4eda7e24dd54c34a2311b9340974265f56ad9fdae2ad9975e0cf7fe,t,142772,5307975,,5000031,2018-01-30 13:48:55,139
0x36a23e0142b69d5b0dd940555e1a1c2d7d3eced17e3caca8489a33f8ba5998b1,t,91955,5399930,,5000031,2018-01-30 13:48:55,140
0xa2f5849469a86132328c908ee8c35a6b625c11e9688af3dce9440969591a1023,t,157516,5557446,,5000031,2018-01-30 13:48:55,141
0xc16d3994606e8a3af4c183a83fb4a5498db270db602e7ba2331fdb196ca102b4,t,142964,5700410,,5000031,2018-01-30 13:48:55,142
0x80c734c8e578d6b88599b562dab5384a65c30117a23783562838505f545286d6,t,67877,5768287,,5000031,2018-01-30 13:48:55,143
0xecafe88da00dd2b51e9f77a5e78e4132f5edf1a7a7e19bf8081e6771b1335ddf,t,142772,5911059,,5000031,2018-01-30 13:48:55,144
0xa26e853d70270aabbf955b07b3f918ba3e36e1778b4f2217edf9578af1ea8d4f,t,127580,6038639,,5000031,2018-01-30 13:48:55,145
0xc076d09f8d4dcc937220fa49d4df280eee265f11282c07cf19eb1cd82e29a59c,t,157644,6196283,,5000031,2018-01-30 13:48:55,146
0xc6f95b43fbbf9f1fb68a3606f9db61bbdee346a82e62a1aa702108b1ac831ada,t,92357,6288640,,5000031,2018-01-30 13:48:55,147
0x45473e7d134b8f7e3389cec55682102a6502d15050f6f8c3362d081bddd3315f,t,37820,6326460,,5000031,2018-01-30 13:48:55,148
0x251f1d244ca03e127bfa786b22d3a0bd274379d585aeb0be5e937b1f8ea2427d,t,55843,6382303,,5000031,2018-01-30 13:48:55,149
0x5dd9ccdcccf42e2bdd971f76cd842d44ef34c94ac3d5d3a98dcdb684bcdea569,t,55779,6438082,,5000031,2018-01-30 13:48:55,150
0xd5f44436686fe52a37b3d10d6b3bccb3d3d0108ddfa5bcc3667c2e6445f4e25c,t,52007,6490089,,5000031,2018-01-30 13:48:55,151
0xdf00441208118aa55d1911e67f84ccdfe68ec1be9d721e0cb98258fa9253c2cf,t,36347,6526436,,5000031,2018-01-30 13:48:55,152
0xb6e1d9057737b2984d1ccb732f312a74ea8e981e371804c5121236134ab02c70,t,40971,6567407,,5000031,2018-01-30 13:48:55,153
0xbdac55e9d335c5bc4c6f4d76ad16f8ec008ce5f540a4b64875134b2fad1944ef,t,51948,6619355,,5000031,2018-01-30 13:48:55,154
0x7838f7c351b324a2f020d6f09d3ac3b7f0a6f35220ae06f919914afc454e0462,t,98809,6718164,,5000031,2018-01-30 13:48:55,155
0xcc2eda4269b14783d6efd162721fbc0c76f30f43b2b402d9e5beb833fc85bfa7,t,21000,6739164,,5000031,2018-01-30 13:48:55,156
0xdf0e17ba21371eecb3ca24415ef71fc4da82fb12e01e98a26cd5fbb405cbd97c,t,21000,6760164,,5000031,2018-01-30 13:48:55,157
0xff267313faf438109bfb088ae62d33042e8706e8bda721ebe26f4bddc435a3bb,t,21000,6781164,,5000031,2018-01-30 13:48:55,158
0xb50fca0c4cb7886483a2ff27e190d419d6d2058ed53f7e042e26c0fe074d6f86,t,21000,6802164,,5000031,2018-01-30 13:48:55,159
0xafd9108f9eac938cd5834716b82e36cd79e2a6dc5c48b78117a0b57a52e75480,t,117637,6919801,,5000031,2018-01-30 13:48:55,160
0x642d4289e9821b3dcce76ce5ed90af878fff7c99fd8ba7f3b79c1fcac9d4ffe2,t,31981,6951782,,5000031,2018-01-30 13:48:55,161
0xc139c004f6531e75643ac2ae4d4c17efb0bdda46ba0c04e5e6a4672a143fe1c6,t,51661,7003443,,5000031,2018-01-30 13:48:55,162
0xc84e4051b71b11340038ea7382de33575d34bfae03bf2992c25516775084ad31,t,36176,7039619,,5000031,2018-01-30 13:48:55,163
0xafee12dae6a50ea64eb54cc20fc4af46204299ecfd7e4b731da49bc9c924f771,t,38103,7077722,,5000031,2018-01-30 13:48:55,164
0xb25e9c0cb02b2c4e25881022bf2954bd3dfd43203909e46623e2b8b47ce577c9,f,51852,7129574,,5000031,2018-01-30 13:48:55,165
0x3c45a3cca14159a42ceb4b52e63f042742cc3355430d5486138ec520a799b2aa,t,52460,7182034,,5000031,2018-01-30 13:48:55,166
0xa079eb974d6c62f1fe10420e955c072b487e128d8938b17b9e761d4d55291f1c,t,21000,7203034,,5000031,2018-01-30 13:48:55,167
0x7a2b0cc9dfee471db40202341893012abadb23dc0b945bbfee5615e27ceb70ec,t,21000,7224034,,5000031,2018-01-30 13:48:55,168
0x9065f373725a1449cce3afa90c09f6efbf2e50ebb616cc01b30fc775e5aab286,t,21000,7245034,,5000031,2018-01-30 13:48:55,169
0x81b95125f5294492369dab3f811a3fb6607fec483064cbc82cc2be3de912dd02,t,21000,7266034,,5000031,2018-01-30 13:48:55,170
0x2fbf031fe02644342b18a42bd22118e98a3d3eac152e95f352269409be597ca4,t,21000,7287034,,5000031,2018-01-30 13:48:55,171
0xdffbbca60f41a8ef664fcfd0579dba0d0090a62b2f418ff190510a89a702c427,t,21000,7308034,,5000031,2018-01-30 13:48:55,172
0x52095473644e5511b3081e3c4874350f19f8737e5b7dc018c5304559831c58bd,t,21000,7329034,,5000031,2018-01-30 13:48:55,173
0x96f5f37f2cf5c3b3c3854a3fd793913cfa093449889993dc683aea9add9108c2,t,21000,7350034,,5000031,2018-01-30 13:48:55,174
0xe23ec570406c6def79198cd523f720d7a22e5812533d9fcc64379f377c705a2f,t,21000,7371034,,5000031,2018-01-30 13:48:55,175
0x7c8fdc44ef787629ac43d2909445085e175ff0b5dad068ed75260ee30d8cf1fa,t,21000,7392034,,5000031,2018-01-30 13:48:55,176
0x48fc30f81018fd0f25067b2ea6d6db2a210d13bc163c625eccf03e266bf98a5b,t,21000,7413034,,5000031,2018-01-30 13:48:55,177
0xb850d020026be82cc143ff0eb0b280eb4efbb1f67beb74c579512a6fc4e1dbba,t,21000,7434034,,5000031,2018-01-30 13:48:55,178
0xc511e88d45fd5a9b3a277f2e9a47adeb3117cd574683f49bdf073e292cb6654a,t,21000,7455034,,5000031,2018-01-30 13:48:55,179
0x6d6516099788e2203938dd1cec6512bb3e9bd39dbfc31254ba970341f6d30fb8,t,21000,7476034,,5000031,2018-01-30 13:48:55,180
0xed1788d84d2d4a04f734d4ffa0df40e8c1c25ccc4a2d348987e5f6bf9a6ad76a,t,21000,7497034,,5000031,2018-01-30 13:48:55,181
0x4d5e1dda82f94d087302b426eae0c8dec351f08677c85d54d9ce1567e744184e,t,21000,7518034,,5000031,2018-01-30 13:48:55,182
0x2de6fe16c17c31e3acd9f10bb4ed944d7454967e196cf58b2d6e8acc26120d2b,t,21000,7539034,,5000031,2018-01-30 13:48:55,183
0x7ce7c6abc49f20a600bd35933dd8d2adcbd678b7578b64aa241659d53f4cbc54,t,21000,7560034,,5000031,2018-01-30 13:48:55,184
0xc36a11a4a56d069915d278161858ed80c2d07d57a4f9f6b51ffa1ca9f9c6a36f,t,21000,7581034,,5000031,2018-01-30 13:48:55,185
0x9166cb439fedea5ed46d0b5880a6de7993b483f4b050b63e28020e2c570b5ec8,t,21000,7602034,,5000031,2018-01-30 13:48:55,186
0xdefba957f42d7e78927a5e85b6145de1e8ae8125a183b9c580bedc5d1488e4a0,t,21000,7623034,,5000031,2018-01-30 13:48:55,187
0x5f5bd7c1af92b4d7a7095e85fbdf376ce75e649cec184ab657f2098879dfbf6d,t,21000,7644034,,5000031,2018-01-30 13:48:55,188
0xafe5f0ba94735a3e0a87724aedfe483a3e7b5c946456c466c07b26cea2bb678e,t,21000,7665034,,5000031,2018-01-30 13:48:55,189
0x10e60a3a2e34622f539ba8faca8b5a2124c28222b575e120c8bd6b07cf0a7712,t,21000,7686034,,5000031,2018-01-30 13:48:55,190
0x429eb81996f4ae51c2eb986fe4127e30e95090e191ca083a530bfdb418bffea9,t,21000,7707034,,5000031,2018-01-30 13:48:55,191
0x3b5318b2b17c13fb45711236065af59d3c1d8db56c301166006cddd692fc1ef4,t,21000,7728034,,5000031,2018-01-30 13:48:55,192
0x351f6e0591c3cfbb58abe0d30c5db45a4c621e48c4617803b5436efbef63ad95,t,21000,7749034,,5000031,2018-01-30 13:48:55,193
0x75a86d25291fd8805fdff99fd2b508c137c0b61b5dc358861196d131f8258ff1,t,21000,7770034,,5000031,2018-01-30 13:48:55,194
0x9926e07a0b7e55c1d8282f376b9e778bd61150ae616be419aae9c7f1ab725d81,t,21000,7791034,,5000031,2018-01-30 13:48:55,195
0x16cf0e4bb335e189335cee9614f4b272d529aef926cd24f6b43c78688e4114f3,t,21000,7812034,,5000031,2018-01-30 13:48:55,196
0x812faa5135e880ae076a5cd5080e33fce43db1e811e040aa222923e09a6e9d47,t,21000,7833034,,5000031,2018-01-30 13:48:55,197
0xb623e9a966aac69ccdd1f8f282ed514a45137b3e0d156427bc0af26351bfa506,t,21000,7854034,,5000031,2018-01-30 13:48:55,198
0xbbcf3c4fb9ac4d7521ed0164b34004481348f2a41f5e38d5b7bd1404bd183d59,t,21000,7875034,,5000031,2018-01-30 13:48:55,199
0xf6e91691a5ec2d61450135d1abf4fd36a0036d3440bae2db3223d8a9368d7694,t,21000,7896034,,5000031,2018-01-30 13:48:55,200
0xd51d5fc0f570a3f86704f01494a70e6aa4f5128f69b79f7faa05162f8e69e80f,t,21000,7917034,,5000031,2018-01-30 13:48:55,201
0xfd19927be51058343d8d9b7bd6b755c8cc8550205d6647e189537872636dfd5b,t,21000,7938034,,5000031,2018-01-30 13:48:55,202
0x09ff3e3db01b098d4158d1c6ed5a23b2e16968a8999bbc4e84db6857e51ad3ae,t,21000,7959034,,5000031,2018-01-30 13:48:55,203
0x45582b6f9d20760ef343e19ca21545454fdc3a2071ddc2883c976860d04a2174,t,21000,7980034,,5000031,2018-01-30 13:48:55,204
0x28542ae04ee09f07a699e0f91cc87bba8ff18d549d2f72b2101d941efb4f1a1b,t,21000,8001034,,5000031,2018-01-30 13:48:55,205
0x32cc8e900cdefc7f77d999df682f43e07215e7ce8ec3c8a95346f9ba18d01e6f,t,36656,36656,,5000032,2018-01-30 13:48:57,0
0x19f14410f9253123e3ff0fd601de57db310d08f91c5ee73c9a2c6a566c8637c3,t,21000,57656,,5000032,2018-01-30 13:48:57,1
0xb4a85d5d6cfa843320411c03fa1468636ea145869aa07b8058ae7ba1b232d7dc,t,103702,161358,,5000032,2018-01-30 13:48:57,2
0x618d4929ffafb6ec2b6f1f641631f2efb71e4d021247bbf6ac41408927a19abf,t,36452,197810,,5000032,2018-01-30 13:48:57,3
0x41993547f751486f61cd3f846cad21c2617ed0ae29f17b4d68485633ff69e682,t,1006378,1204188,,5000032,2018-01-30 13:48:57,4
0x396b9da0d0a0766a620f95c78823a6cd964ecd71f94827a3f94874f8f71ab92d,t,102934,1307122,,5000032,2018-01-30 13:48:57,5
0xd0c1bb7b0514509196c6ba089c70f08b86932e89072deaa12496bd0834423664,t,21000,1328122,,5000032,2018-01-30 13:48:57,6
0xbf146c3a0e60475884a16fa98826348a5cb8ac005cfcf979963c798d9f07af62,t,21000,1349122,,5000032,2018-01-30 13:48:57,7
0x51d1dc80b571606bdc99f5326f764b876e4de011531b7c39b28fef6b8d7f5a55,t,21000,1370122,,5000032,2018-01-30 13:48:57,8
0x0c64204c8a8b4da36e5a3beba1f9884609d74ace81523539fb99768b3b52009c,t,21000,1391122,,5000032,2018-01-30 13:48:57,9
0x7320642222a04fcdca02296ecae225f8b2b89f887a5741f46c1b6846e3cb0a97,t,36478,1427600,,5000032,2018-01-30 13:48:57,10
0x9787071e626bc06b05715f6572d637612dcfb3275aabe760f5b48a3cae6a1902,t,21000,1448600,,5000032,2018-01-30 13:48:57,11
0x0e3a6bf50c2893782c6f6a4f4e313d4720ac6928e32a2116d63aea76a2546ad6,t,51784,1500384,,5000032,2018-01-30 13:48:57,12
0xda1687820ddab22b84344dbe0064ab9ed754ba5aa35a7d3e8fa3c88a376e4ab6,t,21000,1521384,,5000032,2018-01-30 13:48:57,13
0x98ba6836bf6050cac88b1a009a68d80c28c7b733cc6d1bd48768ad80574b2285,t,21000,1542384,,5000032,2018-01-30 13:48:57,14
0xd60bfb3785aacdbf0d13d6fe6aac8e12bf535805a160889ff63cd9fad1e51217,t,21000,1563384,,5000032,2018-01-30 13:48:57,15
0x0c8d2ad30c54c85311372442c296ed682838882568e311b42e0461eb004db8de,t,21000,1584384,,5000032,2018-01-30 13:48:57,16
0x7f78843449a757d016426cef99956d9682ac56e289ca298d08a0884771a710ac,t,21000,1605384,,5000032,2018-01-30 13:48:57,17
0xd17b875f5a0d4cd04bbfbc835d2c4838fa4b2f5c201586a1810df672ed4d671f,t,21000,1626384,,5000032,2018-01-30 13:48:57,18
0x8e5e9cd309f3bdd47a4e738d355c26e7c10f21c01d63ef128059529254c4c0a3,t,21000,1647384,,5000032,2018-01-30 13:48:57,19
0xbcf024fa925427b2eefb2f5871a5456a93c58b3d31312d0c5e23c1ea837f83ec,t,21000,1668384,,5000032,2018-01-30 13:48:57,20
0x015d42606328f1eb21df1bc663ce9ece5c49f6f09e1fe784f6aad3004f75ba96,t,21000,1689384,,5000032,2018-01-30 13:48:57,21
0x2fe78e7a392b6bdde7487198fa0b13948dc7845e057c18aeec79900f8aafc402,t,52886,1742270,,5000032,2018-01-30 13:48:57,22
0x81a076b4184b9d63f7f198d1a6f6c095c6f6d8bdc399f24eee76fc2144e7a467,t,52886,1795156,,5000032,2018-01-30 13:48:57,23
0x1b250c3a26d9dc87633ec6d248fde427553da6b6088e6524ed0005efe0cceb0d,t,52886,1848042,,5000032,2018-01-30 13:48:57,24
0xbf0806605762067d4515c976c54c37ded9db0a0859f0ee033d61f77186bdafb8,t,52886,1900928,,5000032,2018-01-30 13:48:57,25
0xec6334ce63293098acfcf2e8ae0294dfc733a65ecebbc56a3187acd3a32b28e2,t,52886,1953814,,5000032,2018-01-30 13:48:57,26
0xb8757c64caede4e5d8ff32568632496aceaace9462cba8e8c69d2e54119835b5,t,52886,2006700,,5000032,2018-01-30 13:48:57,27
0xdb5027983cc054e9c8ec2070eb6353931039622c8ec7977276042db9c0111d51,t,52886,2059586,,5000032,2018-01-30 13:48:57,28
0x43f053338a0f9f2fcd1056e3b930a451b47c28c48bbfa7eb2a929987df60081d,t,52886,2112472,,5000032,2018-01-30 13:48:57,29
0x1b5d30dbc7870a8a01b93ab6230b14fd489f5b3bc457b583f01e8a843f0a346d,t,52886,2165358,,5000032,2018-01-30 13:48:57,30
0xabf52d919cfe1c3dc906cd8ac27c817c032e02d49e7b0b986dd9958a377e7f1f,t,52886,2218244,,5000032,2018-01-30 13:48:57,31
0xb788dce62db9dba53ff307e056888798131841e34c8fb011ef52b5bc8a748543,t,52886,2271130,,5000032,2018-01-30 13:48:57,32
0x6cc682e365b470ab4d68091e6e11c82b73eb72e5f6bc37d745ad65b2d6116b7c,t,52886,2324016,,5000032,2018-01-30 13:48:57,33
0xa125ec5804800049f7b828b319bfbf62e5eb91c91716d6d9ee3f51fbe8438596,t,52886,2376902,,5000032,2018-01-30 13:48:57,34
0xf5ab5aafbfa8d5cb10b46c1f76295c83c3b0414a93e676488cec10f862d9b4c3,t,52886,2429788,,5000032,2018-01-30 13:48:57,35
0x034c5d7081c5fb0a10db7c69645132644ed69f11fc79549fe8f7cdca7c9b6fee,t,52886,2482674,,5000032,2018-01-30 13:48:57,36
0xad52d6f6ec5db1ac5f5f37ad93c712c689599f0f8cc4c11fcdfaf2a776600d65,t,52886,2535560,,5000032,2018-01-30 13:48:57,37
0xbbac374be8c086803a686d7b31525eed0d64ebaab15c2e4ba881a66ab5b0ddb0,t,52886,2588446,,5000032,2018-01-30 13:48:57,38
0xd412b780e8950b3cf7997d351bc6efb299d986dfb586c8f12960ec39db752e82,t,52886,2641332,,5000032,2018-01-30 13:48:57,39
0xdf75860023cbcb3cca0f3628830dc9c7c1129c6fbdce3d52f99d0b50ee746b1d,t,52886,2694218,,5000032,2018-01-30 13:48:57,40
0x9f343aa54aa4e221a1bb5126cb3fbb8dc36b06dd14eb905b7e6159efe91ac2f5,t,52886,2747104,,5000032,2018-01-30 13:48:57,41
0xa23d3c507bef8edc86ebc098b359b11c6ddd81b4eca07315741e3bf89d05eadd,t,52886,2799990,,5000032,2018-01-30 13:48:57,42
0xde63b6c4e0db499221a774e3159a909506800d143300e1a9f32c82d63ec2ebd9,t,52886,2852876,,5000032,2018-01-30 13:48:57,43
0x487d8656be5056e600107469f331ada4f365c6e3cb16dd9f6af0126d38dbf5bf,t,52886,2905762,,5000032,2018-01-30 13:48:57,44
0xca131e79903d80be11f348331f279fb6a5e16226482e133910fc90b4f283ff9c,t,52886,2958648,,5000032,2018-01-30 13:48:57,45
0x0d1b4b225fdef3ec0f4fe876e20c9e064474873de6bbdbe4f40ae1add146aab1,t,52886,3011534,,5000032,2018-01-30 13:48:57,46
0x96a03a99e2a35ec1792818d7167e1dc6d5dad9c41125d1e683270108822297b6,t,52886,3064420,,5000032,2018-01-30 13:48:57,47
0x395321d39b7bf595cb826b57735eec4d78d10d957821a067fe2869319c138ebe,t,52886,3117306,,5000032,2018-01-30 13:48:57,48
0xff6a6cda71a0bba39e81c5815691b3ce13bf8f1042ea167b585aad45bf79f90f,t,52886,3170192,,5000032,2018-01-30 13:48:57,49
0x04eca2eb0c472ec48b8aba6b04276cd38145fe9cd012296ded292471dddaf523,t,52886,3223078,,5000032,2018-01-30 13:48:57,50
0x936992513bcd4a806a4b150b9b7aea9b888b08bfbef56d3b759d6c8f68b0604d,t,52886,3275964,,5000032,2018-01-30 13:48:57,51
0x10904f75786583f58375a7af8555ef426f9033b66aa7f9fde04ad089cbc2b4a9,t,52886,3328850,,5000032,2018-01-30 13:48:57,52
0x83cdeee120d69329ccc9b1e7a5a34dcedfbf580d6b7544fab2f6dbba36ecc52e,t,52886,3381736,,5000032,2018-01-30 13:48:57,53
0x704db2b8b5c9d068736b227cd61ce0a91bfe6eaa98acafdffeb3360c6677328e,t,52886,3434622,,5000032,2018-01-30 13:48:57,54
0xf4fed46d23d4e3acffd2625fef4534d427c410346361a42a184e17a733a4e4cf,t,52886,3487508,,5000032,2018-01-30 13:48:57,55
0x15059fd00b564d7e9ef3c901bc7d180bcb7bf689a4e5d5a309332171c1f045ad,t,52886,3540394,,5000032,2018-01-30 13:48:57,56
0x40a882d9f2ec470bf3e9da6dc13cc4a3bab7523522c580ef5b1fcf92cd97280d,t,52886,3593280,,5000032,2018-01-30 13:48:57,57
0x28969e956d3e71745390dc1a2508331b396d83a7b2b052882b532e9b3a1e2882,t,52886,3646166,,5000032,2018-01-30 13:48:57,58
0x3c0a7335ea81965a41e860db3c0b67465935b8c8eec1dc49f8cefb7b8d192100,t,52886,3699052,,5000032,2018-01-30 13:48:57,59
0x7ea1138d62350f5838d3a1cd34c73b552f3bdaee8c1ee1c02195f8e6a2ad8998,t,52886,3751938,,5000032,2018-01-30 13:48:57,60
0x9b53967e8f04a9f58a0ba762b2a817af517d6121384d4d0bfb51aa7f3514fa0a,t,52886,3804824,,5000032,2018-01-30 13:48:57,61
0x4a06336c09d2629b5e6fe31958ec5730fec316fc53358e8c7db688e3c33cce12,t,52886,3857710,,5000032,2018-01-30 13:48:57,62
0x0f0152a900eb66350c4980a3d9a60b05a9f8f1ac01236655dc818964027bb444,t,52886,3910596,,5000032,2018-01-30 13:48:57,63
0x2fd0d13aaa033e42bbe9189618aa4e54e5685b504e8742670d31322b8ecf1aa9,t,52886,3963482,,5000032,2018-01-30 13:48:57,64
0x373015dbf2cf82aed9ee5419455417393aee635b153fa939b572c7443f8721fa,t,52886,4016368,,5000032,2018-01-30 13:48:57,65
0x82c00aecd80fc92f7cb0b95c22d15ec9ae79457bc3cacea49254e0b62ed2c06c,t,52886,4069254,,5000032,2018-01-30 13:48:57,66
0x7d59ee99fffde4bf771f286d2670011e1fa46bada8761d6615cfbedeeed4bcd9,t,52886,4122140,,5000032,2018-01-30 13:48:57,67
0x4b8ac12df23cd7755c6e7df418f2d00b6ccfd9cd14d40b1e331f8acada789e7b,t,52886,4175026,,5000032,2018-01-30 13:48:57,68
0x4b6d153135dd518df432c009ad368bc3a0f896746d2e3b2293985be2a29e67e8,t,37886,4212912,,5000032,2018-01-30 13:48:57,69
0x6797614407ae4ff3e56a6651be0f9ea23f465caa68d2cee8eb3b4cbc46d6ba97,t,52886,4265798,,5000032,2018-01-30 13:48:57,70
0xd8d29c56f140ed86ceb4479bb9320acffc4dbd5ccb995b5747059e2c9a31edf3,t,52822,4318620,,5000032,2018-01-30 13:48:57,71
0xdabdcfd5749841489b2548628df7c36331c80b78d935bc5ec928bf288bd6cf34,t,52886,4371506,,5000032,2018-01-30 13:48:57,72
0xea4666939e95ae6faf4f69b34a122de18778a77bb1f3e46de4b2d57158728b3a,t,52886,4424392,,5000032,2018-01-30 13:48:57,73
0x7d7429e7d2b22d5444716306a2bafed47c5c9c6b1910784a311105e477f27f46,t,52886,4477278,,5000032,2018-01-30 13:48:57,74
0x9e6f5b2919bfd0864d257f6e1845aae7efa8a4c898a7b507f9bd8edd30705fea,t,52886,4530164,,5000032,2018-01-30 13:48:57,75
0x9983d3111291c255d7ba0f6ac3e7bb3fc49c37d71f21c73571e9108f1782a299,t,52886,4583050,,5000032,2018-01-30 13:48:57,76
0x8a0888814d3102b3879f0e1db51ba1ebaacaf3ba13f80628734d91bafc95586e,t,52822,4635872,,5000032,2018-01-30 13:48:57,77
0xb73c11b8b37d6ddf9250ab619e6d2800d88c2214bac22ce79b067e751c3749f1,t,52886,4688758,,5000032,2018-01-30 13:48:57,78
0x3eb090a1a7ed9004ed5525eb1a6efc0b502e786d1a0b2eb476652ba5ea201bb6,t,52886,4741644,,5000032,2018-01-30 13:48:57,79
0x3f164d4de00177bf2dfe78ac8945f5cd5fa0f7267a6315474be557735e4a31e7,t,52886,4794530,,5000032,2018-01-30 13:48:57,80
0xd0bbca009a7702bde5763d47f87b011e23795c2cff45c63caa0dbab5d4fa9d69,t,52886,4847416,,5000032,2018-01-30 13:48:57,81
0xb8fc3227121bf88f4c2465778e48646417a7f7b3bef17db3d9b9c48414d5a07e,t,52886,4900302,,5000032,2018-01-30 13:48:57,82
0x3ab2522eab2987690cd964665055059bfc9c3aac469e2ec811521d8ab8630d1f,t,52886,4953188,,5000032,2018-01-30 13:48:57,83
0x4a90d95c72c4f097e0c80d62ffbd4a68f864431bb07015bb911e255945b87427,t,52886,5006074,,5000032,2018-01-30 13:48:57,84
0x2a1a771d1a29aa8fd3030cc73cab39bbe250f6a19067640fe677c821522999cf,t,52886,5058960,,5000032,2018-01-30 13:48:57,85
0x51473998a8da7b149b61508d6979710b3a11c95d3b2f662033563430722c33af,t,52886,5111846,,5000032,2018-01-30 13:48:57,86
0xf6282b07680ee354de422955e62d362bf51905b5d54e8c988c2d7cca1eeb2adb,t,52886,5164732,,5000032,2018-01-30 13:48:57,87
0x00100f4ebc51b78621c9f6430f5f16c04e57d39f9b2d7efe8d243101c2cd2503,t,52886,5217618,,5000032,2018-01-30 13:48:57,88
0x328d61a8e54ebf23fddd2d9b3f3399526959970bbe77f4297b190abafaf2e71a,t,52886,5270504,,5000032,2018-01-30 13:48:57,89
0xc4b16e133cdb5a4e17eb07e65f0bf09761d5ae16124c7617b024bef6de589a09,t,52886,5323390,,5000032,2018-01-30 13:48:57,90
0x8c860491b8c9e81b09823a02020c9953138ef7920dd4b0731ac9067d0711c1a8,t,52886,5376276,,5000032,2018-01-30 13:48:57,91
0x0334770d3151537fa2169e9da2fc0ecb394df92f4e8d64d26060b5c2624d0a3a,t,52886,5429162,,5000032,2018-01-30 13:48:57,92
0x925d127e868da6d924ed54d5d7f65ae2ee5d475dcff725a1c72fbac4742bd81d,t,52886,5482048,,5000032,2018-01-30 13:48:57,93
0xf8b31a97ac23d3ff87fcdacf3cec42d19b99e3ad77a20f29fa675e70d371a17a,t,52886,5534934,,5000032,2018-01-30 13:48:57,94
0x631eda50a5714df9e40e894432873bec5117f2d1625289d3e284a10d252c1c6d,t,52886,5587820,,5000032,2018-01-30 13:48:57,95
0x83a0c50b5bd4d2d0cf36a5848591adf9cf8c4567a9fdc6afa295a970a7f7879f,t,52886,5640706,,5000032,2018-01-30 13:48:57,96
0x6246eb923a420d770cfb369bbffe28630088040b685be5d151441ff048ab1ef7,t,52886,5693592,,5000032,2018-01-30 13:48:57,97
0x935a550758a798378f652fbef7dda932962134dc96e742ae6e7170c91fcac2d9,t,52886,5746478,,5000032,2018-01-30 13:48:57,98
0x6c175a53a76d8ed4acf81c000e5ee1dbec7efd50c2b440438d031fb72be196cd,t,52822,5799300,,5000032,2018-01-30 13:48:57,99
0x0a484c4a8063253ad913eb9e5db786adfd7c731a36fbd7e0ab0d4268f3bf9ca9,t,52886,5852186,,5000032,2018-01-30 13:48:57,100
0xfad90a1423f94d766c8f1fcbacd61c55b0122c0ee1e07d548c4b77bc5b7926bb,t,52886,5905072,,5000032,2018-01-30 13:48:57,101
0x34ab885b1cdb19d129fa92bfb91a299c6bb31b08800887eb3d335a7a9ab9ba48,t,52886,5957958,,5000032,2018-01-30 13:48:57,102
0x99d937fff5de2e1b14de3e5bac4c9f7cb03b18093726518bc8f01761ab4e4cf1,t,52822,6010780,,5000032,2018-01-30 13:48:57,103
0x3a498362865cdb18c8d09bf690debfa1476562e54b5ce45eb5dbf97956edc591,t,52886,6063666,,5000032,2018-01-30 13:48:57,104
0x6fe72dcf74ce0464783a194f1fd6199b44adc8246d1ca410bd9d2ec1d46fbe6d,t,52886,6116552,,5000032,2018-01-30 13:48:57,105
0xf36e7c9850885a82928b149fef8532896cadf7b8ba6089c08bd5aba5e07450ae,t,52886,6169438,,5000032,2018-01-30 13:48:57,106
0x05e7a22f8e9fe8490c563f88248170eacded91741700c6569e445c5f00a02131,t,52886,6222324,,5000032,2018-01-30 13:48:57,107
0x9b809c563e31627d7c09074082ff23dbe4a118eca273304fb967bce0c1436b45,t,37886,6260210,,5000032,2018-01-30 13:48:57,108
0x2ba54f540ebec4b23960504fd4afe9a485e249d361285034f7491e2d4d18d56b,t,52886,6313096,,5000032,2018-01-30 13:48:57,109
0x50b361b7d3206bfe713fb246717b6c932f4b9c5796b2ff7ef16b910c2273f5ab,t,52886,6365982,,5000032,2018-01-30 13:48:57,110
0x23c711c26818c8ffada394ca801598fe3ebb683b25785364c38085b2004ea5d2,t,52886,6418868,,5000032,2018-01-30 13:48:57,111
0xec120ca65db3171a8d81fa82a80d2e3be2b7dbcf4cf620fca25915f0f068c2b6,t,52886,6471754,,5000032,2018-01-30 13:48:57,112
0xee1414eed688faa09bc6674670ab419f40528f9f6c955b82ba1ee4cba3871006,t,52886,6524640,,5000032,2018-01-30 13:48:57,113
0x3e3ea3b403380a9062110a17994a15fe85237625a57720c96cfea37d598065b7,t,52886,6577526,,5000032,2018-01-30 13:48:57,114
0xd12af34691443d7bf96ec7c4b5971ff5db759ff0c187fc9454104e699a0f49a2,t,52886,6630412,,5000032,2018-01-30 13:48:57,115
0x139f6154df65a3f4a7980155bbe450b74eb0d41544c325abee73982607c3896d,t,52886,6683298,,5000032,2018-01-30 13:48:57,116
0x05840c068e6a834257125d2d8f54a7c4866e4a58063bbbd92abaa8c3e2bd19ee,t,52886,6736184,,5000032,2018-01-30 13:48:57,117
0x9a76f6fdad35b3ce41500c6ada4caae3c3017cc52a37d1008c16951851d08993,t,52886,6789070,,5000032,2018-01-30 13:48:57,118
0x012e025a491214599a4a7fabb6370b275c9aa6709a2be33c2ee8d64369b1016a,t,52886,6841956,,5000032,2018-01-30 13:48:57,119
0xcb4b733342cbc1a4d34b8e40910844d734f2826ee20d1710116db20ca48f7a28,t,37886,6879842,,5000032,2018-01-30 13:48:57,120
0x03a064e4f2f4a634013940cdc1828d1b808a20b7e5cee89a0f491b9101b8494a,t,52886,6932728,,5000032,2018-01-30 13:48:57,121
0xa08138110d7dff77d560f2eb6fd6d458649e4d042d211c14b9a915cd73ab1593,t,52886,6985614,,5000032,2018-01-30 13:48:57,122
0xb10ab04cd6cfaaf8b7a6dd6211df6db52e700f3565bc1b358aa2c06990a49661,t,52886,7038500,,5000032,2018-01-30 13:48:57,123
0x44b8451f30415311c5cbe65b96128a22855f43b81cd7f10685c8d475af5455b4,t,52886,7091386,,5000032,2018-01-30 13:48:57,124
0x6fa95643877f1fe8205914f06e3e10614de3348855317cd2912ce13b19b7b6bb,t,52886,7144272,,5000032,2018-01-30 13:48:57,125
0x39778282e0fabef043907ce783fe31633c73c5af55daf2367fd67c91ec7ae458,t,52886,7197158,,5000032,2018-01-30 13:48:57,126
0x0559a49b1ee4e1293f362c3a1124747c0ea652fd4bdcb78048d28ac18f2dae75,t,52886,7250044,,5000032,2018-01-30 13:48:57,127
0xf3fbbca64f7fb5bd35817b129a029f1dd5584da44f5436982ceb0cb83806851c,t,52886,7302930,,5000032,2018-01-30 13:48:57,128
0x56ffcfc352bbf0c4bcb49b00a7d4b3a61f86212ca5ddc78eadb6f9e17b246979,t,52886,7355816,,5000032,2018-01-30 13:48:57,129
0x9b25d3495ee119952be92978259b427e923eb160cc7aa609e9d03cec4d5b9837,t,52886,7408702,,5000032,2018-01-30 13:48:57,130
0xae7dc33b3cc203341678f292e9bdd0feb8463a8db95040e108581338c4631b5f,t,52886,7461588,,5000032,2018-01-30 13:48:57,131
0x9a136aff53e1e9e7afe03de46220970c7c238dceba53ed49489531c76ac65584,t,52886,7514474,,5000032,2018-01-30 13:48:57,132
0x3c8be3214c8907cc8047d51022ab71c37431b7b5425c0867d3e96da67882443b,t,52886,7567360,,5000032,2018-01-30 13:48:57,133
0x6552f0670122e78bbfb94dca4f1f139baeb12922c4db6e235e9a15c2184479c6,t,52886,7620246,,5000032,2018-01-30 13:48:57,134
0x878f3f62234af7504fa26452f983111858a0725e52dd86776aec5e35ff92e3bf,t,52886,7673132,,5000032,2018-01-30 13:48:57,135
0x5ad86725f84bb1d857fa0b459f08a11bf2a7b665580825758ff696ea87d2a1d2,t,52886,7726018,,5000032,2018-01-30 13:48:57,136
0xb53ea4bbc30ee13cb79f349587e8a47e3a8e001c1b98f0500a7abd7f980a364c,t,52822,7778840,,5000032,2018-01-30 13:48:57,137
0x1d80f8ab6cccaa6a540e552760fd1d828dd3619499d578b067f8540f2493ae8f,t,52886,7831726,,5000032,2018-01-30 13:48:57,138
0x71d308675b6e3d7225276695d23b1e95bea227334f4ec21d59b897d427a30ce6,t,52886,7884612,,5000032,2018-01-30 13:48:57,139
0x09b2e369b14207da29a3f1b42a78d97b542127a66475db434be958a9e39b966b,t,52886,7937498,,5000032,2018-01-30 13:48:57,140
0xd0c9acf10ef370532a12bfd1285c1d1e97a5fc8e3786dd32e87cc0bc4a91b7a1,t,21000,7958498,,5000032,2018-01-30 13:48:57,141
0xfe8b31bd2f1c67ca39f0149ff46c4d5ed3e238b395e322d9c5acd8c4bee48e26,t,21000,7979498,,5000032,2018-01-30 13:48:57,142
0x96c12cd087ad8729a1138920a792bbce52f62df09d3436e8f653594530bedb90,t,21000,8000498,,5000032,2018-01-30 13:48:57,143
0xeef20a6f380176d742f94763128cc7fa60ec13c1b0584cd5228272ad77a88b11,t,21000,21000,,5000033,2018-01-30 13:49:02,0
0x74e5a83b846183627b9bad607a30e079ff536e6feb61290f39f54fff6e980c8a,t,21000,42000,,5000033,2018-01-30 13:49:02,1
0x0b9b0ee6b5663ba7aa35f45372276ea8543f4ffc369f6cf2908680733e835f29,t,21000,63000,,5000033,2018-01-30 13:49:02,2
0x681ee0718fd392d04ae1cf8a342f958d85763f4fcf7d896134cb8f6b1af6a27f,t,140972,203972,,5000033,2018-01-30 13:49:02,3
0x20e8e84fcd419e1f76e3f2a2dd6e575704bda495da6e558ec12f6ff8d2c09ddd,t,67819,271791,,5000033,2018-01-30 13:49:02,4
0xe8a99a8a98712cbd6c7fa1167cc76e7a16e5d4d75b39b07ad3f43a8239f87463,t,37886,309677,,5000033,2018-01-30 13:49:02,5
0x76b5c7e48a3b070a8e325bad0726e0f31fc85e6c7b736f4e570ed3e46ec04b8f,t,21000,330677,,5000033,2018-01-30 13:49:02,6
0x04bcf098b696e88ea6dc85f9f053b96ab2ca7e30aa155c6d55e788419136a035,f,30000,360677,,5000033,2018-01-30 13:49:02,7
0x7469b729d81a51bfada3a9a63539cedb8f8bd45be20569f2267497e92a94ca60,t,52158,412835,,5000033,2018-01-30 13:49:02,8
0x622994f48f7d780cc5cfc9632ed7d7ed5462f5adabc967a5b90df06e3e1239ff,t,21000,433835,,5000033,2018-01-30 13:49:02,9
0xb9c2b1ead05996de2f56c4e2aaf4174222da001fbbd19d702a47b6be95c75f50,t,21000,454835,,5000033,2018-01-30 13:49:02,10
0x7feb8df8bb63dfff9ba0bc93980822c2c7e367cca93b721f25218e0ce7687619,t,21000,475835,,5000033,2018-01-30 13:49:02,11
0xd65f775fe7f56524bcbec89457757d5d92ebff4c580e1fb268b24a1946858c53,t,21000,496835,,5000033,2018-01-30 13:49:02,12
0xa68f493ccdd8e08714d064801eb86ac160e8075c440e6a47ab2f1616ac747ff1,t,21000,517835,,5000033,2018-01-30 13:49:02,13
0x4bbdc4d116fb9a5c2a2c30ca3e2bebafe9e95ad7ae0dd03b6932c91831fd8b42,t,21000,538835,,5000033,2018-01-30 13:49:02,14
0xbb3327b9be4e90312004e5f18b39cec22c3cee97bb971d7a2fad5901847e7792,t,21000,559835,,5000033,2018-01-30 13:49:02,15
0xb6bff57c905034d941753dd6cf581dd5bae3b71acf8e4c77f55654e766d28ade,t,21000,580835,,5000033,2018-01-30 13:49:02,16
0x57e98796aa3be208650a5562682325d5c6101a16d3aafd9fdefc684a793fb1e0,t,21000,601835,,5000033,2018-01-30 13:49:02,17
0x59d2342cc251012ea15c58478ce563607218e70d8bec4883d52fb5d2f6de49ca,t,21000,622835,,5000033,2018-01-30 13:49:02,18
0x6b0b81a82cbe43175b70242e714b6d4af0af0767a8115eacd9d466f3d20297be,t,52237,675072,,5000033,2018-01-30 13:49:02,19
0x7a803a7f6ef75f34c66b4a347e4e1a5c418a92b92e5668e24e5927070f99ce0d,t,21000,696072,,5000033,2018-01-30 13:49:02,20
0x6df508d1eb1642cee0cceed05a05aa66b35614d6f1bd27620c39d25b5234a847,t,21000,717072,,5000033,2018-01-30 13:49:02,21
0x325e69c07595b6b29594833ce2bef32f23bce6eff3a8bc23e8bc9720b5d80e4b,t,21000,738072,,5000033,2018-01-30 13:49:02,22
0x9e98ef84c9adae8b39335f623016b28e29b62138a2caf0bbeb280ddfa4b1a46a,t,21000,759072,,5000033,2018-01-30 13:49:02,23
0x598b2a826e55018ba7d61d27b4502170a114aead660e371992e1535b53569037,t,21000,780072,,5000033,2018-01-30 13:49:02,24
0x82909209efd5ca9c5b33817756b46879a0af10fec4390ca3d3bb8ff0609737a2,t,21000,801072,,5000033,2018-01-30 13:49:02,25
0x08dff77d435f2c354c5f32cba00a791e40fdc14e3bcde68a16dca636dfcc56d7,t,21000,822072,,5000033,2018-01-30 13:49:02,26
0x71fe34ccd902235132290e97b439dca79711cf60c9bdec81c1f4ac4b57d39f0b,t,21000,843072,,5000033,2018-01-30 13:49:02,27
0x19d64ed3ff971f02bcc145dfdb1576c963ed2c148723c19516d630dff38cfaee,t,21000,864072,,5000033,2018-01-30 13:49:02,28
0x982b9f849c80275d7423424326b1ef8ead41eeea35a54da97b05a398cec86679,t,21000,885072,,5000033,2018-01-30 13:49:02,29
0x1a10f5fce8e3fe2cc52750b93187fee06ac8d3a58976ebf77bb2e64c92b65305,t,76670,961742,,5000033,2018-01-30 13:49:02,30
0xdfb13731b4dab3f5b48c5194228d985c8e1460ea12a966bb25d5ffd61fef8365,t,21000,982742,,5000033,2018-01-30 13:49:02,31
0x0c82a74c8b1aa023884fc6d697596ef078407350e2f1e9f617f1ee7481521184,t,21000,1003742,,5000033,2018-01-30 13:49:02,32
0xcdc6a9b6a60553911d739d0f4b6d97edaec92e0e1e6f17dd88d4f0b98a69d01e,t,21000,1024742,,5000033,2018-01-30 13:49:02,33
0xdf4097a54131e94b3ba5199a7958221c9de4ca33f216b04335fa052f7a620064,t,30327,1055069,,5000033,2018-01-30 13:49:02,34
0x04fdaad7aae906b4822cd175248c492be673cc01536eb3faeab778d6092b07c3,t,21000,1076069,,5000033,2018-01-30 13:49:02,35
0x44a740401cbc2899057adbd728642cfd4c49b75cd168b24aa6b55a74871244e5,t,21000,1097069,,5000033,2018-01-30 13:49:02,36
0x62f53a5af7e3fa40edbe65c865b2fef218ea2b781982f2723f2c9ff8a44891e3,t,21000,1118069,,5000033,2018-01-30 13:49:02,37
0x560861fc4787e7c37f4cb5fb2aff3a395b4535cc378e1ae0491de408245697a6,t,21000,1139069,,5000033,2018-01-30 13:49:02,38
0x43ea36ff2d93f82af6040994440302e8a34a1ff98127452667cd253755fadd7b,t,22173,1161242,,5000033,2018-01-30 13:49:02,39
0xff549947b94aff0b130bbb2328365d6e4c94a99e16cbd07e505449a625f18662,t,21000,1182242,,5000033,2018-01-30 13:49:02,40
0x9bcd254daa628ae3b171ec23278152572a7ad6fc7807f4901988d5d7c2e78f70,t,21000,1203242,,5000033,2018-01-30 13:49:02,41
0xb4c0a6d547680cfd511510378fe4a3146b58622bf6e21a16347ae18707fb2abf,t,21000,1224242,,5000033,2018-01-30 13:49:02,42
0x07adc8fffb747e5dde4021a37877b08f586382d3962b208f1cda5e54e4b800cf,t,21000,1245242,,5000033,2018-01-30 13:49:02,43
0x0b7fab3cea43fbc17215ac992480bb1fe32656d1a3194071a03f199aa539dcf9,t,21000,1266242,,5000033,2018-01-30 13:49:02,44
0x07c0bf6cb7425536cb5158b83df03b11426cc6920602a02e78c14f40baaa64c3,t,21000,1287242,,5000033,2018-01-30 13:49:02,45
0xa4e3ff91839f7ca3395b4663b34766ae64371431f23b27cdbb5e15790b1cd062,t,21000,1308242,,5000033,2018-01-30 13:49:02,46
0x727bedc9c0015678979ac49a51bde56e4635e982134d93156de262021edf34e8,t,52170,1360412,,5000033,2018-01-30 13:49:02,47
0x108d422a5fdc3429dcf67fce01a54ef5757adb9d69b8fa39f54ea5cee71c72e2,t,21000,1381412,,5000033,2018-01-30 13:49:02,48
0x4fa59f596805a0710152864fcdda7f49d868979e24d2ed4c8e88f643843f8a8e,t,67605,1449017,,5000033,2018-01-30 13:49:02,49
0x90e15d04d6adaa42283e6df4def029e7f11706e0c0d5df6e621358256597d8f1,t,67597,1516614,,5000033,2018-01-30 13:49:02,50
0x1260109b96bad79a81448a9d442a542ec2ff0d9ef24bb5061e193b2dbf966428,t,21000,1537614,,5000033,2018-01-30 13:49:02,51
0xd9c41f1191341af268fc0916850d98f4a39b1a407d143e4745821fef8249c211,t,21000,1558614,,5000033,2018-01-30 13:49:02,52
0xc98f5072373be202352fc2a68b20ea70cabda529b6df1412637bbadf02a1a5df,t,21000,1579614,,5000033,2018-01-30 13:49:02,53
0x3000493621acc696485062d11f5c447970da6992a95ea247548ba3ab4796d182,t,21000,1600614,,5000033,2018-01-30 13:49:02,54
0xc06425499b76ad36e8b29a4e8f1404b74157da92138281b3a632c6631b997ee1,t,21000,1621614,,5000033,2018-01-30 13:49:02,55
0xcc1869f4669975226d4872111a5f7681d5852d1bc868d654522b8f1e2f37f563,t,21000,1642614,,5000033,2018-01-30 13:49:02,56
0x7a6ac34cd23fa66e617d25bbdbc8f4467055420a9cdf89cb176775dd3d419827,t,21000,1663614,,5000033,2018-01-30 13:49:02,57
0x9d351c78ea214e535cd6434706922560c03ef56ce35390fcac571325dd9231e8,t,26122,1689736,,5000033,2018-01-30 13:49:02,58
0x779f44093c05f6c28120c7f9ff82bf928a4f4545932640772e4cb4c50c8f2725,t,21000,1710736,,5000033,2018-01-30 13:49:02,59
0xbc9ae485c2b5df6dd0094e7cf0acbfa7e28d3f0a15bac96983a3204c7e644fa4,f,50000,1760736,,5000033,2018-01-30 13:49:02,60
0x9675d884946996d006b65137abfcf0d0cee98e3442e9add4208d751922a7369c,t,21000,1781736,,5000033,2018-01-30 13:49:02,61
0xfe5b0c15c5ad3b5909c6fcbca2230cf82a8fa3f0d55e6a624e8cf0d77cb466fc,t,21000,1802736,,5000033,2018-01-30 13:49:02,62
0x8f4bb23ac930a0f05595ca3f279d1baeb50e3a648d757c4835a4121f375d913c,t,21000,1823736,,5000033,2018-01-30 13:49:02,63
0x0cd54c1028c27dd313b1a47924ff2157b31b5f347e1866240bc7ec111f20daa2,t,21000,1844736,,5000033,2018-01-30 13:49:02,64
0x55e0f3a8911497b4f3042d41eb8f760142d75ef677fb8ae8e4f8b2c1a0a61d84,t,52222,1896958,,5000033,2018-01-30 13:49:02,65
0xbfdeaca90a687510c64716bcee302aea123e65c4cb8f6c3288c841e5c51146f7,t,53803,1950761,,5000033,2018-01-30 13:49:02,66
0x6ac873f026255c5043a7b890a3ea3d895a05e924313fe8b49df0c91eb53e0a62,t,21000,1971761,,5000033,2018-01-30 13:49:02,67
0xc6be5c8a14f49dc0ff879abe4d145f4a3d89e6bd4cff141c2c49dde4322adb7f,t,21000,1992761,,5000033,2018-01-30 13:49:02,68
0xe2bb7d7695c9acf14faef53fb25076153d69b3d7534e89132f8706aee5b8fa50,t,21000,2013761,,5000033,2018-01-30 13:49:02,69
0x8775daef5a7841fa5d610fdc1cd26be591547bc75aadcb16a8f489e12ef97beb,t,21000,2034761,,5000033,2018-01-30 13:49:02,70
0x4538dd15c4fa9313f940d11467a2343eb5355515cc69a0512c9f41f1718fd9a3,t,21000,2055761,,5000033,2018-01-30 13:49:02,71
0xe42638de8bb9131c888159bcb9864717ca4363666b2e40302fd31b4ce72a3eee,t,21000,2076761,,5000033,2018-01-30 13:49:02,72
0x4b0fab0a6dcb53dd0b89152a4df71e6f7febc136e8db8c67d8ce988612c67eb8,t,21000,2097761,,5000033,2018-01-30 13:49:02,73
0x9cd6c34e5799aa47a7d367598c13fbd38082348eb4c0b1e3d3850fbc2c48c372,t,21000,2118761,,5000033,2018-01-30 13:49:02,74
0x136c6e3286ddd584b3371a26dbdaa324cf7130cfc6da745024f24c6a5497a947,t,21000,2139761,,5000033,2018-01-30 13:49:02,75
0xde2b0d66177660fe95d716c4967a91adbd453a3c498411afaa261e85bc2be818,t,21000,2160761,,5000033,2018-01-30 13:49:02,76
0xf656240300c27eec8e5622311e0162ab577d63cd661305cb4b5b0a3f1d1df0a5,t,21000,2181761,,5000033,2018-01-30 13:49:02,77
0xa95697afc208d0d6b0ce5785a02d3d523424f83ef7d6ec5d011184682ed37829,t,21000,2202761,,5000033,2018-01-30 13:49:02,78
0x0a468a39b16438ea0da177ef4e86cb7280467fe92f81b05c0b6462142f99f223,t,21000,2223761,,5000033,2018-01-30 13:49:02,79
0x56e8993a9a16598d744b290e5f494872d6db192edb9fdc519090e95ad567dd98,t,21000,2244761,,5000033,2018-01-30 13:49:02,80
0xd038a1fd80a7a37ca9b899c12ed54f7c4288472f7768114064c89cc5f54883fc,t,21000,2265761,,5000033,2018-01-30 13:49:02,81
0xd8fe9f1222162e57ff1d38e3ca16b1caf249c2d9da28c94fe5eb93635d6e2a0c,t,21000,2286761,,5000033,2018-01-30 13:49:02,82
0x5f5feccce67038d6659b2f6e4765b72ebb2cac3f7056662bea39f1ada1fa9af2,t,21000,2307761,,5000033,2018-01-30 13:49:02,83
0xacf9c1a5415ae83172c7c0f849b38a6461427678a8ed29db31128b777e52e4e4,t,21000,2328761,,5000033,2018-01-30 13:49:02,84
0xe9e514f7d4974bfa3cba60c348844a856787fefce43edc27e569a13f8f503586,t,21000,2349761,,5000033,2018-01-30 13:49:02,85
0x718b4c0665cb47f5d9951c5ac748c41f7bbf1740b4adc5a7ece3d28c8d85be85,t,21000,2370761,,5000033,2018-01-30 13:49:02,86
0xdce9803df3aa93a1ca2302d797d489085edbf740354b709b23e02b80a9ad9d94,t,21000,2391761,,5000033,2018-01-30 13:49:02,87
0x1819416f57fb6d3397c46801709ccc9e5e9d4c986d748a7d4cd8c85b50a77dd9,t,21000,2412761,,5000033,2018-01-30 13:49:02,88
0x316027dd6ff50ec0b761566944a6e13267d5ab8e283972fb29c0e9ef05d91fc1,t,21000,2433761,,5000033,2018-01-30 13:49:02,89
0xa9e465178e228bf1b89e642bd49bace168bc369756f8506af3576cab1a8d87f7,t,21000,2454761,,5000033,2018-01-30 13:49:02,90
0x775ec7d5e2f7b54d434c3d272ee9399360ce70235a22a3ee2adc02311ce57d17,t,21000,2475761,,5000033,2018-01-30 13:49:02,91
0x6e1749a1775dde1347f173aaaee6f596cb26b53768466bd2103a7c76e1a1c0dd,t,21000,2496761,,5000033,2018-01-30 13:49:02,92
0x2a856af187a30c709a05fe057deca75ae4f065c7b11cf82ba8bca9fb08620ac5,t,21000,2517761,,5000033,2018-01-30 13:49:02,93
0x16112148020a2c7b71232f61ac58455840c044f9a5520a04615d514a9052eb93,t,21000,2538761,,5000033,2018-01-30 13:49:02,94
0xe6f37f125d45d4181bf9fd486cd8ca5c940327ad437f62dc17b1fe114e8fbceb,t,21000,2559761,,5000033,2018-01-30 13:49:02,95
0xefce2912c5bd3182dec67f34abc4898e685140d59c34cea5fdaf36fe54d83ea6,t,52010,2611771,,5000033,2018-01-30 13:49:02,96
0xc4dbf172215160becb925242d21262c11f5522747316ea588e62e715965c6a92,t,21000,2632771,,5000033,2018-01-30 13:49:02,97
0xc95344e238ad2d417bf2779acfaa7a0a994860bd6d565d8aa9c369baf8b5f6f7,t,21000,2653771,,5000033,2018-01-30 13:49:02,98
0xe42820d1a4053a87ebae5f0a3003d72c57e0f90952a43e75377b8fe2ce32e349,t,21000,2674771,,5000033,2018-01-30 13:49:02,99
0xd7bf00b0c27e6d507a666d9595ded8841a0abe66e23cdda733b273e8901611af,t,25907,2700678,,5000033,2018-01-30 13:49:02,100
0xf4054495ab5e31b2153f53ec25925ad94b6ffd613738fb1e93f81176862e6f3e,t,21000,2721678,,5000033,2018-01-30 13:49:02,101
0x5b265f1dbfd5438efcc6da051dbad5ed12ef2e112e3b1ce1965ffd20c7c09223,t,21000,2742678,,5000033,2018-01-30 13:49:02,102
0xffb49ab84298283100a05b4f7ab7527e03b36a7a88221a7982f0221a1e6185a6,t,21000,2763678,,5000033,2018-01-30 13:49:02,103
0x33843b214ea0a993f47a763b7fe5ecf548eb000c0697ef1e8aae8be10f04177a,t,21000,2784678,,5000033,2018-01-30 13:49:02,104
0x9dd5243d72080f505dba8a06c4258d229bd5747d57546c5ff17fb37ce54a619c,t,21000,2805678,,5000033,2018-01-30 13:49:02,105
0x0c48f412c6fcfd160f389eab7dbe77a1c655535523e490209b6f2f5c6d083920,t,21000,2826678,,5000033,2018-01-30 13:49:02,106
0xcf898c96605b4b7f0bb0548dd75982c20439062f9a69738020b0d0ab47752412,t,21000,2847678,,5000033,2018-01-30 13:49:02,107
0xb6167bf590ca184b3b31c7b4efe325d8d31803a6d3f52c1513a1192caf4518d1,t,21000,2868678,,5000033,2018-01-30 13:49:02,108
0xa263a20a2f8cb0e41a85026590f01b3f50d66388e8a4981d6114a11f81632075,t,21000,2889678,,5000033,2018-01-30 13:49:02,109
0xf153da3767d3f572de6a3a2f2a1e8842fde0ad58d495fcf8d5b073b5494b3b7a,t,21000,2910678,,5000033,2018-01-30 13:49:02,110
0x90c0aa08d303dd28db668733eb53d93908aeaa06f0b69b30a264972f56edf1c8,t,21000,2931678,,5000033,2018-01-30 13:49:02,111
0x8bed4295a3205df7b215f4962a68aea2f332ae17caac52642265de7f4e03fa6b,t,21000,2952678,,5000033,2018-01-30 13:49:02,112
0x1312183a1d30315c0cc804ecf88ca1234a854f7e7f334378ada85b6bd6cab566,t,21000,2973678,,5000033,2018-01-30 13:49:02,113
0x99de10e3ff9af18958fad90031b9434da573c063c0a810f49442b3533613ff37,t,21000,2994678,,5000033,2018-01-30 13:49:02,114
0x251a4a76c6e062a6862ea59383d6f190d5b470e27efe3b4097ca67155d087d2a,t,21000,3015678,,5000033,2018-01-30 13:49:02,115
0x0106ace81e3132bfc68f8689a238d0832c8f92673e9f53654f4806942f1e7ace,t,21000,3036678,,5000033,2018-01-30 13:49:02,116
0x257182ab67975fcb454636d261b144c1680b63463ea236e34c1a06aee67d5b63,t,21000,3057678,,5000033,2018-01-30 13:49:02,117
0x1f1f06cc13feacee1bf89579981569391a4b44459907ee2140969e0dbb799138,t,21000,3078678,,5000033,2018-01-30 13:49:02,118
0xc630f4d672af262aa8e11546d732c21297f847b361a75a054a43b2c7d032eb37,t,21000,3099678,,5000033,2018-01-30 13:49:02,119
0xd1738e5c591c765f3ebc46c8fc2c72e2274c83a29ee35a6b29ecdc8a801e74ea,t,21000,3120678,,5000033,2018-01-30 13:49:02,120
0x6771a682fcc396c5912f18c074885851f2cae4f74ede0835e69ef1d6839020a2,t,21000,3141678,,5000033,2018-01-30 13:49:02,121
0x558618680c901ea3ac89572d5de75f365225c3d969ec42b7b46ef4bbbdf2310d,t,21000,3162678,,5000033,2018-01-30 13:49:02,122
0xcd5e5244ce8adf38815ba90af2101d8a46a8dc5af17d0285d67542039013bb16,t,21000,3183678,,5000033,2018-01-30 13:49:02,123
0x1b388451bb5d36543c9f2c7d0bbcb84c9862d39bad39d51ede0ff4bfe85fc8c7,t,21000,3204678,,5000033,2018-01-30 13:49:02,124
0x90b098e8420d16b4521d674d8a8f673fc32cc5d9f05ce6f42dec7e5b16fe6046,t,21000,3225678,,5000033,2018-01-30 13:49:02,125
0xc6ca8374d7aee2cea8fb393fe84acbb0f04eff962346d8a6261ecbf4824a5e6e,t,21000,3246678,,5000033,2018-01-30 13:49:02,126
0x9b8ee025e618c1c6c647c60b1f6ce2fdb37bf1f325359be49a0d0706415c6b72,t,21000,3267678,,5000033,2018-01-30 13:49:02,127
0xdfaf55f6d0739eabccfe1b1cedad409444200dda922bcbf247810ee34e130f6d,t,21000,3288678,,5000033,2018-01-30 13:49:02,128
0x5869699361bec374c260ffb71fc11c215c95e960f61ec7fe9d1f28af994fea3f,t,21000,3309678,,5000033,2018-01-30 13:49:02,129
0xff92f924ea41157818af812b302663d7a17d94308bf4f771b93ec0462fec9a25,t,21000,3330678,,5000033,2018-01-30 13:49:02,130
0x97e9fd78316742f090ce408ea45c94a1dd1a4391e1b7c5f37abe224fea3e159b,t,21000,3351678,,5000033,2018-01-30 13:49:02,131
0x2af46035470bf789e2366767581c70dfeb55215b82f86ee4ca0661e295405a75,t,21000,3372678,,5000033,2018-01-30 13:49:02,132
0x1ab92807d4c6b6106ff737c13ecc8583409c406511671199f6950bb7ad11c1dc,t,21000,3393678,,5000033,2018-01-30 13:49:02,133
0x3dbb70d1dc5535180712ae7e174e71958c57b926df21df85446ed327fbbd5b74,t,21000,3414678,,5000033,2018-01-30 13:49:02,134
0x396755b1e581f8fe1e9714b8c6bf7bf0fc092d6cdf3ef3422460f6f841f210d6,t,21000,3435678,,5000033,2018-01-30 13:49:02,135
0x99f712e3594a82d6140898308da4d0b112600ec4e276a2b188a057bba75db34d,t,21000,3456678,,5000033,2018-01-30 13:49:02,136
0x93c861e798323f6b25001eea2bca0815bbb41876196826a66fb384d946f2b059,t,21000,3477678,,5000033,2018-01-30 13:49:02,137
0x821d789ed876687254accc708dda568c68bb374058a1f58a4cae77af74a6ffd2,t,21000,3498678,,5000033,2018-01-30 13:49:02,138
0xa852d077006c0aca87b17ca217a04de6373db56dc5d88948c6a172346a90268b,t,21000,3519678,,5000033,2018-01-30 13:49:02,139
0x14ed99c7ec3af6f5b62f80d689e71bb14437af7f5e153f15027a0c6a96bb9240,t,21000,3540678,,5000033,2018-01-30 13:49:02,140
0xb41a9d96db61b2329a0bb3c2dced229100c08b02be95b6a0e2aa26b318aad7ef,t,21000,3561678,,5000033,2018-01-30 13:49:02,141
0x44c50f7ecccc7d0c45b4f58a84a4d5bca3624c68b3bec0f03a2468dff2134541,t,37443,3599121,,5000033,2018-01-30 13:49:02,142
0x228107429dfe88d277c3580c7cb80dc6c5d9f751b7e66895797beeac6c25881a,t,21000,3620121,,5000033,2018-01-30 13:49:02,143
0x1a99ca1f806b8f08babc4a40cddb824767068226768721a6921b845c3c0355c7,t,21000,3641121,,5000033,2018-01-30 13:49:02,144
0x8b11d3f78f7dfaff2ce1903e047f61d092159a3db7d80e9d46f75ebf29af95db,t,21000,3662121,,5000033,2018-01-30 13:49:02,145
0x06607b8cdbe37fba200cf9050644c11452063b444a57d8f0b5dccc6d65949acf,t,21000,3683121,,5000033,2018-01-30 13:49:02,146
0x1dfeb7b48be3aed874f793df42859b3a83980d17a3834d61a7f85c7e364d27ef,t,21000,3704121,,5000033,2018-01-30 13:49:02,147
0xe74b3bf9251d820618e888dd114ae609011291e7724b6850fe1b604dbbfcfd2e,t,21000,3725121,,5000033,2018-01-30 13:49:02,148
0x5220db86f3e563ead10359db7aed8ced54e53f14e7bd7b4c6d65cfd154fe2324,t,21000,3746121,,5000033,2018-01-30 13:49:02,149
0xc4fe85a2d528e17362bc45e526149b8919f89bc55442eb32f95a80f7bf99f89a,t,21000,3767121,,5000033,2018-01-30 13:49:02,150
0x287712cdc7e3a856d9663322fc971e2e456e40304b5f8df8173d633381ae5a9d,t,21000,3788121,,5000033,2018-01-30 13:49:02,151
0x7e1c3552bd5ef432f5998aca871e4d286278c6889cbeb6efae8a3a37644a3856,t,21000,3809121,,5000033,2018-01-30 13:49:02,152
0x3a7c9cfa7000423b8b1b74821c6b76ad785e1e8e0611e719f193ad7e7ee429a1,t,21000,3830121,,5000033,2018-01-30 13:49:02,153
0xf61afb2ad7a6c46944cb941866de42410d584595cbb9fdcea2c67c5d5c49cc28,t,21000,3851121,,5000033,2018-01-30 13:49:02,154
0x8b9c0ce70ec000a31b9a663d24d04f39d0e19397c66eae55d9ac07b796d72839,t,21000,3872121,,5000033,2018-01-30 13:49:02,155
0x9a702e9f35628b02c90cc21835b9b18fc49f7b8452b77457c22ca2931a88e4e4,t,52886,3925007,,5000033,2018-01-30 13:49:02,156
0x6c92ac9561bd2235f004c94a19e275dfdd7eb6122cc1d783e1bb30e3d4a73731,t,52886,3977893,,5000033,2018-01-30 13:49:02,157
0xfbd146e636237748176ea5cfe05bc4519b9d869a55b6fb5d44ec8ea81650c91b,t,52886,4030779,,5000033,2018-01-30 13:49:02,158
0x379ce6290dab392e4c838e950951f6635ee82926de69888694ef88a67daf2637,t,52886,4083665,,5000033,2018-01-30 13:49:02,159
0x8cb1889cd3a03f6e595bdeb1bdfeb3690fe969d17e2d582c63846aae1502128e,t,52822,4136487,,5000033,2018-01-30 13:49:02,160
0xfa89ff33588db1586277202422e3400211732ff89277aee04c5e9cd66b8b6f60,t,52886,4189373,,5000033,2018-01-30 13:49:02,161
0x70baf43c6f6af839077ff7ca57860ddc89d42ec32201b786204d006c8bf0f209,t,52886,4242259,,5000033,2018-01-30 13:49:02,162
0x2e2a8d79b0a003388f0c9db25f9aee7b5e23dc23cb8ff40286d0f9056e3a6b8a,t,52886,4295145,,5000033,2018-01-30 13:49:02,163
0x8372d3b445c3c4ba084031749b57ae369c0bf8e2ba52edefac36a862e4c61c89,t,52886,4348031,,5000033,2018-01-30 13:49:02,164
0xa9947901a1ebcc44b49a879318e9f72f8ab08edc12c3d64e2930a78dcda7b313,t,52886,4400917,,5000033,2018-01-30 13:49:02,165
0xb92aea3387fb0431a6d0f63eae3ce44f4d11339daddd298122353faba6c4a480,t,52886,4453803,,5000033,2018-01-30 13:49:02,166
0x697163ac2fe239b2bdcf10a1daf2b4950f2f35af492f6f8a4198801e063024e8,t,52886,4506689,,5000033,2018-01-30 13:49:02,167
0x3c4b58497adde6adf021b75fa1731fe02a0f3500efb953f457fd6f55cc7e937f,t,52886,4559575,,5000033,2018-01-30 13:49:02,168
0x3feb96912b356da7182232186d8f83f7902b2e487f29bb4f35615e76129e0401,t,52886,4612461,,5000033,2018-01-30 13:49:02,169
0x0843779181e720190a42d522f1a940f200eaf34def9fe36561c9783570dcb64b,t,52886,4665347,,5000033,2018-01-30 13:49:02,170
0x123d03ff302e7eefe7dd4c35d49beb9c23221913aa04a7f6e0b8df44ddead281,t,52886,4718233,,5000033,2018-01-30 13:49:02,171
0xe06cb52d7eeb44ffd2224ec995ed1ac6294672f5483d4aa5ab51efeb4d1455f2,t,52886,4771119,,5000033,2018-01-30 13:49:02,172
0x4ff7df1c6dd02ba79e9d91fb904304d3c34a99543b07076eff16bacf84114c32,t,52886,4824005,,5000033,2018-01-30 13:49:02,173
0x34c46d72b3be2418af80ff2adde710ccdfa660825a298e496588556ef5af4183,t,52886,4876891,,5000033,2018-01-30 13:49:02,174
0x573d5ec145feebb801f195aff0072e46638b8c0da62d2bb5f0fd61d5529812e3,t,37822,4914713,,5000033,2018-01-30 13:49:02,175
0x88e579d871a1d4484e21f7c8d6ce03432289007e83c6d8f363d4cd3b734ec2b9,t,52822,4967535,,5000033,2018-01-30 13:49:02,176
0x9fd108f86dd0a6a199342e576ef3a5bb0f0f3716cacba782e16f685f334b571a,t,52886,5020421,,5000033,2018-01-30 13:49:02,177
0x6873a6665afa60209996f66e1c0ab18b2addc0b239cdf9b1956368a4aff3d54a,t,52886,5073307,,5000033,2018-01-30 13:49:02,178
0x373549734027a761f158e0196038fa92294ad20e10235bf9107629d8d5f8af34,t,52886,5126193,,5000033,2018-01-30 13:49:02,179
0x2a6ab4278086dfdaf27a6edb9c54db2636e9717e0140f8ec2f31b92a0e06d639,t,52886,5179079,,5000033,2018-01-30 13:49:02,180
0x518428c1cd58944819c4900b21b52ea16e75bc8b3b388919287813521a15cf74,t,37886,5216965,,5000033,2018-01-30 13:49:02,181
0xc72b36d21d23c22bff9802fa5ea0a74d1edf4cff703c3b3fc9749b2d8d2ea6ec,t,52886,5269851,,5000033,2018-01-30 13:49:02,182
0x66fcd1d735deb37a45a13f2f417dc294ced71f451b2ae9e8cefd90fbe379227f,t,52886,5322737,,5000033,2018-01-30 13:49:02,183
0xb60b0766be7249c56f19f4dc1eb331acbfbc0d98a0a95d040a30f2170b4f9cfb,t,52886,5375623,,5000033,2018-01-30 13:49:02,184
0x953241020d82848b581ad0a0dab384243f15232b1386401670c7ff9c04c0738e,t,52822,5428445,,5000033,2018-01-30 13:49:02,185
0x0eeb541540194f720345badbcc64a50fe01215ee169940abad8c8ea353472953,t,52886,5481331,,5000033,2018-01-30 13:49:02,186
0x612bdc2a702c8fe42f77ff8d8d39d452eafa39e88cba2169dc5cd55973af7629,t,52822,5534153,,5000033,2018-01-30 13:49:02,187
0x72ee0b567d3526f891201e113b7ee5cc0c7d1496532251d0e029297187e3ddbd,t,52886,5587039,,5000033,2018-01-30 13:49:02,188
0x9bb369d21b9ed33e427fc2ced71d8cec7124f872a2466654dc04dae74f87a402,t,52886,5639925,,5000033,2018-01-30 13:49:02,189
0x00cfa0b057df617d886ca3d311ee9abaea99cbcbd223914890f105ace54290ba,t,52886,5692811,,5000033,2018-01-30 13:49:02,190
0x51f548d259c32a4a0e739779e8ae3aa043c043b0860e0164ccd0d9c62395f923,t,52886,5745697,,5000033,2018-01-30 13:49:02,191
0x5f49973122e6d24375e0f5179a3f896a4364f3ff0ac425ebdd2b5a87366c3053,t,52886,5798583,,5000033,2018-01-30 13:49:02,192
0x9dfd2746ce1611783dc781480f2e63ae87e9a7b53268e2e1bf0ae96035912bc9,t,52886,5851469,,5000033,2018-01-30 13:49:02,193
0x5c3c9e4b14b97fa5815bee8fbb61adc7634f8e772fbeb716f968a2f461a4a6a7,t,52886,5904355,,5000033,2018-01-30 13:49:02,194
0xeff6133513c4a77f46e13c2c5e0ac3f3836174d214955f016bae3612db1bf4a2,t,52886,5957241,,5000033,2018-01-30 13:49:02,195
0xd23986e443c161f6e05925aedd0b58328f0ccf98382e4784f52e21630ee72cd4,t,52886,6010127,,5000033,2018-01-30 13:49:02,196
0x350179fdc356a3a8d86701f86094496c29853e3b3b3cea7bcdc79a8b5f8f1692,t,52886,6063013,,5000033,2018-01-30 13:49:02,197
0xe9335585c52a9870cbe934401809f7a869d420ca44558074bb1c8fa5101c1946,t,52886,6115899,,5000033,2018-01-30 13:49:02,198
0x54e5603bf222be487e3718c92678151fbcf3e48cd170002ff5d2527525e26f8e,t,52886,6168785,,5000033,2018-01-30 13:49:02,199
0x0ebe02344f5e824ec8ad8c6e32d0fcaefd00d44bdcb845a84db25853086fe126,t,52886,6221671,,5000033,2018-01-30 13:49:02,200
0x07abd02829ded379f3b25fd80452bfe14715e8a0aea305e91c965eaf154eb857,t,52886,6274557,,5000033,2018-01-30 13:49:02,201
0xe544d4ba9d919e9938cca1e4c1508e06297b881088166613902e420b492ef889,t,37886,6312443,,5000033,2018-01-30 13:49:02,202
0x4204a2ce0c91505538b279fc4eb7d850c8db4514da800c151c2f566022b0c47d,t,52886,6365329,,5000033,2018-01-30 13:49:02,203
0xa7df6fc151cc8de5fb79ba997a1235d6b5781ed4ee3d8d88c0e00c7adf2a56f7,t,37886,6403215,,5000033,2018-01-30 13:49:02,204
0x0504e5dca3949cb3a4da11ff58e2b39dfc60da54af978e12ec08f51f92fa70d1,t,52886,6456101,,5000033,2018-01-30 13:49:02,205
0x89f21766fb0b8e71ca8bc5b1b51b68b569f1ddd582cc53d1525a813b6be78d81,t,52886,6508987,,5000033,2018-01-30 13:49:02,206
0x5c759a8ce84020991e5f091d54f4102352bd87e5f73861ed00edbfae79d8759b,t,52886,6561873,,5000033,2018-01-30 13:49:02,207
0xf0b4ce1a2f8d5a49afac4cee10c809ec0e82f8e3f37b0c9dc80fd995640ffd44,t,52886,6614759,,5000033,2018-01-30 13:49:02,208
0x331961469983ecb3fc516df88fcbc57c1707ff2e505d5af3297e519b468b37a2,t,52886,6667645,,5000033,2018-01-30 13:49:02,209
0x715f278988c3274dbb765a26747704dbc4c67522c75bf3d2b2d3a8318a9b70d4,t,52886,6720531,,5000033,2018-01-30 13:49:02,210
0x0c71731bedb97b18f1da05b659d83c78543178961ac73b17c27ffea6d5b621b0,t,52886,6773417,,5000033,2018-01-30 13:49:02,211
0xcd8d79317e23e3ca22060f51e152a90cc1035f177929aefdd746ccae1adda789,t,52886,6826303,,5000033,2018-01-30 13:49:02,212
0xf6d393739c2d8b15786b95df5caf31f37e85671c46f1e3a35ab09abe2e5825a9,t,52886,6879189,,5000033,2018-01-30 13:49:02,213
0x4bed5fb265d0599d1acbe7d365f30bc546fc2a473e5505a445c043a0600c9bd1,t,37886,6917075,,5000033,2018-01-30 13:49:02,214
0xafa1a1dc7ad2472c3173d57e60f310d146a5dcb2150d921b85686e726a95cbad,t,52886,6969961,,5000033,2018-01-30 13:49:02,215
0x9a104159dd25c8fee0eddbf47d70b12724985d8de550ba03c5065f36d85e74ae,t,52886,7022847,,5000033,2018-01-30 13:49:02,216
0xfbe5d661b25a9ed2becba1e689bcfec7889939b8e7697a478f00047fe39ee2b3,t,52886,7075733,,5000033,2018-01-30 13:49:02,217
0x25d380c3022aebf32466a9908cc0169d499e5389a09acb666bd6c5a9502bd446,t,52886,7128619,,5000033,2018-01-30 13:49:02,218
0xfc96320e7121462140db78edffc923af29fe7142d7d6a28ce3392f979bbfec13,t,52886,7181505,,5000033,2018-01-30 13:49:02,219
0x52e3440bf21d084ce8d23b900fcaf69684894a46e98e1630ca9e55c817830145,t,52886,7234391,,5000033,2018-01-30 13:49:02,220
0x15a6d788f30d34ff2f8af0a24deae2b96a572a59de879dfe6febe94f0cd76029,t,52886,7287277,,5000033,2018-01-30 13:49:02,221
0x29f58da0da4862d11eabc82479d1a2163bc4bda72d87b2550aab6e682f283268,t,52886,7340163,,5000033,2018-01-30 13:49:02,222
0x15873081748e2f87b7a86c78b11773adb81e884c025686883b45396b3d75e591,t,52886,7393049,,5000033,2018-01-30 13:49:02,223
0xe78294af9ff47368e5deb4f97f1c502eb69ece5c59747aff62a9f0c427d444c2,t,52886,7445935,,5000033,2018-01-30 13:49:02,224
0xd62668742a471c897dde4448508f19026f03cd6ad6b56d7e0d1c593da536db92,t,52886,7498821,,5000033,2018-01-30 13:49:02,225
0xe2ea64e05bb42ade07184c2f7533723a361aacea2890f8da4fd018de574e0e14,t,52886,7551707,,5000033,2018-01-30 13:49:02,226
0xd323d5018a173c365892eafa6d5f231c7d53162ba2f2d07112c2296f4288a46e,t,52886,7604593,,5000033,2018-01-30 13:49:02,227
0xcc79ddc9dab5e4c2ff40b99dbed628794621ed5c445e519a0027504a73a1178c,t,52886,7657479,,5000033,2018-01-30 13:49:02,228
0x97d38915bd8e66b0f3619ee86637780b59144728def4b0cce64d529c5fcb66ba,t,52886,7710365,,5000033,2018-01-30 13:49:02,229
0x1ca26b9f3253dd8ba19d35e633aae0ea379acf147a1b4e3862c6f73095a91f06,t,52886,7763251,,5000033,2018-01-30 13:49:02,230
0xc2f2ba89eb07870ae00980f917835362644dfa19aac6a84ebfe675c8cded181f,t,52886,7816137,,5000033,2018-01-30 13:49:02,231
0x2525f054a5af5881281808cdb6b2319577314e948c704f867dc9fa3f4908f276,t,52886,7869023,,5000033,2018-01-30 13:49:02,232
0x410d99854250af3d0efe84e34b49ccbdbca7b15105dda628bb64b0780e0b7ce4,t,52886,7921909,,5000033,2018-01-30 13:49:02,233
0x39416b3969dedf655054610a2786e50a262181597088865c0d1bcfa2006d9f2a,t,37068,7958977,,5000033,2018-01-30 13:49:02,234
0xb45a4c59b0ceb869a44d5cc5303b5fe694befe7e7dac2da718cb8a5f41172e25,t,21000,7979977,,5000033,2018-01-30 13:49:02,235
0xae8d47e33513848f4f59ff16f8948e1cd5d9b94095d00e0c8b842ee1c9f12329,t,21000,8000977,,5000033,2018-01-30 13:49:02,236
0xe79309b983d372d7a2d3dcd054609305006dd26ed2809f7edb69b954d9692ad5,t,36537,36537,,5000034,2018-01-30 13:49:09,0
0x18fe96783d0f3f8d6c22f7d19ae43cdb39f066199c56aaaa9c05d07f68a9a31d,t,53047,89584,,5000034,2018-01-30 13:49:09,1
0x8fef4c9c5e79f50deecfd2ca98346cd31b65cbb859f108805368fc5117f6b7ea,t,52158,141742,,5000034,2018-01-30 13:49:09,2
0x3a91dfb975d4e364fa377a352f169c7eb6d64bfac3d13c955cc2a4f9d1c6d246,t,21000,162742,,5000034,2018-01-30 13:49:09,3
0x823f384506c73b8228a8a6c82971a152a5ba134b7986ce18bacf2305e073c1b8,t,21000,183742,,5000034,2018-01-30 13:49:09,4
0xce5738f15cdffc243c001468c253da2275198cfb5d758022751a65981901ae4a,t,21000,204742,,5000034,2018-01-30 13:49:09,5
0x73b13e64660673989ad3c4adc038cdd987095cb841b3dad650d9690c6bc586d7,t,21000,225742,,5000034,2018-01-30 13:49:09,6
0x2bf8c3e1af6f62990c8fb88b24cc61bc06917f6df618b050d67a9a714cb2d194,t,21000,246742,,5000034,2018-01-30 13:49:09,7
0x9e7318523e3192607ceecc7700ead74aab6f4274d4b60f478a07c2add1615bac,t,21000,267742,,5000034,2018-01-30 13:49:09,8
0xeee50ad0dae914bf2369a579ef7318213a63eb55bba54692a36f165c354b6ba0,t,37151,304893,,5000034,2018-01-30 13:49:09,9
0xfac7461d75a8b34f6ffef82fdf867a4f68906313323fdb7957c8e0a9914d1001,t,37571,342464,,5000034,2018-01-30 13:49:09,10
0x692689af562472cb0f9848e081b3ee355fda022daf7f309b0d39a1b35d5b301b,f,66304,408768,,5000034,2018-01-30 13:49:09,11
0x2ce96a6347669d77ae1d6879630973fe5d23c04dd434945c4d1eb1caa66b7286,t,21000,429768,,5000034,2018-01-30 13:49:09,12
0x86410a863c0732b1d8ed3017f54ee96073bb11692cc065d845347cf33d1f3eec,t,21004,450772,,5000034,2018-01-30 13:49:09,13
0x474b4f1d9153050633b77d322e651a72987cd66465ecd6f378d61c9ef9e9150e,t,21000,471772,,5000034,2018-01-30 13:49:09,14
0xcfb09e781b8d18cce6549a1cb94273c313d0cbf52c5c0abc44693c3fbf1329e6,t,140027,611799,0x1e8Fd16ACD4cF34C75663eB64b0F0998771d7E8e,5000034,2018-01-30 13:49:09,15
0xe4845aacfc7373e98ab605412929bdff9dabb04ab1f7c49dbdaa2490522b641e,t,21000,632799,,5000034,2018-01-30 13:49:09,16
0x03cab606a300772c47e339ec20fe1b080c8e1c156505a8ffa6491aa43067cbb5,t,21000,653799,,5000034,2018-01-30 13:49:09,17
0x683530b1847b9f6a7eee42d925a02a8876f6f680d204b653314e9959ff2c9c39,t,21000,674799,,5000034,2018-01-30 13:49:09,18
0x613f687e15fe225e99d40d79d03f427d07748d6e7aac88c9441204a53b239387,t,37420,712219,,5000034,2018-01-30 13:49:09,19
0x7776f1809e34f1074d5b6188b485fab79e34a5ebe90bb5d0d660e70509ea36c0,t,37030,749249,,5000034,2018-01-30 13:49:09,20
0x6101bbdb15334d04b8b5c60711d9410a8a140cbeeba308eeb67bc7a95a911a5e,t,55907,805156,,5000034,2018-01-30 13:49:09,21
0x20083ef10c3786d354ec49752cb4ce8f1f10b468d31fbad25105e06ddfc07474,t,21000,826156,,5000034,2018-01-30 13:49:09,22
0xff5e246a56a49d4e674e33063f73539d661ddb5284ca0a097c5ca1a2c2f3fd01,t,53226,879382,,5000034,2018-01-30 13:49:09,23
0x1d637e5e5e307630256e407a74c6e23b92f6f7ce90974ad1b8dbf71f241d9e75,t,21000,900382,,5000034,2018-01-30 13:49:09,24
0x8c03d4a2325d564404f90c6ad1287d50ae404744ca6a047320d40774f887911d,t,21000,921382,,5000034,2018-01-30 13:49:09,25
0xa11ef67cdd04cc8a107e5cb127e91d0879d18b532488f040b6a56d357195cc0c,t,21000,942382,,5000034,2018-01-30 13:49:09,26
0x1d9fe2edb6a736020bb6d94ef0f2b9e6068bd7cc1247b9bd6eafe1c15765d24c,t,21000,963382,,5000034,2018-01-30 13:49:09,27
0x6d071f5b92d43722f5ffe88ca4b451071b47de3ede9a059b3563a97987625370,t,21000,984382,,5000034,2018-01-30 13:49:09,28
0x4fa94859409b4b582538f5300deed6ab350f2f24bb808e757f27299aaf70b137,t,21000,1005382,,5000034,2018-01-30 13:49:09,29
0x1d4e624153c3881e1c924d3c79c015e72c83f9b3c2b896b4d982c6dba21000d0,t,21000,1026382,,5000034,2018-01-30 13:49:09,30
0xde81c97e736b1f613c68962935501bfe413768b903f1362e509987bd119dc101,t,21000,1047382,,5000034,2018-01-30 13:49:09,31
0xa6ae1d661e35a6398062f723b43880fb60e192527bf46398612639000ddc82a5,t,36728,1084110,,5000034,2018-01-30 13:49:09,32
0xceda4c503c33ef0c3a1b01e2a41a0d344888a0fc906f5160a50ce9931c421d9a,t,21000,1105110,,5000034,2018-01-30 13:49:09,33
0x358dc1eecb166702a18c887b04fbdceabd03a37960275fc61054f03d102397d6,t,21000,1126110,,5000034,2018-01-30 13:49:09,34
0x2f2408f03d1952bd4237c9490ae22a40fa4d2f97bb7ffcca4f1560fba18a9f5d,t,21000,1147110,,5000034,2018-01-30 13:49:09,35
0x7d0c54797568f0aa1acf3e76272d66cfce0fa0b5c14b2335d81d6d9acf0396b6,t,21000,1168110,,5000034,2018-01-30 13:49:09,36
0xc4a6dad270980cc17525b134b745ede5cd4c7f1d7b5f60a968df293b178c3ce8,t,21000,1189110,,5000034,2018-01-30 13:49:09,37
0x61b8cd5612e51711bea4bd3243e4993bf99b6e1da6f8f4f6f980fcde7c89c944,t,21000,1210110,,5000034,2018-01-30 13:49:09,38
0x5e5e6c69d107ad0532ecacbac22a8cd45381350d098afc98a750e149e103e2c8,t,21000,1231110,,5000034,2018-01-30 13:49:09,39
0xf6482435dbb8bbd24df964dae2f99d5b0ec0f2a3ef39f7106213bc607b8d9ee3,t,21000,1252110,,5000034,2018-01-30 13:49:09,40
0xc91a2510e954d233f1dce3bc2d1e71abe50fc3698885fb679dff29edfc7ea64f,t,52507,1304617,,5000034,2018-01-30 13:49:09,41
0xce3532133277e40bf53394362aad7f4e0aaa42dac0200ca8e982d18ed3e31173,t,21000,1325617,,5000034,2018-01-30 13:49:09,42
0x7128e0bf89f5c1b5397b229c8fc00e580441e33cb462e10d0b247bddcd441aa0,t,21000,1346617,,5000034,2018-01-30 13:49:09,43
0x8664b246056c80854c4ae6938c97594f50ff0941338ac8d12b08321b40684e11,t,21000,1367617,,5000034,2018-01-30 13:49:09,44
0x3eb4ba33d90d7b80bb5bd9a9c50fa63651725a6cc47b6e6b57229c3379ab4abf,t,21000,1388617,,5000034,2018-01-30 13:49:09,45
0xe456bc5db488c7837606b7f2d373ba4e2df6c72892ddcdeeacfdf0e76cc85665,t,21000,1409617,,5000034,2018-01-30 13:49:09,46
0x9b207a8ea3da161d4d688f72742ca7b0789751893b6a2c2ca139ae938bff7738,t,21000,1430617,,5000034,2018-01-30 13:49:09,47
0x6b7339abd0cb6c30b7efdcf701e9e3ad7b91fc060b9c60c5719cb009046df3a3,t,21000,1451617,,5000034,2018-01-30 13:49:09,48
0x428432cc164dc91fe48c9e6f0c554fd1c7927a46b51e1bc1a453e88a55a91376,t,21000,1472617,,5000034,2018-01-30 13:49:09,49
0x17c7c14faa7a3a84eceaa090c2d10ad2cfffbe433c0a59cad0235814652c30af,t,21000,1493617,,5000034,2018-01-30 13:49:09,50
0xc70e3108c93a78a6f3b7fa2428c3fb4210c74c7c5737155dc86b69aaea8fd9f7,t,21000,1514617,,5000034,2018-01-30 13:49:09,51
0xd90609b8a707083aafa19330e77a6b1cec020631aba040eeb830c15c4f21f957,t,21000,1535617,,5000034,2018-01-30 13:49:09,52
0xb459708d18aeb09225422ce66e94bab9f2d8bbb9b1d1670202b0856e42035c77,t,21000,1556617,,5000034,2018-01-30 13:49:09,53
0x6131a8332488f5ec1872b273d6c788fbfbab40c91334540ab4bd7a466c916645,t,21000,1577617,,5000034,2018-01-30 13:49:09,54
0x61faefb141786a7fd180dada80942cde109a496abfe711d9e547f4cd730c8bde,t,21000,1598617,,5000034,2018-01-30 13:49:09,55
0xb5ad456ddca23c78f449ac27c4ddb013468bea06fe4f15afac14fc9b73346a8d,t,21000,1619617,,5000034,2018-01-30 13:49:09,56
0x6c422e44a6183144a181df64bda4a1576fe0eec3c0008327260802a11b2a3b04,t,21000,1640617,,5000034,2018-01-30 13:49:09,57
0x9491c6a12506f22247f2bdb205812b90968d6c71c09ea7eca65b1f19b9d5f4e3,t,21000,1661617,,5000034,2018-01-30 13:49:09,58
0x0ce2c4c48c65201648e77caf91a9665d2712b9281f7ff12791fc36b51c328cae,t,21000,1682617,,5000034,2018-01-30 13:49:09,59
0xc01d2020e57674c5c1406e5535661068760e1ed214ec0a6d894f134f93d3bd47,t,21000,1703617,,5000034,2018-01-30 13:49:09,60
0xd7e13c08a4f5d382d6c6600ff1fb96eb1392245450c0daf1c7bf174a9b168076,t,21000,1724617,,5000034,2018-01-30 13:49:09,61
0x5594d6b117db9345009060c0cafdc888765f7189b1b20da4b7758f0d34d118be,t,21039,1745656,,5000034,2018-01-30 13:49:09,62
0x895e84214f15863febb693bcce6b469d2227939d2b493f3f09c9d5952d88eda5,t,22237,1767893,,5000034,2018-01-30 13:49:09,63
0x5c001468348a028575763a3c782760d3587fd25077a3555f82a0cdf7822832d6,t,22234,1790127,,5000034,2018-01-30 13:49:09,64
0x070400ba2af2693f298e3833b9e5fd18a398456259604a9b479eef1ed6af3cb5,t,21000,1811127,,5000034,2018-01-30 13:49:09,65
0x70749d827ab25fc7dc3334c3ed93c279cbe23758898c3e764590bf69cdb6fd3c,t,52976,1864103,,5000034,2018-01-30 13:49:09,66
0x18731aa5780461dda0fdba961cfe7c5df1ddf8cf49b8c19ff17ef75f0c1b9dcc,t,36545,1900648,,5000034,2018-01-30 13:49:09,67
0xa7daac15fd594aed9fbc088e2828302346fae092e7658062f80c813b5578ed16,t,52460,1953108,,5000034,2018-01-30 13:49:09,68
0xf7e52949edcf1381aa46a592efe6257b6d6fde0e7cbc190ec85a0cffeb54b387,t,21000,1974108,,5000034,2018-01-30 13:49:09,69
0xa8d91da70a6268ab2358da9a87d1705444ce51685e2943d5c72d1b9ec20bca23,t,55327,2029435,,5000034,2018-01-30 13:49:09,70
0xa3facce0be5bb8deb14a63c471990dd5c058d31518cdef16ad2b06b6fca8c13d,t,25907,2055342,,5000034,2018-01-30 13:49:09,71
0x3fc434a4ab30b436bc828f95a97518b99bd6b15d09c7201ab8a382d060039d41,t,30327,2085669,,5000034,2018-01-30 13:49:09,72
0x588401843f95978268fe4beea341a9e94805ecb2b2ee1ffe17de812360112937,t,21000,2106669,,5000034,2018-01-30 13:49:09,73
0x8f19af33ccc7418db2ed0393b0645276afb2f08585864411eb3d9ee3a4807c31,t,21000,2127669,,5000034,2018-01-30 13:49:09,74
0xb84db9fd5d86e4c2b7bb6dbd6c5e4f7dd55e36ea98b6e32fe957f3a558d2b40a,t,21000,2148669,,5000034,2018-01-30 13:49:09,75
0xfa4104f573aeba20a318236b119139efc25cadd2fcb43568e515da9d0c060586,t,21000,2169669,,5000034,2018-01-30 13:49:09,76
0x081a825c0c8899552c63f99144ffef49e5f06e29d19518931711a4f780df609f,t,55327,2224996,,5000034,2018-01-30 13:49:09,77
0xd07570fd3a858dc929d7d55ad0627dac645350291675a46d5e3cbd7be6e46009,t,21000,2245996,,5000034,2018-01-30 13:49:09,78
0xc53579a95da9013881489bb62dc8f931a0968cbbdc7cd18d241183a2f5c2ad90,t,37900,2283896,,5000034,2018-01-30 13:49:09,79
0x5d669ae97efd28d434115051f0da89fde4e6296bc83ac87aca493b20d2e650f1,t,21000,2304896,,5000034,2018-01-30 13:49:09,80
0xcc63d025ea08a6c19899f8f7045e6961107c44f386b84bacf3a475ac5094e1db,t,21000,2325896,,5000034,2018-01-30 13:49:09,81
0x382f318cf3215eab335115f7c1d910c43b7ae1bc05a6dc13d27bf4f5d29d8da8,t,53519,2379415,,5000034,2018-01-30 13:49:09,82
0xb2fe04b08aebb2dd4a1dc3aa28b10db930d467b87e013e8c61fb7e6aaec80267,t,21000,2400415,,5000034,2018-01-30 13:49:09,83
0x221bf76b9805ea16ebccbbba957d656148d04bf0dd45e6f583b21dd251229d2c,t,38231,2438646,,5000034,2018-01-30 13:49:09,84
0xf9ca2ec4c57d1d3c97ea5bae4c32fc3fb497bb303d6f73e31ad46d458a69d533,t,4664396,7103042,,5000034,2018-01-30 13:49:09,85
0x916dce3a14792a5859888c5bc3c135c4df42d1e5b469b839830b00168e139b6d,t,21000,7124042,,5000034,2018-01-30 13:49:09,86
0xa7302e93dd19d4f330cb565940b2d138f38ec7115c6cb6588ca26a62b0a1fdb9,t,52113,7176155,,5000034,2018-01-30 13:49:09,87
0x6f1568acad98d83a744994dfcf8d3875e56bbeddbf41c95abc520c19285e2f1f,t,52344,7228499,,5000034,2018-01-30 13:49:09,88
0x6e2eb9adf0cb5d93ca1d0db5c3018a81eec2f61caeca628785a0bc25162e040d,t,29493,7257992,,5000034,2018-01-30 13:49:09,89
0x8a3330d2d250c92be47a6182818586cb1f490332700b07510901740b68d87046,t,182105,7440097,,5000034,2018-01-30 13:49:09,90
0x108e23b2b5d7f6f18636b333027ffd5ce8d51456262e3ae5c4b11e5d07c01d2e,t,93050,7533147,,5000034,2018-01-30 13:49:09,91
0xe9c28c4d7389fee7d823c6a4aeca22825f692bcef20b6607f8e0470dab5299aa,t,107794,7640941,,5000034,2018-01-30 13:49:09,92
0x4cd2417e6e68b312b9ac8342338e84019f840558be2796865b2fcc8f718eb26c,t,55915,7696856,,5000034,2018-01-30 13:49:09,93
0x904f9c1127b59277a7b030d542823fd05daf295b24c2360f5f0ce4523d14048c,f,85000,7781856,,5000034,2018-01-30 13:49:09,94
0xa2b4d5b78792720b38cfd491f6c1c47d9f47a3c8129ed79ef60ff3301f9d8bec,t,22524,7804380,,5000034,2018-01-30 13:49:09,95
0xaf8a7c2183e0a01c67816c58cf6a862f8e668642bb8de4303a6ece845adb7e25,t,22143,7826523,,5000034,2018-01-30 13:49:09,96
0x6ba1cfb77de0da03ac5e18ba5acd1fff7653909d9d1414446cf683f6988f92bf,t,23040,7849563,,5000034,2018-01-30 13:49:09,97
0xb8a278e857e9a438a350cf473c92b235d90e326caa6ce4b8a5f5094f2dc447e1,t,22524,7872087,,5000034,2018-01-30 13:49:09,98
0xf93643c490a024588787b86bae15619164468e84f5c4195d1a903580af415b38,t,23318,7895405,,5000034,2018-01-30 13:49:09,99
0xe3ea6e1e4f9c70c9308e80aa3099cc630617c2ebd86615ed266c1cacdc87c62e,t,22524,7917929,,5000034,2018-01-30 13:49:09,100
0xcc8511f9d8a4a371313fc22177f79d3bf68650be78fb2648a70e5b46b61cd438,t,21000,7938929,,5000034,2018-01-30 13:49:09,101
0x6400c6fd436f764e5e5ba01323140c1f2c3558ba22686cdc0fec5e6f3a7e6541,t,21000,7959929,,5000034,2018-01-30 13:49:09,102
0xc331ce562e0efa01f0a8d93fabb082cbecbf65e39a982eefc975d4dc09769d6f,t,21000,7980929,,5000034,2018-01-30 13:49:09,103
0xe9d8e85cc5903de24cee81b1985a651fd20de7cb44f199299565fc2568a8eb87,t,21000,8001929,,5000034,2018-01-30 13:49:09,104
0xc4494ebf88fcf4aefa3889c5915a93bb1ebf23bc678d670e93054618113b1dde,t,21000,21000,,5000035,2018-01-30 13:49:21,0
0x5afaa6cdf277fbc0342dfb624d8482e4d11e8b0369b3261005d732b2af9441d2,t,21000,42000,,5000035,2018-01-30 13:49:21,1
0x27947e25ff3969ace1ed5ee617574392932cc6f6672b47c009dfc82714b26d1b,t,21000,63000,,5000035,2018-01-30 13:49:21,2
0x2bf6282fe8d270ea0f2eabd46ea381571c5692b219227f9285013861ab6fe784,t,21000,84000,,5000035,2018-01-30 13:49:21,3
0x0ee840d843f7bbda3e1ab633feebb885dc82d07c8da320707912c373ccc8658a,t,21000,105000,,5000035,2018-01-30 13:49:21,4
0x1c495eef37ca43d66ab5d56b24187c6b884d394bc6ce90587f5435cf53a730d5,t,21000,126000,,5000035,2018-01-30 13:49:21,5
0x04ca9852dc36419e4b3940f9da0ec010e513cfe690103ae7142743f506f1f338,t,21000,147000,,5000035,2018-01-30 13:49:21,6
0x5e2f04401fd2988ac916672c5e5c37540537c53d2ea727cb399883aa581fa599,t,21000,168000,,5000035,2018-01-30 13:49:21,7
0x09d3b6624fa4e1fea076643815d33d0400b6bfe63ede09d57f511e01c8e1aad0,t,21051,189051,,5000035,2018-01-30 13:49:21,8
0x3b7ae35610191dbacf84ffde1a7c5b01932c06e577336056cbac295eb23ba282,t,21000,210051,,5000035,2018-01-30 13:49:21,9
0x2af0b3a6536b7b7191e497ec5c093d43592c2f6ce9a3f511d5a9dc88432831fb,t,21000,231051,,5000035,2018-01-30 13:49:21,10
0x5add69b8e77ce1fc2656f51eb5104ea9a240fc040b057e6c6a53d374d11ce68b,t,21000,252051,,5000035,2018-01-30 13:49:21,11
0xa8c3149a4d9e1efd1a900431eedf9661886e750b5291ae121d7b38bb65eb1876,t,21000,273051,,5000035,2018-01-30 13:49:21,12
0x33ec743c1d30afda61b88eef7cb6926e4281ee766afafc69bc7e4eafc8a08fe8,t,21000,294051,,5000035,2018-01-30 13:49:21,13
0x1629d970b344ee15c100b8419b93824780a2c76c4d895828fdafc0bed2307940,t,21000,315051,,5000035,2018-01-30 13:49:21,14
0xac51956f01cc71a5c309d3d327441942f28c84a0a9c1d4c42e5c5811a97aac85,t,39512,354563,,5000035,2018-01-30 13:49:21,15
0xec599fb3aa75b74ed840d37334b28fe74d3ccffebabf311c73e387e6a536ea65,t,21000,375563,,5000035,2018-01-30 13:49:21,16
0x605e57b855f56b9a6d3162edd6c923e77dca5c60587b32ca93d569f4438c2fda,t,21000,396563,,5000035,2018-01-30 13:49:21,17
0xf27a5faff0c23ce3a589d82eb359844924c4b81e191876eeba69a1ff63e458c1,t,21051,417614,,5000035,2018-01-30 13:49:21,18
0x011b9d262fc8554e6512e85f5e3dc167e618603b26c80d562a58b2e1247b36aa,t,21000,438614,,5000035,2018-01-30 13:49:21,19
0xf7a9178fda6fe68a77ab5bb0caecdb31d35ce0e1197626d2bb77aa1a8b4053c0,t,21000,459614,,5000035,2018-01-30 13:49:21,20
0xa7ebc11418af8b5f7c638a08f232410d248b05c521ebe2a7b6f7cdc8453cf1c0,t,21000,480614,,5000035,2018-01-30 13:49:21,21
0xc921245e345ca19bc1fa1231ad9dfcada3aa3d2ab738fbc8076b049d2d7c381b,t,21000,501614,,5000035,2018-01-30 13:49:21,22
0xb0223c3c308871545da7af09c64a1a1393e9fbfbf924f88e348026db1e856d90,t,21000,522614,,5000035,2018-01-30 13:49:21,23
0x53aae23f29216b3b1c241087b52e50723ee8c8acbbf834e635a2513ab7b93039,t,21000,543614,,5000035,2018-01-30 13:49:21,24
0x6c2089f86614e5f705b4fed72394e86790c355ebe92ab70dbe74f31ee4c5f166,t,21000,564614,,5000035,2018-01-30 13:49:21,25
0x8cbe2e8613b000f2ba061183154617e11f420a19818a1d1c1d134f20cfe43f90,t,21000,585614,,5000035,2018-01-30 13:49:21,26
0xa311013332cd473a43db604ea8e5e9549b16fecf065fd38578ed32cf8998b149,t,21000,606614,,5000035,2018-01-30 13:49:21,27
0x1372acd24d54de8865a4952e6f0ae93a166f66b39e7968c0b86a761dfc228eb0,t,21000,627614,,5000035,2018-01-30 13:49:21,28
0x7a7ed5c7b8121cbff39b301078e18dde662c580905f15586041d6c96301af3a9,t,21000,648614,,5000035,2018-01-30 13:49:21,29
0x382cc0d9d3ef141b2a624b5d21ebbb97957d1a75c7bdf5f676f1b013169a2636,t,21000,669614,,5000035,2018-01-30 13:49:21,30
0xc476ec8de34a7b2c6d8e8798e796b7946bd876c108078c712fb4d2b34773b26e,t,21000,690614,,5000035,2018-01-30 13:49:21,31
0xb1f150bffb14c254681f203c269e226c9fbc184e9a7617dd4c490e9610ff98ed,t,39512,730126,,5000035,2018-01-30 13:49:21,32
0xb7a9e5865e18ff85ad2d56feb39dd0695a7bf9ecb529905a17e8973e5bdf6072,t,21000,751126,,5000035,2018-01-30 13:49:21,33
0xe8d16880ea97f089bca5d3c5ce58bfdd8f672f04aef7aeba3e5ee9e213eb8bb9,t,21000,772126,,5000035,2018-01-30 13:49:21,34
0xbddbf575b2a1dd87d156ef687dbbb4da9064f1b84b78b1ce87653cfd1ccc83e3,t,21000,793126,,5000035,2018-01-30 13:49:21,35
0xadbf853744eb0eb88732f0ef7d120c942a6172bada108892903b5b70ccd6ce92,t,33705,826831,,5000035,2018-01-30 13:49:21,36
0x06cd10698add091241d5b478fb8fa28b36b5ceb70e0efd54e52f038b369cd40f,t,21000,847831,,5000035,2018-01-30 13:49:21,37
0xa0c11e246e120a87ba53a428004c4d39d6354761d68e124f5b5e7a30361dbdf5,t,21000,868831,,5000035,2018-01-30 13:49:21,38
0x4513bc7d46086d62323107d6d1999f465a9227f587a0a941503b55e6971d09b0,t,21000,889831,,5000035,2018-01-30 13:49:21,39
0x22bc3dbccd2f7ce4cce664d7732f3e7dffb0982ebf372b9c5d764d314a93396e,t,21000,910831,,5000035,2018-01-30 13:49:21,40
0xbeb3b5b96283a98b33dbf3b9cbb499ee8834939d24fedb36ee11770c6758caad,t,21000,931831,,5000035,2018-01-30 13:49:21,41
0x79a51581bb4f1e374720e67f488dbae469f08fa9d3d292e97456cbdd1b97a359,t,21000,952831,,5000035,2018-01-30 13:49:21,42
0xc1a008974e4d2df4887ca55a30df248d5e621a482046775a3603af861376b58c,t,21000,973831,,5000035,2018-01-30 13:49:21,43
0xcdfb07cbe348948a7a152d43d7d39d744f4f158217a006a26c7b36ba423c02e1,t,21000,994831,,5000035,2018-01-30 13:49:21,44
0x4f41fc8756d2ae6a06d80e35b2dbbc5320321d8c379865caaf45ca48a3cf427f,t,21000,1015831,,5000035,2018-01-30 13:49:21,45
0x990799a922e881088d417a67cd549de23ed598ce01da3f5f168c6c3b6668650a,t,21000,1036831,,5000035,2018-01-30 13:49:21,46
0x768c918cb9a2961519b4d6c79c866a026ad820f6604a86bbe6aa53e9d4e24afa,t,21000,1057831,,5000035,2018-01-30 13:49:21,47
0x569a028e167da36a70056ca9107c78eb6173a8be23e3dcea3cd6744570e2acb9,t,21000,1078831,,5000035,2018-01-30 13:49:21,48
0xa07fd30cda01ce43e4d42fc40eddc57dd391298b9af620c6b075656c479c2422,t,21051,1099882,,5000035,2018-01-30 13:49:21,49
0xc1d48bbd29918a9df4bfdc400d828bcae39f9081ce58a341c273d63432d933b4,t,21000,1120882,,5000035,2018-01-30 13:49:21,50
0xca4cea1dd18099c0706433c71509f13686abba6b9d93c72e62b5a119ab9bdd56,t,21000,1141882,,5000035,2018-01-30 13:49:21,51
0x93ea5536286463a88db266cc832445b004a418cc21f147ee22ef71a2c742779e,t,21000,1162882,,5000035,2018-01-30 13:49:21,52
0x61fec4cf42c6f01e57258469394128645047ea06d4c7db4fd250a9268588c4c2,t,21000,1183882,,5000035,2018-01-30 13:49:21,53
0xbc2557778fd9f833f19c431f79501347e32822c16042f213217abdbfc15a440c,t,39512,1223394,,5000035,2018-01-30 13:49:21,54
0x49e207a4d79076dce8e9fb0f18b93273275123119b727c982361414fc53a1eeb,t,21000,1244394,,5000035,2018-01-30 13:49:21,55
0xa5612d8462e423cf10e287278c7888a6955e9aa9d4a6c8b6f57458152a13a508,t,21000,1265394,,5000035,2018-01-30 13:49:21,56
0x390df15210cff81766434661e9916f572d2aa2796ebe686c7fdffa6d151ac5ee,t,21000,1286394,,5000035,2018-01-30 13:49:21,57
0x142e32e5e339b71fe1c30268fa689dfd9f4c95ed0a5359bd4ce6867ece14c73f,t,21000,1307394,,5000035,2018-01-30 13:49:21,58
0xbf77f2a66aa7cbe09469547c36c725ac63044ff08447d27f5f0a93562bb001d6,t,21000,1328394,,5000035,2018-01-30 13:49:21,59
0x360f1c6ff98f01370bbd17d3b0f303e5d4d6bbcdeccfca621640000e034e7339,t,21000,1349394,,5000035,2018-01-30 13:49:21,60
0x72f031e55b17b1641997af313629e9d35c1c536c059339fcaa22a51d243ad0cc,t,21000,1370394,,5000035,2018-01-30 13:49:21,61
0x30e20e54fb74917e04a67caefed89ecb1764cf21e32b31021455381edabfb768,t,21000,1391394,,5000035,2018-01-30 13:49:21,62
0x2af21c68b46cb21ca1644fdcbc4bc8f80b1a3a4b6ee10a8e78f102ff2a13009d,t,21000,1412394,,5000035,2018-01-30 13:49:21,63
0xc8a460ca39b95f8ff7b0c7687622b294b3ec34ad7edf5b68dc58cdee6c6d6bfb,t,21051,1433445,,5000035,2018-01-30 13:49:21,64
0x94f9ff58d482a94cc0e58285a32aeea1dbbc8fc1ed70274281fd56e72ae25378,t,21000,1454445,,5000035,2018-01-30 13:49:21,65
0xcdb6d2a4ddb9045e7b0b4798b072d801af2a4778dfce69965c3e9732f95a1472,t,21000,1475445,,5000035,2018-01-30 13:49:21,66
0xfb9161d846e8ec91ee4fa03c9281cf31656523fd3e132ab964d3f529cc430cf0,t,39512,1514957,,5000035,2018-01-30 13:49:21,67
0x80e5e342a3d2ae0a0c0aa324accad5756a7a07c9588d066a050e2ee344a3f693,t,21000,1535957,,5000035,2018-01-30 13:49:21,68
0x1ec8fc28f1e02a6e8bfac10a6aa6a0c6f7cb946b546c97720c051b0f43892247,t,21000,1556957,,5000035,2018-01-30 13:49:21,69
0x31694ff5c8642c6c4658bf74484e5828ea6dc05aea84f2393cd17e591042cd30,t,21000,1577957,,5000035,2018-01-30 13:49:21,70
0xec6fe9a9bafa943f30880dd795ee7b4a2e863dd81ac8372e0e647a2a037cf3fd,t,21000,1598957,,5000035,2018-01-30 13:49:21,71
0x88730a0933d8e4bfcfe3a4e239ff0273c1d86191d9d59771cebebe5755efe73e,t,21000,1619957,,5000035,2018-01-30 13:49:21,72
0x2594c46328d30858c9d40267cc165eba46f46b507e8098dfda15f0bc3649552f,t,21000,1640957,,5000035,2018-01-30 13:49:21,73
0x5c47f915dd210644b76c5672b191b6c120225eaffd9517c8b91edb30a34724a9,t,21000,1661957,,5000035,2018-01-30 13:49:21,74
0xff3ba919fe02d08dc0db2ec32021cf8a513d475eafbb9fa48e4df87912713d1b,t,40843,1702800,,5000035,2018-01-30 13:49:21,75
0x1b5fe45d1b8773313eb567cd67602832e1b0b2b51c57c7035f6f58bcd1a6bf0a,t,21000,1723800,,5000035,2018-01-30 13:49:21,76
0xf77994e955d3466729105eda8c414fb464c01299261508c63b1589fdac19fbb8,t,40907,1764707,,5000035,2018-01-30 13:49:21,77
0x5984d5790ed16f67f0cb0b975138d06d54248aec6c05ec06044ba3da0698d9ab,t,21000,1785707,,5000035,2018-01-30 13:49:21,78
0x96e90aab9a43d9d674bbd6fbb0ab0bd76dac5da62feb8c2f0aa0d6f97a25df8a,t,49250,1834957,,5000035,2018-01-30 13:49:21,79
0x124f634a4d2d627f56568230f5f7e63d94ca107af523cf52b714d7bda8abe135,t,21000,1855957,,5000035,2018-01-30 13:49:21,80
0x85d9a2af81163d591c9f838aeb759365a20a01bcb71a3257bfe50aae6258f75a,t,21000,1876957,,5000035,2018-01-30 13:49:21,81
0x80c0908eba981b9402ec7c3a837571752cc7fe073c530c4e5524e10f7bdc9609,t,21000,1897957,,5000035,2018-01-30 13:49:21,82
0x24868e1429ead000163c907a756c250da1c9275cbfa7e43c3102d44c396b29b9,t,21000,1918957,,5000035,2018-01-30 13:49:21,83
0x10f9880a98cce6b7df966dbc1e8cdd9148f7d923d2fbbdbbccd997407cb4f449,t,21000,1939957,,5000035,2018-01-30 13:49:21,84
0x1387096857d19185e2a90dcb6b871b8397d05f1692cf77614d097ca40b1c7948,t,21000,1960957,,5000035,2018-01-30 13:49:21,85
0xc28354c1454049590a128fa7993f4b2b6e5ce2210bfe75e4b359233d4524b0e1,t,21000,1981957,,5000035,2018-01-30 13:49:21,86
0x839f3ded6efdea00f55a192de5ebeac776c6c87dd126ed345737eee1ff3530b1,t,48900,2030857,,5000035,2018-01-30 13:49:21,87
0xe19d86fd6ce2d417c48046bede122d3027998436c33b5e1944f8b29ebc3bbbd8,t,21000,2051857,,5000035,2018-01-30 13:49:21,88
0xc67f8a27b754dae5b21f88a16525497912146d929d8c92c5b3b61df2fd9f913c,t,33177,2085034,,5000035,2018-01-30 13:49:21,89
0x58c870205b6e8ce81712076960dbf248261399ae90ea506d45800462a5e6fe9f,t,37307,2122341,,5000035,2018-01-30 13:49:21,90
0x9cefe2120f01ec7c98247fe75bdf7615f28f917c8cb83923918bd40b6d5091ff,t,108242,2230583,,5000035,2018-01-30 13:49:21,91
0x1281d840c982755a050fb47a788186ceecb5749377385a06878b2ff7b36dca1a,t,21000,2251583,,5000035,2018-01-30 13:49:21,92
0x8f6bd6aca2c8482ca5e84228b23e8bbca431643ec68605d1f3e3c51f1086ab3f,t,52179,2303762,,5000035,2018-01-30 13:49:21,93
0x1568cb918083a58e3ed6ead156c16503facd3866443810671691040bb8063456,t,21004,2324766,,5000035,2018-01-30 13:49:21,94
0xb6e28137f3ad00e92e6c6ef1a9b6b80a2d8108d038d45ec4acad5a1f6510b22e,t,45918,2370684,,5000035,2018-01-30 13:49:21,95
0x110d1bf80baebc57f38c34e86c1514ea0dfb56ce541e4f871ef9bfb842bfc0bf,t,21039,2391723,,5000035,2018-01-30 13:49:21,96
0xf729d2873fe537113f5c8c704b72a512c585ae5eca45a15068b2d600c04845fd,t,45918,2437641,,5000035,2018-01-30 13:49:21,97
0x2f33d99b6e6a77277440713f0962f89e957f67ded5a966cf89f3c0a7ad80db41,t,21004,2458645,,5000035,2018-01-30 13:49:21,98
0xf74e140e8f21a605e9db7f4a50fa2cd9c07e81e717c972c9ff49ca2ca32f80a9,t,21000,2479645,,5000035,2018-01-30 13:49:21,99
0xe86e96a014be214672d851cc28fdcde0646970afe724524e873d2fd54eb72d82,t,70337,2549982,,5000035,2018-01-30 13:49:21,100
0xafc76e35ed78397a1ca04ae6ac59fcb173768e3b8ffe8c173ef7939c897c96a7,t,37900,2587882,,5000035,2018-01-30 13:49:21,101
0xbd375a838dfac1546884004486cb96c5b9084ec982989588ca57acb0547eaa05,t,21000,2608882,,5000035,2018-01-30 13:49:21,102
0x255c7838371a41683614bd462a417eb4b0692bba974bd9ec3b82be423fedb7eb,t,21000,2629882,,5000035,2018-01-30 13:49:21,103
0xb47cf8d29fc9f5f39c166d7f5f38d5cd5386884f42d0975ab40507837d1c8672,t,21000,2650882,,5000035,2018-01-30 13:49:21,104
0x3d2b5b9e4c2a1c342bf87986545a52ff015cd37b3d6681f5fa787e88fdbc931e,t,21000,2671882,,5000035,2018-01-30 13:49:21,105
0x167d42509e92dd23f80355e76ad09e7ee54ff1fd04c60b0a03964404846eb670,t,21000,2692882,,5000035,2018-01-30 13:49:21,106
0xbac860a716222befea17d1aa29197f753970821dc0ed31f44258043837d6ce59,t,157580,2850462,,5000035,2018-01-30 13:49:21,107
0x3f0f95aa46243a85524008574563694c58c5c0c97aa9b669fa828f345f3144af,t,52380,2902842,,5000035,2018-01-30 13:49:21,108
0x43e6a5260714d14d7622e2aeab8e9e7d2d1f4af55ea870557f7069e511e64b69,t,40779,2943621,,5000035,2018-01-30 13:49:21,109
0xcae110b38aa623a26dc56019182f22cbfa363c075dc4f17e31bdc99e0bfe8b01,t,21000,2964621,,5000035,2018-01-30 13:49:21,110
0x49095b19f97830fad91e88c54380ff67533ffd9908181df974e36ed38b1931d5,t,21000,2985621,,5000035,2018-01-30 13:49:21,111
0x2d60d3f9c04716e49404acf00a248767ab10c86b4e40a403f4a38d1c4514337d,t,37356,3022977,,5000035,2018-01-30 13:49:21,112
0x1316f395a5008d5f463a53be676f107646dcb95dada6587fa984e62bdd3cc0ac,t,21000,3043977,,5000035,2018-01-30 13:49:21,113
0x9e8f7173f1f13af94d601fcd3c85a81a1ce925f1effce7e5cd0cece8fc4123d1,t,21000,3064977,,5000035,2018-01-30 13:49:21,114
0x9e72aa4c7ed7e0ce76b9dde4b28b7f13d1081d4a392e8a9ec18552ea347540fa,t,21000,3085977,,5000035,2018-01-30 13:49:21,115
0xc22583d7cb355734b3099ca246e179fde46c16367903a96ba2cad16566b1de5c,t,21000,3106977,,5000035,2018-01-30 13:49:21,116
0x9baad2ae8375416dc188895f254696261077757675fc827898c9252301841b39,t,71296,3178273,,5000035,2018-01-30 13:49:21,117
0x9b1ed2860b44b9a80785df644d959194577645ae5f6a3e766cf4a68f51268170,t,21000,3199273,,5000035,2018-01-30 13:49:21,118
0x5a27c93b36d158e07e773fe3d9760e24391d6d99492952bc1039c6efa88231e4,t,21000,3220273,,5000035,2018-01-30 13:49:21,119
0x124410c3b40e485c06256f83f8899d2cf0a80567109fefe521eb71047e02920b,t,21000,3241273,,5000035,2018-01-30 13:49:21,120
0x64cfcd38320171c4787abf547ac7bde9c35c42e6f5633c1c4a5e82b8f21a7df3,t,21000,3262273,,5000035,2018-01-30 13:49:21,121
0x2f1283953a0bd26c6f5cf56fe38f2991cae702122eaf38934d7c98bd068d2c19,t,21000,3283273,,5000035,2018-01-30 13:49:21,122
0xb9f6668ff3748118987bd7ff2066b6a0993816892e47f0796c8f8fcad2e11dfa,t,21000,3304273,,5000035,2018-01-30 13:49:21,123
0x7e87ccfeeb354ba40f847d1b519b3887f283aff73da11a5df306158fb36dce57,t,21000,3325273,,5000035,2018-01-30 13:49:21,124
0x08edc47db8d7f2d596c822dd6c187bbf4a6477661919a87d464fdaa49ad1fcfe,t,21000,3346273,,5000035,2018-01-30 13:49:21,125
0x2e1a8bd6c65456f9c8553321beebe31ed2c42612df32551d275033df5183801d,t,21000,3367273,,5000035,2018-01-30 13:49:21,126
0xe0779387c300631568cbb994c6ffc1610e2070092ec4bfe987a7bb8a0185b3cf,t,21000,3388273,,5000035,2018-01-30 13:49:21,127
0xb01d302ad21db32f493aee311f507ffc2db72ecdfe9627ddae0be81d12b59abb,t,21000,3409273,,5000035,2018-01-30 13:49:21,128
0x00df68e017b125e139104d39e291faccb279c670b12fc9dd2890bc015332d451,t,21000,3430273,,5000035,2018-01-30 13:49:21,129
0xfaa65273f4bae9fdeff98e8364464a2c69f05552a01347ed3f1a3ee7f082d91d,t,21000,3451273,,5000035,2018-01-30 13:49:21,130
0xca167c5953c56e5e7538d6d0c42817431c3e4a84943df8bd16fd974a70315ae2,t,21000,3472273,,5000035,2018-01-30 13:49:21,131
0x7d35259f7459403f7b7bf61c768ca3ef8568fc86756c3b0370859b4900bb9a7a,t,21000,3493273,,5000035,2018-01-30 13:49:21,132
0x271a3455a7b21f66fb814039da4ae8107fb0e45779803704bca8428bbe83caba,t,21000,3514273,,5000035,2018-01-30 13:49:21,133
0x45638db67b96831a582e8140159a549cc36395593b9b4173964c1279251b984b,t,21000,3535273,,5000035,2018-01-30 13:49:21,134
0xde9d517548ad96777fad405bddd74be536beaea8ec311afde546489f18ac1153,t,21000,3556273,,5000035,2018-01-30 13:49:21,135
0x058bdc22303054412913198c3db15ec90b7432176a51094efb8b1902d6124148,t,21000,3577273,,5000035,2018-01-30 13:49:21,136
0x1fe9f1d658b1f1f44634df49b509f1a46990b69a6c0e2f0f69cf5cf59de44f91,t,36728,3614001,,5000035,2018-01-30 13:49:21,137
0x708532a770f4ee9a78ce846fc0ef34676de1d856a2de415a67a5e7e7165b46f8,t,30327,3644328,,5000035,2018-01-30 13:49:21,138
0xfcf4c7d0533a900115ad7964528948ad0246f31bb51bd23dabde748d665eff8b,t,25843,3670171,,5000035,2018-01-30 13:49:21,139
0x6aa89870b5dab220bbe5aa283fc6e929db51c4bcd2487067d791360e832521fa,t,25971,3696142,,5000035,2018-01-30 13:49:21,140
0x58d8282c21a2be6fb710e71d04298b31bdbede75ff2a5db6ad0168e8962bd695,t,58999,3755141,,5000035,2018-01-30 13:49:21,141
0xf78376c8617a5e8c73f29f49ce741cc0c1e7c4c2c5a5f360fc1188002d131d23,t,21000,3776141,,5000035,2018-01-30 13:49:21,142
0xbee221b58f784617b02c868a7f0837b936fae0c4fbadb398772256539bbed6f1,t,21000,3797141,,5000035,2018-01-30 13:49:21,143
0x539193a5cb18f9e51f13c8dba9a1e2eb13bad94b4e9e21ad1a47caa49f5a5445,t,36632,3833773,,5000035,2018-01-30 13:49:21,144
0xd34e7fa64b07f891fe9a4def5edc8c0785fd7de67b854d8d216c17f1b64b5425,t,21000,3854773,,5000035,2018-01-30 13:49:21,145
0x1039e1d6e9dc9ae63931c4b3edba682b3e1bbe01ca86e4b01ca08cdb64c51d83,t,21000,3875773,,5000035,2018-01-30 13:49:21,146
0x284d0c2fcd1c59cc6e5284d81c2991acbe5d1ffa5b43f26c361ae3d0bc0e2d42,t,21000,3896773,,5000035,2018-01-30 13:49:21,147
0x4c19a551e11ee5e437fa2e83333e258daec1673d412b876bacfa1f175e26de29,t,52822,3949595,,5000035,2018-01-30 13:49:21,148
0x0db9d72efe8c20b34081ad58c49fe6ab301fcab3152584f5347c462607b90218,t,21000,3970595,,5000035,2018-01-30 13:49:21,149
0xef398d2dbd460eef9dbdc63bc6bad6305d3c1b73094cd937fcc6b153708f5632,t,21000,3991595,,5000035,2018-01-30 13:49:21,150
0x0762f4ebd77705358272ab2d3c84a735d710657599fe9eace5145c0842eac166,t,37048,4028643,,5000035,2018-01-30 13:49:21,151
0xb462a928c8939d94bee2255fa403ff709953db2c85b39af5e76188ead30dbe09,t,21000,4049643,,5000035,2018-01-30 13:49:21,152
0x2df9a5904daae990af7cb4a666728559ce045eb65f34069163e636d6928294bb,t,253854,4303497,0xd67bCA454DBcae8D81960421DEe42D507DfE9944,5000035,2018-01-30 13:49:21,153
0x93ba11ae5e0d495f42a0da5935d300c85f6edfb337867f97381f833ffa73d3eb,t,21000,4324497,,5000035,2018-01-30 13:49:21,154
0x8b3d51135e05090592fc995cbe153ca223da1f420b0c77e2997c6803fc8543cb,t,21000,4345497,,5000035,2018-01-30 13:49:21,155
0x28deebd635cc09027370c4ba633dec1b773b350b8122a66a5bf21810e95f221b,t,21000,4366497,,5000035,2018-01-30 13:49:21,156
0xf3af9dcf7264bfdb648d75e601b386c4818c0e68dc9e53c1792ae2e5ff104c5c,t,21000,4387497,,5000035,2018-01-30 13:49:21,157
0x6f5fc6793fce665a855b512ab8ab007b845d6d1119185f14b31b6fdb5490910c,t,21000,4408497,,5000035,2018-01-30 13:49:21,158
0xedc5c25c568f397d7a81f5a3047519e5c53a4af4bd71a59fae8c5b4cfa49d089,t,21000,4429497,,5000035,2018-01-30 13:49:21,159
0x290d867318e062de1b163fe0b0041c2628eaae2edfaea17c9cb0b557773dacc1,t,21000,4450497,,5000035,2018-01-30 13:49:21,160
0x41876f5aeb55978d550c212644a18bacdd43db661e478f705bcc2c14bb16b249,t,52840,4503337,,5000035,2018-01-30 13:49:21,161
0xed7af7de88d73b1772358e854f4699485b098dc4d5a8ef2a2b11018306be3e3c,t,21000,4524337,,5000035,2018-01-30 13:49:21,162
0x99a4fd8ac03b57661e5bdcb38c8446ad8d3b5e7a8b6c55dd9ff633900be59ae1,t,21000,4545337,,5000035,2018-01-30 13:49:21,163
0x413136e30ac66549a5e9c8938526aa5ac3029c8abefe3140641553ee6cb74af6,t,21000,4566337,,5000035,2018-01-30 13:49:21,164
0x4dc12e6ba60289d7e787367c2ef25ca5c6a7fcda19285c0529ce591d30a09c51,t,21000,4587337,,5000035,2018-01-30 13:49:21,165
0xc55ccc4cf7fe25f3f294013bc5778198281a2147b9d3378c92abfebafd453c45,t,21000,4608337,,5000035,2018-01-30 13:49:21,166
0x146e6efaac303bb2190a43e24c8a0aac4242250a58ef9923325f8279dcab8bd2,t,21000,4629337,,5000035,2018-01-30 13:49:21,167
0xe7935d6b7c032b9a21d788f2a6e202f1e0a8abd0be1ebc00f0ee3897424275b6,t,21000,4650337,,5000035,2018-01-30 13:49:21,168
0xf3a32c177bd46a61f9169d7ad6cc927363c0ac556cd8c2ba4f89074d0113fecb,t,21000,4671337,,5000035,2018-01-30 13:49:21,169
0x4e98d4558a39da1d88a9b9fe6900a42979e25120a640dabfa04408b0718fd06e,t,21000,4692337,,5000035,2018-01-30 13:49:21,170
0xf13b89384808457af82d99a5a1ac01531cee21d7033a869c95f0faad0bab2221,t,21000,4713337,,5000035,2018-01-30 13:49:21,171
0xb50fe187887865da3904e5f6f5fb30bee1b961e51679f33a42ddde2d24e00d98,t,21000,4734337,,5000035,2018-01-30 13:49:21,172
0x622374acc47b4bc16bf691eaa8e9a65bea435d7c08d378d388cddf54a41a352b,t,21000,4755337,,5000035,2018-01-30 13:49:21,173
0x26b6cecdbae1bb7ec7aac08a9891cdfa91c7d778bf72c24ed144bbd67ae15854,t,21000,4776337,,5000035,2018-01-30 13:49:21,174
0xc27aa3a4f2e9b20dad386a79af75e002995d62859357f7eb24c539ffc00e2e2d,t,52776,4829113,,5000035,2018-01-30 13:49:21,175
0x5af44c55c9e7f1e50ef2f8e3083e855fb60bef48f77f9d8d3308be17c8fcdc68,t,21000,4850113,,5000035,2018-01-30 13:49:21,176
0xeeb600068ee05a66609f203f61be351612bee703585c3728e1b204123123b6be,t,21000,4871113,,5000035,2018-01-30 13:49:21,177
0xd9251313ee4ab488b4c055cb769616dd315ee38b076f811ff12335269de70053,t,21000,4892113,,5000035,2018-01-30 13:49:21,178
0xca1be4882767f95bdd1eb3df69a066cbda6188f3f26d65b4c12ed5dbd1768bf6,t,30327,4922440,,5000035,2018-01-30 13:49:21,179
0xe15759d2651d1665202e037ec62db8748a94a64830a598c7cbdebb4b18d5049c,t,21000,4943440,,5000035,2018-01-30 13:49:21,180
0x381158f006b1b172b96c127ff0239439bdee8d78ec3cf1529781968202806a20,t,21000,4964440,,5000035,2018-01-30 13:49:21,181
0xbbfe860d769439b87f05e3343bdf6edc5a2de814e95af56adf12c5ecc31278e7,t,92605,5057045,,5000035,2018-01-30 13:49:21,182
0xf63c82ebe3662e83d857dea099460aa35cc6c7b602dcbc9806a349f8ab04b5fe,t,46203,5103248,,5000035,2018-01-30 13:49:21,183
0x44f22b515423372d7d145290ad4af1d34485e4591215cd5e1d4fd1f05aa8d8a4,t,51877,5155125,,5000035,2018-01-30 13:49:21,184
0x27173350fbd6f9ff1123e58f428df7e9c11f443b5d9de2f3c4ce381996108a21,t,23316,5178441,,5000035,2018-01-30 13:49:21,185
0x7fdf008507dc07ec9926599b59b471c16cf0f264d45786332b39d0a1552c5d99,t,37950,5216391,,5000035,2018-01-30 13:49:21,186
0x5748e86ce92d27c2ddd3f450a14ad16f243c3e8c94a5a758cc05b8a6acdb4ace,t,75247,5291638,,5000035,2018-01-30 13:49:21,187
0xfa5853b5de985c9e796a7da24cb5b80d790bd45d0170476036b123a8168cc2e4,t,59098,5350736,,5000035,2018-01-30 13:49:21,188
0xf7c8cd489b8cd9215e62d161721bee55ceab5255180ede9dbc79fa4e37738b73,t,36557,5387293,,5000035,2018-01-30 13:49:21,189
0x8595063a16df5a4073bf73318404aea22c4dc378d8b8cbed941eccc689b855cf,t,23318,5410611,,5000035,2018-01-30 13:49:21,190
0x5d20ea9cf15190a94d226f9014250b3535a45834042dbb56dc763acd9631522d,t,22460,5433071,,5000035,2018-01-30 13:49:21,191
0x0cfb0a04c4056a576649f0191b904160a5c1c362a75e2e42dc234c5c0becba76,t,23040,5456111,,5000035,2018-01-30 13:49:21,192
0x37ae189ce25c510eaec363def43aa5d7dd4590ef8c049ef5cd237bef8cdccddc,t,22316,5478427,,5000035,2018-01-30 13:49:21,193
0x49d11c380e39391ef66d5004f5a4d6b127cdd4f68133c7bff3794198d782b3f1,t,22524,5500951,,5000035,2018-01-30 13:49:21,194
0x3ba9fba7b0b7acddfcb685e23f539b0cd4f4ec1c24f25a62d957c7fb6c146acc,t,22460,5523411,,5000035,2018-01-30 13:49:21,195
0x0884633b9bef2ea21691f4996aea72b1c4539787d1b60633734a4f9df1b544c5,t,22380,5545791,,5000035,2018-01-30 13:49:21,196
0x1649105b4314b193548e09d42946eabd7bcd7c40a6ea285c7e42a270331daf76,t,21989,5567780,,5000035,2018-01-30 13:49:21,197
0xde87c0da313a1a8e5ebe81f070d2a9064bf6ac6a705ac6512b27d601c206eaa0,t,22402,5590182,,5000035,2018-01-30 13:49:21,198
0xfbaffa5001d6e70d1d5c8d5c896e875af96c641dd58d1c36d4a91447c05d0d84,t,22524,5612706,,5000035,2018-01-30 13:49:21,199
0xff39681860a4a8e9af55b5fbf0b80637fae97c2b83af4111627ed6a45f999ebd,t,22460,5635166,,5000035,2018-01-30 13:49:21,200
0xdd6ac77c975117dea10599c6fd798679de6b7a322674885aa5079178f0f4cd90,t,23254,5658420,,5000035,2018-01-30 13:49:21,201
0x007a5b96679b7bf88e9ec1f55efc1f108e853083694cd74d244c6064cc6a44b1,t,22071,5680491,,5000035,2018-01-30 13:49:21,202
0x91dfdea2a8f6c989f562319864a38cef8862453cbbcd3e78114ce7015febe911,t,23318,5703809,,5000035,2018-01-30 13:49:21,203
0xb83bdd29e00cc7622331f5942392c5d8ae85f27e0a966dcf5159d14a4aa775a4,t,59418,5763227,,5000035,2018-01-30 13:49:21,204
0xfc6c84d2cb6b020d68a566b924b4f038e38a7f68a078144cb35bb021fa96ad67,t,21000,5784227,,5000035,2018-01-30 13:49:21,205
0x206dad61035b93638cdc4a704bb75e43be7144ce49de5abd48a7407797b39637,t,37904,5822131,,5000035,2018-01-30 13:49:21,206
0x9bd5d514a6176fc30d9e89f1a3f7bf53ffcf0caad7c688875432332d7ee024e1,t,21000,5843131,,5000035,2018-01-30 13:49:21,207
0x62df346c7fe90d7cbdf6b0ecef3838b4091eb0ac16367d6efb8b2e3c79f640f7,t,21000,5864131,,5000035,2018-01-30 13:49:21,208
0x06391054ef3018675a2db598fd782f51e8e1a5c842b35bc6a5d1a9e98b0e8222,t,59290,5923421,,5000035,2018-01-30 13:49:21,209
0x9285e597452314b2a0704a6782eaae907ffeec7965eaf2444feb58d2530009f4,t,59354,5982775,,5000035,2018-01-30 13:49:21,210
0xd7c74d1286b5c524f74e4a5699fd43b26655a625a7218280ee9ba046f58dbae6,t,93114,6075889,,5000035,2018-01-30 13:49:21,211
0x233f8a99937ad20cd2a5452e924f3a8c15cf98b7a84a7e08d39b0f1eb7d7b2ca,t,29493,6105382,,5000035,2018-01-30 13:49:21,212
0xc4d17fe4eef40b7a0d95b81eca52ebbc64f0774f8cac2c5ec852f6e8cc339456,t,102998,6208380,,5000035,2018-01-30 13:49:21,213
0x3fdcd84b698e9f643cccd13d9328141950fc1236a89cbb466b23a02b8faae220,t,45675,6254055,,5000035,2018-01-30 13:49:21,214
0xdd94dda361bbe31258d95132a8fcf082eef5028076cae0ac7ef97f0297e29481,t,23028,6277083,,5000035,2018-01-30 13:49:21,215
0x4dec27764c9cc923c9d0ca82235ca1f461401cd38f820d682a0ba84b59165748,t,37501,6314584,,5000035,2018-01-30 13:49:21,216
0x6ae0f5e4c1116512f7258d1b918147107174f23352f9e6e831ae970f01c837d7,t,25604,6340188,,5000035,2018-01-30 13:49:21,217
0x6703e72082c9cf7bbd98c21ee9263f4871bd5b86ee7b37b3498ae1b30ea0e380,t,34291,6374479,,5000035,2018-01-30 13:49:21,218
0xb8eb366c8d046c4371856493400f3270958e28cc2b6ef223276f26e0c0e5273e,t,46045,6420524,,5000035,2018-01-30 13:49:21,219
0x5f945aa784dcc6a646878054f305ff2e8800616bb46b22dce7eca966c4c7ee4c,t,93050,6513574,,5000035,2018-01-30 13:49:21,220
0xd6d6ccd3a04480d71de7061030d94f865601f526fce58563ff2c1ee73e4b67d4,t,107794,6621368,,5000035,2018-01-30 13:49:21,221
0xd0e2346071de26e2ed267c748da75ee52ebaa72b4e5c36a072670f1334632f29,t,174591,6795959,,5000035,2018-01-30 13:49:21,222
0x1954a6184a85def7fce770f5fd10b93f8adbcf1d3963f7cfb5eb99e53d8502e3,t,21000,6816959,,5000035,2018-01-30 13:49:21,223
0x9433249e1888d30635cd4b0ef9dd87f3b40cd0bfade691bcc2e2190495ab887e,t,93114,6910073,,5000035,2018-01-30 13:49:21,224
0xa847b7a3c7204419ab9c7dc7962150e2f543c3417e86f887b17f8a8d70cb97c7,t,93242,7003315,,5000035,2018-01-30 13:49:21,225
0xa2d67587901fd07884b3c99119450fb578025804de74cc95e97a79bed41808ac,t,21000,7024315,,5000035,2018-01-30 13:49:21,226
0xd8a5ff2acce09dbc43cbbd5f89413bf2d2f49c21968aad7f2ff66f291ec1ab55,t,66319,7090634,,5000035,2018-01-30 13:49:21,227
0x023f18619f040d45733427c442efa503d2b4b3cc9406980d3a315114819c0d95,t,22474,7113108,,5000035,2018-01-30 13:49:21,228
0xb423b13dc76cae0d74986adbf2cfb71716917d0f6df9cc2b7a03a374b145d68b,t,93306,7206414,,5000035,2018-01-30 13:49:21,229
0x3ed20781a2f3563acd6314def5149de26e6e868efd4b3cc72d75ee7dc3274bb7,t,59418,7265832,,5000035,2018-01-30 13:49:21,230
0x7256fae7f7d172f0d8c4513467414e030b328cd91ccdaaa71d5c0c033f2360e7,t,44290,7310122,,5000035,2018-01-30 13:49:21,231
0xbb6900f91cbd9507e3d2ae75c47a540c5ef909a7c25c445d35f0fada0aad1846,t,92794,7402916,,5000035,2018-01-30 13:49:21,232
0x8698a8c101e4f1465212d44f12184c4c457c552e5b68b92e4d5400b6f7bdbd3f,t,40704,7443620,,5000035,2018-01-30 13:49:21,233
0x193407af8fce33d25bd65b56dc0cc11c5e6fa1e8b2c49ce681a0d624db0ffa09,t,22474,7466094,,5000035,2018-01-30 13:49:21,234
0x34e77120cabd9ddfd5dab29be6cd36f3f254b7a3cf25cf1caf94a6e3e04a72b2,t,37643,7503737,,5000035,2018-01-30 13:49:21,235
0x7220aa410e02e8dc9c1d400ca385866584bba820a7924a6da8d2372f727e2ec4,t,43779,7547516,,5000035,2018-01-30 13:49:21,236
0xf1b714923fb5e4438ebae43459830bf17559d63d24066b5fd87c1576edf23e13,t,22474,7569990,,5000035,2018-01-30 13:49:21,237
0x28369c856e47798012f174ac275d88942e8822c81f4531801498bf4f49eb77d8,t,107794,7677784,,5000035,2018-01-30 13:49:21,238
0xe62fa3db2e364f263ecf7ca9ff44eec28754929552caa04f17a03116945d6f42,t,51560,7729344,,5000035,2018-01-30 13:49:21,239
0xe72824464f98d71ab4fb1c9af906ae8ee2fa863271359412f4bdecf02567522c,t,21000,7750344,,5000035,2018-01-30 13:49:21,240
0xcb402db151342c618adc86313e366bcf79d0e991db0c3dac036898c28b2e3e63,t,21000,7771344,,5000035,2018-01-30 13:49:21,241
0xaeb546d5f391227f0791dff8c56f9398f95cad25576447e3fa9e1fd58e95f98f,t,39771,7811115,,5000035,2018-01-30 13:49:21,242
0xf27117a7ca3a70604387a3d2860a188021ddb7f1ab56471ecf30950f749d3c95,t,21000,7832115,,5000035,2018-01-30 13:49:21,243
0x380ac50786c278e445738d5dd0ea200ed52adae3b2b82ee5e7318912e4a0b2e1,t,21039,7853154,,5000035,2018-01-30 13:49:21,244
0x2e7a4f4a1f803b8f200b5a6b8086c53c175ea1092f9860f24e215b959909652a,t,37151,7890305,,5000035,2018-01-30 13:49:21,245
0xf5a82ed8b14f2db2e267bf0b26aea15b568cfe5aad5da6979cf4e29df34d875b,t,21000,7911305,,5000035,2018-01-30 13:49:21,246
0xd4eb8351fdaa84c27d228d2df7bd840628ef09beb3df6bed76f79c6e9a9d63df,t,21000,7932305,,5000035,2018-01-30 13:49:21,247
0x7bc13690bcf62608db40ffc4fa050dc2ad16bd24aec18091541ac306c8065cc7,t,21000,7953305,,5000035,2018-01-30 13:49:21,248
0xfff3e669acc634b42fe68d8aa137b117e28cefffeb079bbad07df162ac29fd42,t,21000,7974305,,5000035,2018-01-30 13:49:21,249
0xa9c1783e50c8bedc5dc1819196d72331a4f85d612e390f03858cac3553283408,t,21000,7995305,,5000035,2018-01-30 13:49:21,250
0xcd0897ed7e78ee7f3df28241ae0705e6dadc251d039c9aabdc89a8127c29ff28,t,21000,21000,,5000036,2018-01-30 13:49:46,0
0xa1cb661416b7278d7065b187073c8e7ba1da4170caa900b8c7b7a07f7b60ef79,t,21000,42000,,5000036,2018-01-30 13:49:46,1
0x9c31abb293adc07995651a62b8cd139882b82248a5134836acc0ecbfb57faaae,t,21000,63000,,5000036,2018-01-30 13:49:46,2
0xffd595d2e7baa0c9b98e942e91a4c297d106626432eff9e6d01ec10c2dedac8a,t,21000,84000,,5000036,2018-01-30 13:49:46,3
0xc4ce0dc41c3c140cde888718afd6256435c4c5a00bae0ae9ebcb5c6ca49f7d0a,t,37565,121565,,5000036,2018-01-30 13:49:46,4
0xcf273eb95f7b3d2c84a47119b0c0101b2a0ba8d3520d6bd4baeea005281d26f3,t,52848,174413,,5000036,2018-01-30 13:49:46,5
0x96850b69f1fb3d234bdcb74f401f89f6a7ed50ea80108e732ea85a43aef82a36,t,21000,195413,,5000036,2018-01-30 13:49:46,6
0xb87f593252bd63ac65790bcfc8ffa08591e2415f190172d8306992c59d6a320c,t,52219,247632,,5000036,2018-01-30 13:49:46,7
0x8da6789e204d69632f299e95c4ab4d90488c7163b9229ab9a51bdb3631e6eb4a,t,37027,284659,,5000036,2018-01-30 13:49:46,8
0x70f3111d9bed9c33207f6fdc4f40e6d8882a4b03c4c8d13bdce15e6782f80236,t,21000,305659,,5000036,2018-01-30 13:49:46,9
0xbe0fc9d188a00b651dd69070cf091d26d7f1d012a79536320a27b714a02358ab,t,21000,326659,,5000036,2018-01-30 13:49:46,10
0x435031a7f65056aa8b01d762ff01dc6c983178716b6ceeb38517018ca5c1f2f1,t,21000,347659,,5000036,2018-01-30 13:49:46,11
0x8943c36dee16edff92f81bb7f5faa804c2ce7213ecc04df4c5791bffca979d2c,t,215038,562697,,5000036,2018-01-30 13:49:46,12
0xfcb123660b417c40f589da78d7399e258e562f550b6a9cf07a450024d63f4c91,t,21000,583697,,5000036,2018-01-30 13:49:46,13
0x1b19975bf6b0db02016fc291b25eed328c9ecc263f86592c18087b559e767906,t,55843,639540,,5000036,2018-01-30 13:49:46,14
0x3f3abd500b57d90ba9e40624df9bdf0f342f7a3e5a515e95d6aca4da8f592be8,t,21000,660540,,5000036,2018-01-30 13:49:46,15
0x4a027861e9b60b735a32c261332d5f64fe53b4116a2148c8e422eaae042a1e00,t,21000,681540,,5000036,2018-01-30 13:49:46,16
0x58170201b89306f760c0276bcff46419a7fa54c67a62a18d482c29af70c10697,t,21000,702540,,5000036,2018-01-30 13:49:46,17
0xc3c3562602ef93ee195e8bfe0e58927d18a3cafe0ad100f58f95e0b203ba611a,t,21080,723620,,5000036,2018-01-30 13:49:46,18
0xbbc333fb7b20a23d3e849d03d0bf973aa064aa9954d8358d90d8cc4fa84fb444,t,21000,744620,,5000036,2018-01-30 13:49:46,19
0xce9db64bdc1b3c4930563a95d193337a419e0f0b9c8dd1b4fa354f1af24261be,t,21000,765620,,5000036,2018-01-30 13:49:46,20
0xb5107e909c81c9338163f3752294ea96c1db49ce8e7117e80f3744da1d5285a9,t,31001,796621,,5000036,2018-01-30 13:49:46,21
0xd1ab89af04bfc4831b62a4636c98a4effe9b0fbfbdb9d1f1d817e11c0e8254b3,t,21000,817621,,5000036,2018-01-30 13:49:46,22
0x0e0423f30f4cfcec2293a2a8bbef75a742f4f686853bae080b2114275e6e80c8,t,21000,838621,,5000036,2018-01-30 13:49:46,23
0xdb48580677f21599ce06c8c3b6c98a706a08603c6a4ba5ade1e6b01b1b5d0fd1,t,21000,859621,,5000036,2018-01-30 13:49:46,24
0x08e29943d7a22d77201d143ec85b67eeebca8a525d79bcc0d9975c36ff207f04,t,21000,880621,,5000036,2018-01-30 13:49:46,25
0xd475b6e399cbd3f7895d390c0fce6736067d6ec99bd856809af269ad8f554f7c,t,21000,901621,,5000036,2018-01-30 13:49:46,26
0x8e9536140972b1d3722fa7e9632b19882c6daaac43b9607d40f0e5f4fdc32f66,t,21000,922621,,5000036,2018-01-30 13:49:46,27
0x7c297a08a453060ebb8a698bcb2eb2f01d0bf63abb617313650935e489b6f106,t,21000,943621,,5000036,2018-01-30 13:49:46,28
0xffb60db9164f5a7800de256b7a6425d47c4903601ee066c893c3fe269c3bed9a,t,40995,984616,,5000036,2018-01-30 13:49:46,29
0x5b7834596427778ac8f1ef559e43929426fe9f9f4a70d17476719d4ca1449cf9,t,40843,1025459,,5000036,2018-01-30 13:49:46,30
0x789946b9c69b0a2236aab54e0dd12286c7471e7aaeda968b910248dc4fb10881,t,51883,1077342,,5000036,2018-01-30 13:49:46,31
0x6d95c350de7f9db3c2b3ac451494f47a1d06ac4a89f3b684114c4e784212601e,t,52316,1129658,,5000036,2018-01-30 13:49:46,32
0xa668a0f8bba22ffe9047fc329f22d152893bc6fb9fe4929e5430db82b921a55a,t,21000,1150658,,5000036,2018-01-30 13:49:46,33
0xcf80553a40efa54d5f5cdc62e45219b680c3c48a9828a61295f6618236ab1f89,t,21000,1171658,,5000036,2018-01-30 13:49:46,34
0xd53bf938fbd7fb5b92565eeb09c534a61e8d698ef3518f1b4946a02a89135e79,t,21000,1192658,,5000036,2018-01-30 13:49:46,35
0xa56748d1dc7a0ae92ec2a05905b2caa0224588b2ecbd42661e1465c962a3480f,t,21000,1213658,,5000036,2018-01-30 13:49:46,36
0x41698453aaa8f14b0449efabbcdf9bce8b472060cc1c93011dd6e978d25841e1,t,21000,1234658,,5000036,2018-01-30 13:49:46,37
0xa408cf8979366cea602c023f4f289b51364eba5231447445108a05d915a85daa,t,21000,1255658,,5000036,2018-01-30 13:49:46,38
0x375d94b6e88cfc9564f6e659966569d8bbdadcc3d21c5f5b8f0f9350cf1c5598,t,37371,1293029,,5000036,2018-01-30 13:49:46,39
0x2657f888bd1f2ae8234f37ba428d07961d96ded1377eee435de9fbb4a68aba1d,t,44418,1337447,,5000036,2018-01-30 13:49:46,40
0x477062f6bf81a7a2f75c5dbbb494a8c5abcd36b2321ab3803b6e479feec6a70e,t,21000,1358447,,5000036,2018-01-30 13:49:46,41
0x27ab7f07a8a16851e8dacd3d4f2cdd25c0efaf4261918d1af17f67d497a2758b,t,38382,1396829,,5000036,2018-01-30 13:49:46,42
0xa8b79be40339dc04ae694940f0bd768effe6ac91ebad5d7c818a680ddd546f2d,t,21004,1417833,,5000036,2018-01-30 13:49:46,43
0xe5d153abd5e2353507ab78fa1d93660d7ebdb3af3f8c4750d42fbe96c6b7e82f,t,21004,1438837,,5000036,2018-01-30 13:49:46,44
0xd6325a38c3bc3be40b25220f839c3004abd44ba9f116776d2af01e9197e1afea,t,22027,1460864,,5000036,2018-01-30 13:49:46,45
0xcd1e8904bf7cdc884168c23743f998b78577f809529ff5cc803f9d88380d8aec,t,21000,1481864,,5000036,2018-01-30 13:49:46,46
0xf7b95faeef9a2ca2f331f93991d14da282eadb7116a6b86bfde189b7f0ded74b,t,21000,1502864,,5000036,2018-01-30 13:49:46,47
0x00e7b30bc93fbc7a7bf711a033f9892431ff9c9bd7039c178aa6ccdb2c69e0eb,t,21000,1523864,,5000036,2018-01-30 13:49:46,48
0x5d49137b59e7a7db89b0ada660ad9cb845b449cd81bc9b9d74ac1ee122ae8306,t,21000,1544864,,5000036,2018-01-30 13:49:46,49
0xc0cb3b4d5ac0aaa12d9370ccae8935246a6d8e8cb20f3a47bf3a46ddcda54eb1,t,21000,1565864,,5000036,2018-01-30 13:49:46,50
0xc1a56e9124fbc3055b111d0a6be81ea3f15a2c1a05416b7145313b5aa48261bc,t,22091,1587955,,5000036,2018-01-30 13:49:46,51
0xccb7bf4fdd04e0c159a46df44a37e6afe0008602892cfdc7868e2f72b0680e43,t,21000,1608955,,5000036,2018-01-30 13:49:46,52
0x83e44d99d28b577d3a7271fb665f8e47b98e66f2768ffd595b7890b79afc54c7,t,21000,1629955,,5000036,2018-01-30 13:49:46,53
0x8b8b5d3ccdb0e81fdd8f5ad2adcae2780c7ba37234fe292e590e7f44aa785ed4,t,21000,1650955,,5000036,2018-01-30 13:49:46,54
0x5ff0e716a0897f8766a7a3f20a62c04dbc42257d9e18d00bb65b2389426493cf,t,21000,1671955,,5000036,2018-01-30 13:49:46,55
0x3cef2cdfe5df226cdbe0c53c5f9f1cd76138069fd90fde67015b1c1c5e7d20bf,t,52258,1724213,,5000036,2018-01-30 13:49:46,56
0xcc268bc58de137c29d23b02bc4dafeb25975d89e75d3cb073e711d06bfa12ecb,t,21000,1745213,,5000036,2018-01-30 13:49:46,57
0x7cd788dfbff408c589ef8d157bada161bb6621321baa1659460ac83407225d59,t,51590,1796803,,5000036,2018-01-30 13:49:46,58
0x6fc62fcac654fb35b503e08ebd228f63beec6a1f5ea16d950745aebc28c669d5,t,21000,1817803,,5000036,2018-01-30 13:49:46,59
0xba6bec0a72eb32492f9a1474be9790dbbf819bdb67272acfba96f23bffc8092e,t,21000,1838803,,5000036,2018-01-30 13:49:46,60
0x72e020660c4443eef259302443d9537236baa7997f7cda0b07dc3c68d52b52e6,t,36772,1875575,,5000036,2018-01-30 13:49:46,61
0x309bb902f1556723a78decacfc610f3d5f3e5040e386d10f4fb04a9ac1985879,t,21000,1896575,,5000036,2018-01-30 13:49:46,62
0xef9f493f64caed35f9af2394be3d0e06e45ba2b5c8ea49f295514c39b95b1c7a,t,21000,1917575,,5000036,2018-01-30 13:49:46,63
0xfe09129ed47060a9232fbb4af9a952c392d58a31be928fdf049993f3753691b4,t,21000,1938575,,5000036,2018-01-30 13:49:46,64
0x72792a799af45eb705a6d7f9eb1bd907a1864fc96b875435ec0b4f5d123aa2f6,t,21000,1959575,,5000036,2018-01-30 13:49:46,65
0xb6827c9a086fb4c8c8085867d4469feb7f0dd24fcc7b9f3e98c5f97924053b4a,t,21000,1980575,,5000036,2018-01-30 13:49:46,66
0x63f5b67c268a1932304c19270c155321abf6b5ac7cc4b7b52fc2fe148e4eeb28,t,21000,2001575,,5000036,2018-01-30 13:49:46,67
0xd2daad62f68b5a178038cc29d9bfe4481508f2c9ca17fd204294615b384b281e,t,21000,2022575,,5000036,2018-01-30 13:49:46,68
0x91187fa4c09ea8c47bf7bc9c6986cacbc8b143e64bb77e0ba13da55430e5ccc6,t,21000,2043575,,5000036,2018-01-30 13:49:46,69
0x26db4bf2918bf8f3c0eb68532c8ebbae54eaf4fde0b4994df54fec494031856a,t,142644,2186219,,5000036,2018-01-30 13:49:46,70
0xc025d3a18181245a5da8f099f2873dd6c343b33ad3832383fae4d75f43870c28,t,21000,2207219,,5000036,2018-01-30 13:49:46,71
0x13dfa5b9c17a49d5b59c2f014313bbd29755db8d1738e64eeee15a9b15edea29,f,52314,2259533,,5000036,2018-01-30 13:49:46,72
0x44a940a1578f210c25198c9082638628776ec8b7600c8bf24d57a02c3fe94d9c,t,52309,2311842,,5000036,2018-01-30 13:49:46,73
0x658259f4b12cd55c2355f9937221ffc688e135db549b1fca4998742eb00055bb,t,91730,2403572,,5000036,2018-01-30 13:49:46,74
0x52a971728a437a3b76c8614b4e116f0bdcac853dc6c63f4b431453b6c05b614c,t,40843,2444415,,5000036,2018-01-30 13:49:46,75
0xfe70e99fc1fa8bb3f247c13d921a6ab59a6c3dfd3d62c9dee39d4be35d8a8b3a,t,55779,2500194,,5000036,2018-01-30 13:49:46,76
0x6bf91be183ccb93e79aa09edac5eb8cf87be6ce2fe97fb66cce342dee2a79986,t,37912,2538106,,5000036,2018-01-30 13:49:46,77
0x15bf5020ddfeee014ee3f4b279a394a79e413cb266c519e7473d0f983766c477,t,22948,2561054,,5000036,2018-01-30 13:49:46,78
0xe8ba7221702203ab174eaef8e5d1478fd85b13633d57dc782783b76bb43fc703,t,253854,2814908,0xFc32618329F9eFb0E402e8f3ad5C6FfFa131968a,5000036,2018-01-30 13:49:46,79
0x0f3cbcadf6e4eebfee3de62e5eebb9d5ecf485605fdcf1f0e6ebfa8f56e63af0,t,21000,2835908,,5000036,2018-01-30 13:49:46,80
0xf914eb18b6e0765dbe4962c0a9fd30bd966cb632ddd6bb92f738c137316e9f50,t,21000,2856908,,5000036,2018-01-30 13:49:46,81
0xe4adbb87be184876afeaa87b49e308372512a8950603631e7429771051f40296,t,21000,2877908,,5000036,2018-01-30 13:49:46,82
0xa3d2ce4cc7630694c71e3205dfd4fd06ecf972ffb378947f7fceef14b6f52d58,t,21000,2898908,,5000036,2018-01-30 13:49:46,83
0xebb41d58104c903589b113aa24e21ad738d3ad27f79d5c45eb520b319b9729d2,t,51654,2950562,,5000036,2018-01-30 13:49:46,84
0x6b7e4512a1122ecd3dfbb995566a65ddba69af7c889cad66dbda6c6c0da5fa1f,t,52886,3003448,,5000036,2018-01-30 13:49:46,85
0x4dbb29fee3707f1d0696f1523cf6cec889905bc2ce4a976e0c23347c2c74229b,t,67677,3071125,,5000036,2018-01-30 13:49:46,86
0xdf17ed5bb0074581f7e0fb113531fc1b9cd97cc96db010e682b637518454aa71,t,21000,3092125,,5000036,2018-01-30 13:49:46,87
0x0f0cb0ee99ad8ec8da56284f472c6e587878b739679914c01564a621b04bc518,t,21000,3113125,,5000036,2018-01-30 13:49:46,88
0x793448ae278a0c5431819571a68d166bccc732ad0f2a9df8a121b453b72c7a79,t,21798,3134923,,5000036,2018-01-30 13:49:46,89
0x6147caaf7ea18db3d2b44f61bf3e0491e4d559544e734307cd7aa8673bac7244,t,21000,3155923,,5000036,2018-01-30 13:49:46,90
0x26811fee887219fce5a0e44c23de52685ca1249e169e8b39b25f85d9d8887283,t,21000,3176923,,5000036,2018-01-30 13:49:46,91
0xdc21f160bdd89643d558eb16615f8a3004850d826f8d91f34cf329915494b77f,t,21000,3197923,,5000036,2018-01-30 13:49:46,92
0x91c00b0a7c3d2eccbd63a412d9ec72e1d3ea50ac4397cc9b98c5d0c8a5e81b24,t,53739,3251662,,5000036,2018-01-30 13:49:46,93
0xed3fc3bda8a1d6ad8285666af71a3468359277d56c4e0961b8ab70b59e4b491b,t,153784,3405446,,5000036,2018-01-30 13:49:46,94
0x5c0ba80e23f159d5878d8854d0ff9043a58eefa8f0e1984abac203a829ff6e45,t,21000,3426446,,5000036,2018-01-30 13:49:46,95
0xbb105d9774f0e36a1abe181c7b5c88292a15abdc8e4919614f4d2495a2bef383,t,21000,3447446,,5000036,2018-01-30 13:49:46,96
0x829e18c47aa31f250f0005801f97caafd03225336babdf0af492b4448fe5e7a9,t,21000,3468446,,5000036,2018-01-30 13:49:46,97
0x65d5bc5e6428b7cda0b13196eb33b005156064a4474a3539cd85a1b17d88a5e5,t,21000,3489446,,5000036,2018-01-30 13:49:46,98
0x69b61438f2353d879561c01fb1cb373398fc749bb6b2a8a3d85f4e3232d49b38,t,51606,3541052,,5000036,2018-01-30 13:49:46,99
0x3d6f576a76e9f3570fe7aaa29b4938c766c3a9508a8370798087df1697ad5016,t,21000,3562052,,5000036,2018-01-30 13:49:46,100
0x4f07f35c64e18d7309a06f01e6eb4eff8d8484ecc2cdca58585dd2218e7062da,t,21000,3583052,,5000036,2018-01-30 13:49:46,101
0xcf49cccd05cfe0706a7bdefb262607ce24657e1e525a7aee8ddb23f5801d9130,t,164716,3747768,,5000036,2018-01-30 13:49:46,102
0xbff3365fa4b045196e2cc11ec5249b15c11a6ce7218e2b9e8db5f4690c87c6b5,t,21000,3768768,,5000036,2018-01-30 13:49:46,103
0x35e303fc7cb5d1782676617b6d8d34946eec5e2b070a2a25cb50acbad44a4e6a,t,21000,3789768,,5000036,2018-01-30 13:49:46,104
0x5d7b679476a646a46b3e6fe8064504231f862203c3bb9cd18e0de2d3cfebf9f3,t,21470,3811238,,5000036,2018-01-30 13:49:46,105
0xb0a524c83d86e91d7404e3e410a5ea507cf1ac398b87cd58cf1c42c41b0017b3,t,21000,3832238,,5000036,2018-01-30 13:49:46,106
0xcd19891338ea53ef538af72ec1c027d6e258ca4e18091ab4c245e6b87459876e,t,21000,3853238,,5000036,2018-01-30 13:49:46,107
0xdff63369cc33d2b6b4f2e6ddf82d892d387b809e618565e2d6ac5afdcba9aedc,t,21000,3874238,,5000036,2018-01-30 13:49:46,108
0x1bc7b6bf9476064c246a9836d0526ca36ceb354d7b538910173b9c4ffcebca26,t,21000,3895238,,5000036,2018-01-30 13:49:46,109
0x68bc79489e065b9d55f6cbe16fa033d3ea6a8c8cb48e13829218bacff4e38928,t,21000,3916238,,5000036,2018-01-30 13:49:46,110
0x82a19af05424810258139f43656a1a55bdca88746ab2cdc479fa6549ac3af899,t,21000,3937238,,5000036,2018-01-30 13:49:46,111
0x8eb7c12544c0450b8fb48f003de05a073817b8505a97d7edc271c75dc60ddc24,t,21000,3958238,,5000036,2018-01-30 13:49:46,112
0x7001cf01e23872bce11b9f9837c847648f642b96767296e67278f353b530d687,t,21000,3979238,,5000036,2018-01-30 13:49:46,113
0x66ecd447f87abb597ba3f2df6be419ffc01182ed19ca1afe4dcd830ad1ff7d9a,f,21444,4000682,,5000036,2018-01-30 13:49:46,114
0xd7b9828730aadfea1d0566d65f761647ab582a0c74f1bebf418df6c64958895c,t,21000,4021682,,5000036,2018-01-30 13:49:46,115
0x846d8e79fc36ed2e5c72b176e3b1968eecd717e81d374afb78fbb06feeb811ce,t,79985,4101667,,5000036,2018-01-30 13:49:46,116
0xa22dc7ec4d375b7aded12b3b1f2def7306f47eb0eca887a5db85247c887c289f,t,140340,4242007,,5000036,2018-01-30 13:49:46,117
0xea79cdcfdc3aa9148fa88446bb234643cef434fe78bb4680e78e95d929b0f004,t,37976,4279983,,5000036,2018-01-30 13:49:46,118
0xb456d029708f0411bcfddd4187bd6cda7060fd119d7775252b49a5f998595b11,t,23679,4303662,,5000036,2018-01-30 13:49:46,119
0x3bacc2b1209efe943423513df599127efab0c1cbeae603f6bf42ac57680633b0,t,52584,4356246,,5000036,2018-01-30 13:49:46,120
0x5c1377bd1c33679b72b12e8d90b7b299c6f4b6f1ab6920096fd6dc0d9c18bda6,t,92922,4449168,,5000036,2018-01-30 13:49:46,121
0x5e589fbd525a5b564c4a824ab9f6d61266ebeacdf521ba1e88673bfeba2f48bf,t,22222,4471390,,5000036,2018-01-30 13:49:46,122
0xc4445cb1d515ebafcd79a04c33409a198f9dcc89a2d2c1d545df4fc3f4017fbc,t,22053,4493443,,5000036,2018-01-30 13:49:46,123
0x6c7511d6fbbd4110129616daae44c96ca9ceeb2622e355bdae284ca9df3a3afb,t,23318,4516761,,5000036,2018-01-30 13:49:46,124
0x90eca2476acf98454fd796d6b7fe81819169092e06a293acf18eca713ea87ae2,t,38318,4555079,,5000036,2018-01-30 13:49:46,125
0x5242fcf9429c0f0b5ab48eefa76d80b5b2851ad9479000cff4fbe275a5d355ab,t,22460,4577539,,5000036,2018-01-30 13:49:46,126
0xb7767c4865c6014327c41e1974c686c52325f4a9c9f26e250b25ed671ba38490,t,23754,4601293,,5000036,2018-01-30 13:49:46,127
0x364301de78c2da26059026d519ce6509086b49554a13eccdec8385343b3d9260,t,23040,4624333,,5000036,2018-01-30 13:49:46,128
0xb6b970801917b1a026afc1e189ac66393c3bd871fda6ba0e6c438488eebcfec1,t,22460,4646793,,5000036,2018-01-30 13:49:46,129
0xa0a9611b6f72480d9139f897d0aa7592521bd4a28a47b63452502367bb04d47c,t,23318,4670111,,5000036,2018-01-30 13:49:46,130
0x521a1030270ac0bdc7a698d969a6211d9803e0041b4532630edea8df10d69192,t,22739,4692850,,5000036,2018-01-30 13:49:46,131
0xa915d89ba9bbd135d8b3b0e4f367113c02b55a30add035b1007b5f5077badfac,t,22460,4715310,,5000036,2018-01-30 13:49:46,132
0x994bca5c809894c0d656ecb0f34199c9cf225dbf389a6c5c99c65a7d4edd9ed4,t,98873,4814183,,5000036,2018-01-30 13:49:46,133
0xca7e1339e8f849b36f5959ce08818d0205b5f302c22121058f03895f8569b40c,t,37900,4852083,,5000036,2018-01-30 13:49:46,134
0x1cbbdd52298bf8a9e62c61c8241ec1c75f62846b93508b7bca6b3938984ada12,t,107922,4960005,,5000036,2018-01-30 13:49:46,135
0xf8eeded9b649b45cd1fbb9aa4a55b1f21e10eb35f00a9a3b8ff834d2685ef34c,t,40405,5000410,,5000036,2018-01-30 13:49:46,136
0xbd6fcb75b9227a8ea0d9dbe76656ccebf7c07e6b0e93bee8d3a16ad86ad51f9d,f,250000,5250410,,5000036,2018-01-30 13:49:46,137
0x6d493073dae4e20336e0eada9726a19ac42f3733fe85672af86b249e2d27255a,t,92922,5343332,,5000036,2018-01-30 13:49:46,138
0x8f56a7d734163c9d23b3656dfddadb5722473faa065df60b2f4dbd1b99b03796,t,21000,5364332,,5000036,2018-01-30 13:49:46,139
0x294f9b82511618008d5aca41bf3ca5252d1e0fbada7ecbfd81be2801fb772c7a,t,38319,5402651,,5000036,2018-01-30 13:49:46,140
0x440316dcd61551a10ca27f1ae1740aac6659d1f42c0dd4d30452f4fb386cabb1,t,21000,5423651,,5000036,2018-01-30 13:49:46,141
0xd51cad6ff83497abe203e002bd11434cdf6322a89c89cd6498a155147e989998,t,21000,5444651,,5000036,2018-01-30 13:49:46,142
0xad93b8122deffd91c22a14ce1f0a88c7c31af372e05fe01a9b9a14b9db6a926f,t,93242,5537893,,5000036,2018-01-30 13:49:46,143
0xe4c733dfdf105bc7c1ee4492f62ac54d1ef5618018901bd67071be3c3be305d5,t,38723,5576616,,5000036,2018-01-30 13:49:46,144
0x0f5f0baa49f187d84bd5f4d497b33a3e89c20eaee1f6be94c36b63e1bcddb40a,t,21000,5597616,,5000036,2018-01-30 13:49:46,145
0x59306b04743b1f4449f64206563e064f5ac105e9ac766d01a0db3ec3f2858140,t,51560,5649176,,5000036,2018-01-30 13:49:46,146
0x7e7738dda75b785dda97c494735109d384be2f73caa373f1d5c3431b3998bf5a,t,45543,5694719,,5000036,2018-01-30 13:49:46,147
0xd3ac33aa96cc7a98728b52380ac69985ae98e15a67efe42a4d3577369c8abf2d,t,45512,5740231,,5000036,2018-01-30 13:49:46,148
0x42d40a40a2c2d0f39bd644792837124d6068e2132cc49d03e27b2db2d83b54e1,t,44493,5784724,,5000036,2018-01-30 13:49:46,149
0x50dd907564155126bb10824435b517b89d62225b976c70ca360cc2b732025db2,t,46032,5830756,,5000036,2018-01-30 13:49:46,150
0x756fbb56f862d8f582639b961e4aaf1dbffe1bc53460864c3983c5f65e01da52,t,21000,5851756,,5000036,2018-01-30 13:49:46,151
0xc08bfc4f4d29dbfc744afe251d4eb2cf8ce9bd835ac757f685c191426f7564f4,t,59418,5911174,,5000036,2018-01-30 13:49:46,152
0xf65ff71188a2f7445c446ff36120001f9453f93c41d6843436fb0092705a351b,t,21000,5932174,,5000036,2018-01-30 13:49:46,153
0xef5e3cecb625442e686ddf306ee916d75bffd24d09aceef099ced11f2861e408,t,59354,5991528,,5000036,2018-01-30 13:49:46,154
0x4a539fce04ce916f5ff5727ad6ded07d2f9db8e5a4d9265efa548bc63471c6d8,t,59290,6050818,,5000036,2018-01-30 13:49:46,155
0xc2f17817a66386a84876acd359fe993d039ce56e825213c1fed444a80b4c246c,t,78306,6129124,,5000036,2018-01-30 13:49:46,156
0x327be494be498ea16dcdd81b8e5822841822d8831e93a84bbe0a667bfb96f856,t,84005,6213129,,5000036,2018-01-30 13:49:46,157
0x65a53c0a356c56346cab6f54c7c237a754845c07e0d9ff11bdec35ce9e463b94,t,40806,6253935,,5000036,2018-01-30 13:49:46,158
0xf60120dcbfbdfdeec2e2e2b5b719ea4553b574c059b11f31404f3e09dfad3531,t,52784,6306719,,5000036,2018-01-30 13:49:46,159
0x4eb6248b71be8fd997bf11ee43ce620556511b23f2a9fcf49f0290831a3df635,t,21000,6327719,,5000036,2018-01-30 13:49:46,160
0xc01884efdb8bc7a128f5444dbba4fe3e318f6f2aaa640dab590e96e83c3fe686,t,21000,6348719,,5000036,2018-01-30 13:49:46,161
0x10c422dbea2f22a3e3f8101419da11900ab9a07252d88e3c51c91c53cc6c6dbd,t,21000,6369719,,5000036,2018-01-30 13:49:46,162
0x25678c71e2122990a56c75e8fef553e3cdf17e1577ce8909cedefb6b3c9d0e0d,t,21000,6390719,,5000036,2018-01-30 13:49:46,163
0x93239780e3272ddd594b5a88b1eb77b63827294a09a98f95dc2319edfeaf8c73,t,21000,6411719,,5000036,2018-01-30 13:49:46,164
0x5bb6c5317b9a387bdc477baa7815b0529a691ee2800bfcdb4db9e1b8e5ba8b97,t,21000,6432719,,5000036,2018-01-30 13:49:46,165
0x47bc7b7dadbbeef047931e03384a43d435faba004ba063dcfadd3a914a125dd2,t,21000,6453719,,5000036,2018-01-30 13:49:46,166
0xf1a0b63309ada3b4706f1a3a04158b4f56ee0cfdb820d5a28a8df76c867f611e,t,21000,6474719,,5000036,2018-01-30 13:49:46,167
0x1f48d56a5afc9426a555a6ea989d2430bf3c18425b42855f5b4a1c98639db783,t,54075,6528794,,5000036,2018-01-30 13:49:46,168
0x9c5fa32a71e503fb2e69c71aad2b898af8397058204fb0149751ab39dbe7bc84,t,53318,6582112,,5000036,2018-01-30 13:49:46,169
0x782c906cad251a6ec2913cbb31054188c32b629aac678d7c5a8edd9c89df1b46,t,21000,6603112,,5000036,2018-01-30 13:49:46,170
0xb4e96178dc0331c951c368b2c6b34bae992e800b4c533389d13fed9ba327b502,t,127708,6730820,,5000036,2018-01-30 13:49:46,171
0xf9747958ce8d704bd8dbe1997f4bdf2622dd2dfab679e61930bf7957c62dfc3b,t,21000,6751820,,5000036,2018-01-30 13:49:46,172
0xb2d3d34a79b7247efa6fcfe2a728c79ab5b1fd05f81e80aeaa3154a22240c8d5,t,51820,6803640,,5000036,2018-01-30 13:49:46,173
0xbdd056f5cb8ac80b44e7c704f238f168f1d5713a1f59af943751b549a02f5f04,t,253854,7057494,0xEBD52eCF338a05f44402200C3295F3B1855c4835,5000036,2018-01-30 13:49:46,174
0x86274489a1f698ef45c3f46076cf3a2e90dba1a00660a3c2ce7ea6d45ff10862,t,21000,7078494,,5000036,2018-01-30 13:49:46,175
0xce57da02057d3cb539d731d404fa79ecf0a4a0523e9d00df7cab21540065b186,t,52886,7131380,,5000036,2018-01-30 13:49:46,176
0x30cf2e1704812064a7390d448a257569dcb8798910bd081374b3f535bed2909d,t,79985,7211365,,5000036,2018-01-30 13:49:46,177
0x7e7fc58e847c5ed726f738c17f06e8d5c9a1d20cc7328c2c1e5bae1fd1e24ad9,t,93050,7304415,,5000036,2018-01-30 13:49:46,178
0x58c602bc5e26585fa85088e6374857dc84b248ac858e3db24f6d0e63d3849ed9,t,58193,7362608,,5000036,2018-01-30 13:49:46,179
0xdd55d032f4d4236afc28f9d87b9dd19a6b3b1194119370076c38b602dfe96435,t,37579,7400187,,5000036,2018-01-30 13:49:46,180
0xceb922978417d602f437988484c9fbaa3708c423e92fec9a3ed395b51e00fa34,t,44290,7444477,,5000036,2018-01-30 13:49:46,181
0xb05ab0f348d2521d1a160a05984f6e30c9631ccc98f20197fb9d2be8fc175b26,t,21000,7465477,,5000036,2018-01-30 13:49:46,182
0xcde6f861091ade2231101e9c87629091d6d2b977e40625e9c3933cf70addefb5,t,21000,7486477,,5000036,2018-01-30 13:49:46,183
0xee68e242046117ece5a39165920d7e05f657448f31a2e490ea66a093b9217371,t,21000,7507477,,5000036,2018-01-30 13:49:46,184
0xfc026ae098e194f7f18731f7d2d9f95661b7f2124dd36bdfa2421f41851cdf10,t,21000,7528477,,5000036,2018-01-30 13:49:46,185
0x4ec9f4562c16b8f3301025cebebe1e21b8bfba0f14040ee90edcf32d447ea7cf,t,21000,7549477,,5000036,2018-01-30 13:49:46,186
0xf7ed43eab338647b466b6f5d82c4b1c26db8813241936cdecd4de620b8c6114d,t,21000,7570477,,5000036,2018-01-30 13:49:46,187
0x5cf15cd049088c7c8c4d2f22325ffe5c53c04cf056eb3202dec20752801410b4,t,21000,7591477,,5000036,2018-01-30 13:49:46,188
0x1563a51271a7fa472e0b6001339330e5724a2cc6c9a784cfc491fa5ac938c002,t,21000,7612477,,5000036,2018-01-30 13:49:46,189
0x1fab1277133a4a54819abc08a14e7579d01754d702ffc912052118dd4cb02960,t,21000,7633477,,5000036,2018-01-30 13:49:46,190
0x8c53403800acf7610be1f6c69f383fdd8d2bbb9e3c74c540dfdd7447af72bdc7,t,142708,7776185,,5000036,2018-01-30 13:49:46,191
0x8df4b172d5e885b0e4849c48f6ef6d0ce9d8190420acf5fb4bb82ace895692c8,t,21000,7797185,,5000036,2018-01-30 13:49:46,192
0x89be30035de0b81472f7f02b1037ec03d7ed0f868be50354327cfcb4a7338ab6,t,52886,7850071,,5000036,2018-01-30 13:49:46,193
0x525554dda45f26c17c469e2316099822bd4440331d518de76d65413de7769c0d,t,21000,7871071,,5000036,2018-01-30 13:49:46,194
0x0b678a3f684ff0d5a46ce7b923f1d7f05b87d444cc5c61f8bf1259fa65ad909c,t,21000,7892071,,5000036,2018-01-30 13:49:46,195
0x68887ead07881582f660c22c1a107718bf461ca5687896ebbb52974715e144a4,t,21000,7913071,,5000036,2018-01-30 13:49:46,196
0xea1a9d906b33699c34fbbda97b11864d19349bcec2ba4061878b4ec3a2cc850d,t,21000,7934071,,5000036,2018-01-30 13:49:46,197
0xd7d81c1fe368b89746f8cabb6ab1b7ce5b00fe2e4c52cd7a8f7dcb092fa06bc7,t,103499,103499,,5000037,2018-01-30 13:50:00,0
0x844b7928002b67ccbb4e07c02ec3e8e2faf0e330de59689efae9f63dbd15e51f,t,21000,124499,,5000037,2018-01-30 13:50:00,1
0x36463ccc36ec04e3849da72ed74b336bc4f68b2b5252b98a432e04fe73cdff1a,f,250000,374499,,5000037,2018-01-30 13:50:00,2
0x13f0daf58a81a954f148cade20afa9a17ffff1dccfab994a15c5944437550cc1,t,21000,395499,,5000037,2018-01-30 13:50:00,3
0x3076c42718f03eb248e76d476a7b7ad023c632de8dc82920565b99a0b61c4a43,t,21000,416499,,5000037,2018-01-30 13:50:00,4
0x25114493f51465996ea2bf4cab1223fdfa55fa83cea44a49d543896f77dc5cc2,t,21000,437499,,5000037,2018-01-30 13:50:00,5
0xed80e1b0e474b74c87152fd02f973bcb541d08a9bfc242b30e9585efeb67842c,t,21000,458499,,5000037,2018-01-30 13:50:00,6
0xb7df75eae52d7493da1a0899c0a5856c8a7266a04c59734825d142fc102fc801,t,51984,510483,,5000037,2018-01-30 13:50:00,7
0xed9c1290ea74fd4fb12304b3f5364f0e6f17267048d9d705efcc7a341b7d666d,t,21000,531483,,5000037,2018-01-30 13:50:00,8
0x77807327a77a711d751584406280373e7c874f950aa62589f3a095b8fb2524b9,t,21000,552483,,5000037,2018-01-30 13:50:00,9
0xabd3d83d9a50bbee748b0de4d840eb4bdced8039b58a696ffcc210f1e7454112,t,21000,573483,,5000037,2018-01-30 13:50:00,10
0x886cd73324f888632e1d9ce2be4f1c50ebbc5abe2f08c6f0e95a8b711d73932b,t,21000,594483,,5000037,2018-01-30 13:50:00,11
0x401b896225a0f20758adfc185a226a73eb9d113b4d61678d8e89894061588d8a,t,21000,615483,,5000037,2018-01-30 13:50:00,12
0x7e1fc37b20f9e7a1649efb072473a86feed23b3139463a33ed1ebdb573be096c,t,21000,636483,,5000037,2018-01-30 13:50:00,13
0xf6be7267a0927cc5c15c723d75c1e4a0df3a83a7985cbed382df1e0cbd768e7b,t,21000,657483,,5000037,2018-01-30 13:50:00,14
0x5e1c0c767ca58dc4e30581d42704a03f59a7b1b1c93065dab1c37fb0053b294e,t,21000,678483,,5000037,2018-01-30 13:50:00,15
0x11ebf4f6e5f05cd08628146ab13e4d3620b6b797ec412ff56ef3a5675223de0d,t,21000,699483,,5000037,2018-01-30 13:50:00,16
0x3228cc64cbff31f81e169e1308094a4fcc3ac84d50376bef0e0bf0b9483d412c,t,21000,720483,,5000037,2018-01-30 13:50:00,17
0x139f1f210a5cbf8bca65057a4a726c59d9df52585805d56f4daf633eab369b2b,t,21000,741483,,5000037,2018-01-30 13:50:00,18
0x0beb2ca3820b4166c71e2e65af60c07de496add4bafef134c031dcb648adc1c6,t,21000,762483,,5000037,2018-01-30 13:50:00,19
0x7e822440965d405950776af759badcb4981155e72032ce3cd50b8e89e3021073,t,21000,783483,,5000037,2018-01-30 13:50:00,20
0xb1cbb1cc7484d28f60ffd9fe2227167776400da9026d18effca85cd494271375,t,21000,804483,,5000037,2018-01-30 13:50:00,21
0x6c10cfefd1e11f6e47ba2a95132dc446800d0264351a98335eb783997816e9bd,t,21000,825483,,5000037,2018-01-30 13:50:00,22
0x475493938c047e329993e9dd6930c1e3ebe2db7fdea280dc222a9c6fab21f0fc,t,21000,846483,,5000037,2018-01-30 13:50:00,23
0x11b1fd0d28a9bc9195629b1f09ca466697a4ed941d1cd4835a0218a6ced4cff6,t,21000,867483,,5000037,2018-01-30 13:50:00,24
0x41529c28793f731d7b5513ca9dc02414223e33f181caf9d157edfa5caa5f852e,t,21000,888483,,5000037,2018-01-30 13:50:00,25
0x0f8e79024eab8f4d60accdd5b3392c0c148b210bcf8f4e033e617164c6d36940,t,21000,909483,,5000037,2018-01-30 13:50:00,26
0x862fe8c0bb6fd9c35b8618459dd85e4b84fe092900f3300add43132f62e38b2b,t,21000,930483,,5000037,2018-01-30 13:50:00,27
0x74e7f27ae63fa6ca1c1079855f4a9e2ea1f346a97836cecf2aa5273d4a009df1,t,21000,951483,,5000037,2018-01-30 13:50:00,28
0x403190c077bfc2fa4fd3c8857e495d414a002cbf8ecdee0503d52b0b08819d8c,t,21000,972483,,5000037,2018-01-30 13:50:00,29
0x8f86c34fe36a40cd8a7b94e8c33bfd6a5572c61a6c2cd48b12f19a7244a4fa24,t,21000,993483,,5000037,2018-01-30 13:50:00,30
0xd8a0a9bb7ca1f03d1ba7bba6485215040b8ccb0a1540b76d4eaab5fdbaedf4ba,t,21000,1014483,,5000037,2018-01-30 13:50:00,31
0x38c74d6193fcf7e1ee9f9094b55ea639b82bd7815c3b1b66c5d5424ff53546cf,t,21000,1035483,,5000037,2018-01-30 13:50:00,32
0x333cf15b186bc95beb16ebf121250859c99132444c5a48dc9179eb467df684e3,t,21000,1056483,,5000037,2018-01-30 13:50:00,33
0x700df514be9c9885094a5960a17f8bb94270440ccf324bfaf54d62ee8422de9e,t,21000,1077483,,5000037,2018-01-30 13:50:00,34
0x89a1caf019c561615492f98baf0acd77fa8bc291231c9ea13dce049dc7ab82c1,t,21000,1098483,,5000037,2018-01-30 13:50:00,35
0xca10c36d975d961ba1c6d16a9aab4c3bc19179717ce03dd4e9decd6009098b44,t,21000,1119483,,5000037,2018-01-30 13:50:00,36
0x0241dd9dcb485961600318c13a9a60514912220f70e86811f4b0a14a898dc0f8,t,21000,1140483,,5000037,2018-01-30 13:50:00,37
0x9eb1efc81ebb958f0b1f153edffb11f366629a8d80071b68707c8c6f6b746786,t,21051,1161534,,5000037,2018-01-30 13:50:00,38
0xf2b8d4bc888c9beb109041a5338946cff756260a15800eceb66f7105b2f8e7aa,t,21000,1182534,,5000037,2018-01-30 13:50:00,39
0xb46f40299ce8fd65feca088e8cfd2bf70571480cb4d8f769ad58f240ef0c8ae4,t,21000,1203534,,5000037,2018-01-30 13:50:00,40
0x4c426f8e0d67238706ab5525e6e77ebea1eb0c90c8eefa615ee553e8f12dbb3b,t,21000,1224534,,5000037,2018-01-30 13:50:00,41
0xaaa20ce07963142b790956e20161e8263beee6ca8f9e672f68394c2ba4ae81e0,t,21000,1245534,,5000037,2018-01-30 13:50:00,42
0x2d63005b344ee06c3b0e6efe606a2e6660e7b9fba3bd8c82d27bfb0ab12a8097,t,21000,1266534,,5000037,2018-01-30 13:50:00,43
0x8ed5447b447238659599cb15cfd613cb1b6117d300a930d3ddd9e15f6c4921c6,t,21000,1287534,,5000037,2018-01-30 13:50:00,44
0xffc979a37675862c239b72ac2a66a21d1e188be853febadb0d7820e5ba9765b3,t,21000,1308534,,5000037,2018-01-30 13:50:00,45
0xce9e764c08ee21ffd9bde5fce83ee573a6e8a50c5487b78a4b0af1d997ea7c77,t,21000,1329534,,5000037,2018-01-30 13:50:00,46
0x0c0a2e42677e581fce391d9551eecbdfa912d62e7c4b12f48a9467cd8d4d207d,t,21000,1350534,,5000037,2018-01-30 13:50:00,47
0xcffc6170d7cdf50690516d8f41e45cc37d02cbcba09f5bf5227b79227f9e8657,t,51522,1402056,,5000037,2018-01-30 13:50:00,48
0xe7f8fa43bffcc58f4daff3c94e7b93b7c105ff0e92bafe30c31bc4ae906eebb7,t,52094,1454150,,5000037,2018-01-30 13:50:00,49
0x2181bd7414118c977a8cc9d3ef463ea2a3fa9ea893bda1dd4f04b6f1bb4cf5f9,t,52094,1506244,,5000037,2018-01-30 13:50:00,50
0x5894093c8d61f96739b5c7af46d9d35e32a1c2701fd9708cba2fbc67c231c5ff,t,94190,1600434,,5000037,2018-01-30 13:50:00,51
0xd202c4f4da1f1e439710fec671dbe9311e57a2228f3c443457e914b705912f5c,f,21064,1621498,,5000037,2018-01-30 13:50:00,52
0x1f0847951067a7e4a670ac07d25e0a3a7e7d3b4cb6ba901dd7381fb05a1ffa20,t,21000,1642498,,5000037,2018-01-30 13:50:00,53
0x26611f4a6f97373c90a9581a400f1b157307de7cfdcc0b1b92447ff8a36b6c4b,t,33705,1676203,,5000037,2018-01-30 13:50:00,54
0x645564fe23a099755c048ff54493df35589914078abdb516dcdba7f946903845,t,21080,1697283,,5000037,2018-01-30 13:50:00,55
0xb6e9e5c0c854e0b9ac9b0cf5070cb3b0c5eb89549df35920757d03a8a3d424ec,t,67927,1765210,,5000037,2018-01-30 13:50:00,56
0xc707735c84cf852e779501402e77fe0f9cebd2fe8a936e37f2e829cc7f42cf2e,t,21000,1786210,,5000037,2018-01-30 13:50:00,57
0xb0f283361937d0c7afaef5ca33a9c0cfcbcc3137a5c1b3ed8613548a2fa66339,t,21000,1807210,,5000037,2018-01-30 13:50:00,58
0xbdca05bfddcc4fc44d0221c374d2b2ae99abe9984d9a70e596f7564ce3f6f2d4,t,21000,1828210,,5000037,2018-01-30 13:50:00,59
0xa0e88381d857cdfc75ed12723ca53e77f1e8357140d315ffd50630e5bd5f0ac7,t,21000,1849210,,5000037,2018-01-30 13:50:00,60
0x6380d61ad8051a2db2a7b2305404a59843d970beeea58647c67f9f279bd1d08c,t,21000,1870210,,5000037,2018-01-30 13:50:00,61
0xe48a3b35069ff4580c7ef9e2a8f2b769bbca224019c281a7dca8acf6865caab7,t,21000,1891210,,5000037,2018-01-30 13:50:00,62
0xc7e35030fed04c8f48e3c625ffb815e367f15d064502350a59489269bc45ebec,t,38231,1929441,,5000037,2018-01-30 13:50:00,63
0xe1c8b035e70fa92c2498577400d769ac090b446e63a5114e43440ebb7729f169,t,21000,1950441,,5000037,2018-01-30 13:50:00,64
0x8bed798a63798fae4327d56862c6385a018a89f9263ea2db69de4a42c6287096,t,21000,1971441,,5000037,2018-01-30 13:50:00,65
0x76e4ff083cbeda54aa3278df8cc9cdcffcb4774dbc1c4c7045661349cfbb2f3a,t,51618,2023059,,5000037,2018-01-30 13:50:00,66
0xf8568cefb4fc5ebcbbad063e38158eb77f3c3608bb311df1aafa1b1f7685350f,t,21000,2044059,,5000037,2018-01-30 13:50:00,67
0x29a32ad5ece475d9cfb694fada8935d0bee2198e3f2ec5c43236d179b3c25875,t,59418,2103477,,5000037,2018-01-30 13:50:00,68
0x31945c7166dbc887946dfc50e99e46650f865b5e58aa9c52b9b3ad208611c093,t,21000,2124477,,5000037,2018-01-30 13:50:00,69
0xa92a5c7e1bb9c1dee376a2ec71a888c26ad3f971c6440f89eaaae823eaa8bbc2,t,21000,2145477,,5000037,2018-01-30 13:50:00,70
0xdd5e1b76fb2c637b44ab2163753bf2b393d0f24a9723c3c2d995d417130df308,t,21000,2166477,,5000037,2018-01-30 13:50:00,71
0x5b9ff3de1297d1c87de0b1013e8fdda6e59f9d4155ea250cbd3b504437cd22cd,t,21000,2187477,,5000037,2018-01-30 13:50:00,72
0x3958679163c3478a8593008fd7a4401c7b1baa334da714a01e28cd9306954a99,t,21000,2208477,,5000037,2018-01-30 13:50:00,73
0x6fcf0f4fa59c44552e408d381e2e06c24c9feb0a79df302a2807907fb5394de4,t,21000,2229477,,5000037,2018-01-30 13:50:00,74
0x3d8613b43bc958f3d86578ff133a5893c0845a3495726e576c01a671d94a87bd,t,21000,2250477,,5000037,2018-01-30 13:50:00,75
0x7ae5b69c2b6f3fdbedb58d3e1b891c9914d5b547d0404027409015699e868339,t,21000,2271477,,5000037,2018-01-30 13:50:00,76
0x97ff83fc886146abcbdb80855da617f265ca401b038ef9565bf69d28d3543c52,t,22091,2293568,,5000037,2018-01-30 13:50:00,77
0xb9ae32235612fb63ec1b9519b7005a2ada0f2de57044269b999f70b31e28f5c5,t,22091,2315659,,5000037,2018-01-30 13:50:00,78
0x0d0656419462195dda417584a51e125652f85fa843766bbcf74748803b271b29,t,36517,2352176,,5000037,2018-01-30 13:50:00,79
0xc5885b8241f9362da01611ff3955a63c91f68c3059aaf4bb3115b9fd74306a58,t,23297,2375473,,5000037,2018-01-30 13:50:00,80
0x5e0faa106a5bd8ed4b69dd0aff39dcb045b091fc3f3da22f7cadba1436ceac5a,t,45642,2421115,,5000037,2018-01-30 13:50:00,81
0x283a814e21d9b8b71a4bab2bced1108127c9888d969e93069b93cffdc59d00f3,t,38111,2459226,,5000037,2018-01-30 13:50:00,82
0x7b262bdc73b34c0efc409dfc1057ccd69053fc4ba25d3149089821c2f541353d,t,21000,2480226,,5000037,2018-01-30 13:50:00,83
0x048676fb3f94d162ebf9a335b2c9bf2d1b330656aa730eb175143bb3956ed0b3,t,21000,2501226,,5000037,2018-01-30 13:50:00,84
0xacc53fd402f0af947f23fc0a7c03540b30ed0a47ebf3fff0f37dc2ca79318dd0,t,21000,2522226,,5000037,2018-01-30 13:50:00,85
0x9b7eeddcf8bb9facae8329aae01ae7f72c5ccc126b6690353cb93306b4689006,t,21000,2543226,,5000037,2018-01-30 13:50:00,86
0x04a26e4af5f408b895a5485bc5fbde5886ce020959ba79c0444e617b716e9b2b,t,21000,2564226,,5000037,2018-01-30 13:50:00,87
0x83c53f039d09bfb5037e181cd2a0045ec5e174c1d408513ab44b8ea351bed408,t,21000,2585226,,5000037,2018-01-30 13:50:00,88
0x7b8b5718ab591ab5fc05ccab6ea62d3a4e5f8fb646e01633212c784992592c68,t,21000,2606226,,5000037,2018-01-30 13:50:00,89
0x6b26659f8d1b30828be41368ba7b456345c216e8305c250a860edaa1e0aa8f08,t,21000,2627226,,5000037,2018-01-30 13:50:00,90
0xa21f3e2fd350433c50ce06d7bac697535ac92c0a7606729e17320c8ef1cc9686,t,21000,2648226,,5000037,2018-01-30 13:50:00,91
0xd9e4cf1dad70644b37f4cb2719bf52b8b308e0fd8794e0c6205e6e5668f5ccd2,t,21000,2669226,,5000037,2018-01-30 13:50:00,92
0x379623085cca8423bb55099608e6450f3a2613559adf56deab0c0d2009e8f5d2,t,21000,2690226,,5000037,2018-01-30 13:50:00,93
0x9ec05035ed449576db3c8820b09fd5f3cf41ee50ed51c020f4a2bb8492b7f16d,t,21000,2711226,,5000037,2018-01-30 13:50:00,94
0xa8683f33c82389e32ae115dc32d018f171882be37d8357c925280e1ce8662cba,t,21000,2732226,,5000037,2018-01-30 13:50:00,95
0x591deae4319a7c94680511b912989ce4845d128bc78a530d799c795a4ebde167,t,21000,2753226,,5000037,2018-01-30 13:50:00,96
0x64b665a0df60b1e08f80eff5dfb956bccbc4d95b450c256340b2fec36a418c63,t,21000,2774226,,5000037,2018-01-30 13:50:00,97
0x4276844217f69a164d1373dab9e1ffd683c9ed3d31e46adb0692e993e1e66e95,t,21000,2795226,,5000037,2018-01-30 13:50:00,98
0xb0e5ccb2cd93a3b7e745dc7ba87b2fd17be932b81cb4dd582feae338f2b8ad34,t,21000,2816226,,5000037,2018-01-30 13:50:00,99
0xf4dd8cb2e5f4829edd39019e6e7f24197fc172a0c7338938eab9e70a4ce2f443,t,21000,2837226,,5000037,2018-01-30 13:50:00,100
0x06043c29368fb94ea3875183d705880ef84c545d8621f90577ee65c8d149e001,t,21000,2858226,,5000037,2018-01-30 13:50:00,101
0x7b4f8e7f58e71e80caa51623732f86e1944bcf4fffb4e58d592d915691561705,t,21000,2879226,,5000037,2018-01-30 13:50:00,102
0x40644bf157086beaf492535c477e6161ebd85d4c43a28a19d12b2a4127b1f5be,t,21000,2900226,,5000037,2018-01-30 13:50:00,103
0x5c7e6e3f031d99ed2675fcd331931e657e74f7b966fce6a9deee56fa193cbe76,t,21000,2921226,,5000037,2018-01-30 13:50:00,104
0x7fdf48d214390778f867926263360fe25fd69d07efa4ad83e19e8697af504a21,t,21000,2942226,,5000037,2018-01-30 13:50:00,105
0x725e689a6f1eae14633c5175484db041226d22e6a0d077ea366c357cba2db5f7,t,21000,2963226,,5000037,2018-01-30 13:50:00,106
0xc6d00e42d3ba5bfda4cb696a273463271091f4e9a3054356065ccb223595fdca,t,21000,2984226,,5000037,2018-01-30 13:50:00,107
0xd68842f1e5cb41d667a300243e2853c5147ea0e57f9f1978edd10fde31138770,t,21000,3005226,,5000037,2018-01-30 13:50:00,108
0x97fd1c95fc2d80d62576918868d89b2a40d56446999b9b9e231c334188b625f8,t,21000,3026226,,5000037,2018-01-30 13:50:00,109
0x7ff1a596fb29c63d23934a1241ae6ba2ffcbfbad6321f092427cb7cba67a7c50,t,21000,3047226,,5000037,2018-01-30 13:50:00,110
0x410d7950ab3683b13c972fcc2be2c454e2296e902ff3636e3efb654f69ae569d,t,21000,3068226,,5000037,2018-01-30 13:50:00,111
0xfb34350fd763aef3bd1ef2a525658e26fc763d09d9ac3089127c05a2ed458265,t,21000,3089226,,5000037,2018-01-30 13:50:00,112
0x9a81b895d417af8dd827c8c9b2c56f7b2722d32647ea087565d68c5166327966,t,21000,3110226,,5000037,2018-01-30 13:50:00,113
0xd7ac3d80151eebd802e880f396d363b2384a7c808b3a1454256d94b6d79e1e34,t,21000,3131226,,5000037,2018-01-30 13:50:00,114
0xca6061dee566c679fde067a2440ece80e74a30c514298e66c68b90b2f8b46b1f,t,21000,3152226,,5000037,2018-01-30 13:50:00,115
0x63eb412cc1f79c2317ec1e7d55ac7a87719ecd04d3221450d19c42c0fe6369f7,t,92353,3244579,,5000037,2018-01-30 13:50:00,116
0x9656a6c48588773f91db3a8039ab3f2239cbbfb3335d2319229919755054a8b9,t,127772,3372351,,5000037,2018-01-30 13:50:00,117
0x8d540708a4b3ebe5c07f47319c238882df63fa9b8b742f7689dcac22cbaa3f4e,t,92853,3465204,,5000037,2018-01-30 13:50:00,118
0x90c5692f029bfef7221d5efc8a0ad743247cf83276cd7d3c7ff3eb036b626273,t,91251,3556455,,5000037,2018-01-30 13:50:00,119
0x8b24bb2455e85465e7e75783435c076f930c347f5be1a3ff0de571ed670e2f8d,t,55843,3612298,,5000037,2018-01-30 13:50:00,120
0x200c8694f85be654135a5c8ccf01c502e7872d071ae6c5315c5acadac7a997b8,t,52143,3664441,,5000037,2018-01-30 13:50:00,121
0x16bb25834c47af1b7f88f60f952cc744ed26c1ea3af2b47de3a0ae58e0637872,t,52139,3716580,,5000037,2018-01-30 13:50:00,122
0xaa90e0ccc0d9578146373d0a62afabbd92accd0e304af2d7d23dcb62303f65d0,t,37356,3753936,,5000037,2018-01-30 13:50:00,123
0xc7e7de28a1f04701e6aabbe6b310ff83500574b56bf4c382337a2c8221a2a20d,t,52316,3806252,,5000037,2018-01-30 13:50:00,124
0x5da07dfc829de61eac727eed804f1877100d7894bd7f954f81de5e0b3fecb02c,t,37547,3843799,,5000037,2018-01-30 13:50:00,125
0x942fde5b1797615692ab81bf9113b14d9195b52f4205ad4c87f8b55777a57bc3,t,55843,3899642,,5000037,2018-01-30 13:50:00,126
0xd7c7c72e0b4780482fe559bb1246a21bc022c2878af96a1e91ccab9d1b1f9606,t,55843,3955485,,5000037,2018-01-30 13:50:00,127
0x9ba9ca350830c67e0fc19d475ced27b0cb95b3211f7025acaa52180fdd852580,t,52444,4007929,,5000037,2018-01-30 13:50:00,128
0x963c7dd5ebf8098975b42d2b5bf20eaccb0493d5646673c0b16a814b77438559,t,37071,4045000,,5000037,2018-01-30 13:50:00,129
0x88b9c6e6bead5e1119f0415cf828eb994910e8449d67028635f3cab8dc701688,t,253854,4298854,0xB3f0918c4eA84e0587f48CBC7Bc13656887aBcbd,5000037,2018-01-30 13:50:00,130
0x8d69b02112d489140afc0fd18f75648ab04247c70c5674d0ba09700058291e61,t,253854,4552708,0x9b2a74ee2aBDfA410A12685F307512de6F2863E8,5000037,2018-01-30 13:50:00,131
0x7134b202aee10b2371a5009afbe89e3c11233b15e00dfead25699d6bcbe21e6d,t,253854,4806562,0x5327F1dA98e9a75177a0d6401793235eea498e53,5000037,2018-01-30 13:50:00,132
0x91f65a14fd62203ec056eb88109e41dabec808d7cc6ddc1f72c5eb726ca09caa,t,253854,5060416,0x2DFE0b1E22ca064bee5dB507bb239944AE71E31D,5000037,2018-01-30 13:50:00,133
0xc0ddab2d142cf5eea1b65728780d2dcf65ea623b399cdeab462f893c3dced55d,t,52886,7558129,,5000037,2018-01-30 13:50:00,191
0x5301198f5477044f13a4f10eccbd6a575c11e818d92021c290e1fdb2a160347d,t,253854,5314270,0x4375c72d19E808168694c0CDf221Fd6D95D33D39,5000037,2018-01-30 13:50:00,134
0x6f5674a2fb94ac3e01523517c5ccea6f431ff12df4d9e1819945a21a8b173bab,t,253854,5568124,0xb3cC24987476E1CfCBd49f3a80C8f6f00660e7dF,5000037,2018-01-30 13:50:00,135
0xc07e4d1ec7f71375f6122aa576a41e628bfa21d71ed5415d0e989e64891edb69,t,253854,5821978,0x7c939C7E080Bbe49dE6663E3B70F43D9Cef947f3,5000037,2018-01-30 13:50:00,136
0x93d0c28f708803852dafc6adc30336af919a50b40d05e48ac186bb208f353f8b,t,26262,5848240,,5000037,2018-01-30 13:50:00,137
0x45b2ab9b22d17ae32910dff6aab3d84fbaf2244ece10553886c90feb56b94bda,t,26262,5874502,,5000037,2018-01-30 13:50:00,138
0xe206e56c24aa076dcb86408da9562f2bbc2dcb3fe973083337ada37c0b76daad,t,26262,5900764,,5000037,2018-01-30 13:50:00,139
0x5c91352339b58d48cbed93f93914f58fcc08f9ff12f0129a8b13ddd4712d852a,t,26057,5926821,,5000037,2018-01-30 13:50:00,140
0xc4c0564ff551f7519782693affd3a0a4d922d7e4e6077faecb5294b3646dbdee,t,26262,5953083,,5000037,2018-01-30 13:50:00,141
0x83ef6ba3eb15fd71e11e7577e0121cc95208ff8af988bba0da4c00ececddb670,t,27450,5980533,,5000037,2018-01-30 13:50:00,142
0x02ad11e47aa2382d9f332e002fc21533f00135e5044d3a3ccac8224b4b6f49e6,t,27450,6007983,,5000037,2018-01-30 13:50:00,143
0x41b2dcf17ddd82d2477049fabdcf24e44c6ac8d921fc3823aab53dd942cbf33f,t,27450,6035433,,5000037,2018-01-30 13:50:00,144
0x278dc8595261f9d158da1b2ca045768314077537b92a90c13d42d08d7caeb1bf,t,27450,6062883,,5000037,2018-01-30 13:50:00,145
0x18aa21fb28d9436832037d6dfce8c9a55f60e1809150dc966d62857fcb539606,t,27450,6090333,,5000037,2018-01-30 13:50:00,146
0x9af5e22b33e804dfe85ca8adba85fa1006a82805047c3c9978208df75733d60c,t,26981,6117314,,5000037,2018-01-30 13:50:00,147
0x1f0397584a6e42213ef8e516cfcba97ef66b649cd577eed7173efb6b02d1c3e4,t,30449,6147763,,5000037,2018-01-30 13:50:00,148
0xdb5172a4a9e82fe7709a6b53b183a56589fe38a85bd28421c91e831ccc83eac1,t,30449,6178212,,5000037,2018-01-30 13:50:00,149
0x65ba444c9c76b4b00b6ab9a0c9d5828989c9ea28187f9200907c1d8e11e3a4cf,t,30449,6208661,,5000037,2018-01-30 13:50:00,150
0xb9d05e1cb803dfaeede994a49407184c18c528fd27164bbbaa9df61e0ffa2ba6,t,30449,6239110,,5000037,2018-01-30 13:50:00,151
0x0dee280c110559f4ca2237f084d142f152ab3498936674234aed2ae0a6a29890,t,30011,6269121,,5000037,2018-01-30 13:50:00,152
0xf4f954fd83928ef8a7e6044a442443f6806bfee3c977c33cfb6c08f2f82ed08e,t,30011,6299132,,5000037,2018-01-30 13:50:00,153
0xb414a511a68d3987a3567bc601411651d37af44f096b534c9371d928428d9718,t,30011,6329143,,5000037,2018-01-30 13:50:00,154
0xa620734efca35fa8ea372b760605d7e3310b2372979edbc43f258632b47ccc0a,t,30011,6359154,,5000037,2018-01-30 13:50:00,155
0xd3682ac98a7564f3bceb86adecfe6add3883bb10722a073c024ed348caf694c5,t,26421,6385575,,5000037,2018-01-30 13:50:00,156
0xa0e813f38535da52c5e9b4e6d22b09dd0c8229dc33cf4ee8d9d2cb22c3d5b5bd,t,27703,6413278,,5000037,2018-01-30 13:50:00,157
0xf802a0367caa83591d5dfa55d1065306f134ad8bcb6e9ca30bc6f122a355809c,t,26726,6440004,,5000037,2018-01-30 13:50:00,158
0x9a26c4114c9960e8cff663f9cbe8e61b3a30bd9aa8c3af401eeec725e6036377,t,21000,6461004,,5000037,2018-01-30 13:50:00,159
0xacb8ebce362419d1ccbecdb99abcee86db1c79a7334506c3ffab7e3496b9628b,t,21000,6482004,,5000037,2018-01-30 13:50:00,160
0xa77e77db6b1158957370eab4a01929dba5906ca812d1f296db8efa88985a5e7e,t,76734,6558738,,5000037,2018-01-30 13:50:00,161
0x0b0e146d77749791e34ae0ccac23489308d85d23f1b9cc1572603146a358fdc3,t,21000,6579738,,5000037,2018-01-30 13:50:00,162
0x5170f2c80ac39c6109efbe1b2115304af2ba77aa7bac4c31708e86f78e2ad023,t,52027,6631765,,5000037,2018-01-30 13:50:00,163
0xf27a7a64f810251bec07b4151c15354bb3c06b8f37914f5ad2d35d3a17e028ca,t,24568,6656333,,5000037,2018-01-30 13:50:00,164
0xf2e5ff69810d79643fb7a54c735cba7d86ddaeeea6efa8036b6da69a096b0fd8,t,36885,6693218,,5000037,2018-01-30 13:50:00,165
0x814c8eded47f73f012d0bff39dc0610444750e74f4c93681ae1422b330e262d9,t,21051,6714269,,5000037,2018-01-30 13:50:00,166
0x2a917f6c844722dff6c9da1b77783c8bb41f6f02c54a7720db64d4b768783a66,t,21000,6735269,,5000037,2018-01-30 13:50:00,167
0x5cf4fa8c2a073a37403a4ae00e15bb44a5b09efe2f5b9358bd6cb9edcd84c010,t,21000,6756269,,5000037,2018-01-30 13:50:00,168
0x98457518e858f1c4862ad64d6ac0e945cb15cf32659fb10c308a2ede6577c155,t,21000,6777269,,5000037,2018-01-30 13:50:00,169
0xce56178b46182eb3606f1cd465c6715f66ceb03a850869b7d7153cdfd9baecb1,t,21000,6798269,,5000037,2018-01-30 13:50:00,170
0xb4e97c0dfc161682dfc7013ca3bfd7498ab56c42efd08153a3a917a39d39d416,t,21000,6819269,,5000037,2018-01-30 13:50:00,171
0x8f4f188a460a3c5964e11cf35e9ec3953b703033e2c2ed5a99020debe1387be0,t,21000,6840269,,5000037,2018-01-30 13:50:00,172
0xc0ad84e2e18324311dcf0557fe398cd2d94d475e8fa946bc81faf9e9a508b918,t,21000,6861269,,5000037,2018-01-30 13:50:00,173
0x83f8fb047ec135d21db19cce16b7151511e851f0f70a0ea2bcf8e8d3bc58dfc3,t,21000,6882269,,5000037,2018-01-30 13:50:00,174
0x6488804ab33e2f04b43d4741214928efd7f240eecfd34da4a8f193767a949b86,t,21000,6903269,,5000037,2018-01-30 13:50:00,175
0x88e8d6319c3b117e4ee801124b46ea66c0c372fe23d1057a885de33753b1560a,t,21000,6924269,,5000037,2018-01-30 13:50:00,176
0x9d521ca5ea03fcdabe7fbdff76e8e0dd4b1a992b3c1be71e7f0ad2334dbe5569,t,21000,6945269,,5000037,2018-01-30 13:50:00,177
0xab914d9d1c7e5858cbb23b64d881029f858f1db3a51872ab5b7a367becb6024d,t,21000,6966269,,5000037,2018-01-30 13:50:00,178
0x4aee5b2275824e295b9fcbfe673db1df9e9a029ffc90365b20749cd9fa431ff9,t,21000,6987269,,5000037,2018-01-30 13:50:00,179
0x416fb625187d21d90b6c167e3e9683f74ae4235a55d40efc8e4f8c0381d0d68a,t,21000,7008269,,5000037,2018-01-30 13:50:00,180
0xa57533ed5645f948fa24cdc7222238626f1be49b0738adaf5c4f3f8556270946,t,21000,7029269,,5000037,2018-01-30 13:50:00,181
0x15b9d27997f551e814ca5dd4120e4a93232943699eec4dee5bc8ad3da9877c76,t,52886,7082155,,5000037,2018-01-30 13:50:00,182
0x8c4c348090d4ade53a90e4e651f14045b3a087ad4e4bc00ad4e0121cf85ff713,t,52886,7135041,,5000037,2018-01-30 13:50:00,183
0x70898946613e145bc7c4f14606a3103b0dddc745c41a72c9ffee757f5917820a,t,52886,7187927,,5000037,2018-01-30 13:50:00,184
0xd81aad2f02bf1b9bc66cef0a7d6fb650b46b9140e887f34791570aa9452a6263,t,52886,7240813,,5000037,2018-01-30 13:50:00,185
0x7575d96078531dba826157e3076dc5d34cdffa665b67b73f6dc07972e957f081,t,52886,7293699,,5000037,2018-01-30 13:50:00,186
0xe02251c96f1c4a0afe0949a60172cae51d89cb0679b6e584a4852addcb5c7fc8,t,52886,7346585,,5000037,2018-01-30 13:50:00,187
0x83bafc398d662daf8ee6f9eeacbce9ad1c4ea3ff0ee8f11516e3df0106e5529d,t,52886,7399471,,5000037,2018-01-30 13:50:00,188
0x8da468cdbb75bb75daae72d17e92be0769dfb6121715c492132e924024b09daa,t,52886,7452357,,5000037,2018-01-30 13:50:00,189
0x6f2567f582597c34de5ee9eba95c910d50749a91110a8ba3c295ca8bfb04cae7,t,52886,7505243,,5000037,2018-01-30 13:50:00,190
0xd7bc0e111210ea626f927ef4b8627d76f599e3248cc9056915067d15efa0eef1,t,52886,7611015,,5000037,2018-01-30 13:50:00,192
0x6ed670e684aa58b9fd36c6d47a48396bcf26fda517cae68c385f053dbd95b740,t,52886,7663901,,5000037,2018-01-30 13:50:00,193
0x43a30ef081a7966379fb5e08ca1a444201cafaea1a1b5619a5f0b2f8ad1a4fb8,t,52886,7716787,,5000037,2018-01-30 13:50:00,194
0x9d6ff0932365e4943f2a77f959b048fb23ab2e583f71c7423d369b6e3dcf603a,t,52886,7769673,,5000037,2018-01-30 13:50:00,195
0x12ba5ecbc7082ba4881d384752404c9bf50c45c33357a33fe1bbd1adf825ae6d,t,52886,7822559,,5000037,2018-01-30 13:50:00,196
0xa825956c85669eca5c3d1754e65a778b7dade1a1c83e8d7dfcfa125219d18605,t,52886,7875445,,5000037,2018-01-30 13:50:00,197
0xe4a0a357f2cd163f5443bccdda0081987fb6d0319b421565590ad0de17e5aa7f,t,52886,7928331,,5000037,2018-01-30 13:50:00,198
0xd96043ec0b8414c6a761f14ae9abd0cc469bce3c0e2536d4284f0d5e64cd5fae,t,21000,7949331,,5000037,2018-01-30 13:50:00,199
0xe4034285270debf5a05dcdcff0001b163252a67147921cfce69edacf93b16639,t,21000,7970331,,5000037,2018-01-30 13:50:00,200
0xefd7d7bb96da6784e6a81bed5d3ac9d6692a0f2c8a8dd2fdf42f92fe96379528,t,21000,7991331,,5000037,2018-01-30 13:50:00,201
0xc3f09f56def7139386c6e5f38ad56da69730863702507d473f9bf4661aa17734,t,21000,21000,,5000038,2018-01-30 13:50:15,0
0x5b818d52b1d92c071a77e87da5b662a4d8e856ed876606542225cfee29d07dbd,t,143081,164081,,5000038,2018-01-30 13:50:15,1
0x62f8ef214b996d68ef8857411616603e5a1a59bcfd174f3b2810586ae5038ba0,t,143081,307162,,5000038,2018-01-30 13:50:15,2
0xb9b86873f94bd2fcfa995c8745e823f11f776f72c6d588aec8ee46e9bff26dda,t,21000,328162,,5000038,2018-01-30 13:50:15,3
0xfd6f2b6f2369cbe5ee1e50be4857044c1714e60eb38816e8fc7ad9d2ababb285,t,21000,349162,,5000038,2018-01-30 13:50:15,4
0x04e836e4a130ca93fbe7313d0762d1a86583e5a01e050fd85dc88bff89385019,t,21000,370162,,5000038,2018-01-30 13:50:15,5
0x56ee826481dca0bbd1c10a5c1e41660f76d8d33c902df83e2c9316afcd6de9a2,t,21000,391162,,5000038,2018-01-30 13:50:15,6
0x10e6c0636caa192aaccec5b89ff3e5fa9e4ffb8001f8f7eac06e9f0f9ca0bb09,t,36473,427635,,5000038,2018-01-30 13:50:15,7
0xefdc233c9bdfc63cd42a60378140fb98a70646c50e54759948485b65ecae3541,t,52507,480142,,5000038,2018-01-30 13:50:15,8
0xcab1773783f4e7afd3bafb64d070d7a1a501ed70dfacbc68820dabfc30b8e151,t,52087,532229,,5000038,2018-01-30 13:50:15,9
0x8313482fd27eaacbfec1928a4acf9d3974d897a8193e84392f5f6fbfccd77b45,t,58999,591228,,5000038,2018-01-30 13:50:15,10
0x49f20bc725f2b4f4e842a4ff3c7ec7599ebd0a87a9465b6ca0bf87b3713c255a,t,101877,693105,,5000038,2018-01-30 13:50:15,11
0xe861b7dc2b03277df1eab24cfd9fcb75bd5f6adc19f88560feeefc9906d67bf9,t,52249,745354,,5000038,2018-01-30 13:50:15,12
0x329a9fa09abf1982c9bd9d39dd0b3aefa2910ac4c3278bcda4f0ecebc29c2fd8,t,21000,766354,,5000038,2018-01-30 13:50:15,13
0x9c463280045788e272e4cf6d2d25447df3afb32be76119fd41ef814833b257c9,t,21000,787354,,5000038,2018-01-30 13:50:15,14
0xc40723ec2a9ae4f4d6241abaa7c54357df678288600957c73546c0b2425d1200,t,215038,1002392,,5000038,2018-01-30 13:50:15,15
0x925e12f3faeac53b486f0c5f58ef60a4db903165b1d17b07dc5a688cb88affe6,t,22049,1024441,,5000038,2018-01-30 13:50:15,16
0x1048a63b4bf8070bb100f745c796bf318536b1486ba6254629594d516e0ca232,t,21857,1046298,,5000038,2018-01-30 13:50:15,17
0x479fa0679e0daba4d885ba170e855ef50ea9364a05e1dd4225cb318b3c9fea5a,t,36647,1082945,,5000038,2018-01-30 13:50:15,18
0xa68b7aa9682d55c01519cad769299233333b0716713a02afe12ecf4087f2e332,t,21000,1103945,,5000038,2018-01-30 13:50:15,19
0x0b92b2a8e59a13cef65c16e2b56a0a0c95630389963eb104cabb10b8b3e80358,t,67863,1171808,,5000038,2018-01-30 13:50:15,20
0xa2a45430f3f9757de536080595e8c9cdb625916f579eff1ed91a0d7a8cce0cce,t,21000,1192808,,5000038,2018-01-30 13:50:15,21
0x6aeb3fa676431f73b6c22621f59d488a80c26c1f1602a3dd3792aee62e3e9a49,t,44854,1237662,,5000038,2018-01-30 13:50:15,22
0xf501e24b2f6a4366610ba3b1d07285c2d01946f579818d6ec774282bebe5181c,t,38252,1275914,,5000038,2018-01-30 13:50:15,23
0xb574728f08be0fc99124117c9e953b83b75102b32e252d3440de10dd7d2d813f,t,36411,1312325,,5000038,2018-01-30 13:50:15,24
0xb3d088ff436fd52caac6404e95c4382ab9e940c244ba85eb995b8130d371cf59,t,24835,1337160,,5000038,2018-01-30 13:50:15,25
0x3c859463669c38391fcafef113bf9a989c7ccbcdee99b75d5bd44bafd1a9976e,t,21000,1358160,,5000038,2018-01-30 13:50:15,26
0x382a3e3b25bc5d8d8cbfa3c30beb1f70475d30ca76eed5f9420f1ccc5b5b9dcc,t,21000,1379160,,5000038,2018-01-30 13:50:15,27
0xee7d9c7402721245176fe41f80f32c5fd74b4dd2b9ee318cc5814311d95ca9d8,t,51883,1431043,,5000038,2018-01-30 13:50:15,28
0x140ed92e9f321c928659dfa4d2bdfffc60fdfd4454dc11a7b6277721292889eb,t,108242,1539285,,5000038,2018-01-30 13:50:15,29
0xc5c56fa40305fda922b44a219078e787daa3856faa0c28e974f57d796c385a20,t,59290,1598575,,5000038,2018-01-30 13:50:15,30
0x9fdd5d207599ef2be9f51b6de381a84a0820ccf19d2446644351a186384f35f0,t,21000,1619575,,5000038,2018-01-30 13:50:15,31
0xa15d1de34a2656dda00f4eeecc233770e38f81edc30bd52ab49e758024d0987c,t,21000,1640575,,5000038,2018-01-30 13:50:15,32
0x3c217d9e7c5f274f68c2b6228b3cd8360c27dcc327ab81523666c523c16786e3,t,21000,1661575,,5000038,2018-01-30 13:50:15,33
0x4d3083bd2a47828eef41c330cf6c723201efd9a93ac3cc08865bec73d6b44c6d,t,21000,1682575,,5000038,2018-01-30 13:50:15,34
0x1da06525f149216638add2404b62be21ae70beee21b24f604fdfb9bec79f94f6,t,59354,1741929,,5000038,2018-01-30 13:50:15,35
0xa5cc25be4ea3dc5807652442a25dd990558acf7dee191c33d9b9d286e7e19969,t,21000,1762929,,5000038,2018-01-30 13:50:15,36
0xf3d637e741edd90633a7384bcd47be788672a8d40d3335fc7c66b4bd2ed38a2e,t,22148,1785077,,5000038,2018-01-30 13:50:15,37
0xda9394d5d74a7874e420390f1338813dea46c0bcc679f590655f76201b475e2c,t,21000,1806077,,5000038,2018-01-30 13:50:15,38
0xb9c7a6812eada472312a14a1bde99c3d800fea0b5f0862728915312a94c595e8,t,21000,1827077,,5000038,2018-01-30 13:50:15,39
0x23fe2d3126a5dd1115c128f482bf9b3de94250c56017b7fd05f5ad3c705bca04,t,29308,1856385,,5000038,2018-01-30 13:50:15,40
0xcc834c60400429bc1dbd0edb82226b3090ac041571beff27a2f8f356c5a14e88,t,21000,1877385,,5000038,2018-01-30 13:50:15,41
0xccd3959f17d2ed4ecebecec5f584208d35958518ce00590c69d21c70cc88e004,t,21000,1898385,,5000038,2018-01-30 13:50:15,42
0x76752fe1b441c2252feec89cf9e8f2d69d9e34838de43ffdaa686dd50097189d,t,21000,1919385,,5000038,2018-01-30 13:50:15,43
0xeada4111b7238786ba4e0c62b296fe578f5c3a7825e52436941a71c380ce7297,t,21000,1940385,,5000038,2018-01-30 13:50:15,44
0x60cee9ae059a56277aa73b577d099656e102398c45baab1918035ad1b3798f4e,t,36884,1977269,,5000038,2018-01-30 13:50:15,45
0xd2b4d11d0d76d12cf5261948a7b2d8269d05f850171c99d3c8c668ae359c24ec,t,36884,2014153,,5000038,2018-01-30 13:50:15,46
0xacdd01630a941f2f6fad1d5bfc0a1e85fdf5a852ca6ff2b4476c80ef5e98b30e,t,36948,2051101,,5000038,2018-01-30 13:50:15,47
0x5c573f36f091f424fffa02f4ef28a824684fdc15dcf089db8d2d3a036f2bdc62,t,21000,2072101,,5000038,2018-01-30 13:50:15,48
0x7ad0a6d8ebbf6a9d6cf641812c63cea3e0b3ea2ae0156cbaf9669fe3c98adfec,t,21000,2093101,,5000038,2018-01-30 13:50:15,49
0xff422747fd8fa5304376234c7270206b3791fbaeb36a072d77d7842240a573a7,t,21000,2114101,,5000038,2018-01-30 13:50:15,50
0x3042001f4b57bb6b8b590b52d3a6a25c06e9bd4a04edf2297f26f74d6073d6b9,t,21000,2135101,,5000038,2018-01-30 13:50:15,51
0x11b83728e441c3d74b530799daf6c3dc9c3abcf336ff4660478c6aa7f43bd228,t,21000,2156101,,5000038,2018-01-30 13:50:15,52
0x8b37d4e0f8f10915458cb389c82a09db6acb7f7f087bb528c26d16a554863982,t,21000,2177101,,5000038,2018-01-30 13:50:15,53
0x0fd210bf4988e68b602600a808d0bd4ba0813f1e47465e6db3d68f88de01ae7d,t,21000,2198101,,5000038,2018-01-30 13:50:15,54
0x6b63d02ad09c097c1c3b2af2a2cc1bdbece2401ec356ae437f31071ce797ea43,t,21000,2219101,,5000038,2018-01-30 13:50:15,55
0x69602030ff0c187b8501a2340deae1caa2d5a18b64d4ed106304b8cb86df7144,t,21000,2240101,,5000038,2018-01-30 13:50:15,56
0xba16f9bc739d8efb1002cf49245d795aa69cc8243eabbe74e715c91da89156df,t,21000,2261101,,5000038,2018-01-30 13:50:15,57
0x8198dc106d37cd00a7b0f89bdaec0c29e0469063676cd62e196d1c32f6b99759,t,21000,2282101,,5000038,2018-01-30 13:50:15,58
0xcbec99836b2b378a0157b2bcd58e515b6a90ae0c990ffc2c6dbeaef7a45c1a5e,t,21000,2303101,,5000038,2018-01-30 13:50:15,59
0x17d6d31fe247780b87c8d56c7464844b42ba41c292c4cc82ae11fb6ab7a457a8,t,21000,2324101,,5000038,2018-01-30 13:50:15,60
0xe992b4ab5c54ec36f56d001b311d8b5c4436ca96021a3330f4a7908684f3a8a8,t,21000,2345101,,5000038,2018-01-30 13:50:15,61
0xc0e3aedfe9b6830e1ab18e2c71e498d2fadc93252316a520b32cafc469713c34,t,21000,2366101,,5000038,2018-01-30 13:50:15,62
0x43e282b21f596124b3ac4df3138371cb5d9b150ad77f6a9aa053cafb067edfe4,t,21000,2387101,,5000038,2018-01-30 13:50:15,63
0x359972ff1378423ab98a5e93e2b91aba053aad20e62102c5fd884a438848717b,t,21000,2408101,,5000038,2018-01-30 13:50:15,64
0x33988768fcd243de9d0a43dac7f70c9c92fb119e85a52217d2e6a8c93e6ebe3b,t,21000,2429101,,5000038,2018-01-30 13:50:15,65
0xb32aa8517c75db093348fa57f2b0f8a3df051583dac55212b5125937acd05ada,t,21000,2450101,,5000038,2018-01-30 13:50:15,66
0x540318e9b1ff53dd357acb4b273202d2bba6fc2e2e3d31245f1a045932781409,t,21000,2471101,,5000038,2018-01-30 13:50:15,67
0x6a2541087e5fdb64eec0fde13ff514fd9c5af525f4cbaf0ec24518241f926933,t,21000,2492101,,5000038,2018-01-30 13:50:15,68
0x161649a3698bf33a1711a296f2a91ce7d012037af06a1530002bfd998acbf52d,t,21000,2513101,,5000038,2018-01-30 13:50:15,69
0x6fa5594f93d56fccaad269daa995cb2d8397935cccbd10d9973aa09dfba33cd0,t,21000,2534101,,5000038,2018-01-30 13:50:15,70
0xfca6ac846e8f365a92b4d46d46ab86168ff6565295729f602ace2e498f30f4c4,t,21000,2555101,,5000038,2018-01-30 13:50:15,71
0xc97fa66a34be26cc50842fa607ec442f4cbc350b77298760d78a264640d1e0ae,t,21000,2576101,,5000038,2018-01-30 13:50:15,72
0x3d8361a8f022c1177b82ed1c7b0971e2c3ba053c07ba563b5734ee63937d051a,t,21000,2597101,,5000038,2018-01-30 13:50:15,73
0xbb4b639d39a6935ccabbde48fe5e061b6142978797e5ee723c1d438d88f5f959,t,36948,2634049,,5000038,2018-01-30 13:50:15,74
0xb03ce17aed1c0b6d23182d1e5d305c4b62647970ecf3e73f1ecf585a2156d609,t,52334,2686383,,5000038,2018-01-30 13:50:15,75
0x3f33c7daa619a043931fe0d17769b26eb79313e6c05d00a1c22b793ea934c18e,t,52524,2738907,,5000038,2018-01-30 13:50:15,76
0x57cadb2402fa2e7e93b23358e41c0049a5bcf5f2a6480836e252ef6f57307817,t,21000,2759907,,5000038,2018-01-30 13:50:15,77
0x587504acac9a69e8ebebe18a14d76e9865c723e5823eb8a4f9bcabef34b7ce00,t,21000,2780907,,5000038,2018-01-30 13:50:15,78
0x1d396bfe0d5b3ae9a5027bf0f3d6244dbe56a3c45091947082280db729334350,t,21000,2801907,,5000038,2018-01-30 13:50:15,79
0xc8eaed91f7d34b3e5c2bbb7eb13b07f8de9d220f0ae58036d8bb02fed234363a,t,52084,2853991,,5000038,2018-01-30 13:50:15,80
0x73d55b69bc72635be0ee98b3b3d34459788c881c1a732b3d16c1b6ca470a41e4,t,21000,2874991,,5000038,2018-01-30 13:50:15,81
0x5dae0ec17de15919a51abfaa726717fd5f7c814e21108e27f48ae79fcd89f49b,t,21000,2895991,,5000038,2018-01-30 13:50:15,82
0xa943a13944ac461fdc79ef722175e9ba54320f3d752e4c89a1c98c4217083a44,t,21000,2916991,,5000038,2018-01-30 13:50:15,83
0xb19be634f3a5d9b224e7911d112660bb849d2cb266d72330f91c601ea2f39484,t,21000,2937991,,5000038,2018-01-30 13:50:15,84
0x6e70650935a521e9b254415435fb5becf6a3b5901f3cce26156049f75541d455,t,21000,2958991,,5000038,2018-01-30 13:50:15,85
0xf413a1301b0603d82caa53521294c1c2053e4dccc131afb800758a3af766c831,t,21000,2979991,,5000038,2018-01-30 13:50:15,86
0x1334c22d1f236c296c0378e50eb97bc5ac229ae4738fc6fce15e4a757973821f,t,36848,3016839,,5000038,2018-01-30 13:50:15,87
0x24a205b4f4240f7f0e721d2826bdb172fdb06c66a10442d34c129cf31b031973,t,64725,3081564,,5000038,2018-01-30 13:50:15,88
0xa23469e741bdd67e6438b44647e2f5a7e68dede67c6790a2ec8d3a957c9f3a77,t,21000,3102564,,5000038,2018-01-30 13:50:15,89
0x1749ba9970e83cacd56a6d29a6e171dad3d247a6b3d01a0d7611c57815358629,t,37950,3140514,,5000038,2018-01-30 13:50:15,90
0x2d1e3fbf830bb16bf7449c08578c6f2641b51b9865ff38ccaa739b87c7449091,t,21000,3161514,,5000038,2018-01-30 13:50:15,91
0x446c5d5c9a6a1cc8db2e0355555521c4c6955faa122b4e06381722ce917e7977,t,22373,3183887,,5000038,2018-01-30 13:50:15,92
0x5fbe9fa9fb39da5a3ea6ac55e6aa251adad8babe88b55745095736587b336c22,t,52822,3236709,,5000038,2018-01-30 13:50:15,93
0xc168fc4bdbfef1e09e8afc2fbd46e584dd8837b0f6d7d9f3f6850e4c7a1765a0,t,52886,3289595,,5000038,2018-01-30 13:50:15,94
0x5ba9a3b36f8a9e6148f1650e57121a51149762c2dc3d012fd9e05dee82082bf6,t,52886,3342481,,5000038,2018-01-30 13:50:15,95
0x535ef1af7f55a05e7a63b6add3697509035edd948bf1007a486582e7eaf28581,t,52886,3395367,,5000038,2018-01-30 13:50:15,96
0x337b37a25516b2ba466c8f94296a28c184ded73b03edfe12680775d08e5f2cc4,t,52886,3448253,,5000038,2018-01-30 13:50:15,97
0xba48ed293c84a20a61d0f478512061489591236959e3213e4aa7376c4903fe47,t,52886,3501139,,5000038,2018-01-30 13:50:15,98
0x92ceef630d896c3bfbcbf8cb3f42a89c52ab5e4062f7b41d94151bf333c89866,t,52886,3554025,,5000038,2018-01-30 13:50:15,99
0x7864978395a2ca76ef0b7f6a08ac81579629df1cd7427a0089499d6212144508,t,52886,3606911,,5000038,2018-01-30 13:50:15,100
0x0bc1d487605037dc2ef0a9a67db1251f26fa7b19de0378d58c8cd1c526491825,t,52886,3659797,,5000038,2018-01-30 13:50:15,101
0x1c78ed2596a51d0b20754bde488df319925b4fa62885e559f4525f1762283d6a,t,52886,3712683,,5000038,2018-01-30 13:50:15,102
0xe04165af49b3bf34eda16063ccbae712f32b4252a60ef2b75d832c064591f50c,t,52886,3765569,,5000038,2018-01-30 13:50:15,103
0xf8a0fcf8cbc2044647fd9aa3cfb160138303a4f0dcd3afd7262f9c060cc418c3,t,37886,3803455,,5000038,2018-01-30 13:50:15,104
0xbf6a5e7abb37f31f9fa6d12befdefbc5441e797dbff745369967a3e7ab3ee1dc,t,37886,3841341,,5000038,2018-01-30 13:50:15,105
0xb4ec096499d658c917ae1904fefe0bbf04de6f91505bb6272e44ba57a1e854cb,t,52886,3894227,,5000038,2018-01-30 13:50:15,106
0x80f15be9e32eb885eb4974703f8e9fdb833e3681ae5161d7b07bc8613cc63c7d,t,52886,3947113,,5000038,2018-01-30 13:50:15,107
0x041bbda3d78365684a848e2802ce1c3ea3c13dc20bbf2111a4e35f9e33504b11,t,52886,3999999,,5000038,2018-01-30 13:50:15,108
0xed3f96a21b37c40b21e51a73d7db4d9dc0596b14a618fd83315bfaa173c580c3,t,52886,4052885,,5000038,2018-01-30 13:50:15,109
0x1507f4c54f2d77ae4e5d853ee373dc4510571e802129738493f7b7f168d220f4,t,52822,4105707,,5000038,2018-01-30 13:50:15,110
0xaf6deecbed7285cd9857ded772bd1240ddb4ea66a64b84e1fe064db5fd40cb87,t,52886,4158593,,5000038,2018-01-30 13:50:15,111
0xccefdd95bb61319d02e38e1579ffe3fbf3ac0c4d3591387fd0d8ef5665cf45cb,t,52886,4211479,,5000038,2018-01-30 13:50:15,112
0x26bab431af7be22dbc7b8efd4a86982bbd8ac06257ab25ba10a55b63ffd10f0d,t,52886,4264365,,5000038,2018-01-30 13:50:15,113
0x54c85d7509229d207dab4183304f9e6ff7025efd82ddcb279d1317e4c043eb6f,t,52886,4317251,,5000038,2018-01-30 13:50:15,114
0x9756eb32e9a89e41ff987de972d4d3f4e9625f9ff06c80a72b80644e0a554994,t,52886,4370137,,5000038,2018-01-30 13:50:15,115
0xc1a0041be61b53a0efb1ec3ecb6ece0a05dbbc7b3eb6a41e7fd2bde8bd29c338,t,52822,4422959,,5000038,2018-01-30 13:50:15,116
0x5d320981bb8222667e369fc00dc3ec587a656fc0816cbdc362b0b2a7335e707c,t,52886,4475845,,5000038,2018-01-30 13:50:15,117
0xb00a65802c363be8761b7f3c0b39074a1cfeacffe1152daca2ce518398037caf,t,52886,4528731,,5000038,2018-01-30 13:50:15,118
0x2e3cae474cd3b769a42b1492906f64798f253276f75e6d049ab3b2d80c991cd5,t,52886,4581617,,5000038,2018-01-30 13:50:15,119
0xd4ea94e1fe26caa8bbe7095d6cf6cfacf97d73ffbac4af721ef6e241874dcd96,t,52886,4634503,,5000038,2018-01-30 13:50:15,120
0xaa6769fb4f0bfe2773fd8390d43debad4a345e4d5054ea7716819a2cf018982a,t,52886,4687389,,5000038,2018-01-30 13:50:15,121
0x6e2c56c12fb50f81ecfb4f356e12b805df60407f9c9689353966e4ab91402128,t,52822,4740211,,5000038,2018-01-30 13:50:15,122
0x399e72e73ca6d3f01ae8ed09023c9a0bc8a784cf840a96bfbb942d25e6fdfe28,t,52886,4793097,,5000038,2018-01-30 13:50:15,123
0x90580c5848f69467cf104d132651a1d81fa7b8960f13d085703827c2d9e6f522,t,52886,4845983,,5000038,2018-01-30 13:50:15,124
0x8bddb499b12ae857fbcf0bf00454950d8722d54176700d7c992ce2587fe968cf,t,52886,4898869,,5000038,2018-01-30 13:50:15,125
0x6c62042e107dd91566314ba54a3a1ec10da5266ec711ca9bddfcae3960600a92,t,52886,4951755,,5000038,2018-01-30 13:50:15,126
0x0def8cda2be74288ec10ac95ebd7e64582eae30a5dd43d3ac9ca17eb6b9c5501,t,52886,5004641,,5000038,2018-01-30 13:50:15,127
0xcb52e2dc82604ed9902011f223c97aa073baa1f2bf43dbb8a57806b955c00a2a,t,52886,5057527,,5000038,2018-01-30 13:50:15,128
0x1dec2ae2f2bb7fc29dbb98a73f95e46e9fab4a3783350215060e5a3da9813e7b,t,52822,5110349,,5000038,2018-01-30 13:50:15,129
0xc66438dc539d5666cd03c561a6beb34cd53459a9e59b4ea58767fc80569eb6e3,t,52886,5163235,,5000038,2018-01-30 13:50:15,130
0x0f19f42e9f5f90094f2d80714986c143db04341cd49da765b4e47e04453d909f,t,52886,5216121,,5000038,2018-01-30 13:50:15,131
0x455eb8b558aecd01239376a07077505bca019ec091f6076bdfe56a1c40db697d,t,52886,5269007,,5000038,2018-01-30 13:50:15,132
0x90cf2c8a08340b613510aecc2d0dca6f4ed26b2bf10d30836f9566e4ea69c669,t,52886,5321893,,5000038,2018-01-30 13:50:15,133
0xebf60a567810bcfd8b936633c21b8baa1804a26a770512618aa0b191a5c7e91e,t,52886,5374779,,5000038,2018-01-30 13:50:15,134
0x6e4b7ff404ae19a184ae60f1aa245c24b92198a6c1a56d8a8e6b2a9659d2934b,t,52886,5427665,,5000038,2018-01-30 13:50:15,135
0x343053e3137de7e840f90f62342cc90bf04034bdfac9e628fa716ff909536ec0,t,52886,5480551,,5000038,2018-01-30 13:50:15,136
0x4200a801fe028d015571278a98efaafdd7667efc011de552fc7b993f05caeac0,t,52886,5533437,,5000038,2018-01-30 13:50:15,137
0x41979833f9468fdd1bd768b0fce057b9c885648a4eeadb77df0d5c6e0d8ada0d,t,52886,5586323,,5000038,2018-01-30 13:50:15,138
0x6e8199107f102b2b2fafac1a355327de3420e0bebe0bf0bd0bb78208a8403d5f,t,37886,5624209,,5000038,2018-01-30 13:50:15,139
0xe391537ef80aa72c1c1365304e1faf5f1b7b2935526f3b739b171d4a329217ee,t,52886,5677095,,5000038,2018-01-30 13:50:15,140
0x8b2691aebc698436bbf81e26d92f16a45eca23ef12e2e95544c206935043d7c4,t,52886,5729981,,5000038,2018-01-30 13:50:15,141
0xc88f68c6eeb4471594d2a92828bead1f8a6993338184ff0f1d2d8b92e1ad6a54,t,52886,5782867,,5000038,2018-01-30 13:50:15,142
0x1118f75a8777753168d0630090c1cee168c5c944caaa8612a5b385a71292c6a3,t,52886,5835753,,5000038,2018-01-30 13:50:15,143
0xd812417b70d8d55743f3a367a1e1c24c1f0a4bf1b7c0291d2b27699bb357f163,t,52886,5888639,,5000038,2018-01-30 13:50:15,144
0xf9ca9ec5006dbfac62f8330833e11ed3e96552c82de9326f1ab067f0e1ead56d,t,52886,5941525,,5000038,2018-01-30 13:50:15,145
0x6ce0b2e32fc9aba39553c51a24f74e53cc7648a977708515322c9727247c7a70,t,52886,5994411,,5000038,2018-01-30 13:50:15,146
0x61fcc9a52bce109335f27bbe1907e56575ac915250eb87650388d33a67cdab20,t,52886,6047297,,5000038,2018-01-30 13:50:15,147
0x2986e138bbee232d38a40b9c52628e8341f4b75c390b7ad3184b2f3e1fc399c6,t,52886,6100183,,5000038,2018-01-30 13:50:15,148
0xb8dbcb1ed519e2f332742b8cd8d4d95ca8faad44abdf393be1ccda5cf5fa2746,t,52886,6153069,,5000038,2018-01-30 13:50:15,149
0xefad156b7614a280c52121a356d5b1d0e593ee22a864d2fb6915d6dcf4e2beaf,t,52886,6205955,,5000038,2018-01-30 13:50:15,150
0x7ea2fc0d896873d54688d442530be84b2a882084073273293ad1851c70178d30,t,52886,6258841,,5000038,2018-01-30 13:50:15,151
0x16ab859b45c68de5a5b99f8abe660793808d57a49e0420f3bfced630296e2c0d,t,52886,6311727,,5000038,2018-01-30 13:50:15,152
0x354a12a742f52e1b561362846f4d744806ec5adba84a82e85b1061a952be8d81,t,52886,6364613,,5000038,2018-01-30 13:50:15,153
0xb69c8d4a7823fa6eadad5c1ec1c0b992e9858d54b64699ac7be6745480d52168,t,52886,6417499,,5000038,2018-01-30 13:50:15,154
0xe2e95c5c0c769fcdbb35a01b00b55f8b7d9b0f78f39716bbd9e89ade0169dd5a,t,52886,6470385,,5000038,2018-01-30 13:50:15,155
0xfb4b43ca9e0ace704ca070627e260da3effbdc7ce76e513352b0a364ad2c35a1,t,52886,6523271,,5000038,2018-01-30 13:50:15,156
0x71321b4ed13839720bbc0b7e2ed7659a61d61acbca7b529fd5c21ff1a2f15608,t,52886,6576157,,5000038,2018-01-30 13:50:15,157
0x399ad58c61d6f54a6679b7b3e99c1776b593c36a25cd14eb2c1b1359819c5d04,t,52886,6629043,,5000038,2018-01-30 13:50:15,158
0x1a7d8cd4f3f41ffb2a7e584855041e126b9b1a19e3d3a426ade92758d6c76dd9,t,52886,6681929,,5000038,2018-01-30 13:50:15,159
0xb4805f132ba8ef486b7fc216f4089e2f6b2e8ad05ea6635f6fec4c247e75dc5a,t,52886,6734815,,5000038,2018-01-30 13:50:15,160
0xda50c6166a0c271614c0daa63c0b8e55761f4fc78cb045959eac7d1550f43a46,t,52822,6787637,,5000038,2018-01-30 13:50:15,161
0x6b29764bf7bc6c79154eeed96e5b6ebbf3ccab283f78ae1e2f6478dbad7bc27d,t,52886,6840523,,5000038,2018-01-30 13:50:15,162
0x68357220ba585138c8c3a90ceb403b880dc5956e02f726d69d12a6480c2a614d,t,52886,6893409,,5000038,2018-01-30 13:50:15,163
0xf8b18d69abf9b737dde03821d191ef08ab71c4d7eb258f6ff244e736665fe29d,t,52886,6946295,,5000038,2018-01-30 13:50:15,164
0x1b51a609efab077085e22fb9db7d5b58a165aa5c46dcc7c6981b6a62cb137063,t,52822,6999117,,5000038,2018-01-30 13:50:15,165
0x7598d0489a7fea624dbc91c9d9506732bf91011b7acd157b23f61ad5a80ea68b,t,52886,7052003,,5000038,2018-01-30 13:50:15,166
0x2960b743e02ea609527b6a99bc557c71ed20cf7a85af3ca0c51c73316c5a47f2,t,52886,7104889,,5000038,2018-01-30 13:50:15,167
0xc7683fa5e677ae87b00328316e027dca29ac926766986e317187907d9841c478,t,52886,7157775,,5000038,2018-01-30 13:50:15,168
0xbc4a2b28b7bf2af58a941fc136ef221a63e38519b3e40365f254988f04852997,t,52886,7210661,,5000038,2018-01-30 13:50:15,169
0x2401e202808dcbbe2f08cc323c9a221e2871d002c32337629539aade09ef7ebe,t,52886,7263547,,5000038,2018-01-30 13:50:15,170
0x89b540b6fc15214acdcb35051f8c4bb208ca831a865cee47baeb78e6c03ede15,t,52886,7316433,,5000038,2018-01-30 13:50:15,171
0xd2c193289f7457cb4acaf70ae340866c19d247a0e6d7d1bf216b7fbe2dbbe371,t,37886,7354319,,5000038,2018-01-30 13:50:15,172
0xd9594dbf3206b1b16dfecb30ccb4e5964b8303396c613333f31a8d4c06d02f17,t,52886,7407205,,5000038,2018-01-30 13:50:15,173
0x473313644538e7b20c7c01e859aaade3dc2185cd261dd5b117f09f98bbc2cd07,t,52886,7460091,,5000038,2018-01-30 13:50:15,174
0xc6738d60c14a5bbf80ae556924e449b8ecaca235d192e5f4f2c6d2dd43ac14ca,t,52822,7512913,,5000038,2018-01-30 13:50:15,175
0x406d104326fa8544793299b86daaaab86d7273cfb3ac0be2071aa7aa74f294bd,t,52886,7565799,,5000038,2018-01-30 13:50:15,176
0x9f90884f4aa489a9dce18bd0d5e30f0d027ab16371b677f20198c33c742abb76,t,52886,7618685,,5000038,2018-01-30 13:50:15,177
0xe5d7dbe2099ebc338fcf65a580f96fb4d4f99c7cc7dc3d4cea32260877f57c53,t,52822,7671507,,5000038,2018-01-30 13:50:15,178
0x45305d1ed401c999d5c66ecf41481c170fed25095b0f187bc1a3953ea8b2a7f3,t,52886,7724393,,5000038,2018-01-30 13:50:15,179
0xee050c39fa6c42fa7d4749f37c33e3a0242e6a9808c6169530205163e0f60d7c,t,52886,7777279,,5000038,2018-01-30 13:50:15,180
0xce57c77258e22a9924713fe9917e22c4cb09375edea10f92e7f2235369f3286c,t,52886,7830165,,5000038,2018-01-30 13:50:15,181
0x7cd4f2c900f16c4497ed1bc727ee5c10f7b211ee75ce5ccd38d5e582911049c8,t,52822,7882987,,5000038,2018-01-30 13:50:15,182
0xa288913ffac1c95e14fc2a60c47ee9c1011026931f5142637227ce1cdae934d3,t,52886,7935873,,5000038,2018-01-30 13:50:15,183
0x765e7d83c029fcbb221c78ac0532b9a02a0ea3fbd079fed81e0795848e82f239,t,21000,7956873,,5000038,2018-01-30 13:50:15,184
0xc5eb788ccc2d5aba979798b84497c20ab3f26fdf469b19d2fb0855f8a37d9106,t,21000,7977873,,5000038,2018-01-30 13:50:15,185
0x281274a687a3b2903afea2d9803a95ecf24c4a76cffe90a3753c320aa8c4e015,t,21000,7998873,,5000038,2018-01-30 13:50:15,186
0xdf1510797361aee8ee83437c7b2a759a587e695c06f67f469cd1ec3f2c953393,t,21000,21000,,5000039,2018-01-30 13:50:18,0
0x82589a7f30f9c0c7f2c36d0d134d0af279cb35c256b302401c417bf4f052b622,t,21000,42000,,5000039,2018-01-30 13:50:18,1
0x3fb4f1e720702cc2908033f9c40c8d0f68f4bd23923b871d4a047694094b273f,t,55843,97843,,5000039,2018-01-30 13:50:18,2
0x56bdf525b16b9d866ff46d8180ed49242fecea7d7b1fa65fc7b1ff0ace6e9c44,t,40907,138750,,5000039,2018-01-30 13:50:18,3
0x6a2c7195ad52fdf6197d0bcb1b42b5a81f2017ea8a972318a3bdd6ebcc22e0a5,t,21000,159750,,5000039,2018-01-30 13:50:18,4
0x5e457912582d7d22c33ef7f4a947a25134eda75bd7c357069f39c5fedd60dc6b,t,21000,180750,,5000039,2018-01-30 13:50:18,5
0x63edd61df20682c4eb60986237df2565eea189f0678dfec8ae9d7b4090fa1c31,t,21000,201750,,5000039,2018-01-30 13:50:18,6
0xe897f394b2bb528025a86ea5771216e34783f353cff5bfcb5f2685a10d2fabdc,t,21000,222750,,5000039,2018-01-30 13:50:18,7
0x840d725ff676e1aba129f7a13f3a3b37e4be66a51723febcc83e5c69cd7a33a1,t,21000,243750,,5000039,2018-01-30 13:50:18,8
0xa32f893df6400a879317b8174dab2bfc3d5545144a2ce0e67fab1cb3dec00c7e,t,21000,264750,,5000039,2018-01-30 13:50:18,9
0x3d046fccff8fa497ad223f1cda64114ae800492fb05305c8bbfdd38d47e6b3ce,t,21000,285750,,5000039,2018-01-30 13:50:18,10
0x1913e6cf581647d5204962c71765efda6d46e01916100fe362753336932cf8d8,t,21000,306750,,5000039,2018-01-30 13:50:18,11
0xc65bce735435b1c7e0699d6e3513111aa51c5abcb669164382dcdf9217b183ba,t,21000,327750,,5000039,2018-01-30 13:50:18,12
0xbfeeb8d69baca27f5a37429de13c8388352e54f0cb82b88487bd007c4feacdea,t,21000,348750,,5000039,2018-01-30 13:50:18,13
0xddeaf5cf509fa214d733d619a4c528745693ba05c3035e0f2d1fc5818945e5d5,t,21000,369750,,5000039,2018-01-30 13:50:18,14
0xb44d4bf51a4c4c1d9f3d398ea6dc03521bb5a852a0f101ccabb6dbe2b24d25ad,t,21000,390750,,5000039,2018-01-30 13:50:18,15
0x7e0d74ce344b31f6e603945697663561fe36438a290b408b2e8e649d6385e46e,t,21000,411750,,5000039,2018-01-30 13:50:18,16
0xa0451e8c5763dec688d2c925d82e9e9724a8a4d49ae17a66a384282bfa2b2041,t,21000,432750,,5000039,2018-01-30 13:50:18,17
0xe6fde42e8b8def7c03632f83a1fe0221743e016dc143d8dd54e38275d153937c,t,21000,453750,,5000039,2018-01-30 13:50:18,18
0xa4d331e2dc826cc7ebf79f62647ed2aa0f5b3af0dd18963a3878fd28a3db1c4f,t,21000,474750,,5000039,2018-01-30 13:50:18,19
0x9d1b85d8b226766f59dfc26a1b547d00b3669b320bf1decadb4ee6bb9bc8ad19,t,21000,495750,,5000039,2018-01-30 13:50:18,20
0xd00fe379f4ff7586e74f2a226969d384e6e7c915f1ad1c44dead1e4d0d280968,t,21000,516750,,5000039,2018-01-30 13:50:18,21
0x78d8f830190072fb32206bdb92775ae8a2d904f687ca84094174cd00eb87bb1d,t,21000,537750,,5000039,2018-01-30 13:50:18,22
0xcc558ccefd352e4d229feb5aa63779367249fc6397b9161fb01bfe5727ac6fb8,t,21000,558750,,5000039,2018-01-30 13:50:18,23
0xfaa0a56a19b8903dc7cdc4708f0dbaa04a703d7b4b4551be91b4092c0aab41ab,t,52552,611302,,5000039,2018-01-30 13:50:18,24
0xe618f8d6687d7e91694b129001540f6bae87877f1e956fc2f9a7f1ce282a7710,t,36948,648250,,5000039,2018-01-30 13:50:18,25
0xf21cdb2c5e67b46d8140af695e174e6acb35aca4e15486d2789ec1a6c85ea91f,t,21000,669250,,5000039,2018-01-30 13:50:18,26
0x625a5a69bcb241ac7fe2e5b773a29c083a5331a23bf4a6709227fbdf4189cec2,t,53233,722483,,5000039,2018-01-30 13:50:18,27
0x58c1d65bfb6981600520700ea32520725ea3fd96470c58d209344bbb998b1202,t,140027,862510,0xD480C30Eab940b299A8888a43A64fD5B8b37dB4B,5000039,2018-01-30 13:50:18,28
0x412171bcbfd410b2299f1e89625d2538c756fa4435269a640fac95fb79f6ee7f,t,21000,883510,,5000039,2018-01-30 13:50:18,29
0x5e5b98455c9d837c21f32db069462595fe70c8da6800c39b0b31e15086cc7959,t,21000,904510,,5000039,2018-01-30 13:50:18,30
0xa38817f8e0d7832ef6ea6d896d87a85484137d70ea4039f6a564e2ad9d57d6a8,t,21000,925510,,5000039,2018-01-30 13:50:18,31
0x9f00ea307ed90916c0b1531b595f5144ae89a917dfafd552f3dbfb01b801eaeb,t,52460,977970,,5000039,2018-01-30 13:50:18,32
0xd5174fbed517e834f27fa4455489f7fe344b5d48298049c02d76b8c22f2d3fc8,t,21000,998970,,5000039,2018-01-30 13:50:18,33
0x6a3b543eadbdd9a29d13cfe651405d1d49a2412cf168689c6fd1a2e76c72078e,t,21000,1019970,,5000039,2018-01-30 13:50:18,34
0x7b30046eee35132f61bbc6288cdf304da30943d82372831051fde4a037762c33,t,21000,1040970,,5000039,2018-01-30 13:50:18,35
0x013da40980a3ef4ef6734c62b1cf371f0161ab5f57897876e335c53953fac4c9,t,30327,1071297,,5000039,2018-01-30 13:50:18,36
0x681c2db492cff7db11d316fe54c56a1d4e1ad06b8f02c7fe12138b5bde6f2607,t,21000,1092297,,5000039,2018-01-30 13:50:18,37
0x41ef64eb7fe90ae0c46f487257f38c2adbddfeb4db890280c635debf748337c6,t,21000,1113297,,5000039,2018-01-30 13:50:18,38
0xec4ae3c7b1c85ab5848f167eda70d1f91e7571ce47ac23ac696b7bfe9321f7ce,t,22373,1135670,,5000039,2018-01-30 13:50:18,39
0x67923590c227fbf9a8ead76c84a78ec9c78615bddd6886dc8d45d9d999cb8d6c,t,21000,1156670,,5000039,2018-01-30 13:50:18,40
0x09a1240c95e2a067003453c0a0132e775499e6a447da5622603784e1aafa8221,t,52886,1209556,,5000039,2018-01-30 13:50:18,41
0x41ea593c9a18f50749c24110d6d45eb37f7cac13cc48a4c8d8bebeb2f1b02724,t,52886,1262442,,5000039,2018-01-30 13:50:18,42
0x90399e0ec48bbabd2ef187630958638ff5dcfc7d4abbcb8749818daa9bf04fc6,t,52822,1315264,,5000039,2018-01-30 13:50:18,43
0xec67fe22e53bae8af2e4a7c772cd19f4f6ebc92ad056127937319596c436209e,t,52886,1368150,,5000039,2018-01-30 13:50:18,44
0xe659fe5d0112968b1c8e22a4fdecbf1f2007d333982509cdbc7f27e74bf2f5a0,t,52886,1421036,,5000039,2018-01-30 13:50:18,45
0xcc0ebcb26f7da2ce659aff082f5a2f1d69049cafa46416df67d54a292a3429fe,t,52886,1473922,,5000039,2018-01-30 13:50:18,46
0xd46eefe3a399fcc1b44455dabb2c37ed2b2d76b1b402494a920ba1a46f475042,t,52822,1526744,,5000039,2018-01-30 13:50:18,47
0x791717f91fb58189cf49889eee2052ef1fd1c572a105c798e920da847bbe22f4,t,52886,1579630,,5000039,2018-01-30 13:50:18,48
0x2a275570738bddf512f7f286150b20a3927cb18f4e63d83203fd9df7e602e2ba,t,52886,1632516,,5000039,2018-01-30 13:50:18,49
0x02414db6930a4b0ad817c0a5f600d6890d113982357bb3de3a3bcb68738f925f,t,52886,1685402,,5000039,2018-01-30 13:50:18,50
0x62ba239ac7b069f02eeab1af7e9aa14ec00cf12c6a482c1df07d11735249a3d9,t,52886,1738288,,5000039,2018-01-30 13:50:18,51
0x7e23526127452f3e64cf1491f2661c7e1856ffa2de76f4a55ca3deea96505e5b,t,52822,1791110,,5000039,2018-01-30 13:50:18,52
0xeb7560179c22252db9b3fe9c4cdc569eb644089a6934fd14ce20cbb48ae53c7d,t,52886,1843996,,5000039,2018-01-30 13:50:18,53
0x5c727152e6334d29a5d45958fe6bb555f9d0840b1bb5587468adda3b86aa7334,t,52886,1896882,,5000039,2018-01-30 13:50:18,54
0x715592232bc1ed884a73168ae3100a03c64bf1adde65d604160720cb08cc9e12,t,52886,1949768,,5000039,2018-01-30 13:50:18,55
0x78023d721cf8433c1cfd42bb8073567436e9364c95d57b82e6ea3a61d3c502a8,t,52886,2002654,,5000039,2018-01-30 13:50:18,56
0xdd4c55bf1e0e4bf0a010704d74f35d5985fb6ab2239e9ee4c3a39da84e3f56c6,t,52886,2055540,,5000039,2018-01-30 13:50:18,57
0xdacd4a1cb23582f91ebf4f7542bafefc25feadea037eee730d828d341fc7436a,t,52886,2108426,,5000039,2018-01-30 13:50:18,58
0xf67a20b7f1ad6e323747d6d7c40f00682bf65f943c88e76069044be4e2d6e693,t,52886,2161312,,5000039,2018-01-30 13:50:18,59
0xa72ec534ce22f7ae4d9f4df649cce853cfe23ce3a6ba5e2fd763587c19e224c7,t,37822,2199134,,5000039,2018-01-30 13:50:18,60
0xb6cf48986217256b4e3f9570dc98043d282fcf8a5594724f88253cc1ae633451,t,52886,2252020,,5000039,2018-01-30 13:50:18,61
0xfba9d87fa63e506d7ee44803cee3edac1fcf0bc48f27c4d10d648c7e92064d19,t,52886,2304906,,5000039,2018-01-30 13:50:18,62
0x9f48bf834577c24f159485c8ab769333256ea0bbcc42d68c7c1611e1745d4786,t,52886,2357792,,5000039,2018-01-30 13:50:18,63
0xb31a95bc143439b9e0906bac0a3656dc533701b3214e70b7f69cc9eaf7352c01,t,52886,2410678,,5000039,2018-01-30 13:50:18,64
0xa3a33df34950c6d7c310f925ec4e0330edcf501f94a86312048357ccc5c2f1b3,t,52886,2463564,,5000039,2018-01-30 13:50:18,65
0x14dd8c8d0cac1a17157973c4591c3bcbfd2bbc157dd1e43f23440c6b8828412d,t,52886,2516450,,5000039,2018-01-30 13:50:18,66
0x808afc1ecf01e230b55d9ad08854d5c9bfcbd2e5ba7d8e0437aa7b6fbe622dc8,t,52886,2569336,,5000039,2018-01-30 13:50:18,67
0x5c6ce1cfe154db8fb81fd2ac329a65e36f0f761f47eeb273551d2ef15fde559a,t,52886,2622222,,5000039,2018-01-30 13:50:18,68
0x193bde1e61a41e9c6d0544340472cccc49de037cc144921eccbc02f3dad0aeb2,t,52886,2675108,,5000039,2018-01-30 13:50:18,69
0x951e2251d732649e5701b6d0ea4856832b37d43598b7a57fc80adb7c758abe3f,t,52886,2727994,,5000039,2018-01-30 13:50:18,70
0x0e54e49f8652eaf47048bcb2eeb6e541fff52a0274921daeb7d671038459174c,t,52886,2780880,,5000039,2018-01-30 13:50:18,71
0xf16d1b275dd4f688f68b84f4426305bc3d7c236a10ecac307f46c76e14cae94a,t,52886,2833766,,5000039,2018-01-30 13:50:18,72
0x2c9fb5eae9e66e31920e15dd7ea661f0020e360f047c11b00f1a2391ba20ed9c,t,52822,2886588,,5000039,2018-01-30 13:50:18,73
0xd8128911045a3ee45163a8df5fe3b6c4b902d5edf78a65a4b55eaeaba51b7b11,t,52886,2939474,,5000039,2018-01-30 13:50:18,74
0xa4c49ffd22380dec82abd23b4d02cdb8765f909f9b8626fed0a652abd5bf93df,t,52886,2992360,,5000039,2018-01-30 13:50:18,75
0xcb1ddb06a5237c46a24f3fd9b75415997de5e7b3a372fca9c4e7f45094cbbbeb,t,52822,3045182,,5000039,2018-01-30 13:50:18,76
0xa1290a3aca4d924290ef4f795bdd22d7990320a10518e4bc11e80adfde5b809c,t,52886,3098068,,5000039,2018-01-30 13:50:18,77
0xe0b4c4b2aad19d1cdc127ef5600fdfc6cd6156c688ce1c6d735b78b7fb35e5e7,t,52886,3150954,,5000039,2018-01-30 13:50:18,78
0xf71c3c663dd2fee721ae4900599187e16225c27565c99c3f76e4506034af7046,t,52886,3203840,,5000039,2018-01-30 13:50:18,79
0x056debe60aa2a376f1953de3b2aef83534966df2bce4df95afa5400be972468f,t,52886,3256726,,5000039,2018-01-30 13:50:18,80
0x7626fc12fef9cfb8899a838750b197b0cc0f4a52c46a928fea5db30641ef1661,t,52886,3309612,,5000039,2018-01-30 13:50:18,81
0x4638522be8502d48572c2aea32b54f43f111e3435a5eec6997d87feff6a99054,t,52886,3362498,,5000039,2018-01-30 13:50:18,82
0xa4d4a16424fd7a1781f771d69d0051e4900563452a6ebbeab73e50d653a0829f,t,52886,3415384,,5000039,2018-01-30 13:50:18,83
0x4fba9ab991ecd9e5937b26bd06a201294ed29ab92fe36ff54316b21005f9544c,t,52886,3468270,,5000039,2018-01-30 13:50:18,84
0x393351732bd7ff8f0648cd110b6659312f7fc304523d8c25312ac0d1b18e24e4,t,52886,3521156,,5000039,2018-01-30 13:50:18,85
0x3945dd349fd93e6f3d72fa5ab9c4d7b10ab28808e41ed218feca1772f934155f,t,52886,3574042,,5000039,2018-01-30 13:50:18,86
0xa714301c74e98b1e3f5140d05855b3edc35a82e94d528cbcbccfc0d28773b392,t,52886,3626928,,5000039,2018-01-30 13:50:18,87
0x1f028946afd661c8c796d9887e4606993dda7a4fbcff5e48081f0cfc0a4b8988,t,52886,3679814,,5000039,2018-01-30 13:50:18,88
0xe9672e50b914b70c7481286787d0fba6ef03aa96f63c14f7f1f9d0fd9aff0371,t,37886,3717700,,5000039,2018-01-30 13:50:18,89
0x50cc728682991b7468d6d3ba943450d36819318dd6051faf86d6fabecbc618a3,t,52886,3770586,,5000039,2018-01-30 13:50:18,90
0xc0ce66d9185c5929de5b46f806e07deba9179627af02271f5f7eb9b4b1628a65,t,52822,3823408,,5000039,2018-01-30 13:50:18,91
0x8baf8f2e5c78cd459cf3d9f8b988e61349c6053580df5171e3f484e9e4eab1f5,t,52886,3876294,,5000039,2018-01-30 13:50:18,92
0x3453c6dab478a6989a784e52452525da562a7b64c0cb697db0cf70284e0d8196,t,52886,3929180,,5000039,2018-01-30 13:50:18,93
0x67130f346bab962d60208774cbe2cc23e0a2985f23fe3eb670c7da72b403272f,t,52886,3982066,,5000039,2018-01-30 13:50:18,94
0x2cda119b02c1b72ce858cf01d4f0ee11894ded49ae04360f82133b02c5c0bacf,t,52886,4034952,,5000039,2018-01-30 13:50:18,95
0xb498f029f90658fb1624819c19b0fff97f4aea2d2ea78bd878b1e0889ac4c14f,t,52886,4087838,,5000039,2018-01-30 13:50:18,96
0x1bdee67bbaa099b8af4699e3121f131bdf2062ea1a7cb617e8c63c4cc3d91b43,t,52886,4140724,,5000039,2018-01-30 13:50:18,97
0x83397e641d881c85573c57fd70a117de2fe3071ea6e63898ea4b4c157235d736,t,52886,4193610,,5000039,2018-01-30 13:50:18,98
0xa1c726ed9d447a1cd29794b8303ab5ca027b2d99adeb848674574e748389bc9a,t,37886,4231496,,5000039,2018-01-30 13:50:18,99
0x31b85ab3429656b77b4f01a797a6ddd8fd10802d081c6ee242b57a3bb2a1e67b,t,52886,4284382,,5000039,2018-01-30 13:50:18,100
0xe57dcead78adf321f545b234c06a21ce04c830ff61afc9d178211afaa7b869a3,t,52822,4337204,,5000039,2018-01-30 13:50:18,101
0x54ebc4c0579c7415467334a66482cc92a86f3280c16ee7c5568b9583d36123d7,t,52886,4390090,,5000039,2018-01-30 13:50:18,102
0x505c55f3b0cc4556996263d61aba0edd182e82a9b0d9abab64bc51443d6a89b6,t,52886,4442976,,5000039,2018-01-30 13:50:18,103
0x06f051dda67a06bd3f4d611d159ffe518f6ad8968b54aef3cfd44563929c221a,t,52886,4495862,,5000039,2018-01-30 13:50:18,104
0x73a77bd66155d8377e5576f996d9af17ebcaf76d15703a43b9fb4a19dd55ac3d,t,52886,4548748,,5000039,2018-01-30 13:50:18,105
0x0ef8cd04f420c5b7571031d2fdb1fca74fe70cd3636d7a1399ddf687b9c19c9f,t,52886,4601634,,5000039,2018-01-30 13:50:18,106
0x5e2d7c355d45a1e785b8ed7ebb814160cbd3d1156ae88920ff6c2584299f0173,t,52886,4654520,,5000039,2018-01-30 13:50:18,107
0x8fb7e1e9116b692cfeaea2bdd64cee4fc66ca193bff3ba370c4a3beabc791d4c,t,52886,4707406,,5000039,2018-01-30 13:50:18,108
0x8abac75ff4372f06e36d83fbfaeb80cad990dc023b853409a53ebbbb752de157,t,52886,4760292,,5000039,2018-01-30 13:50:18,109
0xb9b491645f823634287edb79a1f992df95996c9c1786e6c7017d2bef24b56109,t,52886,4813178,,5000039,2018-01-30 13:50:18,110
0xd4104f747b17a9c0d14d7ac9355c439462db5b381b703b14e81f8e58c0a25364,t,52886,4866064,,5000039,2018-01-30 13:50:18,111
0x9d9797c7f04afe83af4ef358580e6bb301b24ff2287f3c8097dc83c4024a34a4,t,52886,4918950,,5000039,2018-01-30 13:50:18,112
0xfe63066acdf7f43c63888807da506ba0a878cab307f7bd2ca37d7c53fee17134,t,52886,4971836,,5000039,2018-01-30 13:50:18,113
0xad18f7a9dcc5af473e1da2725908ff084587c2d82c13a006b8d1b613664d95e8,t,52886,5024722,,5000039,2018-01-30 13:50:18,114
0x07498e46c4c4bf7bb751cd36322221e98dac543a9c40cf7835e7939a33367d2c,t,52886,5077608,,5000039,2018-01-30 13:50:18,115
0x28f98bf023c7e447d2b02304e736ff4de533ee04030e4b28d442e306c6863830,t,52886,5130494,,5000039,2018-01-30 13:50:18,116
0x50e94a4c1c8f3439150a0967edaba115a08da63461089e4846fe87bad55ff5cd,t,52886,5183380,,5000039,2018-01-30 13:50:18,117
0xcb51e122e83864432da94cd7c9464d0ffbeaa5e8375c3796a9c5da12357ffe7b,t,52886,5236266,,5000039,2018-01-30 13:50:18,118
0xa1d1be8c26333765f50215207812aefc96637bde920ea6c5afdf0eb6b5e4237a,t,52886,5289152,,5000039,2018-01-30 13:50:18,119
0xca910249c0ed358e379079e56df29f7d5cc9c7da3adf7052ce541f01ef51c04e,t,52886,5342038,,5000039,2018-01-30 13:50:18,120
0x219a21c83701b63e48999c4671aebc67b5ad4c2afd93d5504b0025f0f7aa0be7,t,37822,5379860,,5000039,2018-01-30 13:50:18,121
0xa248a048e00af405dfd96182a54b4bc54113973a645879c443efe986c8f6a527,t,52886,5432746,,5000039,2018-01-30 13:50:18,122
0xb578f2ed0d3984ab429f0b2cf59dd6a53bd279eae6921b72cedb333759208255,t,52886,5485632,,5000039,2018-01-30 13:50:18,123
0xc686ea2d5adb669cd28d314495da4dd05dcfec56d0c0eeefaa53a804dcec1b9b,t,52886,5538518,,5000039,2018-01-30 13:50:18,124
0x9bb8d1aca48a64d5277dbcfb117fb3c9feb4ba3d7a21e5983d4bd4d924e1ff7b,t,52886,5591404,,5000039,2018-01-30 13:50:18,125
0xb6a7d7e2489fd79c0ca440a76751aeed883f3d43dd9784aea752390342992009,t,52886,5644290,,5000039,2018-01-30 13:50:18,126
0x0e6d889b91402f91c7f105578d710da57c37b266b8693194a2fc190b1b3ec100,t,52886,5697176,,5000039,2018-01-30 13:50:18,127
0x7991c71cac248c690b8f6e0386dc947d506c01afcee6fbbc4c11b471ea71be41,t,52886,5750062,,5000039,2018-01-30 13:50:18,128
0xa15588d4631c5f22249ee28e21faccb249f79e3a52409ceb0c857e173bef1a03,t,52822,5802884,,5000039,2018-01-30 13:50:18,129
0x712d11a3402997c0f230eff993b9e40f67f6a4640e6f81738508b3aac3285836,t,52886,5855770,,5000039,2018-01-30 13:50:18,130
0xcea6ea65b95c79c7f441e095a66caf3d36054672c671ac471e5f99b8ce042bb0,t,52886,5908656,,5000039,2018-01-30 13:50:18,131
0xc92f0d85e3ddf9e75922f13d3842fc63cd999c5cd04ab9919b3701e778f03f43,t,52886,5961542,,5000039,2018-01-30 13:50:18,132
0x88910cb28e3e070ede4026b5d6d4d68ffa82e060b1b9557d4dea46a01aa3cd5e,t,52886,6014428,,5000039,2018-01-30 13:50:18,133
0xc82961c76c02535dfbc5ddf263dd299f76b61e528cfc4d1d89969e372051f58e,t,52886,6067314,,5000039,2018-01-30 13:50:18,134
0xc8860b1fb6c8acb23aac416c395616f289b58f1ea1ce1e816e92be80ea2c683f,t,52886,6120200,,5000039,2018-01-30 13:50:18,135
0xc0aec43dc5c4bf036f202aa12871c266ed7b0ca7684e9737306233cae59289b6,t,52886,6173086,,5000039,2018-01-30 13:50:18,136
0xb76ebfe42f00f0e43bc12ad66a6e15b9dd16c031b7c6e6959c3cee30ddb293a5,t,52886,6225972,,5000039,2018-01-30 13:50:18,137
0xfbaa0199b2d64fb4ce75ef15d7d0b2cd1ce4c5fb495ddcacc2ba218c8f564399,t,52886,6278858,,5000039,2018-01-30 13:50:18,138
0x5bbbd19c20486ffbee6ddc2375e7dd76a7e6ec96f6999d298199521a72f21b00,t,52886,6331744,,5000039,2018-01-30 13:50:18,139
0x0dba7f41f4945b762f3de97935154c09fdf45ff899c8951ab78328a53538b833,t,52886,6384630,,5000039,2018-01-30 13:50:18,140
0xb8b834602c22666415988d64a7c1cfa4f5a21d938e886c5ec6710be6a8efebb8,t,52822,6437452,,5000039,2018-01-30 13:50:18,141
0x022bee8165d0c89c7d9ec1701e9e97d49a910dd6968c9c4332de54803cb8606c,t,52886,6490338,,5000039,2018-01-30 13:50:18,142
0x778be3d3186068565d19d0327fa304eb0cee8e8598e7fece7ec0594caaef0e5b,t,52886,6543224,,5000039,2018-01-30 13:50:18,143
0xc197cb0affefccb2ed0019ed172d44030f726cc12c5c78b53794027f761480ac,t,52886,6596110,,5000039,2018-01-30 13:50:18,144
0x7b2b5b202d48faa4bc7a988744f7a789e174744e0a52abf4ae673ee7efb38400,t,52822,6648932,,5000039,2018-01-30 13:50:18,145
0xd194f0f09ac5aacc33ab8cc72050be894b31ec61dac1e608c32e9321bfd8bbcb,t,52886,6701818,,5000039,2018-01-30 13:50:18,146
0xd57b0e0e0483ea7230933c203fc4420e2796af0d910b62600a99803e6fca4bc6,t,52886,6754704,,5000039,2018-01-30 13:50:18,147
0xef67cabd5f71db30b8631a3848ac5db2c4891b3254c567befcb3dc5cadb02bc2,t,52822,6807526,,5000039,2018-01-30 13:50:18,148
0xa33e53fcff7609460cb6975de361a39bb9352df75f485bae34295cdca15202a8,t,52886,6860412,,5000039,2018-01-30 13:50:18,149
0x246e8eec7b8a619e8f41770e587d53eb71799d0d1171470c278945ea6f958784,t,52886,6913298,,5000039,2018-01-30 13:50:18,150
0x2d13cce7fbfa7e28b478cb81faed5e0d1f1ad0f3ce494fabb638c7c9b0d87b73,t,52886,6966184,,5000039,2018-01-30 13:50:18,151
0x247d388bb93db37f18c96ab7e8c4602a1f04ce816c1c566b82704701d6f1a612,t,37886,7004070,,5000039,2018-01-30 13:50:18,152
0x5a5933fc41cfaae70a351ff798004213efe8662a0e3cbbb2ef7eae9f001f722f,t,52886,7056956,,5000039,2018-01-30 13:50:18,153
0x5139711e0464b262e829d832cc984ccdbc0d5934467b3af384dc1bdc24bb74a6,t,52886,7109842,,5000039,2018-01-30 13:50:18,154
0x5a76ada7646c369c2f8fd98faba46542f7d390d55730eba3fc638edb3d7ef634,t,52886,7162728,,5000039,2018-01-30 13:50:18,155
0xd59aa9c602fb59a90f0c087e12a890e907f07910968652690283072ae255ce2e,t,52886,7215614,,5000039,2018-01-30 13:50:18,156
0xb5853a36444ec80809b3cf9be87089f5df4877d015c694ceeeca24a9e62eca37,t,52886,7268500,,5000039,2018-01-30 13:50:18,157
0xc5e8c95ff31fa5dbd5db2e7a0f02188b3d12f896784b31c1eecdba08f4013091,t,52886,7321386,,5000039,2018-01-30 13:50:18,158
0x7f1806b7f758b519b131ee7202410ec5a7c59516bc21120302022aa7b69a49c4,t,52886,7374272,,5000039,2018-01-30 13:50:18,159
0xe50e62e33f448d908768eb8d029eaaad7f84ac344f275a5a81e4e0323e2933e6,t,52886,7427158,,5000039,2018-01-30 13:50:18,160
0x64a60cca7449953d3fb408b8c9a8a23a7258d44f3ea72f24fc806d0842dcbfa4,t,52886,7480044,,5000039,2018-01-30 13:50:18,161
0x8805d883c1d2266930cc4291082ad2bf5baaa30228980999a18be8be192d9c53,t,52886,7532930,,5000039,2018-01-30 13:50:18,162
0xf3e3443e132deef251df9511d881f3c5a1ca946647283b8eb7be0a360b39ea17,t,52886,7585816,,5000039,2018-01-30 13:50:18,163
0xba4eb377b1a348f05a89529b9fbbf325ef636e54365f87a7158283de080f2e78,t,52886,7638702,,5000039,2018-01-30 13:50:18,164
0x2007add219abea0b43c5baeac247ddf9f9e9f6a7bcd5b217cda82d5a91579dbd,t,52822,7691524,,5000039,2018-01-30 13:50:18,165
0x2268ae7b2d4e932130dfd3e9c914f70aff4ef661aa1d6a7f4bc681e8f8600af8,t,52886,7744410,,5000039,2018-01-30 13:50:18,166
0x0e41ce3150afd8355936eae85911be9a86ea31290ff7eb69ed93de4417fb861a,t,52886,7797296,,5000039,2018-01-30 13:50:18,167
0x81e7914e77439677a6ff09b51cf8b3a6e7d01e6f3b042fdc31daad6e8070380b,t,52886,7850182,,5000039,2018-01-30 13:50:18,168
0xb889d71b3a0796e7085e7e98c70551cf3730655692b97ef256ffe1b64fa6dc40,t,52886,7903068,,5000039,2018-01-30 13:50:18,169
0xef14384bcac351624cdc5331da80125fbaf1da97976416508d4ac4d20faab364,t,52886,7955954,,5000039,2018-01-30 13:50:18,170
0x56461c6a7fb055c71e2f3f44fd3a9846bb014ba96405b4ef8107cbe5a4467041,t,21000,7976954,,5000039,2018-01-30 13:50:18,171
0x7b206216288773caf0243c942ca7e988a3cf5fc29687e7ab76c0649d2dfb82ee,t,21000,21000,,5000040,2018-01-30 13:51:07,0
0x7de2941ac2bc663ecce65b96f6a67c84f142b6a91216534b9ac442d8681d4cdc,t,21000,42000,,5000040,2018-01-30 13:51:07,1
0xd2510c755bcaea30171567c5d05bd7a56fed807b55948a0c4c250970fb4bf867,t,21000,63000,,5000040,2018-01-30 13:51:07,2
0xbe6d6e8aed1c3d3af2dff770a7536f1e81d44aeadf2015d40cc717aeed21d25b,t,21000,84000,,5000040,2018-01-30 13:51:07,3
0xe37d33dd88287f23a1ad27cdb93d033e7043008529f3e0b241f28fa54220a39e,t,21051,105051,,5000040,2018-01-30 13:51:07,4
0x05ecabab83e0d342eec4ec0939b4936311ab9b46b425a62df705b1c682054cc3,t,39512,144563,,5000040,2018-01-30 13:51:07,5
0x5447fbe075444c38308ff5c26103ac26fad3c9ee985bd2fa5d2a066a77c76e6e,t,21000,165563,,5000040,2018-01-30 13:51:07,6
0x5793a38e09f3ebc92707c6b498db1c195d251f8ca4c2a8256b7dc00564cb453e,t,21000,186563,,5000040,2018-01-30 13:51:07,7
0x01cfe6134b9c0bb7df0f46a72554d11c8e40f1d217e21c71eb88b31dd412de5b,t,21000,207563,,5000040,2018-01-30 13:51:07,8
0x744abbd782091e856ff0f75d3fe402ad2cbbbb26f2e5508fec9f7c196dfef09d,t,21000,228563,,5000040,2018-01-30 13:51:07,9
0x585e295606abb54b98a6d7792238a1dfdfd0b58fbb7bdcb2ca184f508b6d3ab2,t,21000,249563,,5000040,2018-01-30 13:51:07,10
0xabe5b028b46d7acbe95152c0e3498ca1ec78fe397cb21af5bda4c3346cac29ff,t,21000,270563,,5000040,2018-01-30 13:51:07,11
0xc24373f08cf1d434c0cac76fedcc0efc6aa9db67f93114391a65b261a645675c,t,21000,291563,,5000040,2018-01-30 13:51:07,12
0x499565aeb508a64e1bde4e06c5fcbda557d9d4c0cda175639ec981148defe690,t,21000,312563,,5000040,2018-01-30 13:51:07,13
0x4d3fdd084f3872e61933ed80e8904569c7365c86b1f73218d04c2aa24ee34c48,t,21000,333563,,5000040,2018-01-30 13:51:07,14
0xa8f200359f57a430a1becbfe90f0940961203444a3b2d64a728b53b4010a3880,t,21000,354563,,5000040,2018-01-30 13:51:07,15
0x97231f04c72c34f9c3f3996827128250dd1f3af3ab8c7c504bc289a2421ab0c4,t,21000,375563,,5000040,2018-01-30 13:51:07,16
0x911dc409a5ed7266dcfe4e6a4c98a2a492da652f40d27fefd3f957362a03b54c,t,21000,396563,,5000040,2018-01-30 13:51:07,17
0xf18d9be5b5edfcbad68cc0ad7d1279df54e0f6faceccabaa832c8144f27ff508,t,21000,417563,,5000040,2018-01-30 13:51:07,18
0x5d6e8b48c5718d0b216cca6bf4e0a653ab4f5a006c99587fd6996c1b0f08c3db,t,21000,438563,,5000040,2018-01-30 13:51:07,19
0x0e4a65a3097ff33dab5daa933a788befc79141874cb163a2dec2ea6112b24bd5,t,21000,459563,,5000040,2018-01-30 13:51:07,20
0x1a814c32f110b9b408961f3d0a6dbbb92e70f2a9d8fbc91bee9ccfac4782573f,t,21000,480563,,5000040,2018-01-30 13:51:07,21
0x03f02e337186fa2c50ab9091c4ff52902d1d03d0d5d0faa95a2203ce08a07f1d,t,21000,501563,,5000040,2018-01-30 13:51:07,22
0xc1e00c7ed7ea8cc900693a684be97147b2d5470ce28dcb8a0e98df809d8ff2bd,t,21000,522563,,5000040,2018-01-30 13:51:07,23
0x71c32716f118ab2fc6b4fbf68276caa0c5833d2e27da33bb163b9762152393c2,t,21000,543563,,5000040,2018-01-30 13:51:07,24
0x1e11aaeec0ed639e02199ab463e720db5f6770816703b6b7cf26bbfab0f51b88,t,21000,564563,,5000040,2018-01-30 13:51:07,25
0xcf7426461e9cf96e5191f82fa5712a10afecb477073377f913632a91797f37bc,t,21000,585563,,5000040,2018-01-30 13:51:07,26
0x7d414682d426bb9f04facc401a843769b50efef235973a07a98a87e55eac521a,t,21000,606563,,5000040,2018-01-30 13:51:07,27
0xb7dcf8806c1227b54cd2f9e5ecad8da67b7c532bfcc425ea0ecece680abe2957,t,21000,627563,,5000040,2018-01-30 13:51:07,28
0x9d483411e670192a3c44956eb443fb2e16c2d6bb455c817b71dfaf72b3d1fb1e,t,21000,648563,,5000040,2018-01-30 13:51:07,29
0xfdad62affc1275db758f8e61d6410b768f36bd4f4332c4f4e1e969d3da81220f,t,21000,669563,,5000040,2018-01-30 13:51:07,30
0xd17cd88635e76f78d5d8262e22ccb42051758a556406956c77890fd38d1e6049,t,21000,690563,,5000040,2018-01-30 13:51:07,31
0x9184ad3b921677710a01eed4d216597635c9265ec30a5c3c8ba2cab024185f09,t,21000,711563,,5000040,2018-01-30 13:51:07,32
0x9ef2c9097200cbc68e5ba94f2376765bf7ca166ef518611918fb908f6a231572,t,21000,732563,,5000040,2018-01-30 13:51:07,33
0x254e2b766d30f478d87f1ad29d5f51930dbbe0d32119f12f24c5dd4940399f2b,t,21000,753563,,5000040,2018-01-30 13:51:07,34
0xc0698be14a3d0ad733b85a3301db79143820570acc9e9fee993395f9a440ffe0,t,21000,774563,,5000040,2018-01-30 13:51:07,35
0x276e251997e61281fe25c18f6f9d9b787d72951be636db8db3ef9c11efab6c90,t,21000,795563,,5000040,2018-01-30 13:51:07,36
0x87e81911fc28d0022590d95ac23bde594bd8681269ee967b6f7451b6eaf5f43b,t,21000,816563,,5000040,2018-01-30 13:51:07,37
0xa198f6010d4c6b4190d3f89768310d1a76808ddcf3dfb6f7437d7b008ad36ecc,t,21000,837563,,5000040,2018-01-30 13:51:07,38
0xd7124b439c35dc19dcebf9e754b41a9fd0d78b4e4bca2d6f5fbc81c4fec41eb6,t,21000,858563,,5000040,2018-01-30 13:51:07,39
0xd838bd554eead4959f5b4c873a0e9abf7c8dc191a31a829181199463d9f44676,t,21000,879563,,5000040,2018-01-30 13:51:07,40
0x3ea8988f13081f0e3a0363fabbfd8dcb6431cefed674d77d03270529a0e324eb,t,21000,900563,,5000040,2018-01-30 13:51:07,41
0x9d4267448c309d7aec4002e7caae5b7ea642180e582e0cd69ca6f99559e6ca65,t,21000,921563,,5000040,2018-01-30 13:51:07,42
0x3f6c4d6a387f4a63aff1a7136c5df11efbb1cd59134c6af670910a8079cdd889,t,21000,942563,,5000040,2018-01-30 13:51:07,43
0x1b63641f8504756193d3494b4826491de211fca7e4efefd2da1e7cd1f69ac768,t,21000,963563,,5000040,2018-01-30 13:51:07,44
0x5f6283b2f76634d979fe2a2b8b208c7c6c07addbc1d33ae827c1973145c4f00e,t,21000,984563,,5000040,2018-01-30 13:51:07,45
0xcd0ad68a983661cede269b1199886729604561489d66f8025a506b6a0ac9f8e2,t,21000,1005563,,5000040,2018-01-30 13:51:07,46
0x478e314268c62df2a12e42e3796f0c402462f1778f95fa26b1c97d7cf5d3d96c,t,21051,1026614,,5000040,2018-01-30 13:51:07,47
0xdbd7b8dfef7f4c3749a46d22c959f78ffdb0512a4785a619c130cdefc3c88e9e,t,21000,1047614,,5000040,2018-01-30 13:51:07,48
0xd278a2551afb9c79d0ca2b3277900be5d680a409c50d5dbca5d048e17d33e273,t,21000,1068614,,5000040,2018-01-30 13:51:07,49
0xf28181f0ff8ff676bc9a9441ed53bee8f0d66b540c58f48b5cdf7c2f9b624228,t,21000,1089614,,5000040,2018-01-30 13:51:07,50
0x05cd12fd21510906311966c39c1c5d0d6a231f9098114b0bc7cb343f18af3818,t,21000,1110614,,5000040,2018-01-30 13:51:07,51
0xd2b9508266a145734ade46b2dd180a47f20c89f8301723bb534f3af525f50549,t,21000,1131614,,5000040,2018-01-30 13:51:07,52
0xb9214e9463e08d50862bd5e97954314549ae63110c594542aebde5a3492525d6,t,21000,1152614,,5000040,2018-01-30 13:51:07,53
0x2af163a4daa9126ee3ae257f12c477a4922b95ed7aababc8e4ff2e6ecf7dc421,t,21000,1173614,,5000040,2018-01-30 13:51:07,54
0x159182e71368736f9c99addc77d6fd7dd6790b5c69c252a7a76d254e2f898aa4,t,21000,1194614,,5000040,2018-01-30 13:51:07,55
0x1243d98811306a68e12d721799181b04e7b396130b996319fe9b4ef1acac1e5e,t,21000,1215614,,5000040,2018-01-30 13:51:07,56
0x51d64d6f90ae633496832ee51329967e9f84e4b6fc98fb60629f5caf23f9f851,t,21000,1236614,,5000040,2018-01-30 13:51:07,57
0xefef4ff393376b09d9f23739f447a91a95dd6e1e265a57e9a03f10d848c399bd,t,21051,1257665,,5000040,2018-01-30 13:51:07,58
0x128bc16bb65aa4385527d66768be3c3ce5dff673cbb3192b0592478d31a6991e,t,21000,1278665,,5000040,2018-01-30 13:51:07,59
0xcca8dda778739d443e32abb80577ca7dab6d0796f237f727ec0ce9ac7721d51b,t,21000,1299665,,5000040,2018-01-30 13:51:07,60
0x9d95ccf5676aad0da35eaa451496545615826afd1c4011b2163a6b33e1b4373a,t,21000,1320665,,5000040,2018-01-30 13:51:07,61
0xa081f510433cfcf7507f74a1ab475e3edb42e08bfbbded955f5381c631f8eedd,t,21000,1341665,,5000040,2018-01-30 13:51:07,62
0x34840dd771b96badeaafece4e3ccd9b1c7278f5d25b42e4a03b5caa172cd1cbf,t,21000,1362665,,5000040,2018-01-30 13:51:07,63
0x7e56fb273710797c0c0c28b5c40be9dd4b4898d7b66a4a4ec3544f7912dfe1de,t,21000,1383665,,5000040,2018-01-30 13:51:07,64
0xa37cdc7591e685c6d7132ec2495929ae4ea3f7ee3872a15d4700a9662a4bfb43,t,21000,1404665,,5000040,2018-01-30 13:51:07,65
0xa39bb34c74c400388de853042bdb07a884f2a38fa4ba81124f3fc624d17b1e80,t,21000,1425665,,5000040,2018-01-30 13:51:07,66
0x81cdf07d706e3d889081972cba26321d3a794687b27f1505c12674ebabaa948c,t,21000,1446665,,5000040,2018-01-30 13:51:07,67
0x2baee98a4bba2d443664237969ba3acbaedf37596f2110e6165b3ed5e21180ed,t,39512,1486177,,5000040,2018-01-30 13:51:07,68
0x14d7a4d6ca1889e89ddee4120368517e451a7dcf2d04136da321f6bcf750d0e7,t,21000,1507177,,5000040,2018-01-30 13:51:07,69
0xb09146697819f4c3cc6cb17266cc2e760c02ef44e657fe4cbe2757e1caa29b68,t,21000,1528177,,5000040,2018-01-30 13:51:07,70
0x1373149375e66323319137b2efa9c603bd7aaffcacbace63d919cb0534ea9e30,t,21000,1549177,,5000040,2018-01-30 13:51:07,71
0x1c81cadfb23ee57fa16a90404f1484aeaa0c6e809fc30c6c0945e3ec6f9aa7ce,t,21000,1570177,,5000040,2018-01-30 13:51:07,72
0x2780057ae34264e7cdcdf0f76444c3d3c193aced4b0756eddbb9995c91cf8c86,t,21000,1591177,,5000040,2018-01-30 13:51:07,73
0x3d23edca3fe56d890235aff673192f7912d2d17c7a2b097e4b43019454b9839a,t,21051,1612228,,5000040,2018-01-30 13:51:07,74
0x88098d821beb8f5dcfc37ec8fb541ba1fa610fb220c21f2a867d25d5172d10a2,t,21000,1633228,,5000040,2018-01-30 13:51:07,75
0x914513fd71cc53557de3c0b687194a14f9fcfc5e4eb2a6468cde4d3c684b002a,t,21000,1654228,,5000040,2018-01-30 13:51:07,76
0xda027482d565e267e19c302932720bec99077698d1d777c0ca9a5149f842c416,t,21000,1675228,,5000040,2018-01-30 13:51:07,77
0x9aebed5dc648ec094e713a2d7f58666a6b90718926ff4deb536c9b0dc8399b57,t,21000,1696228,,5000040,2018-01-30 13:51:07,78
0xd08a32d002503833fed2e449afadd75c7324b23c88965b6bf7f528be39fe0c6a,t,21000,1717228,,5000040,2018-01-30 13:51:07,79
0xde9f38cd81d7b846e3b959cf7bee4b6bb32b2a98502ac9d2a7fa2a5691dda042,t,21000,1738228,,5000040,2018-01-30 13:51:07,80
0x7b75631a4f8e666a0282451b5a14a4b57e5124244c297d3f442ee36bd677d775,t,21000,1759228,,5000040,2018-01-30 13:51:07,81
0x35b1f89ac50f8b1f844bfb38afbfd8a8a5ad92cf848d032d7626c95c0a8b930a,t,21000,1780228,,5000040,2018-01-30 13:51:07,82
0xc27817be6023b73e8266f42a70786bc4e5e1f7a97614a843974ca5a5bea7c526,t,21000,1801228,,5000040,2018-01-30 13:51:07,83
0xe048eb2026e57addde5b359a8e08e642981d7264efd086e6a2ceb258caac7ef0,t,21051,1822279,,5000040,2018-01-30 13:51:07,84
0x8ea36aeef0b9d59ebed019ed4b03aa8171b997040ca9a533e0777e4b007c9506,t,21000,1843279,,5000040,2018-01-30 13:51:07,85
0xcce53ed7113bcb0ddb8c25edf72dfad8ca0d372eb3932d765333189f89ceed96,t,21000,1864279,,5000040,2018-01-30 13:51:07,86
0x22b3fe1ccaa6a4fc7cc8a29e2cab372020eb14ca5a47f18e11e4d5c558cb6ef0,t,21000,1885279,,5000040,2018-01-30 13:51:07,87
0xe5a0717c6307673f4113270fe15c920a107a3d51ad21fd86fde2b55c5ccdeee7,t,21000,1906279,,5000040,2018-01-30 13:51:07,88
0x2fa6c5b2b3d485d4ac6ce5fcd0a9c42beca52e50122a272813ea92c851ae12f6,t,21000,1927279,,5000040,2018-01-30 13:51:07,89
0x20aefed0dae2d74b72b31f54c010d6b03f8a5422cef0dceeca3d1a966ebe997c,t,21000,1948279,,5000040,2018-01-30 13:51:07,90
0x04623fa3b91842f4e2683890415eefacc146b3a33442286ff2bd9d2b76277dac,t,21000,1969279,,5000040,2018-01-30 13:51:07,91
0xb496a5db93108386d75651535a5061cc55484bc1cd579c8d4ba12ea17debdf42,t,21000,1990279,,5000040,2018-01-30 13:51:07,92
0x79ce7c7b46c8e0c1997a50d13e305535b83e8564e1359c19638fc9fbf8b298f5,t,21000,2011279,,5000040,2018-01-30 13:51:07,93
0x2d53958823a3d2de50758f1e8b2fd2561eb5dbf6ff06cc8313a690df772b8d16,t,21000,2032279,,5000040,2018-01-30 13:51:07,94
0x75fe1f118812b8b28fcb862f8e0c11d5251de5053a22ee4f9d6610b80907e80a,t,21000,2053279,,5000040,2018-01-30 13:51:07,95
0x7d01db3541c7f6a69790d08dc3eeebad0843b2cdee7c038a24d2de7de81d223e,t,31005,2084284,,5000040,2018-01-30 13:51:07,96
0x0f6303e3b978b8c2e15c6cdf373c52c058581bd2992320a2263a14ddad49fb5f,t,21000,2105284,,5000040,2018-01-30 13:51:07,97
0xe2fe51d93a27c15ed1862328aea821ab5dbe5a29e01dc2c343003a8e6a1c9919,t,21000,2126284,,5000040,2018-01-30 13:51:07,98
0x5e585cc4d2bbfc6ced6640de9069b0b76b220265f34eae65969d6fdd51a00ace,t,21000,2147284,,5000040,2018-01-30 13:51:07,99
0xffd6cde89392ca31f0636aef2f72f00debf740bcd32614403aedeac617fad776,t,21000,2168284,,5000040,2018-01-30 13:51:07,100
0xed12d67afc0f3f2c09c33bb14dd052a39548d050873dcfc69bea1079ffe50941,t,21000,2189284,,5000040,2018-01-30 13:51:07,101
0xefa8afd3922676679daa44f190908dc1aaba5f5fd3460aed91b62bb003603208,t,21000,2210284,,5000040,2018-01-30 13:51:07,102
0x297cafd58b88a4ce84b507d1abf38bd4edc887d99f9f163a9cc65d5d22dab57a,t,21000,2231284,,5000040,2018-01-30 13:51:07,103
0xceb0874242fd2feb32a23c2478fb28b00f02085e2814f2a9f1eb24357d8651de,t,21000,2252284,,5000040,2018-01-30 13:51:07,104
0xa1c645a17ee55245e98c421c292156ff4a23a5ee327ea0a1865179b0fdcd1558,t,21000,2273284,,5000040,2018-01-30 13:51:07,105
0x01148bc611226fbb41f99d6ce03a57da2072948437590ee115f976a32b573696,t,21000,2294284,,5000040,2018-01-30 13:51:07,106
0x5d2bfbf78b5d59b81b23f4d833d72c300991b24f9a7ab35aec9f298fea3ff5f8,t,21000,2315284,,5000040,2018-01-30 13:51:07,107
0xad72e58cc6b6b21a3fcadf312e30c4d36a6f37192e5b799c29b982f3d2d29955,t,21000,2336284,,5000040,2018-01-30 13:51:07,108
0x9bfdb4d9604b0761a936f3d34a3a515c7b92bcb6dd5df3e060ebdad33bd63f15,t,21000,2357284,,5000040,2018-01-30 13:51:07,109
0xe9d19761782e1e6a3b05cbd2edc21691cc714f8f35595cbeb1e2811e1babcb0c,t,21000,2378284,,5000040,2018-01-30 13:51:07,110
0xcc8cbacbc2ed6c2127b3ed1d26c1348970ca43b7a775d3730de0bd8374966af1,t,21000,2399284,,5000040,2018-01-30 13:51:07,111
0x30f913049eb144b144e75a8791727ad6972c7b72f7aa5e590a2ea7327dd3aebd,t,21000,2420284,,5000040,2018-01-30 13:51:07,112
0x8a90ff74e54f691b5647ad177991908a05276486b45c041a13cbf64bad1732d3,t,21000,2441284,,5000040,2018-01-30 13:51:07,113
0x0d9812905f970e28b772f4314474cb627ac2a9c4c089693e38db2afb7ea60cc4,t,21000,2462284,,5000040,2018-01-30 13:51:07,114
0x0191c6ac29d83703af413b94c57a531bef83ef618c038399ea1635d0246310eb,t,21000,2483284,,5000040,2018-01-30 13:51:07,115
0x7db11fcee3e4cec6540dac6a5638ada4be27e386c527d4d446934a062a97a81d,t,21000,2504284,,5000040,2018-01-30 13:51:07,116
0x97777f2771b827bcfed88bf84378b215a24b18c44b93df2f8b784658f4218917,t,21000,2525284,,5000040,2018-01-30 13:51:07,117
0xda59ad00f1793233b771ab6b3240f49785b40e52d15630819ba4feba470d121e,t,39512,2564796,,5000040,2018-01-30 13:51:07,118
0x9c3b0c6e196fa4ce36f7e64319741785490f6777784ee77e2880b78faa8f9854,t,21000,2585796,,5000040,2018-01-30 13:51:07,119
0x19fd0c29e9603ee9764a2ad7cdee07fa7a64d8e23b25461022d98f31243f4a3e,t,21000,2606796,,5000040,2018-01-30 13:51:07,120
0x338f1ebdd701a6b22a3e0a122eebf7406b2c48130572edaf7523573b4caf8b13,t,21000,2627796,,5000040,2018-01-30 13:51:07,121
0xb6762a911889f4b99ccd7a3b45031eb0635de7859d54ed7ef97f4b9d3c1b4b6e,t,21000,2648796,,5000040,2018-01-30 13:51:07,122
0x64fe440265e1954c9f6d1c7f1a258ef7666fc8121e0f0f12666a3b3cd93df063,t,21000,2669796,,5000040,2018-01-30 13:51:07,123
0x555ac5f482d2c157c9185007c74d0af055f1875e69cd40c647ca02240b728b18,t,21000,2690796,,5000040,2018-01-30 13:51:07,124
0x0fd51721fa00fc61ad3cf10b7899807322d3c58285c57fb1254f666273ed8289,t,21000,2711796,,5000040,2018-01-30 13:51:07,125
0xdab0cbb8bd2e6d54a23cfdcf255ac163158c73bd433d0031c72259ce5a657075,t,21000,2732796,,5000040,2018-01-30 13:51:07,126
0x391eb877749faad7a3e9f7dfc0dfce9ac0c51e61647b609267c65a0af4b7d785,t,21000,2753796,,5000040,2018-01-30 13:51:07,127
0x797a42fd4b73e3ad0585c2a8a60bb59db29d162cf30fdbc7aa7ec2009178abf4,t,21000,2774796,,5000040,2018-01-30 13:51:07,128
0xe868b7e29ff0bf898359036ee98c83c14d2af1ce4c7258b547224a8342dc4b5f,t,21000,2795796,,5000040,2018-01-30 13:51:07,129
0xce7f9384c82dee6d821ab585527cea9d57241e3b8b80ddc14e45cd7fa6a5200d,t,21000,2816796,,5000040,2018-01-30 13:51:07,130
0x57a6b6f5a93008a31d8cd0610a576958f81b9cb1537a582899832c3bc8a209e2,t,21000,2837796,,5000040,2018-01-30 13:51:07,131
0x102962e469f82c48c6e35956a517790476a8fc3f3f78aeef5b270de236c2f973,t,21000,2858796,,5000040,2018-01-30 13:51:07,132
0xe55fae777d190c88af2951cc7db40058045a270091abc8f7b2437bbb6f08799b,t,21000,2879796,,5000040,2018-01-30 13:51:07,133
0xb08f2ebec020ac6df16c3d357b835dcf82ab8717fc1f22687f4ff01714bb89fc,t,21000,2900796,,5000040,2018-01-30 13:51:07,134
0x7dab5adbc418dfbb1d932a3b648c9bd44541747f6059faed401859323136a473,t,21000,2921796,,5000040,2018-01-30 13:51:07,135
0x401f5c74dc17161725ad1481d103e032c9d343f3e9376be6dd88c6bcc0859f35,t,21000,2942796,,5000040,2018-01-30 13:51:07,136
0x45c66cbd7d1649ca6e455a00570da7d99b0e36747bc7b28407e853ba96591630,t,21000,2963796,,5000040,2018-01-30 13:51:07,137
0x7c728a7de3d2f68229bcb0c7c9d644d5e1eddeb4326b20d1075f8fe96c4fd150,t,21000,2984796,,5000040,2018-01-30 13:51:07,138
0xcafc5b7af021a33944a2982bfcd6d26680d0504f443714371e5e2c46b92d573b,t,21051,3005847,,5000040,2018-01-30 13:51:07,139
0x1f990ca3014efdea06f387556577bd1f501541989ca0dac94568fb21748a17a5,t,21051,3026898,,5000040,2018-01-30 13:51:07,140
0x186c2093d72e4dfe2c3f44a010f4b056143088fb58875d3fce4e1b04e6fce3fb,t,21000,3047898,,5000040,2018-01-30 13:51:07,141
0xef39ef6581ce5caa74c6975efba49eadb9d8a80f188f3f0fcc130bc8dc8cb33a,t,39512,3087410,,5000040,2018-01-30 13:51:07,142
0x64be568b65c7f8c2856a1a8ea6c7932f3e6971c2dc78fe8bdd66efe80936437f,t,21000,3108410,,5000040,2018-01-30 13:51:07,143
0xf17384e6db0c3ffbb505ec27f095aa8cf7c209eadd0c34c7b49bbbd4286357b3,t,21000,3129410,,5000040,2018-01-30 13:51:07,144
0x9000bb4ce9c35199e67ee9c0a7cb975118465e46b2e55906deabf52d85abec38,t,21000,3150410,,5000040,2018-01-30 13:51:07,145
0x5b51bf755137e6214b6eb4d89830dbb7f156ffabd3c69c7b8eeec758addc27a7,t,39512,3189922,,5000040,2018-01-30 13:51:07,146
0x2c1089022a967b1f4bfe1147493c22ae08531231288fdb344c07c17112e791f1,t,39512,3229434,,5000040,2018-01-30 13:51:07,147
0xfa4eb179f93623cc4fa63677ccce26713396917e8bc619290bf84f9a1e350678,t,21000,3250434,,5000040,2018-01-30 13:51:07,148
0x321a77cbebb4c8581602875773dc7695a6176cdfacd5de45efd13aa55d015593,t,21000,3271434,,5000040,2018-01-30 13:51:07,149
0x91248fc8c06ae46d89b32e456f5a0ee79d176d768ef5e9ac2c6bdbbe0c35d4f0,t,39512,3310946,,5000040,2018-01-30 13:51:07,150
0xdad32da328600d675a8e2e9251ad46a61a431ff0239cedc4577fba9356683510,t,21000,3331946,,5000040,2018-01-30 13:51:07,151
0x23b1243cd641778d59c8af6ec6296f8dbcee419162edb02297f9ed9e0b0ec0ff,t,21000,3352946,,5000040,2018-01-30 13:51:07,152
0x14957e4a3b73cf004cf72b21ed80a02cb52d2679fb23cd0f66d926f712d193bd,t,21000,3373946,,5000040,2018-01-30 13:51:07,153
0x187de6518e1005ac4c33592a470378bbe318d5dd2fe20074ee3fd7459769d0e8,t,21000,3394946,,5000040,2018-01-30 13:51:07,154
0xae927b5760fd44ab6404bd8bf6f91215f968685f45e034bffd4f274788c40359,t,21000,3415946,,5000040,2018-01-30 13:51:07,155
0x7183294b19adae0fa7a518e958bda66f710446347f6fa7055080e9d3831a08f3,t,91258,3507204,,5000040,2018-01-30 13:51:07,156
0xf2c996ba5b0dd3472590a6fcfc8e45d86f3b16dae8ac0c9eea012012291426a7,t,21000,3528204,,5000040,2018-01-30 13:51:07,157
0xe168ce13eccd229720e505e83dd76dcbce49d0b806d6a022256917fa02f2f880,t,46018,3574222,,5000040,2018-01-30 13:51:07,158
0x8e72687365a31772d3962132c088b74f61469c654024c3552aac367080c62c2a,t,52559,3626781,,5000040,2018-01-30 13:51:07,159
0x14d832c35c1a3caf7d599837abfae8e4a41780774df4499211c37ce7f95acacf,t,52155,3678936,,5000040,2018-01-30 13:51:07,160
0xd493cbfcb162db2d4021e786a554f9555e80b33585c1858812d43a5fa1eabc58,t,21000,3699936,,5000040,2018-01-30 13:51:07,161
0xee4930221809765a4d3d60e3ab92fb4b04a9cc132ac6170670a0b6c14675071f,t,34725,3734661,,5000040,2018-01-30 13:51:07,162
0x44698a31561e3712e8ff741b112c1cc84637392909a5ece70749e26de1c48866,t,21000,3755661,,5000040,2018-01-30 13:51:07,163
0xf15d9384057f878862bf12e358befda72e412fd3d6e3a1d59d9f0fc82cd2ae41,t,21000,3776661,,5000040,2018-01-30 13:51:07,164
0x46102374c9d0736a305f40d1aa6ecf3b715ee2c0a4c3826f6ebbc4da0950887b,t,37155,3813816,,5000040,2018-01-30 13:51:07,165
0x229c5b0deada62ccb45fecdac0ef80b3977dd2b3e3013c810e2ef6f62241addc,t,52027,3865843,,5000040,2018-01-30 13:51:07,166
0x9d70aad6803711785ea013771e69821e5d31c449e4a02a8a45e691799cc5fe49,t,52091,3917934,,5000040,2018-01-30 13:51:07,167
0x6ae1038ecf3c3e5ab5b26edd3a4b8fa394d5f45dae0349621cd7c93be6fbcfc9,t,37263,3955197,,5000040,2018-01-30 13:51:07,168
0x9cd2ebf71527816e41186500d26186e3a7145a50b8afe384c2cc6bf3ca8252a4,t,140972,4096169,,5000040,2018-01-30 13:51:07,169
0xfb1b7ad660927e297abc726ddc8f91003e3d2e1d8b2502d8abaee7362032aa30,t,21000,4117169,,5000040,2018-01-30 13:51:07,170
0xb36fa1107ab134543f8d80bcc3d6de6f47d1a3af23c0e61b9596043f79fd6676,t,21000,4138169,,5000040,2018-01-30 13:51:07,171
0x647112733fe1c2d2f0a7c4ce04ee5de833aedb91434c465f212355dc1bcf4a91,t,21000,4159169,,5000040,2018-01-30 13:51:07,172
0x9b7b023f177cff7a911c5842335cdb422ad91d91fbe58419e86608bd68a66886,t,50057,4209226,,5000040,2018-01-30 13:51:07,173
0xfb99c1377186ff8bd41da3851f0b6f7a8d83440d54e2dc1786c62e8e00c390a9,t,34470,4243696,,5000040,2018-01-30 13:51:07,174
0xd3e216afea489c61f5da8aa4c1435fb408d2dc062fa583a9ef63b87640c6246f,t,34470,4278166,,5000040,2018-01-30 13:51:07,175
0xec9f23f16f99ac84b9fe620bdab619173960f595f308db0146b3b353e299ca5b,t,215038,4493204,,5000040,2018-01-30 13:51:07,176
0x2dd232061d1b6728690d5987b42b4983848a683a894e5f15fe4b12247891b674,t,21000,4514204,,5000040,2018-01-30 13:51:07,177
0x2531102908f19c2590ee795fc4c5a23ea3b62eb49e924e413881d0d763437bae,t,21000,4535204,,5000040,2018-01-30 13:51:07,178
0x8e11db3f2752eb77e3204f2407897e2257697c30240c314402ea2c0c3e84eff5,t,22173,4557377,,5000040,2018-01-30 13:51:07,179
0x764a776730fca2ca17c8c8accafdf15cf2d49dfac7544609c68ac5343c5657c7,t,23419,4580796,,5000040,2018-01-30 13:51:07,180
0xf13f31d43030c9f9746c5e00aaef0439608055f730d01d1b2938749e4ad61fcc,t,54317,4635113,,5000040,2018-01-30 13:51:07,181
0xc9290b53ae179d3967ab9decc657acf9d4e89c3030f953391edc7c39bb45daf9,t,21000,4656113,,5000040,2018-01-30 13:51:07,182
0x0f8e3e56a227a6845d8080793a2ddf1cab0ec68108b59ed0ae5fb9b17f09e48c,t,37222,4693335,,5000040,2018-01-30 13:51:07,183
0xe516e0b2bbe2c229307ffcb81bc31b0a717b2dcf228216d1a3d62fc46a9e2225,t,104678,4798013,,5000040,2018-01-30 13:51:07,184
0xd8dbfb8c68ddd34b2b36d0b50e6d5b3a46b6c62865819162abe25e4328eaf00b,t,33296,4831309,,5000040,2018-01-30 13:51:07,185
0x31f5f8aa64e11a0b1810639c4f80243a213ebe54800d633267db2d5b0b9d6d8c,t,21000,4852309,,5000040,2018-01-30 13:51:07,186
0x16e72cc16494907be8a115ddb05b219877961d5884a5444fb1452552d2a6c483,t,21000,4873309,,5000040,2018-01-30 13:51:07,187
0xc48cd1d900a21173843689d82bf1ee4865531f458fac8f24044a71a25213aa56,t,91898,4965207,,5000040,2018-01-30 13:51:07,188
0xb3582737f1e725c8260a3484b19006689d34b981578924238a69382ac76d9d7e,t,21000,4986207,,5000040,2018-01-30 13:51:07,189
0xb6bdb6ec815a5b18a2a1084f0488e43278c515ba73627f2aaba0ca4d9b7667a8,t,21000,5007207,,5000040,2018-01-30 13:51:07,190
0xfb50ec5cbafe583c3f4b10717a7616d9ab0e871f24f2a4e4acb7fcc7ec8ee5bc,t,21000,5028207,,5000040,2018-01-30 13:51:07,191
0x39b60719dd4cb5c6f01ea6e00b95867768dfe75a3ec0623cf3b81c20e2c8c0ec,t,297508,5325715,0x206f32278f3022B5EdBDe42Be7e7D82f1A9225BA,5000040,2018-01-30 13:51:07,192
0xfd3727ba57d0cbcf964db7362ac769df92dbd2a8719be1241591fa9f3692e133,t,21000,5346715,,5000040,2018-01-30 13:51:07,193
0x70ded4d1a5fb3828fa693a6b491724d9ec2712336d58dcf696a19e867bf33e47,t,21000,5367715,,5000040,2018-01-30 13:51:07,194
0xf37c9b68ee2077dca22354de06619945ca04fe08200c59fefd08d1d51c928f07,t,21000,5388715,,5000040,2018-01-30 13:51:07,195
0x7f67bf0c1b236ddb8adf93b0d2bffd7e4dadbd76f3a6bc34e335eeff352617a8,t,52091,5440806,,5000040,2018-01-30 13:51:07,196
0xb8d56e332211466ded583d565a5ec35a05e3a638ef9b70c9d4f000b347cf82a9,t,21000,5461806,,5000040,2018-01-30 13:51:07,197
0x957e0520a28910bd6ed933e80778fd80ff72acece4b7f4cdeb9d15a7a515df41,t,21000,5482806,,5000040,2018-01-30 13:51:07,198
0xb4959f2822ed8bcafa3e8b78d6ec86d183b93a613c39f08296c532ee2aa8579d,t,21000,5503806,,5000040,2018-01-30 13:51:07,199
0x8bdaf4358313abc4ad01c79bb28dc7c00c24a3e83460192aa9b5bcbd3e57d213,t,37848,5541654,,5000040,2018-01-30 13:51:07,200
0xd4fbd294b21987cc48a58cc0bc39b76ac226ceda0b530fed9eb7c0234fdb9c81,t,21000,5562654,,5000040,2018-01-30 13:51:07,201
0x19acdd71b2c3c0167a2b08010764e8e52a911174c651019029d17094b18a89cf,t,21000,5583654,,5000040,2018-01-30 13:51:07,202
0x0863d695f21ee892358265d7e9921cdf060dba1e4714e1772351a2989ccff26d,t,21000,5604654,,5000040,2018-01-30 13:51:07,203
0x154ca3e218368e0894ab3bc124f384c3be36249bb84152203fc166b7e2edfccf,t,52848,5657502,,5000040,2018-01-30 13:51:07,204
0x7ea748556667f6856dcebdd33cf8abf7e11fb269c51a9f3bc44cf410de5b9d93,t,214974,5872476,,5000040,2018-01-30 13:51:07,205
0x84eaf890ce20fbe62d843951b620d46a10946fabcf9fd590d59b17722e0e8328,t,21000,5893476,,5000040,2018-01-30 13:51:07,206
0x7cc5cd0a5edd275361df1bc7ffd1a6524dfbd37772c78e033ffc36c3e2604e12,t,21000,5914476,,5000040,2018-01-30 13:51:07,207
0xef5440673b52813fdc94ff90865e30cc32356698d66ec91ade51277e52ba302f,t,21000,5935476,,5000040,2018-01-30 13:51:07,208
0xe664b36a01d66cb53bbeda527fddb240225acceb0b640f14213fe147e51a2e0c,t,21000,5956476,,5000040,2018-01-30 13:51:07,209
0x3574d20925184c9c83e041c18f2279f34bbce78e8b02cc9a17fcdffb25e1b008,t,21000,5977476,,5000040,2018-01-30 13:51:07,210
0xd589d186bb8924c43aaad6f268055a58b0455d7f35b2110b81f0a247b1b338fb,t,63240,6040716,,5000040,2018-01-30 13:51:07,211
0x1cb35b6b00032b9274000a14b3e180e2e4355f3131fe6dcb4f59c8c9561e09ca,f,23320,6064036,,5000040,2018-01-30 13:51:07,212
0x41730ddce538b67014d45be1b79916019e30efcb3a49d7b2071984f2f96fe92d,t,102934,6166970,,5000040,2018-01-30 13:51:07,213
0x926afff97072567823a265879baff5380c471dcc5f24e68e4fd8719416194123,t,51606,6218576,,5000040,2018-01-30 13:51:07,214
0x72f7b077300c516ce08961dfcf2c51d964b8005c671fd9ebfe4334836b0ff521,t,38004,6256580,,5000040,2018-01-30 13:51:07,215
0x99b991d99f5a2681f70262414b8fe0ad74ad2052d6c381d4ce29ed1ace1f6def,t,21000,6277580,,5000040,2018-01-30 13:51:07,216
0x87c86c0442a649f016a39e59d7fe8da5cad4b811b436260328383c804959f8de,t,21000,6298580,,5000040,2018-01-30 13:51:07,217
0x64400314b527ff7ff7c42ef1021dd5890b46ad1b2d6a4f65faaca793affe4d05,t,21000,6319580,,5000040,2018-01-30 13:51:07,218
0x37c17a6c452dda2414cb8edb6b9fffe743744efaccb3fd90e7e2d260bda3cdd8,t,33177,6352757,,5000040,2018-01-30 13:51:07,219
0x996e57e395ca33d0a059d8ffe33de209972246e5a565dd1b6dee78eb1d8c2015,t,51740,6404497,,5000040,2018-01-30 13:51:07,220
0x6eb7fbc30a886efdbab9fc5aca6fe8305f32317e5b7295032e3689dd569e2d2b,t,21000,6425497,,5000040,2018-01-30 13:51:07,221
0xdbac02f06c454151cf350e8965f89bd4efb97feaf25325f281043c7105728886,f,30000,6455497,,5000040,2018-01-30 13:51:07,222
0xa0b1c5193e3a7d5c07af0a6817665b28148e4d78ca30a1a6f79cfe8887f28660,t,21051,6476548,,5000040,2018-01-30 13:51:07,223
0xf3b61886e2e938a2be7d322ed2d76a90dec09752c0f0abc11ea1e5e695a88eb1,t,21000,6497548,,5000040,2018-01-30 13:51:07,224
0x39668dc451d6aaa0c54d44734173fcd79b099ea7d098dd5948794007e325d6c6,t,64725,6562273,,5000040,2018-01-30 13:51:07,225
0x5b23d10fcc85dc831081fe03cc4c21d493d628a69af0f6ff0ae7b0e3fbe778fd,t,21000,6583273,,5000040,2018-01-30 13:51:07,226
0x8b0c61a2cce0db3e6bfbcad7ac52870fca6b3988446f281a45c855fc32477d30,t,49725,6632998,,5000040,2018-01-30 13:51:07,227
0x3c4f73288cb2d0902bad466919904bc601f944142126765268a4b57fe5d040b3,t,21000,6653998,,5000040,2018-01-30 13:51:07,228
0x89c6e7ddeaf8ecaa9374c3c91f6db75d50cd9f3938c77f11bac67dbae2455d84,t,45633,6699631,,5000040,2018-01-30 13:51:07,229
0x8ef78becb948c022467d54d757a0e1ef937e3fdc16afdd26d93f17c8c85c2c77,t,21000,6720631,,5000040,2018-01-30 13:51:07,230
0x3ba78621a10bf191f13b4c1338a3109a02f5e7dfa344d176b498b36c403924fd,t,37507,6758138,,5000040,2018-01-30 13:51:07,231
0x1cad3b86b6b0328c4ac3a310fcf159db019f9f6c5465e2b050cfbb38f094cc64,t,36891,6795029,,5000040,2018-01-30 13:51:07,232
0x70a9162d96bb10b79fc3cd97c673b7229cd8ebfac505f1b2b0cf4574b85c9a3a,t,64725,6859754,,5000040,2018-01-30 13:51:07,233
0x21ffffe9402a2398600776127cd824631654401d2dadb055d25ea8bed4446f29,t,21000,6880754,,5000040,2018-01-30 13:51:07,234
0x1e1b43601bd3d6bd165c2b298340de18b08642ef262ca127f737bae8fc7a922f,t,44493,6925247,,5000040,2018-01-30 13:51:07,235
0x6d688ff87ad6f87c75659983e491f28a47833d67d635f07732ec8f2c708e45aa,t,21000,6946247,,5000040,2018-01-30 13:51:07,236
0x4058f39380978789d6c10f1818ffcdd4e18c3416c2dd8de910fdbc3183f1e3a3,t,45738,6991985,,5000040,2018-01-30 13:51:07,237
0x1e9ffe2598158b9227e58bcdaee4bbafd0c90ed4b5ef9b89d3205f6176e668b9,t,21000,7012985,,5000040,2018-01-30 13:51:07,238
0x061b57e445b030597d3d4325619742104c2f2419fe505b693364bac6a32f7f6d,t,45738,7058723,,5000040,2018-01-30 13:51:07,239
0x33b81ab785f43befa7541a3a5fc3ad28c6c6ac3958775432f081181e78357871,t,53529,7112252,,5000040,2018-01-30 13:51:07,240
0xed29575956dda368ef1559efc41748675d214252efe1e4c95c29fe7bca206ef3,t,28498,7140750,,5000040,2018-01-30 13:51:07,241
0xfdec2923c0c2608da112dd372e166d0841b1145db9cc917d766cc1b7b170a183,t,21000,7161750,,5000040,2018-01-30 13:51:07,242
0x240d9616bc4c82ca39660e491a87b1f4068097c4c4898bd1248efbb3008612a2,t,22027,7183777,,5000040,2018-01-30 13:51:07,243
0x7cfee2580909ac25dbe4d7d8382c3435e31820e0d8377e927eec004f641162ea,t,22091,7205868,,5000040,2018-01-30 13:51:07,244
0x3718a596ff94661a4cb03055cef2074e025d8941020432f76b3f7a20e24c5c20,t,21000,7226868,,5000040,2018-01-30 13:51:07,245
0x90991b5bfdb60e10cc4d5b67bd50b34b2e8e5c75ceebb7b264cb326414382849,t,36542,7263410,,5000040,2018-01-30 13:51:07,246
0x93f91bbf65f195293f7e66aac6d8f523c315a30efe617517c32fa027cc55d56a,t,44051,7307461,,5000040,2018-01-30 13:51:07,247
0xad5552e3d80bb6aa14f57eef2ec34c16c180bb5556865e97ff29c3c020703aee,t,21000,7328461,,5000040,2018-01-30 13:51:07,248
0x39ab21b7f8c8085679228818e70ea13ad18fadf382ebace79506ccbd5df7fa5f,t,36948,7365409,,5000040,2018-01-30 13:51:07,249
0xbe056ebdb4fb4946217fdb76bab720b2f549587e9a4fa23e7abbc58cd6b9e66a,f,90000,7455409,,5000040,2018-01-30 13:51:07,250
0xe512d0f733c15a504caba045b3c01ced83c3d6aa09f8aeab87584f3b40ece49f,t,102934,7558343,,5000040,2018-01-30 13:51:07,251
0x13e8c2cd5978215572a2faef7f555b3b5bfb3767cfba77d50ee1eb64453f2bf4,t,78178,7636521,,5000040,2018-01-30 13:51:07,252
0xf66dfe8ceec3a4cdf5116d2697c34c49868c9e1e6d927c6ec5934ef5d7a0c199,t,108306,7744827,,5000040,2018-01-30 13:51:07,253
0xa2468ff0ab4602d988ffc0d95316ecdf9ff0602cabc8bb33e6d81f4d9acf116d,t,53233,7798060,,5000040,2018-01-30 13:51:07,254
0xea8628153f713d2804484244b16cfbf048c42f7118c8282b813cae759e34d045,t,21912,7819972,,5000040,2018-01-30 13:51:07,255
0xa2cd913131d9d80cb253e8169c70840e161ce9a6994344a81fc479424aeb6590,t,21000,7840972,,5000040,2018-01-30 13:51:07,256
0xed0dbf75aa8e758f6c6884833259f52f17e5e6d2ae19676a576afaf496007638,t,21000,7861972,,5000040,2018-01-30 13:51:07,257
0xff45f3422cb54b533e5bbd757bd2f19bb356a94f21dd699a4d3cced3d53cebe7,t,21000,7882972,,5000040,2018-01-30 13:51:07,258
0xb7fdfbecde8654cd44fed2e1f6ff15f77aead2b48fb1f77cfca917353aa4a772,t,21000,7903972,,5000040,2018-01-30 13:51:07,259
0x53d8a0d52d0747d37175a627e5ada30e6d99ee5461212e6eb87b5c8c8e93ef67,t,21000,7924972,,5000040,2018-01-30 13:51:07,260
0xd6c4a5377f2f62dfd069cf1309df08f1b1aadd077da2ace855412a50b27d7021,t,21000,7945972,,5000040,2018-01-30 13:51:07,261
0x63911293abe6278dd0b0f4779c63678a8c46817143267ee828cc89a17d1a67ca,t,21000,7966972,,5000040,2018-01-30 13:51:07,262
0x62e7c0c229382c481745a9fe0c2d46c2ba57cc47fea6f9a3dc6c0765e6c05f83,t,21000,7987972,,5000040,2018-01-30 13:51:07,263
0x252364eea16264fd5784519401ee1bdd06c3f7e71561e5bb56ce9ebfd5223585,t,21000,21000,,5000041,2018-01-30 13:51:11,0
0x1735271cd24ccd9f74ee240a1165b3773c34cac2166812fcccfb722290935abb,t,21000,42000,,5000041,2018-01-30 13:51:11,1
0x17f43880f3d113e919e77cbb1cad1af3f10da8348d5d20d77651230b3be1bf24,t,21000,63000,,5000041,2018-01-30 13:51:11,2
0xf624f56b78b6847a610e4bfd710740374f1e78a5a93c69029c4142b8ddc8aa20,t,21000,84000,,5000041,2018-01-30 13:51:11,3
0x00989127b6a493ad9a33d1eb8575b4d63456df2f06d726ee36f0e5ac429b9c85,t,21000,105000,,5000041,2018-01-30 13:51:11,4
0x05dd5b8e203dc6326464ffc00bc629dd05fc5d7fb87321a7f5a22e91b97b5d9b,t,21000,126000,,5000041,2018-01-30 13:51:11,5
0x0279e8fa03b1375a2eedab41cd78a94ecf4c66ddd9644b0a6169a8631bf60d54,t,21000,147000,,5000041,2018-01-30 13:51:11,6
0x08cf12fc708d6b9690897447842675e672fcbac808c7f4ad284048d26f23c058,t,31005,178005,,5000041,2018-01-30 13:51:11,7
0xaf3d46ddfcf02774bdfdf7279685558b4698911226a47f29a5d1d826f4c00230,t,21000,199005,,5000041,2018-01-30 13:51:11,8
0xdfbc2f601da42a5a76707c02937e1df24e832b5590ae9402a959cdc7415e0060,t,21000,220005,,5000041,2018-01-30 13:51:11,9
0x6f0ce8e3ed767a0c8c4dddc7532344080f2073c39e338f2c7467e27a4dd0a1a9,t,21000,241005,,5000041,2018-01-30 13:51:11,10
0xb1f9a27939fbdb9a58a7061875cea3800aad31f5b5e8ac9e7c9b1b04a3bd97cd,t,21000,262005,,5000041,2018-01-30 13:51:11,11
0x9442fab6bae7b507e8dfc01aad68653595e6f80c7eaad4a141bce18b1ab4da95,t,21000,283005,,5000041,2018-01-30 13:51:11,12
0x4cb03d68d442bd1ba6ecbea70f87255c10042d65c205b3131e56ba64f81a25c5,t,21000,304005,,5000041,2018-01-30 13:51:11,13
0x4f98ee0f119d3a353763c9288f0b21bb19d44e7074edc9068c735c8822cb2500,t,21000,325005,,5000041,2018-01-30 13:51:11,14
0x08baac3b036ae28774c41a800a78aa11f126527bb31e4e0c645f0c20b3c982d5,t,21000,346005,,5000041,2018-01-30 13:51:11,15
0xe00f2d7ba6242da17ef617131d6257f908dc56ca90e9b3d0b52be43836799dde,t,21000,367005,,5000041,2018-01-30 13:51:11,16
0x4331c5a962a72882d2890004233ebe09ee7a4f2dbd70ae23cd7e5beb5ae74e4e,t,21000,388005,,5000041,2018-01-30 13:51:11,17
0xfade26717b603a538c2127a38291edf7d7e89aa2aa91df2e2aa2fd10b9ea6895,t,21000,409005,,5000041,2018-01-30 13:51:11,18
0x23b084ec2e96eda24535346538cb9788a04f0ec7aa787992de1138d523ca8512,t,21000,430005,,5000041,2018-01-30 13:51:11,19
0x2310469e6cb59b54e53331a2e5c13e544806a57042b4008976b4374637c73933,t,21000,451005,,5000041,2018-01-30 13:51:11,20
0xc53967d0248d8892091560697628a2a28d5e360e8ff595eeb2bc6646927f5afa,t,21000,472005,,5000041,2018-01-30 13:51:11,21
0x4549e1a1a4c9fa65983afb8b91d55f08ea76c80aca4cbdaab79064773260263c,t,21000,493005,,5000041,2018-01-30 13:51:11,22
0x2669bcf287c8ca459c7a9b602598415afe4cf36b0cda784626c4766e9c044d70,t,143081,636086,,5000041,2018-01-30 13:51:11,23
0x87ee8bc12f4a5f222b68c0a48729581611b83b606246847cfaf50a72842d7057,t,26183,662269,,5000041,2018-01-30 13:51:11,24
0xce3584f43291352cd959f24e5755b569a03e4ac6561a347c31ab18163e0c5ac3,t,52751,715020,,5000041,2018-01-30 13:51:11,25
0x725b97a212152a4ead30f062377e003f0729f4fe6d18a273c4efcf7bda7f955f,t,21000,736020,,5000041,2018-01-30 13:51:11,26
0xbf58b9a8808819a5fda2835ecff653dfad39a511a9b97af06977f7af8cb56698,t,37155,773175,,5000041,2018-01-30 13:51:11,27
0x4420a758d5d25c0d010e9242efd23ac1ffec22bfea0fd407e1a34a410c60321a,t,52614,825789,,5000041,2018-01-30 13:51:11,28
0x385ce000fb6c59e4d54d1554ff75d4c5939a258e4d0572a00ce74121671ef154,t,21000,846789,,5000041,2018-01-30 13:51:11,29
0x5d6c32201f801c9b311fb033b3a22b49e01328e62d484c7fb592a0ceb52ff07a,t,21000,867789,,5000041,2018-01-30 13:51:11,30
0x6e69c1562208f85c04df0c1103ba38983797c189efcf492e2be2b85ffa8e3ce5,t,49993,917782,,5000041,2018-01-30 13:51:11,31
0xcaf25a03a4d03b290f2c751d1df5edc1fa11069615b188b59ff21d2dc636b6b5,t,23419,941201,,5000041,2018-01-30 13:51:11,32
0x3a0e92603827162f487e7b902b3a49b822ff94eb78bc4a3f4ad5cb10c3d1244d,t,21000,962201,,5000041,2018-01-30 13:51:11,33
0x601be4a542e615437342605791b885e988ea6edf6056c0f6a02ecb316b3fe7f4,t,37072,999273,,5000041,2018-01-30 13:51:11,34
0x050d92b379caff941e2ecf5697e5f36edb948680fe68dfe7bd53fcc1c8256964,t,40907,1040180,,5000041,2018-01-30 13:51:11,35
0x007496a1d42acaa5cd0ba29e00e5be4b2b618c2d80723e18c5a0670381c7c8e1,t,21000,1061180,,5000041,2018-01-30 13:51:11,36
0xccf2c3b19742084c83316cd7ffb56d76bd34529fe795b6577e47772cb9abe4ee,t,21000,1082180,,5000041,2018-01-30 13:51:11,37
0x45b564e3b554fae423ef2b76f2e955861046096b781a78d3dbd275f1467cadea,t,21000,1103180,,5000041,2018-01-30 13:51:11,38
0x8f4ebcb5b7b9af75788dd4dd9be1c11f514085ef2c607bbeb87f24aff0034f0d,t,21000,1124180,,5000041,2018-01-30 13:51:11,39
0x43e2567ac53ea211b18b13ea60dc5f8a9257a490fd48d5bf06bf61f012e0af39,t,21000,1145180,,5000041,2018-01-30 13:51:11,40
0xff2af472730843fd692e2f691c2e252d6dc3b9a1bc5e952075759cab2130f00b,t,21000,1166180,,5000041,2018-01-30 13:51:11,41
0x17aa5a2c22f1ac481492e823b04bd4f862d3caff5d2bd19c018c596a38a15efc,t,21000,1187180,,5000041,2018-01-30 13:51:11,42
0x29221142a830681a765ba9d72f48cabdba0452a3d3ade27b44fccc307b6a8e78,t,63104,1250284,,5000041,2018-01-30 13:51:11,43
0xe6b60af6cfd93dd7c835e93e14dfeb2f67c011628fe9f314a09a1d22a844628c,t,21000,1271284,,5000041,2018-01-30 13:51:11,44
0x0c92c883b10e50fb2aca48c49d6df1679ba5e6fac299bbc7055e6c917aa269ba,t,21000,1292284,,5000041,2018-01-30 13:51:11,45
0x820354b926ccc97f1754dc21d37c61adf6bc1262fc51e42581038cff975b932e,t,37619,1329903,,5000041,2018-01-30 13:51:11,46
0xc60de600abd6a97001626631b606072a4adf81bd70985dd9b5b08b6a414040d0,t,21000,1350903,,5000041,2018-01-30 13:51:11,47
0x2b232d4f2fd1e2230346d1ca8112cfb1669258cdb56ba502b99e1aa0d8cafba5,t,51542,1402445,,5000041,2018-01-30 13:51:11,48
0x03dfca7f327ff6264b123692e330c8f9fa8acaa157826afb190b4ff26361e4cd,t,21000,1423445,,5000041,2018-01-30 13:51:11,49
0xe20aabbcf4f6517725a5909d6110f032656adbe60acdfe90d97eecd601ede706,t,21000,1444445,,5000041,2018-01-30 13:51:11,50
0x5d44990d9dad6f95dec068cb9e358490cc225e7622ac0fa7502acdbab64fee17,t,21000,1465445,,5000041,2018-01-30 13:51:11,51
0x67ebe09f87858e1a596254637f5e7a2b43df2643c57bd1427320ecae034a53de,t,21000,1486445,,5000041,2018-01-30 13:51:11,52
0x8ffa0fa5fe2e59f85a93f54b1bca6bb69df40cec3f7306ff95a6f26fec009b50,t,21000,1507445,,5000041,2018-01-30 13:51:11,53
0x57d74774157390ed91b903016255e3319b7d9e80ee648424db35f5f892e24654,t,21000,1528445,,5000041,2018-01-30 13:51:11,54
0x8c6047f53b0827cc01a08bbe3a9912f1080cd105bdfd9595fa404e02b1062f1f,t,21000,1549445,,5000041,2018-01-30 13:51:11,55
0x5094c3a3dfb5ecbe834c710368fddc4a2e42e40c443380d8e139b045f24536d1,t,21000,1570445,,5000041,2018-01-30 13:51:11,56
0x63eed53a2d061d4a5629142e9005fd07a9f5e03c66f5aed144f6757937ee5bf3,t,21000,1591445,,5000041,2018-01-30 13:51:11,57
0xd36c853be7514ce98db3268a41032530b27ee73e5f625584dfa0e5816178324f,t,21000,1612445,,5000041,2018-01-30 13:51:11,58
0xc135969243ef651a77c3c8eea8c69dcc8c0ba776a107464410a1316cf1f45046,t,21000,1633445,,5000041,2018-01-30 13:51:11,59
0x7579a087241358edb0023f0039a3a093543272452d3afad909a03c748b79dd9b,t,21000,1654445,,5000041,2018-01-30 13:51:11,60
0x223abea8aa6934df2f396c8c309f358be3c62f0429d84ad4487e85fe9e6fbc19,t,21000,1675445,,5000041,2018-01-30 13:51:11,61
0x33ddf4829ea51000d78b1ec8fda6659cfc769d2117df2b2350903658e0ebf3e8,t,21000,1696445,,5000041,2018-01-30 13:51:11,62
0xc5c2ca5a82c2505251b74ebb085f8526000e8de34749336e6bfdb7adcc655720,t,21000,1717445,,5000041,2018-01-30 13:51:11,63
0x89f875fd1df5c5be386db1a391dfad23ac5c6dc52276a2ad6d169af7b0125d96,t,21000,1738445,,5000041,2018-01-30 13:51:11,64
0x99bb14e4f217d24b585e123de12feff7c2a6a56389327e4dcdedfeca41d2142f,t,111441,1849886,,5000041,2018-01-30 13:51:11,65
0x00676fcafa1384d82936320d12364c79c8b13290afc337ec153cbe2cc77c1ef5,t,142772,1992658,,5000041,2018-01-30 13:51:11,66
0x861c6002a3407d470304f9c5f110e77cb6b4fa36e21b120b0362a164723e8dc7,t,52886,2045544,,5000041,2018-01-30 13:51:11,67
0x3f361864086a62032e1893840dbcab734ba6704aee27e471fe594230dca9c848,t,37948,2083492,,5000041,2018-01-30 13:51:11,68
0xadd88e5730af91ee14c9e3090d61009913e05f26cc8c1ce4d5a0296d7b63a46e,t,40907,2124399,,5000041,2018-01-30 13:51:11,69
0x9d73d14e759dcd7cbdd637e35c9f9a516acd404a9e9abd45f76805ab85ea8793,t,51820,2176219,,5000041,2018-01-30 13:51:11,70
0x92cf1c5155b7dbbe6f66b75576a19bd67c51ae11dabb7700f7db06a149b6836b,t,55843,2232062,,5000041,2018-01-30 13:51:11,71
0x2401dcbb197e3d3494ccad4c0f82190eb616eb03df65a016353cf18af263073a,t,37376,2269438,,5000041,2018-01-30 13:51:11,72
0x18e1566b29e85899940e1f5fbe5a1921b48a4a0f49b8d318261aa7c346508e1e,t,37881,2307319,,5000041,2018-01-30 13:51:11,73
0xdd0b8f1fd46b5c9315489c9531e3f2175d51f2ad348605d60571a1599fca640d,t,37884,2345203,,5000041,2018-01-30 13:51:11,74
0xb3d7d56331eefb35fb717fbba50e8850875398528499346cff050055af486081,t,52065,2397268,,5000041,2018-01-30 13:51:11,75
0x3da3e25508984d2d9edf98ede102544cdb0d0362a86bad8caf839c67873ba965,t,53104,2450372,,5000041,2018-01-30 13:51:11,76
0xaa92f5ae91e0957a3944fd97b797507de2540ddd34b81f0fac9553409d386cf4,t,21000,2471372,,5000041,2018-01-30 13:51:11,77
0xf3c4d6b9c9f0012c21d966852d0e537a1226608f1a99edb2aa5baf1838eb3fcb,t,51467,2522839,,5000041,2018-01-30 13:51:11,78
0x5a7f0ceabdd890078508dfb4892e41537dc20d868170c3c2a0ef3b6c45a1f234,t,37193,2560032,,5000041,2018-01-30 13:51:11,79
0x77b724fc822129da4b15e1419ebc9328fdd5c6c24df7bc9c290569d123363d4f,t,37873,2597905,,5000041,2018-01-30 13:51:11,80
0x02701e6246954f77cc4a4f77e405cf7a5e551674388caaef72cbd7b135db6158,t,21000,2618905,,5000041,2018-01-30 13:51:11,81
0xeed4a1c850d3a54971df2a494ec41d67d6daa5144b6df35c8e6c790d769fe28d,t,21000,2639905,,5000041,2018-01-30 13:51:11,82
0xb9231790218fd881bd1d3615e7887cfb5ded1625edb233fb72db43596d896533,t,53615,2693520,,5000041,2018-01-30 13:51:11,83
0xcb1fba9fb4660a81fa9bb4518182ba477004d3caf05c8937645614333b8654a5,t,21000,2714520,,5000041,2018-01-30 13:51:11,84
0x35a80dee8bdc13ca2166cb548679cd2ec2e0b38beba955f05c0b470dc0132708,t,21000,2735520,,5000041,2018-01-30 13:51:11,85
0x18d74dc6a8941eb9fcfb9a55ed497ab6dcdae2b0025fa5f5ab9616337c413f83,t,21000,2756520,,5000041,2018-01-30 13:51:11,86
0x3a6627474aa4e6ad1041d0d1ef884a3489efa1a3d858c791bdae228d104ac882,t,33571,2790091,,5000041,2018-01-30 13:51:11,87
0x12a4d332abf99e9f2c3ea589f1de96327a37886f8e96a6b008a4b6baf7911ab5,t,33571,2823662,,5000041,2018-01-30 13:51:11,88
0x8c337c8844494eac945913230eab25a46b6fd641b254caf452cfd55baaf9d01d,t,98809,2922471,,5000041,2018-01-30 13:51:11,89
0xc10730dfcb70a44a8590bb2a713b1a98ceb56a0c0d7b5225eec3805de2410a08,t,22309,2944780,,5000041,2018-01-30 13:51:11,90
0xebf130e479b521b7a79c6f77dac3fdbea4e181f91e018444d1c205368ac6d51b,t,52862,2997642,,5000041,2018-01-30 13:51:11,91
0xffdb5b9bb5e7799780af4237026c6c9a2d6d886e24912e45b76e5f2b688fce21,t,21000,3018642,,5000041,2018-01-30 13:51:11,92
0x687862efbe5f903f3dde9d464aabf443d37c92b6fe057c4db434453b862b3902,t,22387,3041029,,5000041,2018-01-30 13:51:11,93
0x6de5d2d268349fb6f74f36db83ac21a2e67bab52ed6f20a29b2a34d107942b0b,t,21000,3062029,,5000041,2018-01-30 13:51:11,94
0x25f90d31622bba91a85be43c1fda565b04c3e46b459b9d4b7ea4b2e7d2920e9a,t,21000,3083029,,5000041,2018-01-30 13:51:11,95
0x76a4bdb413ef138acd4812df05ef1afa57dca6d48a469a555ddc183a8e870e25,t,21000,3104029,,5000041,2018-01-30 13:51:11,96
0xe38b48447033fa7a46272c2785fe6fc23c40dc3b285e22007b1eaabb1c437c21,t,21000,3125029,,5000041,2018-01-30 13:51:11,97
0x1f1449ae8af7655560c06f5226abe91eb8e85f51b8bf2f3f8160b2d6acae0e49,t,21000,3146029,,5000041,2018-01-30 13:51:11,98
0x9060aebed6f2e97b8c13b846b7047e49a30f7a421687801465f8516973eb2406,t,22310,3168339,,5000041,2018-01-30 13:51:11,99
0xc3e044ff8e93bf0d1a2e3a51d129b86a45aff9f7ff082e870545fb96832df2f6,t,21000,3189339,,5000041,2018-01-30 13:51:11,100
0xa8f0729b1f6f5ce88fb06a4581d2737ad743db32d7775c5c41d7bbb427e7957a,t,92493,3281832,,5000041,2018-01-30 13:51:11,101
0x01a1dae1ea83c2047999c24019da7d3c51be56df8b654629f77b868f6b9149fd,t,21000,3302832,,5000041,2018-01-30 13:51:11,102
0xd567b14cf31d3bd396dbd05d1bbbc2ff474d2937547a34dec9fa14d568c8a18d,t,51672,3354504,,5000041,2018-01-30 13:51:11,103
0x3da78b8698de1cb0ce935afdec8f3b9202bc4de51bb1e5539df6317f896a0842,t,144053,3498557,,5000041,2018-01-30 13:51:11,104
0x0da25f50c67fd9cac5cf0b96b7b8a4e93e258102ab267ce6c2d6e7aad0c7faba,t,51792,3550349,,5000041,2018-01-30 13:51:11,105
0xd83ef68728f9a5887850bb1aa061fdbd0ed451e3728f5142d2bc0f316233bada,t,21000,3571349,,5000041,2018-01-30 13:51:11,106
0xf981b06b6a4009d505303552074d39f6c8aef0355b4d129b71d131593bb428f1,t,37810,3609159,,5000041,2018-01-30 13:51:11,107
0x29eec6e6f201446e7edc01ea55307609a8fe39bdf7b17162e7503f1af08a35c9,t,21000,3630159,,5000041,2018-01-30 13:51:11,108
0x9b56e03f7b902088bf83a53ad7ce684b623470f711c00ed34f84ec4241021a9b,t,21000,3651159,,5000041,2018-01-30 13:51:11,109
0x4b85bd8fca39ebeb13af0f19e879b38109c38a20617be0b5cdb461b3bbf58f50,t,21000,3672159,,5000041,2018-01-30 13:51:11,110
0x7bba4fe1b3a109385c54d643701714eed792892fb03b7ef15f34ab512a780788,t,64725,3736884,,5000041,2018-01-30 13:51:11,111
0xb1863a1421eb048afc6491abce38316eb214d9370d17cd38993021d06f76dbc8,t,21000,3757884,,5000041,2018-01-30 13:51:11,112
0xea9be0a5ec321049627400f487e4ac3d3512aa58e265295fc8a17acbe0751991,t,21000,3778884,,5000041,2018-01-30 13:51:11,113
0x2cb98c9e0a0598bcefc25574432734b174b1ad2e41f76e5bbc2e1bab0d451905,t,30327,3809211,,5000041,2018-01-30 13:51:11,114
0x2369e6a670337cd6d215cea6464b09f5d6e58e1b52dcae38cd1bb6ea063ec35d,t,21000,3830211,,5000041,2018-01-30 13:51:11,115
0x4d2a4cdd7dd1b40708db937a6b2ed406ce12ac54a5b207f2141167596258b921,t,21000,3851211,,5000041,2018-01-30 13:51:11,116
0xe3bccee9b7ed93ea32ced7dc66b63b9306ef4108524efaf3f67fb3af14ab4876,t,44063,3895274,,5000041,2018-01-30 13:51:11,117
0xb38ab14a0c8cd6faebb3ae93bc98a94d29cf07e1b3d58d2c69facab9e7162826,t,21000,3916274,,5000041,2018-01-30 13:51:11,118
0x2c9bf4b70ab2bf4da0000fdf457b896e0e02e32c0605f370b8d2e04813d94d25,t,21000,3937274,,5000041,2018-01-30 13:51:11,119
0x493667345fd2a13eb29de1c0a26d9231d95eb064d6c0715fb4fedecd5507fd85,t,21000,3958274,,5000041,2018-01-30 13:51:11,120
0x2201e3a82ab5cf7a152d820089204e01650bb6949b20ea96d66c3aadd408f994,t,21000,3979274,,5000041,2018-01-30 13:51:11,121
0xef50684a0bf5a93915888e6d363880cd2cc038ee4f2abe3e8cbf6f9e7831eb06,t,21000,4000274,,5000041,2018-01-30 13:51:11,122
0x92fb7ce1637e831ba3477ae032b93d8d031c1a34fbd9dbcf7f0e842821408d83,t,21000,4021274,,5000041,2018-01-30 13:51:11,123
0x3c735b457d5f06efcef4307fb024607a465ebd2663dca28e9b5daa4459311dce,t,21000,4042274,,5000041,2018-01-30 13:51:11,124
0xd3413f78691493ba2ae44fb69a4aacfb9ba4d14ba5b9bcea86fd96a1362962b1,t,21000,4063274,,5000041,2018-01-30 13:51:11,125
0x6ec2ca8c993e03a1d38e04fe9895f69b8e68e73062c51a6d7d8575a653a9c1ba,t,21000,4084274,,5000041,2018-01-30 13:51:11,126
0x9fe4fcb22cac0823c011e086522159adc2379733981083b87e853257bcb13639,t,21000,4105274,,5000041,2018-01-30 13:51:11,127
0x92261b0f6b07c3abbae7bf8ef41bd3253e3fe38fb7b1836b1561759c60192882,t,36779,4142053,,5000041,2018-01-30 13:51:11,128
0x8b38a50823a0e501cef29ad03762d5a84c4b415197bd449077f82d1854f01c8e,t,25843,4167896,,5000041,2018-01-30 13:51:11,129
0x7e9efb8f3a95fdd709e1d40879012946583772f96e7429ae866064fc05dc1fb5,t,21000,4188896,,5000041,2018-01-30 13:51:11,130
0x595ddb7c40aa9a6d682f572fd6c168544bd95b96e52650bf314f915eb6f4bf2e,t,21000,4209896,,5000041,2018-01-30 13:51:11,131
0xc6beaa97c2d4e71d337f9c92286d7613cf01a38cab0c492d5ef0b8f0b22c197c,t,38615,4248511,,5000041,2018-01-30 13:51:11,132
0x4e4edd6cd0a851de1e4602ee96403e9235bb723199d5ca1ca5b09ed51867a3d6,t,21000,4269511,,5000041,2018-01-30 13:51:11,133
0xc03c109c7c4a9015cd6bfd971aa73cc80bbd04604dcec30224d798e664fe6c6c,t,21000,4290511,,5000041,2018-01-30 13:51:11,134
0x735c9d2979a69d5f7f27a2880a38ab9102072c26a034483f08dca47a7d6fc454,t,21000,4311511,,5000041,2018-01-30 13:51:11,135
0x42214b89a5956d805e9418834ef1a6a6cd676bc9206d6280137c3577eedb8068,t,21000,4332511,,5000041,2018-01-30 13:51:11,136
0x81870ada563efac116c88897a0cf759e62f482b43d8bd04c56bac02f49a16725,t,21000,4353511,,5000041,2018-01-30 13:51:11,137
0x64fccc6adf88bca17557263c0c8e92da6d3e932ee68c1298b4e636a7b856d479,t,76734,4430245,,5000041,2018-01-30 13:51:11,138
0xc2597c8c50284492954960012dff0a9855ee70d2cff36d2ad4f679e3630b68cd,t,21000,4451245,,5000041,2018-01-30 13:51:11,139
0x10e74ac44cc5018e9873114c6cf4f4cdfa394ce07b8e7ff69f028566568b27e5,t,21000,4472245,,5000041,2018-01-30 13:51:11,140
0x0cfc3971f896f3ea7a3d22e2dd03e99af711bf679c3f7c2fbfd51a30b11bb50d,t,52904,4525149,,5000041,2018-01-30 13:51:11,141
0x07d5d482f7965788b6dae88f5a00aee1e6c2a6964c4794019a6dc051acdccce6,t,21000,4546149,,5000041,2018-01-30 13:51:11,142
0x7e8794b96b215881eb26fd52bfeeeb29cf4eabc0a166eedd720be4a1aa2788d7,t,21000,4567149,,5000041,2018-01-30 13:51:11,143
0xc62d44737cb7551150bef39c4ffcd4447bddbb40aa8b597e22f6c47daf13f8bb,t,21000,4588149,,5000041,2018-01-30 13:51:11,144
0x4d5c91628bc4654823aedcf17622c00df9ea3f17808e7ce7252189959d41b2cf,t,21000,4609149,,5000041,2018-01-30 13:51:11,145
0xd3bef14ff7150ec1c447d180f6e53869fcc01eea41e39c6f05c8719b4bb7328a,t,21000,4630149,,5000041,2018-01-30 13:51:11,146
0xc3e1d0d41de303bfdfdb1db52d7af6c6f432faf46d6a0fdcaa8e7c3fd1b69ade,t,22404,4652553,,5000041,2018-01-30 13:51:11,147
0x15e2b03a60eac573c7104f1ed5b3412773fa41b59758b33da1c7eb84fd4ea209,t,21000,4673553,,5000041,2018-01-30 13:51:11,148
0xde66856906a189eec2b65db1458aa79cc084d85a5dacb7d4f6e44b7d9b7ee661,t,21000,4694553,,5000041,2018-01-30 13:51:11,149
0x42b7b0b2ea1be91e9c23e9d2a0f90205962a94352bb2996c9ad53bfb72c4c79f,t,21000,4715553,,5000041,2018-01-30 13:51:11,150
0xdc9c769f6f5575261eae8975e36086eea204b3369ed4f2a0b7aee6dbfb835cde,t,21000,4736553,,5000041,2018-01-30 13:51:11,151
0xcad6f82fa839561f4321af0e57a2f68f23a5bf60d2b15832a2e239f92d53adcd,t,51938,4788491,,5000041,2018-01-30 13:51:11,152
0xc79318b56020800b003bd2999b8065b9b9d5517e285e920106e060b28c180197,t,91322,4879813,,5000041,2018-01-30 13:51:11,153
0x1b6ae3cf6eb539623f46f2db827a20da185a3410bc9ee7e2d3718c0e898119a8,t,21562,4901375,,5000041,2018-01-30 13:51:11,154
0x18302edd06af6e007353edd098a1fca61db583099311e9bd5204d4cfabdbc50c,t,22912,4924287,,5000041,2018-01-30 13:51:11,155
0x7184ec55b7f2c15709495b12cc73a58238bc8042ffc68477a282e286ceb257cf,t,21000,4945287,,5000041,2018-01-30 13:51:11,156
0x59c6338f6e4e7a343ac678d74a15337d9cb3ae7e2275119a87cb7d218f62cd9d,t,21562,4966849,,5000041,2018-01-30 13:51:11,157
0x1ade6ce6c77ab0dbe5327c8f58b355dbfc867f5bd468f2abb71f9b907efbae51,t,70574,5037423,,5000041,2018-01-30 13:51:11,158
0xf05009c94acb40e56bae543017bc77a89b45f86968bed88671d38a5918e2dd05,t,21562,5058985,,5000041,2018-01-30 13:51:11,159
0xf181ec3a6a8ee18842d74fca4ae115ed737580e41d59c2c6ab23911ec9b39f99,t,22848,5081833,,5000041,2018-01-30 13:51:11,160
0x9bc347326a5e6f0eb9c0d626119614ad2cfa56f8da552131b1511dafcedc2c7f,t,22336,5104169,,5000041,2018-01-30 13:51:11,161
0xd3b48b33d9234cdff479b849b0c4d91fe8512daf30bb2142ad491e81096d721c,t,22336,5126505,,5000041,2018-01-30 13:51:11,162
0x9360d06ebf6a7e43a6f7a7ed299e29ea804937dbce6ac9bc3670cddd8479a910,t,30327,5156832,,5000041,2018-01-30 13:51:11,163
0xe42036af1aa1373b0b2eff75d3428d6aa2f42c38132ee668beeb1a1e3279fc26,t,22964,5179796,,5000041,2018-01-30 13:51:11,164
0xfd872f509226c2739b2f010b4dac0c782011ce597fae55ef8d84b7ecc02537c6,t,21000,5200796,,5000041,2018-01-30 13:51:11,165
0xd51f49b9f1cc8f2aae78dd723c5a66a12c859c04ae7a1c11b43a72fc3635fc77,t,36770,5237566,,5000041,2018-01-30 13:51:11,166
0xf0246e274e90bb465fd7ae879b54b542bded3266d28ecc7b36afe744cb37ea3d,t,52524,5290090,,5000041,2018-01-30 13:51:11,167
0x58dabd86ad046ef1daaa5aec1dbb0056a7d908c45cdf09101bfa43a350144a5a,t,21000,5311090,,5000041,2018-01-30 13:51:11,168
0x434053d4e86f8190af90f0f1a7ff570c83622e5b900ab6493c579dc492587c35,t,30327,5341417,,5000041,2018-01-30 13:51:11,169
0x9307e50f485c37c1f3612fafdb24cf3fe4b05693df0f866ecd6d4c4ed022b59e,t,21000,5362417,,5000041,2018-01-30 13:51:11,170
0x0aa0ce8011c7681a1b1571872c10fdbd2dd166c0191fe4cbb0d8a6bed2c8437f,t,23590,5386007,,5000041,2018-01-30 13:51:11,171
0x580f9105c2fc1bc2a1ad356f003847bb112795b6e7383fe00b6b8b58897ea2b3,t,21000,5407007,,5000041,2018-01-30 13:51:11,172
0xb9f8337732d7baf4e99456f5fbf32bfddf56ad8826586c16f98902e90d0615b3,t,44666,5451673,,5000041,2018-01-30 13:51:11,173
0x198cb302e304784ab0cb762c2add77daf5ea36a50cfebf911bd03cf73392aac0,t,21000,5472673,,5000041,2018-01-30 13:51:11,174
0x15190596fd6de5fa412c02e002ea6ce91f1743279e9a7638940f299bead9aca4,t,21000,5493673,,5000041,2018-01-30 13:51:11,175
0x8e1bf39a6dc7d2f8a06dd683e0fb47ce241d21c3e6b567ae390faf9ed594b5a1,t,37882,5531555,,5000041,2018-01-30 13:51:11,176
0x1d757d8a9f807b355f2bd148f85a279e51702fd9f39d40ac7ba751cd45e70f73,t,21000,5552555,,5000041,2018-01-30 13:51:11,177
0xf599c71e6787449ff47b7b7d186c3b9db22b419c5588d32113bc368e9c9b3fbe,t,21000,5573555,,5000041,2018-01-30 13:51:11,178
0x7f3095d84b212ad82e48d3cea2b034b447a687db66e53bfd3e80c7e0b6ad76d5,t,21000,5594555,,5000041,2018-01-30 13:51:11,179
0x3fe5bb8b5f5dd6149fac44fac1c9a779a67109375ecf2ec3583d9aa04a8a9aab,t,42630,5637185,,5000041,2018-01-30 13:51:11,180
0x87926dc87e8c559a2177665a25d87b4c69955612b88bbdcc33c95603fb0cce34,t,52372,5689557,,5000041,2018-01-30 13:51:11,181
0xf5259fbe8961753b10ea9426a2011e6fcab6612faf89a0a36c1e85bf17d57cdd,t,21000,5710557,,5000041,2018-01-30 13:51:11,182
0xe43d2a72bc322495363ec10f0d4c9aac19baa5d739593bd5967c723ba06ce3c5,t,21000,5731557,,5000041,2018-01-30 13:51:11,183
0x5801ce9baca7c6197b31f68507878e60cb6a0a7bf6f12fd65c7e8f99641a5740,t,21000,5752557,,5000041,2018-01-30 13:51:11,184
0xf3cdd1d6720cb647d4909ad60add6f7a13911a41401b048d04fb9ca8f6968f37,t,21000,5773557,,5000041,2018-01-30 13:51:11,185
0x536ef6f70a2e30ad680cba9dfc5afe4e980e0334853a46cbbb25a036dec39a24,t,23316,5796873,,5000041,2018-01-30 13:51:11,186
0x2d83e3724a76f6b166a63ac6ea16216717a3430641d7ddba64ecbe68be94ede7,t,21000,5817873,,5000041,2018-01-30 13:51:11,187
0x87c1dc11cd93f45526efc2cb3ce8d61b0bb082d92e0d477c19b44a006963170f,t,37241,5855114,,5000041,2018-01-30 13:51:11,188
0xfd95f3c50ab4894fcf1d4fdd43bc9ca6d8a5f4317caca689c5313e7e787ecc33,t,21000,5876114,,5000041,2018-01-30 13:51:11,189
0x2456e84a0c920d262fa085bd397ad0fccf2260fdde09ab757a45a49eddfec21b,t,54379,5930493,,5000041,2018-01-30 13:51:11,190
0x2ad9f801a33bf33cd232b3533815e059849765d3d6657a642929084eb0b8165a,t,109100,6039593,,5000041,2018-01-30 13:51:11,191
0x9d2c0cae52bf91f04a065e03a171eec17201867603f91d85f94c865c05d99c10,t,21000,6060593,,5000041,2018-01-30 13:51:11,192
0x5e45530e2bb58ed845ee117423cb937c0d8ff59636c1812af7a091e035d1f62c,t,38543,6099136,,5000041,2018-01-30 13:51:11,193
0xad870f538d8410a54397834ab7a0768d19d2d887425cb9e4f391ef98c7bea502,t,167107,6266243,,5000041,2018-01-30 13:51:11,194
0xa9e983e3aca5a87cbdd72b79eaf1b9d0c34a03bee7dfa688d7e5e2a253beb76e,t,27923,6294166,,5000041,2018-01-30 13:51:11,195
0x2acb787a6507f2af0cbcae907d58f6758bec0760ee24f8d672fcdeb2675eb8bc,t,21000,6315166,,5000041,2018-01-30 13:51:11,196
0x4cb2e5d2fb7e7e8b58998d0f89b808d94e731ffbf7a61e24fa9ccfbb86540c58,t,36733,6351899,,5000041,2018-01-30 13:51:11,197
0x710e2efe1dd1045aafab98c835f876938f883a386f4b341d532772486e20ab72,t,22352,6374251,,5000041,2018-01-30 13:51:11,198
0x963351d68fd4a3067c4b6df56779bc0c304a339ee389b05d69952461a2a9b857,t,52292,6426543,,5000041,2018-01-30 13:51:11,199
0x377ed8fff804f94c201a573f7a032700447a4145e517b25aafc376c36c3f8ff1,t,49129,6475672,,5000041,2018-01-30 13:51:11,200
0x0b10597f9f9b6ffc216d0659d1853f436ab308dec17245345960a850a9a39bc9,t,21000,6496672,,5000041,2018-01-30 13:51:11,201
0x8200ece41f7c120190a9997df803fcb3962ca33f34eceb88e668243a37db274d,t,77986,6574658,,5000041,2018-01-30 13:51:11,202
0x69b24c0c58f37b54c534cab8a91133c8e63ba35eb17b70603ba8200f34415b56,t,21852,6596510,,5000041,2018-01-30 13:51:11,203
0x689c4ec6497f9f5b32d50c5c8fdbc919bcdc44881267b0a13b1b4ac0ce1c9608,t,64725,6661235,,5000041,2018-01-30 13:51:11,204
0xf3816733fd069303591246579cc183bcc01f376e82e20f6a9f3ddc3d437a475b,t,21000,6682235,,5000041,2018-01-30 13:51:11,205
0x40a8d2f96b4f6ff447d0428cac20fce6a2fc6c036df5ae5584544ffad3fbf1e6,t,37251,6719486,,5000041,2018-01-30 13:51:11,206
0x50d00e17f01d3e430ce28308450ec6a18705b4589f0c67fe1bf7852ba58adfef,t,21000,6740486,,5000041,2018-01-30 13:51:11,207
0xc14fe4af1c09fd14e84dd7d1fdd46c21310623d56b45f748ac64a8643e9792f0,t,76769,6817255,,5000041,2018-01-30 13:51:11,208
0x5693cbe07b5d9cbd087426cdd1efae6262a2540167d0b3868533ef893a88fb8b,t,23145,6840400,,5000041,2018-01-30 13:51:11,209
0x5cd260bec2e4835daa6cf042ed4e9f0623b9b77bfbb55bdaa23ddeef8f19669b,t,84017,6924417,,5000041,2018-01-30 13:51:11,210
0xa59aff90fa7737936c8c846a0fe22ecfc97de950a8b787fd795d00bca4a5415f,t,22380,6946797,,5000041,2018-01-30 13:51:11,211
0x70d233706b846922c866bd0d99d8f631d4d682a76b1f47a91e1e2e42365c9d15,t,22391,6969188,,5000041,2018-01-30 13:51:11,212
0x4fe38fb10387d8bfc4cf86d3b514b291039125a6a75576f8cf2d80891ee63b2d,t,23318,6992506,,5000041,2018-01-30 13:51:11,213
0x010bc4203dba6b51bcc3cde4ebe9257c44e6849ace51a0a0b51c6af8c1c69699,t,23318,7015824,,5000041,2018-01-30 13:51:11,214
0x4871b68a3596ee70c070a54b1d99b16c7e1c09a5bc091a125f7ea76d236edb0c,t,22460,7038284,,5000041,2018-01-30 13:51:11,215
0x72d056040edc0cee28a0e9260ad66f3502e087d01066a379791fc4702bdfaef2,t,22524,7060808,,5000041,2018-01-30 13:51:11,216
0xcb51d788b5e6c1dfcf4b2546e6825192370f1d4840b2df5b7a4a037bb549397f,t,22465,7083273,,5000041,2018-01-30 13:51:11,217
0xc65377c611202c65da646a68a32b593ffbf683c9e75cddf88cac99ab86f47d58,t,23382,7106655,,5000041,2018-01-30 13:51:11,218
0xa945e5740227e2c751f9a05eb9dc52f91baf122cf42975aac0aa69d84b252abb,t,22524,7129179,,5000041,2018-01-30 13:51:11,219
0x87edb16e059a4c719199630d7655d0922ad26248388703ca53c17af0794203f8,t,22460,7151639,,5000041,2018-01-30 13:51:11,220
0xc8b668a13fd430229a4ecf16830c74ce3c0364cdda9b8f183798b45ba88259ed,t,23818,7175457,,5000041,2018-01-30 13:51:11,221
0x70d027155bcd56d03576fafe77cc1c8cb016686a7fdb5b13fd5f65dbb31d80bd,t,22524,7197981,,5000041,2018-01-30 13:51:11,222
0xac8bacdea29779622d892a238ef4f672510d7dd8f221ef1046c2563722a78f28,t,22460,7220441,,5000041,2018-01-30 13:51:11,223
0xc3a89725d6d862a6373410a718c99009647aa5c82dfe9e930a7cf7b4fdd6b07d,t,22316,7242757,,5000041,2018-01-30 13:51:11,224
0xe39173d5932030762fa8427db18f1e6327c408037e3ac2e1688ab2ab78685f4e,t,22316,7265073,,5000041,2018-01-30 13:51:11,225
0x568b74b144e088e39d067cc8bfb30a26619a47104a29d76c39c02ffe0cf51cce,t,22460,7287533,,5000041,2018-01-30 13:51:11,226
0xa6084f7a33cf85a29bb3c276b76e5817fc30177d369cf47eea2983dccf121374,t,22444,7309977,,5000041,2018-01-30 13:51:11,227
0x206e86a96dace79fab7d944a502851fd6d9e4fe73e75516da5a8394a6c048b40,t,23754,7333731,,5000041,2018-01-30 13:51:11,228
0xd090b0fa76d3754c3d2a06e0cb0ac88f8532917cd7228aeca68ea421ba17516c,t,23254,7356985,,5000041,2018-01-30 13:51:11,229
0x5b29edaec7790c3dd4169afb0ba47938095dad709c7907a1ed381f4e0ec22041,t,23754,7380739,,5000041,2018-01-30 13:51:11,230
0xbccb55786eead87479a5687bb519e935eb0099d7017eed97dd4f6d72e22798c2,t,23254,7403993,,5000041,2018-01-30 13:51:11,231
0xad719e8961c64c2827732aa1fc8e169dbf8ae301f1bcd57b1ec72491eddeaf6e,t,23318,7427311,,5000041,2018-01-30 13:51:11,232
0x0bca950be163b7d0487bf69dee3916708e75bb09946cd38c59c40cc2a1718032,t,22091,7449402,,5000041,2018-01-30 13:51:11,233
0x5c0f9ab082b4b5b822bbcb244623637170b6aff501765f8af5444a1fd5972622,t,23254,7472656,,5000041,2018-01-30 13:51:11,234
0x0faf97b9ad04b2820f12adcdd134408f6e0f4d7f08aabf7eaf1e872502c48463,t,26937,7499593,,5000041,2018-01-30 13:51:11,235
0xeb6f19b3bab2f3abfb2ec2cc07ded2a0c4cc35831953ace86fdbc8ca1c6e6924,t,93114,7592707,,5000041,2018-01-30 13:51:11,236
0x4211967f39fc5cd2b5f02dce86de2219701f50cc55c7b251d99852f753942587,t,59418,7652125,,5000041,2018-01-30 13:51:11,237
0x2be82f10b5ee0d5470e7406b5c889fde53408df56a238533a65a9d7834b2e97b,t,78306,7730431,,5000041,2018-01-30 13:51:11,238
0x41688b501b66e7ee502f2f15868c84149a6840f21fa2c35336ab1508a2aca9f0,t,21000,7751431,,5000041,2018-01-30 13:51:11,239
0x9ff98c24386f70d15f19f337bf75ab0421bde9807b40dd2addf377149ee95d3e,t,45508,7796939,,5000041,2018-01-30 13:51:11,240
0x7eab53c0e698557e648752b1df6506ad53ac27d175c73cb1b17c91b2799fb2d1,t,22624,7819563,,5000041,2018-01-30 13:51:11,241
0x2d8ba17a591a46daae448a9002fc1e12fa49114734f8c38956a7c14e10c3b1ba,t,79985,7899548,,5000041,2018-01-30 13:51:11,242
0x8adfb8c703fb52dd7a018849446f3e39ba5844e245dc0056d8f93ebc42e93609,t,21000,7920548,,5000041,2018-01-30 13:51:11,243
0xd523099a2f1bbd115aa61646926438bd0baf3ef1b5e99d999d0d576ac816763c,t,21000,7941548,,5000041,2018-01-30 13:51:11,244
0x5f38ca0871b3b37bed53196133cb0f4a123903b715ed72b50d8a73c5487c4842,t,21000,7962548,,5000041,2018-01-30 13:51:11,245
0x323e7d3e81b8de78d929988d07293e3ece28ad825aeaea64ccae218fcc097e39,t,21000,7983548,,5000041,2018-01-30 13:51:11,246
0xb10588fa09307bd1176c0b8fa5b850aeec72f0cc8cf1484debfc96e7fbc68168,t,21000,21000,,5000042,2018-01-30 13:51:48,0
0xa3e53e9c417c94656b78ad59b1b048ace97529ddefa432dbc45aa63686a35912,t,21000,42000,,5000042,2018-01-30 13:51:48,1
0x6c0c3cb8b76ffa6ab545b85f2f34a1836c88a97acc15d75e7c6c7d609760bbbb,t,21000,63000,,5000042,2018-01-30 13:51:48,2
0x1a0823a201a94233d62fef12bd4c8af2b8d764d016b190384f2539121547e251,t,21000,84000,,5000042,2018-01-30 13:51:48,3
0xbaabfbac20fa587fc0edb060c65acd7854bc596728939c768e260bdc7664cdfb,t,46018,130018,,5000042,2018-01-30 13:51:48,4
0x3411595d382c65a48239f968d648a82847d149778702b16adbc962d4afd527f3,t,37687,167705,,5000042,2018-01-30 13:51:48,5
0x8b6660f2b7819e9d21ed297ac6ec4b9da882d98c5ef1f557709ebe8e0cc8420c,t,37091,204796,,5000042,2018-01-30 13:51:48,6
0x9dcf166de37205b6229d964e1f6e4091e6eb9bcee6c5842318d02e55d6a3b1e4,t,59098,263894,,5000042,2018-01-30 13:51:48,7
0xbca2ebaf3509d2ff8dea83c9a9ddca86b0f991cd4f9098f782f2368c53344a8c,t,21000,284894,,5000042,2018-01-30 13:51:48,8
0x568316144e0e3c88f04ae172af2ab5b6eef60bda676cf1f5eaec563c12c4a4d0,t,21000,305894,,5000042,2018-01-30 13:51:48,9
0xf41c8fd03974a95e6610e66060404fc08979f11e9618b5289db81d5fbae5af70,t,21000,326894,,5000042,2018-01-30 13:51:48,10
0x5f7d533d44cc4b2636b6f91a54f7518a22b9efd4600f9996ccb11d8b7f0d98ba,t,21000,347894,,5000042,2018-01-30 13:51:48,11
0x322f3259fabc8eabc4ea6dc36f1c873a28e1018fe2208f30fca89aeb5a9d4c4b,t,37320,385214,,5000042,2018-01-30 13:51:48,12
0x684bd0e3e62499ec21c1d59f2d3ab3703b5e1bc91b9abcc025d998f8be41b9e1,t,104678,489892,,5000042,2018-01-30 13:51:48,13
0x010671022f66971b317bced254cc01db1441ccc1add3c0978e0d9c99f722da6d,t,53419,543311,,5000042,2018-01-30 13:51:48,14
0x9526a55749b73aafab952207b600bdde242e16bfb53a38af37d0ab7687e7119c,t,49131,592442,,5000042,2018-01-30 13:51:48,15
0x983ee0a5b1971a629d4b7c1218f387f12813b2569371da8b3780d9943bd49c72,t,21000,613442,,5000042,2018-01-30 13:51:48,16
0x0b3212755b016c35e9f82a94723277231f228c63862cd732e0eb97470ad1da26,t,50057,663499,,5000042,2018-01-30 13:51:48,17
0xf820eb4b0207eeae6531da908ba4f51570fa90d03fbaada7607508001567b805,f,34293,697792,,5000042,2018-01-30 13:51:48,18
0xa9329054b5a8ea8ecf77ab3e7c6fa8287e780f1626b1768262c420bc096aaffc,t,21000,718792,,5000042,2018-01-30 13:51:48,19
0x798af2cd0a32b06d626367e0cd6084298f6f47832dfd843cf0e96bb50ffcd060,t,33341,752133,,5000042,2018-01-30 13:51:48,20
0xeaa13de9c1f233b505e9ef8bac259a69ecbd863c03acd257a1d339729bbc6d39,t,21000,773133,,5000042,2018-01-30 13:51:48,21
0x3c48c95897e33c6695af2f56e38dc8779faf19114b8c7262b12d90b7b825c084,t,29493,802626,,5000042,2018-01-30 13:51:48,22
0x16df8f8f3f275895fcb475d0e5beb509b4c5dd1374b1af3506b97f9f2eeff399,t,23355,825981,,5000042,2018-01-30 13:51:48,23
0xb9f652e9becb963552f772c439a5bf8a73ac7c510b60521c34aa6f8f2fc6032c,t,21000,846981,,5000042,2018-01-30 13:51:48,24
0xc838ca5bcf2a9fd989be034ee190505e4ac3560ac6ed1dbe8ebba1df72fef407,f,21594,868575,,5000042,2018-01-30 13:51:48,25
0xae3682b417f5185eff951a851f55b3b4abfbdca5231dd80f906dab8923369bcb,t,21000,889575,,5000042,2018-01-30 13:51:48,26
0x81e4195f524af84aacd84df39a797ae7fcb5e53b74e04ced4fe995a6b33b6f18,t,140972,1030547,,5000042,2018-01-30 13:51:48,27
0x3f605103fb32e721e863a485e5ab177da2dcb3db0aa1e78acdadd15d1e3ed3bd,t,140972,1171519,,5000042,2018-01-30 13:51:48,28
0x5033c821fab94a08a9eb875bb40dfaec63fa76cb41c84ef7320e46e93cb94c43,t,21000,1192519,,5000042,2018-01-30 13:51:48,29
0x617f1f5e92f5d8fdf61eb6a703161725d37524d92338ac39cfacc12b05ccb0db,t,52923,1245442,,5000042,2018-01-30 13:51:48,30
0x0dbab980732a1912e97a9062c4e76056718aba4177f7ff077533ee51a167c293,t,78242,1323684,,5000042,2018-01-30 13:51:48,31
0x10b2c1d1a36904a8abf56f8f3df2c3f6640cbfef5b5c1e856dc3e04cf7b9b971,t,21000,1344684,,5000042,2018-01-30 13:51:48,32
0x228adf5df00e4bedb0078e57daeb20e196655bfdda1bc1d7cb6ca536d58ce84e,t,55907,1400591,,5000042,2018-01-30 13:51:48,33
0x24055f70129a3dd624fed583255b92b623c66cb05d12cda267826b9222ef06a5,t,21000,1421591,,5000042,2018-01-30 13:51:48,34
0x580eb00274375c4e4cb312d0a4074750e51834f1e7b49ba3230422bcf12f1dee,t,21000,1442591,,5000042,2018-01-30 13:51:48,35
0x02ff41f73f27742b94b31f1021b95d264d7dc0b9e6ae5863004db15ddabfed3b,t,52884,1495475,,5000042,2018-01-30 13:51:48,36
0xc872d8f14e2e7a8535c0b803090101b78f941437278a7c82c7af6561cc78640a,t,21000,1516475,,5000042,2018-01-30 13:51:48,37
0x782548764f0b9736d6489e83b97c48626ade5307629b0bc032c791125dd26628,t,49639,1566114,,5000042,2018-01-30 13:51:48,38
0x988717e03714ac7387c5fcea9cd3735079d0abbfbc1a58007f919cc46697099b,t,29493,1595607,,5000042,2018-01-30 13:51:48,39
0xd36be0df69f357c59412f1507af5c401091e2ec5dec6c4cb60434cd41cb511b7,t,140972,1736579,,5000042,2018-01-30 13:51:48,40
0xb49fee6e4eae83643a221729420ab915990850fd022e91f85500dacc89b75de6,t,21000,1757579,,5000042,2018-01-30 13:51:48,41
0xfd32a219ee7cce8da5353fafa871641dafd58d7e14c2e05aeeb4b4039691be72,t,63701,1821280,,5000042,2018-01-30 13:51:48,42
0x53bd0b7bf52e92a23fba558a6ab2253083f59a64dcba957a7a26882b0f919617,t,21000,1842280,,5000042,2018-01-30 13:51:48,43
0x8bfa1296a4ca35d6005436e6fd05715b1cf6ed6f6eb0336c501f7d8bf6003282,t,21000,1863280,,5000042,2018-01-30 13:51:48,44
0xed5eedbd4480fa96c97fc484bc633cee05515309e956b175dfd4c26e8c62388c,t,21000,1884280,,5000042,2018-01-30 13:51:48,45
0x7b813cf61b4a02442fdd7f05b1184cbb80f413cf03b30f451c12c9fb068b545e,t,21000,1905280,,5000042,2018-01-30 13:51:48,46
0x06a8278d6d844511ab292530eb698dd672c09f5c70cf400f523e6448d88b6b32,t,21000,1926280,,5000042,2018-01-30 13:51:48,47
0x159f06665d76ba8c64dc65ca1988a9a44ffff4e855ebaf1570c08ca40f8bf92b,t,51416,1977696,,5000042,2018-01-30 13:51:48,48
0x79719d7417135329f7d40c14a669110b08c68aecefbc54608cb103389f5b765f,t,21000,1998696,,5000042,2018-01-30 13:51:48,49
0xaca51f0fe1c9b5d20716ba9e69c625d81e9be5b8aef48410ad0626a7dc16fe20,t,104678,2103374,,5000042,2018-01-30 13:51:48,50
0xbd8ea72a0051d267f99e123996d7fa65a0350b154b1e97a96db9f3de033e6d79,t,21000,2124374,,5000042,2018-01-30 13:51:48,51
0xd90238d9bfb37fa69241fc789e80a092e06fcb2dd3d59ba3be487c0cc63af807,t,52282,2176656,,5000042,2018-01-30 13:51:48,52
0x7c09292535b083e83f89fc2618e8493ee2cb4c9c2402e33efc6015c26c17ce78,t,21000,2197656,,5000042,2018-01-30 13:51:48,53
0x8a54611d2fa711d23daa58ad8ec80f5a98ec1641a9b92afd6cec2c6b9d7f816d,t,37746,2235402,,5000042,2018-01-30 13:51:48,54
0x01ee3f08c4f5b8304c620d0a0f0f274435a834d44511ec23de1cd498882d26de,t,21000,2256402,,5000042,2018-01-30 13:51:48,55
0xf41d139c2ab0a273eac7f4862044e928e8adfd8faff316aa4ce79b423068d7e8,t,21000,2277402,,5000042,2018-01-30 13:51:48,56
0xae7a3f1c40f8531528b44d823d2eec9da8e3743a134bbc5102b7b01fc8783f93,t,21000,2298402,,5000042,2018-01-30 13:51:48,57
0xdfa86c92b26f71bba51d5cf9f08c6dfee0e960651000a4b393c656761e185db3,t,21000,2319402,,5000042,2018-01-30 13:51:48,58
0xe8b849397e93a4db63b58cbf628eaa7e410aeacef3d4d0f301fbee4228c5e600,t,21000,2340402,,5000042,2018-01-30 13:51:48,59
0x46cb0982b26b7ffb6872e33fd1e4c5a8301248166ba7cb3fa10b8ff7d752a018,t,34725,2375127,,5000042,2018-01-30 13:51:48,60
0x9836e124c8c8db2562f0e006d4afc49591360108a0f0c38b58ed4e0a11b70b4e,t,94190,2469317,,5000042,2018-01-30 13:51:48,61
0x3634524e629595389067efd07784686940b9814eb6a6dd3c808ba5de0f1f2006,t,55907,2525224,,5000042,2018-01-30 13:51:48,62
0xe2eacca42ae7dc5413d4a1b1070777e5f69b4d802cc16ed65de23c0481fbc6b9,t,52222,2577446,,5000042,2018-01-30 13:51:48,63
0x1f2ed0bdcc1d5e5db156d42160ae4fbd1d46287505e6cdd1f628b9a7031557bd,t,37987,2615433,,5000042,2018-01-30 13:51:48,64
0x06771c00687504b87dae7ac0a64a9c76690a47ee4a322f83131edfe5677aa0a2,f,66304,2681737,,5000042,2018-01-30 13:51:48,65
0x3c58884b2adb201f9d10d9790519c167f1fa441b8e50984f035bf15cd20ae270,t,21000,2702737,,5000042,2018-01-30 13:51:48,66
0x1d2be1f726283bd6ac6fce49cfdcbe8141e3b2a921a20133ab29d1a88f255c55,t,29372,2732109,,5000042,2018-01-30 13:51:48,67
0x3722aad813bd468cb064ddd77ed9ef3aa7fff4729730413c7574a3559e642037,t,52900,2785009,,5000042,2018-01-30 13:51:48,68
0xe800ec5fb2aa0c1facf1fd94e07ae01d6027739b6a8ecb2796aab25f56a80ee5,t,21039,2806048,,5000042,2018-01-30 13:51:48,69
0xae495c740b45c812c521eb102d68d495f6c92a329dd00bf6a79b961eed062b76,t,45738,2851786,,5000042,2018-01-30 13:51:48,70
0x69a356ba27d35fe38bae91ea2152c4d33dcd103d3530f003f2641e288e15b5fd,t,22088,2873874,,5000042,2018-01-30 13:51:48,71
0xbe119cf83a2b29281b13ad350d8732a1001c2899caa46fcf23019b55d2836d10,t,25843,2899717,,5000042,2018-01-30 13:51:48,72
0x6820045b7528f7cc9a284f571413edc4cdc3ff613b88c5a496d65db2c4062010,t,21000,2920717,,5000042,2018-01-30 13:51:48,73
0xa0e086a1ddaf138cf0cef33773d556100828d0977228c2d8789d20f6f6498f04,t,22091,2942808,,5000042,2018-01-30 13:51:48,74
0x70bfe3bc5631aacfccc23a831f810cd33dacd1db029ed49775ee56f4968077c5,t,21000,2963808,,5000042,2018-01-30 13:51:48,75
0xc491c0e70b64a98391d6ee4aa5b1c3e8b403aa6fee5dbbf333076f8e60f3e102,t,21000,2984808,,5000042,2018-01-30 13:51:48,76
0xd0365ca246002e39b4978d3c15f2247560c9a4f5a758cdf6fed1d52357b00301,t,21000,3005808,,5000042,2018-01-30 13:51:48,77
0x3eae4bf53a6fda1d77fd173560b68688e02e57c88a47c06bf620ef90dedd968a,t,21000,3026808,,5000042,2018-01-30 13:51:48,78
0xe9ce01c0947b96ad69e36fde96031f113d6a1b6ecd4cb1608983e43215cd9cfa,t,22650,3049458,,5000042,2018-01-30 13:51:48,79
0x4fa390b477a2a76b38b0ce1411f8781cd8ea66138e478a9cbb15d5f10e6a7561,t,39720,3089178,,5000042,2018-01-30 13:51:48,80
0xe4ba8439186d1b0d35281fc4f7b70b35041841db57e18941d52a73c15d4cd33c,t,111441,3200619,,5000042,2018-01-30 13:51:48,81
0x4a142197be6aae62e8df92485ba7974ea21180f82345cac8f5d661693c75c3a8,t,53233,3253852,,5000042,2018-01-30 13:51:48,82
0xdea336b23d923c86fc7ab27baeb7b44a9017657c3c9cc5ddaba4e049f9f06902,t,92538,3346390,,5000042,2018-01-30 13:51:48,83
0x9246fb28f62e8d7a23aabeaf3491811c3c7460998ff0b2c30106bce77c4e3902,t,102934,3449324,,5000042,2018-01-30 13:51:48,84
0x82e5412396e718220f34e00f6010e586248928172c02cdeaf634e1daff9e15d8,t,45868,3495192,,5000042,2018-01-30 13:51:48,85
0x16598e48b3b37f708a8c32c3dfd2cb04285a3e94b5bf711a00496af768ec1dbe,t,21000,3516192,,5000042,2018-01-30 13:51:48,86
0xcd765bc3fc845bad531ab8ffcdf918ec971e863ffe94b980aa6d457805b16ccf,t,21000,3537192,,5000042,2018-01-30 13:51:48,87
0x5d9d6db1ba9924b66690d2bbdaad8332c814a4c93c8b1056c495578f54c60872,t,21000,3558192,,5000042,2018-01-30 13:51:48,88
0xf4900750f906f972de5dd57af884370dfea2f6a2f48a4d6a41bffb5ce7683b48,t,21000,3579192,,5000042,2018-01-30 13:51:48,89
0x21cab6801e642d382afa6ae82dafba41144e534387d8ffb629615532f184f37b,t,21000,3600192,,5000042,2018-01-30 13:51:48,90
0x3028eb21f48e3f4adcfe5f9f4adb01fb77fa55792f0015f52a85e2d6c0e498e3,t,21000,3621192,,5000042,2018-01-30 13:51:48,91
0xb9717382d85f5484ed074127f13048c9e17e245c9062b4cd187214058e0bc51a,t,21000,3642192,,5000042,2018-01-30 13:51:48,92
0xfcad6480992fe397b23884d6b6b7a01568c5a43b00e34ed5691fbf1d9b053bdc,t,21000,3663192,,5000042,2018-01-30 13:51:48,93
0xbe2c994099c62fd99ac0832032fffd4bd198ed19d8929d04a907dffb044d9801,t,21000,3684192,,5000042,2018-01-30 13:51:48,94
0xe0d97e470a0e5e58b22f9ca3142e32bdb48a7e565a4aea70b4d3637de8cb62f3,t,21000,3705192,,5000042,2018-01-30 13:51:48,95
0x6ed124f82ae81d1996fc04978c1c4bd7f4dfb29c4600e925d4811bcc2852c757,t,21000,3726192,,5000042,2018-01-30 13:51:48,96
0x697174da67376aafc4170651fa5e3e9f8bed10bd8d3c73eea05125dcf59790fb,t,21000,3747192,,5000042,2018-01-30 13:51:48,97
0x1c38756dcc51bc7e334af4f574259d4728295e55f368145c144a1ee491be854a,t,21000,3768192,,5000042,2018-01-30 13:51:48,98
0xdb515c1b7b196186a6e0cb8729466911fb42af0e3402fbcfd05d695c24b7554f,t,21000,3789192,,5000042,2018-01-30 13:51:48,99
0x0165b437aaa756963e5f60c1e1421a3d6c4325fd713fb061c09190ea8d0deda1,t,142772,3931964,,5000042,2018-01-30 13:51:48,100
0x6b91d2b708116d9d23bd53e5178ec184a06025fdebdd84cbbc53c8f3c9bc56a6,t,59482,3991446,,5000042,2018-01-30 13:51:48,101
0x30a5ccb72244c7557cbc22087d650025370386726ee119728276d9f7266ddcdb,t,62759,4054205,,5000042,2018-01-30 13:51:48,102
0x3961fd642bfa85f3539b21eb640aba8cbda48b90cd71f36365c4794f71bebe7f,t,76614,4130819,,5000042,2018-01-30 13:51:48,103
0x42f30d854af4d8d78a85071bb7cb061de682975886b37d9d45d12bb9267cddb0,t,37500,4168319,,5000042,2018-01-30 13:51:48,104
0x5befeee228638b0e1ddd277ca5f60028436c8918c505122629bc7ef2b51b50cf,t,52886,4221205,,5000042,2018-01-30 13:51:48,105
0x66fb33607507f664368977356a977b4b5c1de8a1c0540ca3d8a7f546f7b8f11f,t,98809,4320014,,5000042,2018-01-30 13:51:48,106
0xe991b89f62a71aea6221d28723bbd323a74cd59217feba55f2203e1728d5cb46,t,52380,4372394,,5000042,2018-01-30 13:51:48,107
0x7aba1d6aeb613a3837a035f5d9546e6147a410e70ce5526ee9e40713fcd618be,t,52976,4425370,,5000042,2018-01-30 13:51:48,108
0x0fe0012aec6b40602755f784504db0298bd756d10591b1339bcdbff20ee7b1c2,t,37784,4463154,,5000042,2018-01-30 13:51:48,109
0x289da74f0ecb3c620f5605d6fabdb9c8ac4f8655f282ad9c1c3b48db5dd119b5,t,55843,4518997,,5000042,2018-01-30 13:51:48,110
0xeeb2e270c4b662ee000c47ec0167c16071ed090dcd4a4874657274e3d3f5bd40,t,36411,4555408,,5000042,2018-01-30 13:51:48,111
0x83aa40acd5bff0a1619f9e7d411e86f0f8c971143dc141125c6be57187de20bb,t,53040,4608448,,5000042,2018-01-30 13:51:48,112
0xb7176f1a33baea56fe4bd22835de73bbb1117245ea50eb649fc8b7bfe1f66d09,t,37185,4645633,,5000042,2018-01-30 13:51:48,113
0xa97fc4fca16209a358bdc9262b221da9c78c89ebb0b73193b092ffe4487a6181,t,40907,4686540,,5000042,2018-01-30 13:51:48,114
0xe799877725c81c8cd24c91f28470aae55fa8a490c5f1903de0875dc60b38a166,t,52237,4738777,,5000042,2018-01-30 13:51:48,115
0xaf04671859de5c7fcd3cda15394df6044d40671d21568a6d13d7a972717a6f34,t,37187,4775964,,5000042,2018-01-30 13:51:48,116
0xec361b0d218d1aed05f2fe41d7457df5438eee718b695d877380ae341f84b2aa,t,33571,4809535,,5000042,2018-01-30 13:51:48,117
0xf1f660a9cbea1f1aceef57569964204b06ccebf91ef7bbfa2c035a32a7c5d70b,t,33571,4843106,,5000042,2018-01-30 13:51:48,118
0x45f38322763e9a2e93fe7012a35e184acdb82e30eeffda65b179a714e0045d75,t,33571,4876677,,5000042,2018-01-30 13:51:48,119
0x2abc97ac73dcca78492bc727ca4a0f65ac43f25375cae9494c4b643dbfdf72d9,t,33571,4910248,,5000042,2018-01-30 13:51:48,120
0xbd684c01b23d06721387f136cd6d212927592676421f7281115374872afd2207,t,33571,4943819,,5000042,2018-01-30 13:51:48,121
0x2927364507870705a14f4981649768d57a5064f55c1f3def6c919f36c3e2a40d,t,33571,4977390,,5000042,2018-01-30 13:51:48,122
0x38a7c1b1244229bd26c15d8035624c109e396fd5995c18e121428c116397bbe5,t,33571,5010961,,5000042,2018-01-30 13:51:48,123
0x54ee47fd7e8f09aa3476d84f95fe7fdefcfd918494e90db7feb39744a50a97f5,t,33571,5044532,,5000042,2018-01-30 13:51:48,124
0x953725a1ee9f62b0be164fc3bd3967b44fcee47ea4b3c40211919f1ec5781e97,t,33571,5078103,,5000042,2018-01-30 13:51:48,125
0x802e8eed9be87fc2141825f9ba85fb4fbcf69e01741b831273dd0182f042b1ad,t,33571,5111674,,5000042,2018-01-30 13:51:48,126
0x9ce41d6c082cbebcc9f8a112e948e4ea53046844d8c595b1fd4e9a8199ba9383,t,33571,5145245,,5000042,2018-01-30 13:51:48,127
0xf308017dd973bcb287c829a97d50a7f7c7ba0f68d316d32ee83361046628d96b,t,127269,5272514,,5000042,2018-01-30 13:51:48,128
0xab0c2c908b3ab9a046971889fcba28b2fd17e8d623e95924dd27899d7ba24551,t,33571,5306085,,5000042,2018-01-30 13:51:48,129
0x754a0e7d0bfc167f9e845fad8644826a0b787afb47f371d1a3f602b409d93692,t,33571,5339656,,5000042,2018-01-30 13:51:48,130
0x4e65f3d3c78e24116c2b12a4302b51ffad2f886fb177acefebb09365512a855c,f,24808,5364464,,5000042,2018-01-30 13:51:48,131
0xf2504e39d133dfb1dd8cfba6806a762dd15bcb7c2b344180af12ab3513d71dbd,t,37282,5401746,,5000042,2018-01-30 13:51:48,132
0xddf8b8fd89579d88950a186cacca26dd06439c625215c7eab5cd2495e16a05c6,t,40971,5442717,,5000042,2018-01-30 13:51:48,133
0xe4bde979f2016104e09fad4717f09f2a4237c0ac2b5d0e05ddeba761f5c9bacf,t,67549,5510266,,5000042,2018-01-30 13:51:48,134
0xd4c162339e2a2569f903aeb1e78c035782bf94288b4be63304da888542ff9c83,t,36792,5547058,,5000042,2018-01-30 13:51:48,135
0x5a5f3ef4b032ab9451e2fa410fe3e04b3e14d045cc2f99db721cd1ebb54356a2,t,37408,5584466,,5000042,2018-01-30 13:51:48,136
0xc3e6bc59924741bf21224a6500b676fe45ac657fcd0345a35f5bf0ae6d2a1287,t,21000,5605466,,5000042,2018-01-30 13:51:48,137
0x02236d76dfbc9f1b03da9035cf3ad9768bb421dc3b492dbf3f42c4e3fb7b327e,t,21000,5626466,,5000042,2018-01-30 13:51:48,138
0xc849eefcf4e775a25234136faa9d88751878f989ec9886efb072e7d2c1906928,t,106385,5732851,,5000042,2018-01-30 13:51:48,139
0xb9a8dbc3fe932c8041362ad6fa215462f73d5d63ffbfcde31e8e8c483732c5e3,t,21000,5753851,,5000042,2018-01-30 13:51:48,140
0xbd093f24d77eab8121d8dfd2c947bd00d8e6460e3b81c9e4d221775c41183190,t,21000,5774851,,5000042,2018-01-30 13:51:48,141
0x12d59d96b963cffa785ca4f7c346c5c820e24855b53a50f66c6804da83e6ea11,t,36770,5811621,,5000042,2018-01-30 13:51:48,142
0x96ee01abd8dbf772bc8dd383fb5137073ce6119603f60d1eaf3aa685e67c7930,t,21000,5832621,,5000042,2018-01-30 13:51:48,143
0xe6c4cd2fbcd290e725301c9cd19ea5989132ba1076aacd989930ce8b92ea6a57,t,21000,5853621,,5000042,2018-01-30 13:51:48,144
0x7d24f2f1587cacf8b22a2873edd9b6b0c50cc2b121aa2f2638259694224ee015,t,21000,5874621,,5000042,2018-01-30 13:51:48,145
0xfc48b7916076fe2a0b4b30ac9c87b90c35fa5853d8a77d11b50c20243f9f1377,t,21000,5895621,,5000042,2018-01-30 13:51:48,146
0x710f47332246b2467685babe655facc2a221c38e191d81047ea40e4abc63440f,t,58999,5954620,,5000042,2018-01-30 13:51:48,147
0x76da7ab71986b1659d4de92dfb6c1f7f04d0e29e982c7df6ecd41e4d8d83e4af,t,21000,5975620,,5000042,2018-01-30 13:51:48,148
0x6d896da181e2ca2f67d7852de744020b68ee10695014159e9f70b9ee72518977,t,21000,5996620,,5000042,2018-01-30 13:51:48,149
0x6f07f897ccd93f4600cda8062417b49e9f9a41df618e018c5a8dcd805cdee13a,t,21000,6017620,,5000042,2018-01-30 13:51:48,150
0xefa0937f4052c73dd076930600d4e0bc3998fc2e465210f4fb9af433170491e4,t,21000,6038620,,5000042,2018-01-30 13:51:48,151
0x3e3242f23dc22573987bbc0369da6cc4e5c167e7c88ac5d9cfe8259f048367ea,t,21000,6059620,,5000042,2018-01-30 13:51:48,152
0xec8984c2e062e24d9287b5be505d1d71990e011806ee1ba54403d5495e292e3e,t,21000,6080620,,5000042,2018-01-30 13:51:48,153
0x8203c37216eb7a5ea21fda78b08dcc0d5e65faf24bf41db96af75ebdb56c020b,t,53297,6133917,,5000042,2018-01-30 13:51:48,154
0x5d7707da798cdae9675941aaa3e3b8a24432bc8069ed62a9671f145fc9bf0b1e,t,36762,6170679,,5000042,2018-01-30 13:51:48,155
0x051859ad90ca03ad32140bb5086881cd2e9ecc5cd28340d0bba0a4581a6691f2,t,51955,6222634,,5000042,2018-01-30 13:51:48,156
0xd94fd6a77fcb04b19e3bcb4a5ea3d5f8dd4a13464f80e124aeb1b37b9d16f347,t,37524,6260158,,5000042,2018-01-30 13:51:48,157
0xcb9bb300b961b1696aedba763918ade3d7f9c303d84d9ec908aef0f5cf4f3616,t,21000,6281158,,5000042,2018-01-30 13:51:48,158
0x0c4c204b3aee14406876d60882b5d6278adc0a8d30acb07ceba1f1b2fcfc3939,t,21000,6302158,,5000042,2018-01-30 13:51:48,159
0x6bccd1784c8c61938ed1ebbbd7b3812556d25e05c45f44b28b2fda0c987720e6,t,21000,6323158,,5000042,2018-01-30 13:51:48,160
0x30521a951a4ca0518141020222d016cf296ed0bbdeaee6d7dcf0e8f8a3ffc026,t,21000,6344158,,5000042,2018-01-30 13:51:48,161
0xaf99912dc8429c84ec7bda3a977f8ec50075b919177a3f094a514d6f95d2e48b,t,21000,6365158,,5000042,2018-01-30 13:51:48,162
0x83e28aad4a5fd7e9a078a3acda47fa61d6a8ce72104b943869bff438ef5e0b05,t,21000,6386158,,5000042,2018-01-30 13:51:48,163
0x54214752b828264dff66f05730b861613db5077493d874ae583223e80c08e908,t,21000,6407158,,5000042,2018-01-30 13:51:48,164
0xe26cd792832a4907b9dd5d3fb10faa7b4aa10b4d465559eef5956646d1d927b3,t,21000,6428158,,5000042,2018-01-30 13:51:48,165
0x0856b4f45ca2f33322ec457592d50a0215b181c19ce4f1e5552a7177f861e530,t,21000,6449158,,5000042,2018-01-30 13:51:48,166
0xf923023a526285e418963e0756190780d6fb07054290f5cdd8a9271febf76d0f,t,55907,6505065,,5000042,2018-01-30 13:51:48,167
0x122199476a5d346491a952e64962e6dbf214fc3fac7c17b90f73da6357863eb8,t,21000,6526065,,5000042,2018-01-30 13:51:48,168
0xe5e2add3d34e7ebacb4b0f40269a12550be207260395b06d9a92cd5fcd5b57b2,t,21000,6547065,,5000042,2018-01-30 13:51:48,169
0x7678b1805e23a6857f65e9c864a2e20a21cc5308f55e6af2cc0b2c34917e02b4,t,21000,6568065,,5000042,2018-01-30 13:51:48,170
0xdde1f958a916e5bb575122f5a901bf84d4a11473258e7fe4c320277eaaa7315f,t,21000,6589065,,5000042,2018-01-30 13:51:48,171
0x1c96cda15c3f307bbbc84cd01b4da9ddd05652df2968bd20a9843c781465055a,t,52950,6642015,,5000042,2018-01-30 13:51:48,172
0xfa5ee1b400de6f7f854bf0774a66e713d69ccc3e23a84b9aa1a686c0d25f5b14,t,37251,6679266,,5000042,2018-01-30 13:51:48,173
0x1a5cb61a37c5f349737fb5d16aaa2e70226feaa2a456482b9356bb2bd89cbf24,t,21000,6700266,,5000042,2018-01-30 13:51:48,174
0x073a45baa2821ae71fac7b8b39469220b6adba2d9f41c0654038cbfcb4690af7,t,21000,6721266,,5000042,2018-01-30 13:51:48,175
0x49827a496e0a9f37ad7e4c2e2c34f13b48b3f56c2f4c4ebd54ed1c35504885d6,t,21000,6742266,,5000042,2018-01-30 13:51:48,176
0x3c08c27764fa205c46f36a0de98f9c06d24ef6d3028ad92ffdd29d66f53d8f08,t,40979,6783245,,5000042,2018-01-30 13:51:48,177
0xf8c9d0b5cb17418017f524ab9edc427d778476e97a9f5e973742909b157659a7,t,21000,6804245,,5000042,2018-01-30 13:51:48,178
0x3d4fccba4f2884bdd1cb245d1d4fc6ef0f32aa6b69fa26cd59b134b69feb4bb3,t,21000,6825245,,5000042,2018-01-30 13:51:48,179
0xe1f67bdb5c2f876df70e863653e35786b810c473d9e225b1fa60a7de8c527b6a,t,21000,6846245,,5000042,2018-01-30 13:51:48,180
0x964ea6f3d9a647b062f0f58fbc90729722258f98efdd7e14c8cb45e1443ebde7,t,21000,6867245,,5000042,2018-01-30 13:51:48,181
0xa7242c2bd271fcbd2c96989108ef669865ce4b088931bb75a535e1cd72775e4f,t,21669,6888914,,5000042,2018-01-30 13:51:48,182
0xd8ad46e0b677210af082edc408dde57f63c0d616582cf0879baa845f7a9672da,t,21000,6909914,,5000042,2018-01-30 13:51:48,183
0x1406d7c4769fcfeca0b898997c28045e7fd586fc5dd39f3b389ffd9b74243c14,t,127010,7036924,,5000042,2018-01-30 13:51:48,184
0xc1aa2b9cd2ee894960141efa08d009660b1c778b4f7ef9674b6fcbd4faafc067,t,21000,7057924,,5000042,2018-01-30 13:51:48,185
0x4e358032fbe8a71bcc5dd2edc3842caa03d91d3e47af1e975cc3de09832e8169,t,52460,7110384,,5000042,2018-01-30 13:51:48,186
0xa648a5536f294cb1dd11b570c0d2fd0f83e551e8e3c5a10aaf0b02ba72d3dac9,t,21000,7131384,,5000042,2018-01-30 13:51:48,187
0xe932132ed2aed04b6cc335c60f069326f286ec7002904fa54acbb157ad780bb6,t,21000,7152384,,5000042,2018-01-30 13:51:48,188
0x1cdaf516ae8ec7aaac39f02536352a2094ecb037192c49bbdc2bdb2922a50c44,t,21051,7173435,,5000042,2018-01-30 13:51:48,189
0xc886dbb8e644240af1c7b200ab75455a92f3800908570c18dc068c06e4b91a27,t,21000,7194435,,5000042,2018-01-30 13:51:48,190
0x6b79191015fc6d2a31ca5eef9222ec80854b4819287a581b0a46ce5fe22413af,t,21000,7215435,,5000042,2018-01-30 13:51:48,191
0xa3d1c7f7873417ad528ca805cd64c0452de895d7d48fbce0b2670e5a4a4d762b,t,21000,7236435,,5000042,2018-01-30 13:51:48,192
0xd99989a3489552cdab4a4569277cfbce724d0dbb425bf84106d37d91f185c542,t,21000,7257435,,5000042,2018-01-30 13:51:48,193
0xed4f0f9540ad06fd522509a510273e0f8b8fbaca07b2bf296dd56fe4bc85ca95,t,21000,7278435,,5000042,2018-01-30 13:51:48,194
0x85c99fa143b1a4cfbb780c4c3104b1825a8919710ceb795086d6f82412c88927,t,21000,7299435,,5000042,2018-01-30 13:51:48,195
0x91a1de4f9b15ab235417e890e1ea8b85a594a3b5086543635efd8806d646fedb,t,21000,7320435,,5000042,2018-01-30 13:51:48,196
0x3b7bf990e7571563c2c696e0ff1be27ed570d8b88e17ab5d5f5883b437b7fddd,t,21000,7341435,,5000042,2018-01-30 13:51:48,197
0x679b99175dff04c3e91f7bb17d9919c87dbbe37bd838b0fed6ab48d2ab581ef9,t,44098,7385533,,5000042,2018-01-30 13:51:48,198
0x8f99190e461b65f467a4e05e681026bf13631c8dea3f485268232820a1644d68,t,37746,7423279,,5000042,2018-01-30 13:51:48,199
0x6bb0b391ec003833182811faeaf4ec87e0af7d0814c6c75f7583ff0bddd75fa5,t,21000,7444279,,5000042,2018-01-30 13:51:48,200
0x2378bc68eaf84f09e32b67a46b2ce3e3edc358f3efea1796aab6e80793967154,t,52148,7496427,,5000042,2018-01-30 13:51:48,201
0xdcbf02403f668c9ef4d278e049eab789c437420a6a1b47c419e51e9a29ecbe8e,t,21000,7517427,,5000042,2018-01-30 13:51:48,202
0x7b686dafdd2a778fad55c2879d3fb4300be81f596f10a654b1f20071e5af2e68,t,21000,7538427,,5000042,2018-01-30 13:51:48,203
0x852585a8bc84cc1bc46c5d790173dae3787e3545674da76eba786983ac2e830a,f,250000,7788427,,5000042,2018-01-30 13:51:48,204
0x77f8895f24221c7f1b02c36881461c0661b95053767bec864863fb538e619143,t,52169,7840596,,5000042,2018-01-30 13:51:48,205
0xf53bcbb51d62141e1b27f477078e1524745a67262ad809120852eb91861ac6e3,t,21000,7861596,,5000042,2018-01-30 13:51:48,206
0xe73d0322d8e44192aa5393b65113e44f1510548124b84d3f69decb6c4b35d193,t,21000,7882596,,5000042,2018-01-30 13:51:48,207
0xba330c577aad7f96f409826f4a3764027bad222ebdff16869409c9e9d57a2c60,t,21000,7903596,,5000042,2018-01-30 13:51:48,208
0xe054b0640262e3b55e153771abef76f49ae37f8841b83794f882df4ffd0b5442,t,21000,7924596,,5000042,2018-01-30 13:51:48,209
0x9d856a95574a6db3fc3bc454cc1ffccc483b65bdbf08ca37b41971bfcc33656e,t,21000,7945596,,5000042,2018-01-30 13:51:48,210
0xbeea4d13e6a26dd9ddd18ba141a8b2f844c5b56694e1686fa9e841ec218949e4,t,21000,7966596,,5000042,2018-01-30 13:51:48,211
0x346cb2ea55c3bf72fe7b976b3b581eff1d7ade07e28f744b6aa2954a1ba09df5,t,21000,7987596,,5000042,2018-01-30 13:51:48,212
0x6b34025610406f07ed16add06f16ce8b6415e9735a7e0092817e360f80fc7c04,t,21000,21000,,5000043,2018-01-30 13:51:56,0
0xc4e0094ad88eb5a9c57a37b4087889a6283e228ba314f7be00cff91d95268272,t,21000,42000,,5000043,2018-01-30 13:51:56,1
0x5420165129da323514b7e7c7f6189ed73e998ac294fb3c5f2ab4ed5f164605ab,t,21000,63000,,5000043,2018-01-30 13:51:56,2
0x2234568f33c61b961eefec2413ac6ddb1eefbdc81b054ef90e6fb9be96fb1b18,t,21000,84000,,5000043,2018-01-30 13:51:56,3
0x0cba81ef3f44a0e857aff64fbd58b354c302201fdc3c778742e9160006916a79,t,21000,105000,,5000043,2018-01-30 13:51:56,4
0xd8f7842543af5674f59e9d76fb86edfd176ed018febf99aff4f60dcf5aa00ec9,t,52547,157547,,5000043,2018-01-30 13:51:56,5
0x3b795ed1adf8b92aba35cf2adffc8898fae7b8610ecaf3ca213c19495635787e,t,21000,178547,,5000043,2018-01-30 13:51:56,6
0x7eec3d7a24502b36ff322ab64466726465da073edc585785c2c0ebeff537ac16,t,49929,228476,,5000043,2018-01-30 13:51:56,7
0xd289c6fbb6fab539ffe601ac1d490bb4caffddb4519377e9c545595060759fb8,t,21000,249476,,5000043,2018-01-30 13:51:56,8
0x43707ab83d245f3d602166ad259a9b641fd998d32d21c09dc64d487013ba20e7,t,21000,270476,,5000043,2018-01-30 13:51:56,9
0x1ddc0b1de243a5f84e59ced67e8f5773e97e048c0df7316f014487425158b79e,t,21000,291476,,5000043,2018-01-30 13:51:56,10
0xaeb5b7ded2793b9d6e669166f29fb4be8344993321d18a448b124ebf6306a36b,t,21000,312476,,5000043,2018-01-30 13:51:56,11
0x41eb949ed8a9712ac88b48bf016052e1cd46a8681695fdcf0d0c3a8ae8c487e5,t,31257,343733,,5000043,2018-01-30 13:51:56,12
0x0006aff274ba16197838dc1fadcfafb0e30a6a4623cba76c2706d7abe6764157,t,55843,399576,,5000043,2018-01-30 13:51:56,13
0x356af6d8e41c31182c9feb2d8e85949b76521c360b1e62c4d402bf621fe3178c,t,21000,420576,,5000043,2018-01-30 13:51:56,14
0xa3cb4c1363252d4fee5b1870ad355b5ff762ff41ac25b02ecd49975a5d311013,t,21000,441576,,5000043,2018-01-30 13:51:56,15
0xabf2e6e67b303005b6b863afe8c731ab03cf9080504085abde854c6f9d3cae82,t,21000,462576,,5000043,2018-01-30 13:51:56,16
0x2e3026dbe3623a1897a8110ba1432a3ad1f7dfb95f59d3851e3219f30514c107,t,37848,500424,,5000043,2018-01-30 13:51:56,17
0x7cafd744ad987ed60fefed5951eff5f8d20b8c612dbf8890ec788b4270af09bb,f,23300,523724,,5000043,2018-01-30 13:51:56,18
0xbe0ed71a8ab9a97c02630ff13b1e4fca54f8704738814c673c51f9097a4f2a43,t,36697,560421,,5000043,2018-01-30 13:51:56,19
0x4bcf97e46348a34d8c37e3b0ce5fff07e29bfbac2953f052ae01803813ebec0e,t,21000,581421,,5000043,2018-01-30 13:51:56,20
0x9f1e325c86ede3187b4817eea114ff26a4fd376eec39ef678a6e3e5be7587c65,t,21000,602421,,5000043,2018-01-30 13:51:56,21
0x08fbbb6c93b7fa256de34633b05c7ebf8956da1ae5a2ec3a8071876f2cf35e0e,t,21000,623421,,5000043,2018-01-30 13:51:56,22
0xe67b10e7225452a058410e0ff7a6d0fcfcbc03c7532d7004b810160c3f685460,t,21000,644421,,5000043,2018-01-30 13:51:56,23
0x282959c97fa8d1634372712848e2d5d2227ce0851b86cdbd4e625348a7b19c5c,t,21000,665421,,5000043,2018-01-30 13:51:56,24
0x2611c0c4eefda4a8accb9a7fb1477e012b8c3a006eb365f90e1e74d4c2f97eb5,t,53318,718739,,5000043,2018-01-30 13:51:56,25
0xb8bfd6d02f5156a524876561c89a9a3923ed80476fcbd03ab9b63c2600d8d77c,t,94126,812865,,5000043,2018-01-30 13:51:56,26
0xade3385bd0080cdaa7844b2454782d41a5b34793dfe467424c1de8695074538a,t,21000,833865,,5000043,2018-01-30 13:51:56,27
0xa50230461a5ba1639d5d727856ae61b6580ef404081c99b5ff2489fb5e3dea79,t,21000,854865,,5000043,2018-01-30 13:51:56,28
0x6b71a5efc187b26f1720396e2b86df1a3a07e91affe9d355244334dfe27244e2,t,64725,919590,,5000043,2018-01-30 13:51:56,29
0x6494a16ad450c189f6e89f4ff819ed88cec954361c432f13a448ed2b2521d580,t,64725,984315,,5000043,2018-01-30 13:51:56,30
0xd1f9a99682f676c6cf25b313f493b8acd00e9af567504877ef6c0d9cc3b2b813,t,21000,1005315,,5000043,2018-01-30 13:51:56,31
0xe1bdb04319049ed07ef3f2b4771e030e3f5a719be76ac559cbe859dbf578273e,t,21000,1026315,,5000043,2018-01-30 13:51:56,32
0x766c8cc7506bcf98760c7fdd623dc6b0766a0a7c6bac0b7194d266034e4b4732,t,21000,1047315,,5000043,2018-01-30 13:51:56,33
0xb04476ccd9fb07ce74e0f1ad88be5af2b3f27cb9636b2ac643162a8cbae43c08,t,38529,1085844,,5000043,2018-01-30 13:51:56,34
0xf1ab24026cd3c2022a722429f3ca03237a18189c3d6f8957df028af1eb6dd9f5,t,21000,1106844,,5000043,2018-01-30 13:51:56,35
0x1e0223c138f2772a4b89620e42adc0c38dbabb553dcafcf55d04fb0999fa4cb8,t,21000,1127844,,5000043,2018-01-30 13:51:56,36
0x6434b08f110980716361e916a2cf72edb009cf3293f9e50a3ccccc9f065aa7b1,t,45738,1173582,,5000043,2018-01-30 13:51:56,37
0x8e4f311f8c07b0547d9c98b8f0fae36868c06503338bbbeaf43ed430ad27c751,t,21000,1194582,,5000043,2018-01-30 13:51:56,38
0xb6ffc0a1cb34be127d8b75534e76b485cdb06cdd883c0e09236cbee29a4c113d,t,21000,1215582,,5000043,2018-01-30 13:51:56,39
0xf1065a446900458f27a6ca17803e41e01fd77d9eddb32583b59951efbd922843,t,107410,1322992,,5000043,2018-01-30 13:51:56,40
0x4d73d7e6b88cb738c7007d40cd5318358a3b4958776b5126171d44e585f8cc07,t,53233,1376225,,5000043,2018-01-30 13:51:56,41
0xf890b7b4628b4e7386d8a933b83b6bcb6e94a52a0ece5830924a890c5cd083d2,t,34314,1410539,,5000043,2018-01-30 13:51:56,42
0xbcf6ffd6cce3bf6cce93e96e575a888ca117422914800a1bd2fcbf265a9ed4e2,t,37543,1448082,,5000043,2018-01-30 13:51:56,43
0x79e03ff857073ebdc1f75ba515705deb4e8a0a50db48e1c82788b85718f47729,t,21000,1469082,,5000043,2018-01-30 13:51:56,44
0x309308a12444c0dc299428ad127159f47afe5bb76e8d865b96d3e269ae86e98d,t,21000,1490082,,5000043,2018-01-30 13:51:56,45
0x67dd26cf672459123a828d2cef0e0cc0ba3dc9d18a4e429a826993b56019fbe0,t,21000,1511082,,5000043,2018-01-30 13:51:56,46
0xe63eb03d9ee67e86d6ee80dfe39789cdf8be0b54b45fcc710082ece9722404a3,t,21000,1532082,,5000043,2018-01-30 13:51:56,47
0xb6b0faceb29ce7f0e7df48af53cd4a46585ff2f861042788f33d7fa76a16a59b,t,157836,1689918,,5000043,2018-01-30 13:51:56,48
0x69e868e4913c8e51f31fcd7b78e54295bf90f8e7776a3c989d68b4e5d51bd720,t,74244,1764162,,5000043,2018-01-30 13:51:56,49
0xb8dfcffd66e2f73c6e36513700ce33e52d439a1844a03154d82eb0abafa3aea7,t,59418,1823580,,5000043,2018-01-30 13:51:56,50
0xe3da9ed6a18bfcbf7eaa65a389b80b8fd4e2b1fb796edf85d8ae7a8895a61a76,t,52547,1876127,,5000043,2018-01-30 13:51:56,51
0x4fed2666600bea5234e49f902a4e195da043300b6dfe8c3fd730a8f29d56ebd9,t,52822,1928949,,5000043,2018-01-30 13:51:56,52
0xa78821a5a4153e32b611440f31bc3fd58e0eb25d65393445f8a49d715f627127,t,55843,1984792,,5000043,2018-01-30 13:51:56,53
0x8b41f2f6e0853d113faf2b546385a4a2bb3186416adb77bf455884a862a887c7,t,52380,2037172,,5000043,2018-01-30 13:51:56,54
0x0142349259fa9e3f7785263edd0367369140d3a700424a487dfa1c2797ebb21f,t,52109,2089281,,5000043,2018-01-30 13:51:56,55
0x14d017ce047f89f21648e51a77e7d17e55ae771fa474566485a9ea4097230a73,t,52391,2141672,,5000043,2018-01-30 13:51:56,56
0x2e4e92efb84992fade9868db1f26332cea95200acfecedaf174447cffbb70cf8,t,110406,2252078,,5000043,2018-01-30 13:51:56,57
0x78ff9b5da51a4f5be5e943d9e284e80b1ada29e9f2854808c090a464a7692737,t,52316,2304394,,5000043,2018-01-30 13:51:56,58
0xdc7e7d3d0239287e57dbf7cf45e386b2b827061663374d8731f43319efdf306b,t,52237,2356631,,5000043,2018-01-30 13:51:56,59
0x834a1f9125bd5f2672f555c5009b80c13264c1d181a4b12bfdbfc994432e79b8,t,52380,2409011,,5000043,2018-01-30 13:51:56,60
0xe11a7100c616c8918f3304312d978398fbf8b0b009423bc23ed10186bc82167e,t,36792,2445803,,5000043,2018-01-30 13:51:56,61
0x9d826fc770815c104e198b4771f368b230def87924d531ee0ac4dade3d35e784,t,21000,2466803,,5000043,2018-01-30 13:51:56,62
0xd9d323b7331d46f5e70069e9070ce3814cc076aea8338f4e5c54535f2b8b6644,t,37061,2503864,,5000043,2018-01-30 13:51:56,63
0xe03d7e440099ce91f55e6b93e54a4a6d70bcd5d6588a8ebe9a94ec957eb24e83,t,21000,2524864,,5000043,2018-01-30 13:51:56,64
0x6d55c1b4b88a6a23bf3d6da4cc3b16504cf91700ad97504a05da0fba88b1a713,t,21000,2545864,,5000043,2018-01-30 13:51:56,65
0x62d2640d52ee93d6c7f2568b54492e596e0802dd9de48ff90c28efbbe1c0fbcb,t,21000,2566864,,5000043,2018-01-30 13:51:56,66
0xecf0e978c6284d9591da0f73d856ad85483aaf4d7fc4497beb248934a20cef89,t,21000,2587864,,5000043,2018-01-30 13:51:56,67
0x3b0f36100b6e2edb8d510e36c8ed46ea8a565c4a8069f61a3171fb75db6f4623,t,38679,2626543,,5000043,2018-01-30 13:51:56,68
0xdcbcd0c2f49329859d0927b4a6706bc2ae430f18ee1893ed9d3219436c770f53,t,21000,2647543,,5000043,2018-01-30 13:51:56,69
0x98cf15be4c0f0b0532023edc27018b8f4b3401a5212819386b6196ba357d5154,t,92613,2740156,,5000043,2018-01-30 13:51:56,70
0x5b603fc381e992900c9d6181612d3bb3192008beb53b2c1fbfd282c5527729fb,t,21000,2761156,,5000043,2018-01-30 13:51:56,71
0x0102d1b1c81598cbc17bf2ceea259b84274ebae193e55d16d994bae9abef17c1,t,21000,2782156,,5000043,2018-01-30 13:51:56,72
0x06cc7def1ed4792ea9b1907bb72ff1d96b456ae40d29543bbbaaecef65caf573,t,52173,2834329,,5000043,2018-01-30 13:51:56,73
0x0ef2c76465f3653e5a4a29c5dbcf0d97b5a57820b603cfc9c1e94700b3b5c1f4,t,21000,2855329,,5000043,2018-01-30 13:51:56,74
0x43d7f497d956cbb3f0d62ab45bbc9e278596416024626b5259f6f8db4edad44d,t,33050,2888379,,5000043,2018-01-30 13:51:56,75
0x6f0056305f879e800b2978f3e79d80956b6f9e11787c19880daa00bea6cd8c1c,t,23519,2911898,,5000043,2018-01-30 13:51:56,76
0xe74c45d9872ac8c8c9c465a953abd8a40f20f5c45301c34db39dcd71057d1c0f,t,21000,2932898,,5000043,2018-01-30 13:51:56,77
0x50598920d796d18103782b114262e2204210790fed69545f026e515bc16d8fb1,t,108306,3041204,,5000043,2018-01-30 13:51:56,78
0x72b6d02cef83a620a6e01d838d784402311a03da484d76060323ca2dd68ac398,t,51545,3092749,,5000043,2018-01-30 13:51:56,79
0x41b111e33d9f4135e75e154fa3006042e0fb773299ddfdc633327a91b9344abe,t,21000,3113749,,5000043,2018-01-30 13:51:56,80
0xd78c883de74b2bbcf451b36d6ef17176aadd7b82470d9f1eeb3c7f524e0407fb,t,21000,3134749,,5000043,2018-01-30 13:51:56,81
0x96258d2a7a0c5c1319e3f7aaac5cf8d9a8caf02434f886bea40dff395b6e4dd5,t,21000,3155749,,5000043,2018-01-30 13:51:56,82
0xba0340b4f35b0a7d01a25d6afbe45576fec6fe9c115a9129a813635e328dda59,t,92922,3248671,,5000043,2018-01-30 13:51:56,83
0x3adbfaaad4198597ea43b4706001b1ff61975c118505a47f42009c12ed2f6171,t,21000,3269671,,5000043,2018-01-30 13:51:56,84
0x0702c85677f6dc19995e5205da1694ef54efd692511bcdecb66315fb97ec7936,t,37352,3307023,,5000043,2018-01-30 13:51:56,85
0x6e12f7e80a1b1743accf1ec86c10a8e2ca3aaee73106deb9736f0f3b94c277e3,t,51447,3358470,,5000043,2018-01-30 13:51:56,86
0x4359187df238367b8cbbfa458b1a97938045110cd619a74f2a24b2aebcaf9116,t,26645,3385115,,5000043,2018-01-30 13:51:56,87
0x5dd7329c0e79900cb99ddc0f65eeb116075f05ef056c213002d77cb24b660b70,t,37900,3423015,,5000043,2018-01-30 13:51:56,88
0xc80a08318c327d42ba31c499f12503a4985fddc7d96e2495738ee7b873b2db6b,t,21000,3444015,,5000043,2018-01-30 13:51:56,89
0x15c3270020d3d8944dce0a3444456e4f208f59c9007bb0f1c13094261ca215eb,t,37312,3481327,,5000043,2018-01-30 13:51:56,90
0xc3f1ee535d6feab90d560fff0c05836fe508de0f159ff7bccb0a3b87f03a943e,f,250000,3731327,,5000043,2018-01-30 13:51:56,91
0xbfa9c6545e52b6f51f5a1594fd3485ab68d25fb0c5da600fa6324cad6c4a8363,t,48274,3779601,,5000043,2018-01-30 13:51:56,92
0xcb492ee56e405b1b86a1bbedb51f926b1d2dc9a8a358eb3329a818f95aa3109a,t,23318,3802919,,5000043,2018-01-30 13:51:56,93
0x242857a372b00a357daa79cb169d28c2dadaef0766a7e810a1f712b863eb234c,t,23167,3826086,,5000043,2018-01-30 13:51:56,94
0x3c97af0905031723dad267a7086214d1c3b46b5bfb91d4caae3efc96323974c4,t,22460,3848546,,5000043,2018-01-30 13:51:56,95
0xf7c679b800c74c4b59c8b6d914bead7a3f50c9630ee3371126c612dd0208d7be,t,22466,3871012,,5000043,2018-01-30 13:51:56,96
0x383a611ae08deaff0cf04643cdd6e983c3ee6d1c0bdb28e8ee78daa5f204ba5c,t,22173,3893185,,5000043,2018-01-30 13:51:56,97
0xb11c7da30252182d6fbfbfcf4f08621c4868c5aee1708ad7f708780392c0bc1b,t,23519,3916704,,5000043,2018-01-30 13:51:56,98
0x4b508feb78a736db9fbf6f3f27d29c29d62bf7a79cb827f77b22dda8d9c7b1c9,t,37964,3954668,,5000043,2018-01-30 13:51:56,99
0xe17cedd46b7bebb5288d53d82db297a24d6e0f1f0913280aed368a438294363b,t,21000,3975668,,5000043,2018-01-30 13:51:56,100
0xde063edda8579b42ac997932decfb25ffdb79c243413ad70d6213e7959f89a70,t,29493,4005161,,5000043,2018-01-30 13:51:56,101
0x55b63a66ed98c16fcdeb970665866283c17b5e1ca559a7c24c5aa766eaa0e0fa,t,52518,4057679,,5000043,2018-01-30 13:51:56,102
0x787a9c7b7c0d009b7f144b9e7d2968ca34d34b6b3620e1fdfc619b56a9bc2955,t,38028,4095707,,5000043,2018-01-30 13:51:56,103
0x89686ff9fda0c1bc8bc225b4fd75bc9d40a2ba1aa6a885e91069d2e830498d66,t,104123,4199830,,5000043,2018-01-30 13:51:56,104
0x7f5fb47a9fd5af9c005c3b8f2afb163d25776cbaee5cfd9ec5e3467cb7478c9e,t,21000,4220830,,5000043,2018-01-30 13:51:56,105
0x3fe6bd00790902a26209f5cc651523ef2367adb5f9757065b4d101e475c5e855,t,97817,4318647,,5000043,2018-01-30 13:51:56,106
0xafc48b8ee33acbc51324505b560904a58a9f00f20d02aceb855718c7188a5827,t,108178,4426825,,5000043,2018-01-30 13:51:56,107
0xb65b3299cdcfc88a9d4cab8372dd38ef532a9e73d0f0232bdbbdefaa80d57c1a,t,78050,4504875,,5000043,2018-01-30 13:51:56,108
0x1043486b9f11d7eb94fa059c4ece82bc87597caeeacdb7bbfa0f5e40b62d0893,t,26543,4531418,,5000043,2018-01-30 13:51:56,109
0xce846e84227ee98c043123c5a55fc46ddd028dfd2d312303a206605cd622db8f,t,150292,4681710,,5000043,2018-01-30 13:51:56,110
0xc495ec9bd11a35f9248035afb38381ba27872316728ae99ee9c71b46768d97cc,t,93178,4774888,,5000043,2018-01-30 13:51:56,111
0x19a92e1afdd746327a9e004ac6e2735d30ecf4f964e06c4784989a4084624ce7,t,174591,4949479,,5000043,2018-01-30 13:51:56,112
0x9f680eeda795b49bb0becdbe9a07dadded0c5a2d4facb458d1200e75a7d6de53,t,44162,4993641,,5000043,2018-01-30 13:51:56,113
0x1306c819a0823e5ce826add28fcd13f274a26919002e6e19e9ff1188d6e13974,f,250000,5243641,,5000043,2018-01-30 13:51:56,114
0xa2edbaf2ee8f424df2c725b8673545aca0f56fb7eedc70d23eee38bc68c35250,t,59418,5303059,,5000043,2018-01-30 13:51:56,115
0xc8cd48e569ae7cfb0c1cd6c18d72d36773d526fa25fad81c00f95a5d762ed578,t,44493,5347552,,5000043,2018-01-30 13:51:56,116
0x37c9166be4645e35ec6d7b0684f34a2b7de808475923e6675e990dca841cc984,t,44493,5392045,,5000043,2018-01-30 13:51:56,117
0x97aa4559a99051a35ff9354da920e73b78378738afe0c7ac492fa579f6ea3eba,t,21000,5413045,,5000043,2018-01-30 13:51:56,118
0xaa48ed6b94af257527e25f4bafb852f338161da1974575821c0b8ed54467f188,t,59354,5472399,,5000043,2018-01-30 13:51:56,119
0xa3f686d98d5d13aef282a172d1b815d92d53cbc6f984d3ed11d9c07b5ae8dca7,t,45981,5518380,,5000043,2018-01-30 13:51:56,120
0x4f916ca4a43cee1aec44dbdcde086c93159ebbc095126a241959eced1949e8b4,t,21000,5539380,,5000043,2018-01-30 13:51:56,121
0xdd9870634c983076a3652e7963286d549f25a7b44e8a7582409a6bb13df54a1b,t,59162,5598542,,5000043,2018-01-30 13:51:56,122
0x677d51f2a81604fc87cbac07c20fd2106d3d1bd44835fd5c25178ca86f98683c,t,59354,5657896,,5000043,2018-01-30 13:51:56,123
0x203e84d1285aada041ed864c4668552283e5ca9407f6ec9dc5a941a61af73dd6,t,84005,5741901,,5000043,2018-01-30 13:51:56,124
0x22809eb0d45545b2098771577076c5b8f76242ee9770b65d1c18e88a813cab97,t,59290,5801191,,5000043,2018-01-30 13:51:56,125
0x499a68d133f54465816785c8a7a0f5782566eb08bc0632eec48e304659327ef2,t,29493,5830684,,5000043,2018-01-30 13:51:56,126
0x682e2b021c5c1d981ff5a299fb6cd11b4e0d9324ffa16e41030dfa619d8dc7b4,t,51560,5882244,,5000043,2018-01-30 13:51:56,127
0x367d34a8d1a44918cd9f29019468bdcc54a8c17267e468184d35eb70e720f8d3,t,76971,5959215,,5000043,2018-01-30 13:51:56,128
0x74b3c32de308f51c321b9e43c8d379a520228ca15bf25eb9df8d847467b5d6e6,t,78242,6037457,,5000043,2018-01-30 13:51:56,129
0x39303ac7df4d5c6a12ce2867277cec56be820dc9216be85347fe8f4b8bfd1714,t,437623,6475080,,5000043,2018-01-30 13:51:56,130
0x2f129376ab234d132bee272fe09175a0d2c2b3c04e404ffc352ddeb1bf3dd04a,t,92538,6567618,,5000043,2018-01-30 13:51:56,131
0x746a15c8f399f10f589ff715512f807f789939c6cf3d925ea1772b2622f22a53,t,44354,6611972,,5000043,2018-01-30 13:51:56,132
0xc0de1ee51aadcdf2b027ec27a0bd449c4716a848996ab968e4613b74f598e89a,t,93050,6705022,,5000043,2018-01-30 13:51:56,133
0x297d0af9e12d9aceb670b5c92a8706730e820507de601b9e3dc5c4b0ca277922,t,59354,6764376,,5000043,2018-01-30 13:51:56,134
0x56274e19a30306f38d6ec77594ffcd566c3532b118712aa424b8159e2ac6bd9a,t,21000,6785376,,5000043,2018-01-30 13:51:56,135
0x8a2398ba3ba1c46878e57f0d685a0dda8ade3749de90589eadfffd3da87d410a,t,37285,6822661,,5000043,2018-01-30 13:51:56,136
0xeb0d8ee05594d18566b5cb9631150db55f110bcb1af3b57d6927055094cd214e,t,84005,6906666,,5000043,2018-01-30 13:51:56,137
0xf8db02a330edcef4fe9fc04f1b970dc9a21507cf5c02f76ecc04097724375609,t,45508,6952174,,5000043,2018-01-30 13:51:56,138
0x7493f251ec9ee5b36b69e3d9968007cad1b51ac7411a18f722c3df126eb43246,t,46018,6998192,,5000043,2018-01-30 13:51:56,139
0x1ed18ff8834955ae091a0066b10c5ba41433a261856907951f8825e878a9a5d3,t,21000,7019192,,5000043,2018-01-30 13:51:56,140
0xe72e9fd2ca9db2aa7ebb65631ad016e770cf4c2b5879ce09c34e933692f3845d,f,250000,7269192,,5000043,2018-01-30 13:51:56,141
0x5c3c573722aa31667881a42ff8297ccc6dc11bd276b5a73d55b340bdeed4387e,t,53158,7322350,,5000043,2018-01-30 13:51:56,142
0x26303b220ff2bc13177c0b18ec7fddaa780e1084374bd8cb2b9296be3fd1aeb4,t,122666,7445016,,5000043,2018-01-30 13:51:56,143
0x5e550d0a2f7cd9ea87534f5fe6b30ea84fb8c26bad5070cae40b221866917ff7,t,21000,7466016,,5000043,2018-01-30 13:51:56,144
0x40fc0b78e4399e82c553bbbdd5a6727b54ee22505f0edde88769ba16c679d19d,t,93050,7559066,,5000043,2018-01-30 13:51:56,145
0xff988a15499a26a3f9c54fa26d1054fdf04d803a651250e974f08078419a1544,t,78242,7637308,,5000043,2018-01-30 13:51:56,146
0xa1d857f639749a9c6b3ed78a4b3f2addbf3ee514cfe8ef778e9f42a9354f7260,t,23028,7660336,,5000043,2018-01-30 13:51:56,147
0x72dab04a41693f9eb374f02a688c079087d5f6368c05e40b2dcafeb4528e5387,t,108178,7768514,,5000043,2018-01-30 13:51:56,148
0x80583e8385f123ddf67024a22cfd29ecc80da83789a9a0ce544a8b6277e5a024,t,84005,7852519,,5000043,2018-01-30 13:51:56,149
0xb897f23949c82824cd87df804e6e7f9ef38456a679126c1c7b1a990d5826e737,t,21000,7873519,,5000043,2018-01-30 13:51:56,150
0x95ef9ac5a8d7c665429e251efebd2992fc0e20c6d4a2e65bba04931474603096,t,21000,7894519,,5000043,2018-01-30 13:51:56,151
0xecbcb7c1d1e1bed4dfad513d1c1c1d8b2da27a7610c9fdf1a227d2d2ae92090e,t,21000,7915519,,5000043,2018-01-30 13:51:56,152
0x2a1f294c9af021014c6327c52b03ec3bdbfba3d85ee30fd7b52db61b87820a0c,t,21000,7936519,,5000043,2018-01-30 13:51:56,153
0x6a0b3e59013c0a268bca5e4e09476c026f82c454373b4698d753f1e6d610c536,t,21000,7957519,,5000043,2018-01-30 13:51:56,154
0xb835765c5cd30326cbc52a045b3f89b67df18e5b828fa9e9eeed855ed19a1a03,t,21000,7978519,,5000043,2018-01-30 13:51:56,155
0x9f4a5a1cfce6645265e5f26a6e72d2d78f6c18c1c0f1593db6efa1e836e8c7c6,t,21000,21000,,5000044,2018-01-30 13:53:06,0
0x29f6340f677635bfd5847c2a5e8c80f02d0f800544d61bc33b5598c51b6bb2cf,t,51647,72647,,5000044,2018-01-30 13:53:06,1
0x75cac058a073c25b2f6fb271c9b42e48b980f44c1d07aff83e78146e32a7e8e6,t,37155,109802,,5000044,2018-01-30 13:53:06,2
0x78f93dcce7a869e6502c0262092d93e1871bba0b91c38cf24fe5365a2c4d4e8a,t,36542,146344,,5000044,2018-01-30 13:53:06,3
0x54ecbcd80f4c6d3fd52a2bf55cc7fc1044d857f29d940e4bbf58262ee05e679a,t,21000,167344,,5000044,2018-01-30 13:53:06,4
0x4e16e7bb22ca1ddea4762db297586cec528eb69c8ab6be860e91bf9a66aa2f3d,t,21000,188344,,5000044,2018-01-30 13:53:06,5
0x9d57c751edf67cb25a63c1b428cae711c1d0738fb154aa77551729d3c8d19958,t,21000,209344,,5000044,2018-01-30 13:53:06,6
0x30c4c968123118eb9cd15db56e106c238795b55c777b1d970483978a5969b56c,t,21000,230344,,5000044,2018-01-30 13:53:06,7
0xbd21c134e788023b3df1cdca7a4a24d57a9c53edee024c49450f8c88331a61de,t,4679460,4909804,,5000044,2018-01-30 13:53:06,8
0xa34be852a1e245ce66345d39ba7cdcedef0163a3cf89f51dcd85d041370ab801,t,21000,4930804,,5000044,2018-01-30 13:53:06,9
0x7ff3dec9df03afdbaa03cc8a24d720a3522f9c98a99c2ea46c042b0709c47655,t,21000,4951804,,5000044,2018-01-30 13:53:06,10
0x3ac7b3d0c1c06fa03e22eb3a41480be2334d33545ccdc3cdba5518a9ac064bd7,t,21000,4972804,,5000044,2018-01-30 13:53:06,11
0x9eeef61ef893e4aac939fc3fc26f93eabc952800ab6b94ca3bbab5b0c347c2c9,t,143081,5115885,,5000044,2018-01-30 13:53:06,12
0x70b974c6947373cc16d2cd24595bd6af3289ddaa58372e15d79d6e7e45f011b2,t,21000,5136885,,5000044,2018-01-30 13:53:06,13
0xa13ef9a72830c51071124b4f9447e9fb5cca53ba7f7c4f65ce1887843dfe09fb,t,21000,5157885,,5000044,2018-01-30 13:53:06,14
0x4bc556c15e2c11ba603b26a8115a57d790c349cf82bad388b120706ccfd0bda2,t,21000,5178885,,5000044,2018-01-30 13:53:06,15
0x2c31db5b7473c06d956f19c394cbfcbad3cd684b14ae247970297c27a8c800e1,t,54835,5233720,,5000044,2018-01-30 13:53:06,16
0x25a94936a8117cece4ce6ecb77039d6657ca706ffc8684af8e243cca63da0546,t,21000,5254720,,5000044,2018-01-30 13:53:06,17
0x1f301946c3faecd49550a0519216266bd167e9089b8683cdef0cbd78af7e00d1,t,21000,5275720,,5000044,2018-01-30 13:53:06,18
0xfc5ee08cc966527d9214921dfafe4fc2f2fe91e159262be1a2479e951d971536,t,52155,5327875,,5000044,2018-01-30 13:53:06,19
0xf94a6bc1c9922d2a0277f75b2e1348dac884a93f98adf311f7db75274a1cff69,t,21000,5348875,,5000044,2018-01-30 13:53:06,20
0xdbce1adcfb70f29ef376aa34f2205ddb31ba165d8cfba89ad29ad40def0ae967,t,21000,5369875,,5000044,2018-01-30 13:53:06,21
0xdd582cc37a65f6ac22443b044a58795b7fcfa49e6e7c94d1aff040b000828e8d,t,182105,5551980,,5000044,2018-01-30 13:53:06,22
0x1fd592c4a324870d86f65286bfcdeef2f43a7be20cc8d13df43b2247d284bbb6,t,21000,5572980,,5000044,2018-01-30 13:53:06,23
0xc5f354a7bf27c4771f79d6fb4df5cb9b67e51c7105d26c11d24b8844ff1f033d,t,49993,5622973,,5000044,2018-01-30 13:53:06,24
0x4daf79228188eca61b3e924b86e47c8cf5b5252c18796cd42ce022c8ef532a66,t,40733,5663706,,5000044,2018-01-30 13:53:06,25
0xc86b961e9d260fffde83834f02b223c83ebe77575aa11b5065e56ed98b998109,t,21000,5684706,,5000044,2018-01-30 13:53:06,26
0xac32484101f0533b2700e4fca790e9994123eea344f3c50486401c16fb2d16e6,t,34725,5719431,,5000044,2018-01-30 13:53:06,27
0x41faf7eec9b21387b5db6647e13bd5d0bcb32c0c67674198516ee107a45468d0,t,21000,5740431,,5000044,2018-01-30 13:53:06,28
0x239f4cd43bf6691390da588e4d7c233a0bd416f2e5b6cf56c9bef6fc370db511,t,39784,5780215,,5000044,2018-01-30 13:53:06,29
0xf17df4c4bef19988ca05ed63abb6673fe329cd4dd7cfcc1abc93bc2b6f2bf91f,t,21000,5801215,,5000044,2018-01-30 13:53:06,30
0x8a10eea3896fcc3b52a414f0bee098f8f32632dd4cce3dde5bc47cfafa8d7acc,t,21000,5822215,,5000044,2018-01-30 13:53:06,31
0x470c4c60217b6d684ebeb79e5e51738aa375fc05f92025515ac8890d9f8be6ea,t,108114,5930329,,5000044,2018-01-30 13:53:06,32
0x82d3cec6e450e0308fa09d744c3fc4a01062672e3ecf8c6b355edfc00fe904c9,t,104678,6035007,,5000044,2018-01-30 13:53:06,33
0x524f1aaa827aa417a21840282ab31da271bd3c0912221071f1414e9bcd3a51c0,f,25000,6060007,,5000044,2018-01-30 13:53:06,34
0x97e4a97d3ae67ed5f23851f9b824de41ee510f4ba1fd618026b1433a47ac1491,t,21000,6081007,,5000044,2018-01-30 13:53:06,35
0xcd0fc14412ed7357ec2d9851a8bcc61a3eaf4fe40846e94b0bcd60a0b0eeac89,t,21000,6102007,,5000044,2018-01-30 13:53:06,36
0xeb180652129db293098a58f488d4ab36a723972fd97b2905813212e325306ba8,t,21000,6123007,,5000044,2018-01-30 13:53:06,37
0x3e75583fdbda0949ea8efb747df48eae3aea9666f2a9a6318f1062bd4b77d486,f,24608,6147615,,5000044,2018-01-30 13:53:06,38
0x1fc06bbe3d0f5f003a5eab9f01b71a9e88c117620bcfa018a0f7daa711faee88,t,140972,6288587,,5000044,2018-01-30 13:53:06,39
0xb62000b2d5623444dc90bc447b376edd25fcf1f09ef46003566f4b132f9912d8,t,140972,6429559,,5000044,2018-01-30 13:53:06,40
0xef53a2f1b2fed6220e182b17f42f8c5a5b25610e2085bc105d76d510e3108091,f,300000,6729559,,5000044,2018-01-30 13:53:06,41
0x2f77d03c4a69068b9b18d069f44f92080e907b4d7aef0c3f54e4d0883aca2078,t,21000,6750559,,5000044,2018-01-30 13:53:06,42
0x796801572411fce916ba3a4498bcc644f16dceba61807112647eefbc05f5a276,t,21000,6771559,,5000044,2018-01-30 13:53:06,43
0x353958a55ca42d32ca083fe2cb3bc922fa5d60c9d5c628e86e499828dc99019c,t,21000,6792559,,5000044,2018-01-30 13:53:06,44
0x3e3b763629452927851cce96a450a912ff52d1629157259104fae3eee4e1b19e,t,55779,6848338,,5000044,2018-01-30 13:53:06,45
0x351f45a2429c02c4309f12279211861b1a48da5bf4620ac03719059160670783,t,21000,6869338,,5000044,2018-01-30 13:53:06,46
0xf3abee3b601902f732ab5c794826a9d3e4caae6855ebc5785e2054164aa82019,t,52524,6921862,,5000044,2018-01-30 13:53:06,47
0xa7f785de7852834c62a22ee143b5af138d7dbe7db2fe2540ca48d32b8d3562e7,t,21000,6942862,,5000044,2018-01-30 13:53:06,48
0x96ce1b19df6ad7620d3f4d8eb9f9dc44d8ae6dedb1acca1330f47704bca93a9a,t,40843,6983705,,5000044,2018-01-30 13:53:06,49
0xaa2deb106cb9b6a2fbd94042fa3d43692ee46eeb9c065b48f927c2562a6a31cd,t,21000,7004705,,5000044,2018-01-30 13:53:06,50
0x666a38ecd7ff06f7e040df089d3991dd235296ad86302e8aeaf3e05dfc7f5af2,t,21000,7025705,,5000044,2018-01-30 13:53:06,51
0xd3adb8a7280dd291eff4e466e570729fd3f81f56d333c1a50be1bc1643e12ebe,t,21000,7046705,,5000044,2018-01-30 13:53:06,52
0x6359ee46140a1050dd087061fcc763461943377b4f9e6463b54ba49f00a0083f,t,21000,7067705,,5000044,2018-01-30 13:53:06,53
0x2cf9a09af92ebbe899cb7fe2ec2aa6a780a1cc96db0eedc86baee883dd09f2bf,t,21000,7088705,,5000044,2018-01-30 13:53:06,54
0xc639141e0ae26d23bdeffabe98b96e2f15a3d9c7d8ebcf803b43d2204eebe577,t,21000,7109705,,5000044,2018-01-30 13:53:06,55
0xdafba1a21abb7b76e4825dc5a33d4564ee0d3427efd257fc917800042ea47a1d,t,21000,7130705,,5000044,2018-01-30 13:53:06,56
0x9b62b815a1e6eef8daab005fa2a9c59ad592dd3ec60abd4855e8288f635728c9,t,21000,7151705,,5000044,2018-01-30 13:53:06,57
0x29b98190ad4ea38ecede9a34d7c29a1d3fcf41e3f359b3624adafc4497402cf2,t,21000,7172705,,5000044,2018-01-30 13:53:06,58
0x231c70602b32e6186fe31120b93096809740092015369bd7d4e0007e856c97c6,t,21000,7193705,,5000044,2018-01-30 13:53:06,59
0xb76daa8172d3d9bb7f96cc90c7d041348bee6c2105e0ccbd11f65f96a8a1cc16,t,52027,7245732,,5000044,2018-01-30 13:53:06,60
0xf9f53618c87ab1f1fabb2e515b8961d67b8ef471912fe10e3c4aabb659a6f465,t,21000,7266732,,5000044,2018-01-30 13:53:06,61
0x0059331407a02a304895903f055b94d31d5b3da4077051de150321c3e2cd30bd,t,21000,7287732,,5000044,2018-01-30 13:53:06,62
0xdddf24cddd0ad718dd03499383198e72f17a59ae66a7d4d52da1dd0dd348c647,t,21000,7308732,,5000044,2018-01-30 13:53:06,63
0xbda60966bfe87d70c53694c8c1781de54bf85eb271e25bd2d32bad63ab196932,t,21000,7329732,,5000044,2018-01-30 13:53:06,64
0xa2b5ddc06029e53e7a033a83158db18db26c8f54b324adb433660b2b6e5cad7c,t,21000,7350732,,5000044,2018-01-30 13:53:06,65
0xb84a77c422e16276e93239e0018dbb14aa57cc51761e231d0cba6c61ec59549d,t,22379,7373111,,5000044,2018-01-30 13:53:06,66
0x322b0ee7e7e1b3abb916978b41a3796dde6d950620328a828dadf0e5efe25bf3,t,21000,7394111,,5000044,2018-01-30 13:53:06,67
0x6727cc84313f66f12c3c9106f8202cdf3dcf260a8de2b5c3e638d36e7b21f0eb,t,21000,7415111,,5000044,2018-01-30 13:53:06,68
0xc276bf2cd8206b74b0a7d4259bcc3d5c4f8c63a4dc6e85747be0b9b104aa6045,t,21000,7436111,,5000044,2018-01-30 13:53:06,69
0x7ca24585329ece1a386d5a4efff2deed4f07133736b0d3e2a7df7b1ae6a1a7bf,t,21000,7457111,,5000044,2018-01-30 13:53:06,70
0x54b7208027d0ecf55b8dcf3b3594e0ad138123a4f74297bae3172f1619035693,t,21000,7478111,,5000044,2018-01-30 13:53:06,71
0xad1e26f9ae81b763d56dcda5a5161c8e4c4f6fbf95eeddf9e947654f2677906f,t,37571,7515682,,5000044,2018-01-30 13:53:06,72
0x0cf1f2c4fa2250c83bc08db66a958971b04b63036125367747f6ff6753541716,t,44162,7559844,,5000044,2018-01-30 13:53:06,73
0x77a0d1129db79bdbb42c52233ada2225bdab5c619c438a3dab7d2344d0522122,t,21000,7580844,,5000044,2018-01-30 13:53:06,74
0x9c387e2408356ef56036e7b3391b242a8403a6cc3768003b98d90b248ce63703,t,21000,7601844,,5000044,2018-01-30 13:53:06,75
0xde543bda4ffef7604b3c7569a551c336a97d12e76769359c0eeb78ad0fe235d2,t,52267,7654111,,5000044,2018-01-30 13:53:06,76
0x70f07722971e1fc64c85598998e73bf78349f9469389223695c3491a6ece3a30,t,215038,7869149,,5000044,2018-01-30 13:53:06,77
0x1e6a61fe238c73c84d533430a1fca496d5926cccfbf53de74769fed9d972e4a9,t,38679,7907828,,5000044,2018-01-30 13:53:06,78
0xf32085a68526f8eb01b57c326987bc6a4a1ee39982e750adcbe57cd0fe43d121,f,23064,7930892,,5000044,2018-01-30 13:53:06,79
0xd17561b610300df5d1a40ce02c5ca005700033e83cf644ad3c8827d21c453735,t,21000,7951892,,5000044,2018-01-30 13:53:06,80
0xc6682f5f5b7da4a093729b5a499795500dcee25c512e99a177decbef0f3f216c,t,21000,7972892,,5000044,2018-01-30 13:53:06,81
0x20e476a257a47475b95fc8f438a0cd4c1711b998a4982ce1d35b75a5449ea6ee,t,21000,21000,,5000045,2018-01-30 13:53:32,0
0x294c83ea65cfd933261df92e8c181d4f6d7b08e8adf48e23ad303b8335b3dd6c,t,21000,42000,,5000045,2018-01-30 13:53:32,1
0xd4bcba043603900c48c272342299932d6eaecc5ab95c8552809ffb841a0a556e,t,21000,63000,,5000045,2018-01-30 13:53:32,2
0x58380cae65a459c23b449b8a6071f58d0e22bbbce36d99bd29a9165d5ad181a3,t,21000,84000,,5000045,2018-01-30 13:53:32,3
0x9f00b342db4164dcf73cedfb68bb1be43ae4c483632e6a62351d129b886f89dc,t,39512,123512,,5000045,2018-01-30 13:53:32,4
0x8e03e07d03e498ddd57841a875157b4f54e20066546d8ad99d918520ca80168a,t,21000,144512,,5000045,2018-01-30 13:53:32,5
0x67dcec417279ff18b75c028c72a96978bd86c62ac43401e09a2f37128d975585,t,21000,165512,,5000045,2018-01-30 13:53:32,6
0x09333960b12f023239667ffc89824c2210012c35eb3df09592c76ed450b186c8,t,31005,196517,,5000045,2018-01-30 13:53:32,7
0x70db71eed92cc2ca695d557d6ca643287be2f13f9901f20b38e74cb28f3c08c6,t,21000,217517,,5000045,2018-01-30 13:53:32,8
0x8a92bea4470de7c7244f16193559cbe7fb253b91eafaa1257047fd3595289be5,t,21000,238517,,5000045,2018-01-30 13:53:32,9
0x0d236751c9d4ab0f7b9caf93a6ae251c3a10bf6d7c026468298d4e857aa97944,t,21000,259517,,5000045,2018-01-30 13:53:32,10
0xff9b273c7aa0fc1278c4a0ff1b28102d53f3bf8e1a9df5899168b1a303582402,t,21000,280517,,5000045,2018-01-30 13:53:32,11
0xe3c11f7914342d68eee7f044c39b07024525bfe29fcf89e7c38c7b3a9d71460b,t,21000,301517,,5000045,2018-01-30 13:53:32,12
0xd0f948a2e5a7bbb8909ee8cfd75f9d65c38997013b5358715632349739428c83,t,21000,322517,,5000045,2018-01-30 13:53:32,13
0x7e12f5dc8eb3f927fa2decdae9d36bc9867519329f8c9257164a3f06697a5816,t,21000,343517,,5000045,2018-01-30 13:53:32,14
0xe7291f346594abfba108c9d21f8e71d651bd30fe07c4ebaf9342c2d9a92c4068,t,21000,364517,,5000045,2018-01-30 13:53:32,15
0x69bdef044eb5fd730afac6f0b652edc9cbb706ddf981b94224f8018132ea416b,t,21000,385517,,5000045,2018-01-30 13:53:32,16
0xb7ac7e94ca5aab656b7c775d013bc1f5a7265a6a2e123ff489cf393c6324a6c1,t,21000,406517,,5000045,2018-01-30 13:53:32,17
0xe30c3f26095704f1dfd7637936174724828db47fe07b295fc64ac4860dde76ca,t,21000,427517,,5000045,2018-01-30 13:53:32,18
0x2a08e993a19d4e94a39595bf53b8e3c30a8f55e0941ee6cfc262a0a8933aa52e,t,21000,448517,,5000045,2018-01-30 13:53:32,19
0x0763f02a4b1639a0f1433fd150d2c3377ed57a3a6f6f4f8303cf1bfef84680d9,t,21000,469517,,5000045,2018-01-30 13:53:32,20
0x1aec98e24c938e137e53b300358ac5a532f2b6c3afff3084539fe0280cac08f1,t,21000,490517,,5000045,2018-01-30 13:53:32,21
0x8cdbeb58a3eaaaa5a4dd0291393c4f798c9910ed44eb4b7f97366dae13da9da9,t,21000,511517,,5000045,2018-01-30 13:53:32,22
0x861f0de01f851ad92a8f597845a265f9fca10cafaa905c40d46204eb87226125,t,21000,532517,,5000045,2018-01-30 13:53:32,23
0xc165daad3fabb50322efef1b3c1ef522bf67720d6f379aaf4079bb7cf9f2c921,t,21000,553517,,5000045,2018-01-30 13:53:32,24
0xbcd784fed6ca0a59112a78d47521877fa82dddf92011d7fc171752a39542695f,t,39512,593029,,5000045,2018-01-30 13:53:32,25
0x589a9d020353ae8d930f790e5acaecb81967e807db232ebf42f72fb25c7d8a3b,t,21000,614029,,5000045,2018-01-30 13:53:32,26
0x3486b7923c875f7d45b309c5170f0f20f7eb05ee6e557bab077b200fb9381d6f,t,39512,653541,,5000045,2018-01-30 13:53:32,27
0xdc4a06e34077e1da4ce9c5357602b1128606bf1e70e0af7feb49d36cf75ff466,t,21000,674541,,5000045,2018-01-30 13:53:32,28
0x5bfbcb1725843b8656f8e5badba44cc4313a34f63bdc32fae00a3a420119e93c,t,21000,695541,,5000045,2018-01-30 13:53:32,29
0x8325ca16d2a607fa7ef6299f1ee227702d11df3ec8f81d22c3237d100a923ea6,t,21000,716541,,5000045,2018-01-30 13:53:32,30
0xa08d92a0e5048302f23b8fd08016e3f87d99e4dd90c31b223474844c7bd30585,t,21000,737541,,5000045,2018-01-30 13:53:32,31
0x2367449b67629f864a112989def3bce7611149ce78893d22b750c1b26239a563,t,21000,758541,,5000045,2018-01-30 13:53:32,32
0xc5168c858d50a6e836e99cc091fe98ed11d9089cc887a6b1a8031683d4a23197,t,21000,779541,,5000045,2018-01-30 13:53:32,33
0xa56d72dac7af43510d3d1debe4b44f2a2fe7a02a3335fd9a17f8406f57fcb69b,t,21000,800541,,5000045,2018-01-30 13:53:32,34
0x2355fcec982a9246868121cd8c955de4c1252a00ad952cd735e413282546df7b,t,39512,840053,,5000045,2018-01-30 13:53:32,35
0xd080a9ceb9256b60f7a051c2c2c905c96f0dc192169bd116617a4080e222d38c,t,21000,861053,,5000045,2018-01-30 13:53:32,36
0x5620e0688e9963b2612797c88f4894b375e3033b74d3336b0751ea222c76db7a,t,21000,882053,,5000045,2018-01-30 13:53:32,37
0xbc1e411d706e4c600f5538d1bf57a94bf4cd65fcbefaeb7e0cdb9700a53b5406,t,21000,903053,,5000045,2018-01-30 13:53:32,38
0x5a0e28303c4956034f946a42364c0b05fb4d2db338658a15ead1a88334376bc2,t,21000,924053,,5000045,2018-01-30 13:53:32,39
0x1a91ba3e45437c06ebdc4b20f405751795808087e296ce76b00dc8f4378440d1,t,21000,945053,,5000045,2018-01-30 13:53:32,40
0x3c0e6811d9065e59b8ed522632cb3356174ddf70675d86d9fe7463db0b5250c2,t,21000,966053,,5000045,2018-01-30 13:53:32,41
0x712fa1644cec50a0f1d5d5c0cb04fd2b5ffc9e0f032c4251ab448befeb477bb7,t,21000,987053,,5000045,2018-01-30 13:53:32,42
0x3814d572682d8195c81d360ccf30d428f8b884ab6ccb2cc037a0480fc9610a58,t,21000,1008053,,5000045,2018-01-30 13:53:32,43
0x9bee381e62fad3d29eea02941c568a9b51fb8565a377400801379f073b686169,t,21000,1029053,,5000045,2018-01-30 13:53:32,44
0x9b244038873e857ed0aaf39e6add3e92a7818eadd50163bb51a7efd8f9c3c411,t,21000,1050053,,5000045,2018-01-30 13:53:32,45
0xc94c99993709958f700d023daf098c93653905f527764b18c5391a4abf9e4134,t,21000,1071053,,5000045,2018-01-30 13:53:32,46
0xafda42d3184c24e85c2395503dc5c92cb1e2244266dd32518b4170a9939a1f88,t,21000,1092053,,5000045,2018-01-30 13:53:32,47
0x5d6a4ea840b5e6a7979e19268978954cbe81ab5f46a104c50825e4682c0d6d5a,t,21000,1113053,,5000045,2018-01-30 13:53:32,48
0x4c5da21bf59cf99622a6cd15332723a4d9e4974dc9718d2f801509e59e3ca1ca,t,21000,1134053,,5000045,2018-01-30 13:53:32,49
0x00aa5d199c9cc137a9242488a9df21ebe768a8a6a90c8b8281d3c2a53d881919,t,21000,1155053,,5000045,2018-01-30 13:53:32,50
0xfaa4ccf4138943e7533bac5a8758ca4c76f4eed300a127c5cc0cca2d6661b0ff,t,21000,1176053,,5000045,2018-01-30 13:53:32,51
0x0bfe361806ab95b3958241654ab1e2d811b4e7e7b954c5bab03bdad05dea0ea7,t,21000,1197053,,5000045,2018-01-30 13:53:32,52
0x5fb3213aad72ffa5f401ff4c231e0cdb7a1be640968bc68164039ada2f88a6fe,t,21000,1218053,,5000045,2018-01-30 13:53:32,53
0xdab92b6c076079a96dfbb94aad77b463b2e804929e2c40f398258f3b8ddd0c44,t,21000,1239053,,5000045,2018-01-30 13:53:32,54
0x72d7338557346a88bd53f53ade2fab35e87d2f757216d6ef41ba0bda0060510e,t,21000,1260053,,5000045,2018-01-30 13:53:32,55
0x48964592c1458bb5a041d154fd2bdb221f8ba568fbb8d00b6081442925544778,t,143081,1403134,,5000045,2018-01-30 13:53:32,56
0x2d6e1656de5238bb75faff84f98a9f3897aa329c2af70f466fea0306c0671e77,t,21000,1424134,,5000045,2018-01-30 13:53:32,57
0xcd1ea01316fafe3085e2afdfe04b7b9fc41db389181780a92cbb86e217ee24c4,t,21000,1445134,,5000045,2018-01-30 13:53:32,58
0xe2df0addfeb88d0c2a70b8ff047da7b0a504b606b366e5312dfae324b264363d,t,33705,1478839,,5000045,2018-01-30 13:53:32,59
0xab0453c2925a3e3bb7a92a1ba1bbaf46d2b63e321a82dc6aba33f0ce01e00063,t,52678,1531517,,5000045,2018-01-30 13:53:32,60
0xb590c932eb0e14f124ef202f55024352735d81299c92c9823fe780c4cb9bbbc7,t,37155,1568672,,5000045,2018-01-30 13:53:32,61
0xdc1d913035a8c8d45022e48e15c927384f00258851f236b442fdbefb68a3e94f,t,21000,1589672,,5000045,2018-01-30 13:53:32,62
0x4c5697aa23a2970daef216c20ab1a7b073d813ef16f81f2293c2af0bb4540e01,t,51406,1641078,,5000045,2018-01-30 13:53:32,63
0xca0335121c6e2087a97a769150ff8211beceda05bed788bc0addf1620eee5065,t,21000,1662078,,5000045,2018-01-30 13:53:32,64
0x20f1527262d0e07544a523ccc0779a50e333d3984c3612b88db32fecdcab8a7e,t,50057,1712135,,5000045,2018-01-30 13:53:32,65
0x6eb74ca7eee296342d2957f20021e506436306daf0e02ffcd1b8a6f874c4db82,t,52155,1764290,,5000045,2018-01-30 13:53:32,66
0x2139e015e7b9ccbf510c0f24ee9b2c7fe888bd7b26672c33c9caf45dd23ced9c,t,214910,1979200,,5000045,2018-01-30 13:53:32,67
0x2e535010208ec9209a6638dca0f1437af05b7fb895e1869e31a5cf2edbe9991b,t,21000,2000200,,5000045,2018-01-30 13:53:32,68
0x8b98fbe26e9c19c98176a0f5f97abf29a28352524530451433906b3f95644823,t,21000,2021200,,5000045,2018-01-30 13:53:32,69
0xe1127ffb14af30f12cec161d39fa841a266d8a08086dccd12c1fc2607e67c53e,t,21000,2042200,,5000045,2018-01-30 13:53:32,70
0x8ce147a925dc870acaf28d178ba7b438b52ca41d6593c78c62444ee76b717ea5,t,21000,2063200,,5000045,2018-01-30 13:53:32,71
0xe304c56545ec63206b9f32ba03aec5da7581958bc0a83d72ecc85d84f2690496,t,21000,2084200,,5000045,2018-01-30 13:53:32,72
0x437ee18d91081389a3b66f474dccd8787276b5ac9b66ebad6068ed860f609a9e,t,93306,2177506,,5000045,2018-01-30 13:53:32,73
0x66616a5ac6784042e688c3e906ac2bde9ebe5bd4ec7c75735666b3c2fdb26e71,t,21000,2198506,,5000045,2018-01-30 13:53:32,74
0xf2a5045a7cd3baaa592db9d7a6a99a43ebfeb2a58d0793968f76de32d9321d6a,t,59305,2257811,,5000045,2018-01-30 13:53:32,75
0xaa364e743c0d55b33ebf999a2ec4d3bb451c1acc15f315babcc468a7fa635529,t,21000,2278811,,5000045,2018-01-30 13:53:32,76
0x2e1ae3911a52dc8a620a758d13bda704416785e0bb27124d7a3edc05c8187152,t,21000,2299811,,5000045,2018-01-30 13:53:32,77
0xceb80a250836503fdd3cf93402cfb7c1877e125ffb81079e1819d79f77e75ccf,t,21080,2320891,,5000045,2018-01-30 13:53:32,78
0x9c0e416bd72116ff1fe2c2d5eff432cbf0b4661fe4d4eb253f968101db12510f,t,39538,2360429,,5000045,2018-01-30 13:53:32,79
0xf9aa7531e1b3f7a6ca1a44c8fe9098fdfc809b4ae63f5a27dc1c0ff1ffaaea6d,t,21000,2381429,,5000045,2018-01-30 13:53:32,80
0x0e23a0ea90259406284d8f350559b3943d95b287b405ff0bf36d10cc0eee3d89,t,52158,2433587,,5000045,2018-01-30 13:53:32,81
0x12087cdedef0fd60bea47958278626595ee7ce6be0863074f4bba5b87a869645,t,21000,2454587,,5000045,2018-01-30 13:53:32,82
0x77d49e3660e9d3b9a63082534f5038b9f984e8d71edecd362e5099a57c95f269,t,30416,2485003,,5000045,2018-01-30 13:53:32,83
0x5d175c6dcaee6672c4d4bb16b0e84ac464559b5a3ec5ddf7f4f89b4056ca892b,t,30416,2515419,,5000045,2018-01-30 13:53:32,84
0x7b892c2013617456e579e08c10627418914462c6dacb0fd8e019c3156d3d3b4b,t,30416,2545835,,5000045,2018-01-30 13:53:32,85
0xd879ae1bc5501300e78d9253cf76355cf751ea85386b8df78e7f8451ba8a972f,t,30416,2576251,,5000045,2018-01-30 13:53:32,86
0x51c43dea4c27efc3175997db74b5d563687ce11f46674f5efb138415bc9855d7,t,30416,2606667,,5000045,2018-01-30 13:53:32,87
0x5beb71deeeab58260ec75bfa7f3ec88cf5dd29397412ec3ef0689b6aa6c9a628,t,30416,2637083,,5000045,2018-01-30 13:53:32,88
0x928bbb836323ed3b7f825a9d84a9a082d6fd538d5b208b9de02fbab95a9bc61c,t,30416,2667499,,5000045,2018-01-30 13:53:32,89
0xef9e472a5d498564d800ba8aba70bd07f6bd340a116eb68de68182f45208dadb,t,30416,2697915,,5000045,2018-01-30 13:53:32,90
0x9dc3a4418159abcbae92e032238ba8586347f7fb8ad4c2a5a72ef6326f0dd4bc,t,30416,2728331,,5000045,2018-01-30 13:53:32,91
0x7d5e593668670e7df5b42a98c3ff82602f55c695d51a7787982be78e2440b6e3,t,30416,2758747,,5000045,2018-01-30 13:53:32,92
0x482f4c636fb7a0e05448ba8b06e11d5afafd4e06587ea34abb4460df6a352824,t,30416,2789163,,5000045,2018-01-30 13:53:32,93
0x7e0ea8421b675c7c223a82d7f0546ccf77583334ad70f0b12d3f80bf59d34119,t,30416,2819579,,5000045,2018-01-30 13:53:32,94
0xefd65879649b8a99caf5f96a5aa68d2573e738e15d70dda46a9045878cefd018,t,30416,2849995,,5000045,2018-01-30 13:53:32,95
0xcaa908597d22100192b99c2da474857acf80dc0e06d3b1b3fa20621954d4d68b,t,51736,2901731,,5000045,2018-01-30 13:53:32,96
0x5e0824c5f09acc9cf1b50da64651b4628029739a2eff35d4dda270d0144d3ec6,t,21000,2922731,,5000045,2018-01-30 13:53:32,97
0x25d217aa5ea222c57e9f7b1311fc2fc42a3687355c3f21ba36a7b191718c7ec5,t,21000,2943731,,5000045,2018-01-30 13:53:32,98
0x93266b5b8fc7faeec3c50057a37c28629a457e85681d60a2eeae87f1a8340dcb,t,21000,2964731,,5000045,2018-01-30 13:53:32,99
0x69c4240af65db4a4997208d17ca95bf93535bb5e178828e167baa2670f080578,t,21000,2985731,,5000045,2018-01-30 13:53:32,100
0x060f2482c77fe4d0738d03e95c78e70c2664cee886073ad963987734372af5b6,t,21000,3006731,,5000045,2018-01-30 13:53:32,101
0x6162866c2c542bf7354835248ccb49daf8cdbd3c23feeb5c0e3b7f2b83726dd3,t,37707,3044438,,5000045,2018-01-30 13:53:32,102
0x4bb0b92873418816c612434baf112361726bcfa728b2d7e1d84400ca4f99f7cc,t,21000,3065438,,5000045,2018-01-30 13:53:32,103
0x72a71fa64b4205c0da70b281787a35fd47b0d93e738934cb054a32e494c116b2,t,21000,3086438,,5000045,2018-01-30 13:53:32,104
0x14d83eff3e2efefdb7cb85f3c322291f3a3d880790f1a48a1ba4416aa6c6d295,t,21000,3107438,,5000045,2018-01-30 13:53:32,105
0xbd694543105d143bd1ddb02846af0f43cdba9e909ffc82745330ec66860a8550,t,45611,3153049,,5000045,2018-01-30 13:53:32,106
0x819d3c814870a3960409385ca61bb3f126c8da61cfb773458b46f2d81ed3784a,t,51406,3204455,,5000045,2018-01-30 13:53:32,107
0xaa138169a8dc4c240ed52032299b3cd4baa8533232e38003c99a585c04be1604,t,28724,3233179,,5000045,2018-01-30 13:53:32,108
0xc98e5d9f520db119ead27b07f25080328c1118643a6935aa3c6a19842e6600f9,t,21000,3254179,,5000045,2018-01-30 13:53:32,109
0x9b73358bf25e965dc4ec58570fe9ebed8a2c36d5cfdee3ecbca3821a06d0d079,t,21000,3275179,,5000045,2018-01-30 13:53:32,110
0x769e09af6a38948170d32547f467589f630e34d75b10ea2548221011a83fbffd,t,53254,3328433,,5000045,2018-01-30 13:53:32,111
0x667e3fd70dd95813f49fedd7310881e51a7059921a0a92cfb13b6fcdca5501fe,t,21000,3349433,,5000045,2018-01-30 13:53:32,112
0x56075d49465cc35d332f6390b5127889a8a7d1f6cd1c3d188772089242be49bf,f,21000,3370433,,5000045,2018-01-30 13:53:32,113
0xf636ed737cc617ea2c44cfca3059f3128fb0d4d24f6f856dec5e8ba7bc85876b,t,21000,3391433,,5000045,2018-01-30 13:53:32,114
0xf0ba96e51007035276e3c1556a965af2811a6de91bca253beab52b2ebcba5f6a,t,21000,3412433,,5000045,2018-01-30 13:53:32,115
0x983facf2d495e32c235126d04dad7aef3c854787b2ac17e1d97cd51731262ac8,t,21000,3433433,,5000045,2018-01-30 13:53:32,116
0x109c0e51e50c734242f8549c1e078665b8d6b4cb3dac790374e3f6cf5e780943,f,24019,3457452,,5000045,2018-01-30 13:53:32,117
0x7c5df742165ad0b53eec57e78ece8165fd17fcd13fbdc505be5a1d99df71afff,t,21000,3478452,,5000045,2018-01-30 13:53:32,118
0x7c41df03cad3ba597e8f08fd6854afc050b15ee7411034fe879706af0f01f9eb,t,102934,3581386,,5000045,2018-01-30 13:53:32,119
0xb53bcce12154cb074c457ad2ac8d89e8414807e259be3f4121324c685d2bc17f,t,37948,3619334,,5000045,2018-01-30 13:53:32,120
0xef95fff27419781dcf38b900d72e27533b4b84fe504da71b03277920dda057a8,t,21000,3640334,,5000045,2018-01-30 13:53:32,121
0x279b2f790f674ccf5f257ccdb4fb1c2d6fd261ce1b29cc3c5cb2c8114cc6a52a,t,57787,3698121,,5000045,2018-01-30 13:53:32,122
0x0fe10b763ec57b7ced66ae18ce90d6949b2906ec405abb500e196b96cfe27d6a,t,21000,3719121,,5000045,2018-01-30 13:53:32,123
0x27bf69a47ada5458c3ee90a16134eeab7a69614edf705271dd42cb8c779b486e,t,64725,3783846,,5000045,2018-01-30 13:53:32,124
0xb9f51eae2718063840395d6e06c0073351ea1b1c40708b260fb613898db2209f,t,21000,3804846,,5000045,2018-01-30 13:53:32,125
0x1a127d07b28230b5613d5bc866641a08ff67d3032dfc551d58105c552133465b,t,64725,3869571,,5000045,2018-01-30 13:53:32,126
0x1590387287978a632166e74ec5059d06c570c2e5e5899d7b0b8ec95e222fd02d,t,25779,3895350,,5000045,2018-01-30 13:53:32,127
0xaa1833c0060846f4df546e100551aea7c5c80ecce4176beec6e09ff4cddf93e9,t,64725,3960075,,5000045,2018-01-30 13:53:32,128
0x40489ba55aac349ef61aa330212776ae0efc0e6f1a74ee087ea3b4346f1069d5,t,21000,3981075,,5000045,2018-01-30 13:53:32,129
0xbeec881eb958f67e51313cc124834bf58dfdb9347427936021cc9baa7108d310,t,21000,4002075,,5000045,2018-01-30 13:53:32,130
0x91bdee2857cf7d3384f14df8f57cb5d96ff648b3e47120662b1d560be403328a,t,21000,4023075,,5000045,2018-01-30 13:53:32,131
0xe10e70b4c95c059348733a3ab8d07c4be56501676e808ce3541558823546fd16,t,21000,4044075,,5000045,2018-01-30 13:53:32,132
0x43d737740013e3bff949754eed464cf0a803ca75daeefcbf12de3ab064b94018,t,21000,4065075,,5000045,2018-01-30 13:53:32,133
0x384e2b4e7b3cde37f9c85ef9673cd934f413aee4cc9b5887b95c2636d10f60fe,t,21000,4086075,,5000045,2018-01-30 13:53:32,134
0x85d10c548db1a3d5b72479cb412ca08b80417acd0573e290cc74a992fce7d66c,t,21000,4107075,,5000045,2018-01-30 13:53:32,135
0x435af7d75b6892b63743109443b23479942397242c18705a7c26bb22a0283911,t,21000,4128075,,5000045,2018-01-30 13:53:32,136
0xdb306106413047c27f49b0dfc8d3275341b69134805b41acb7a7b4ad7dbd575c,t,21000,4149075,,5000045,2018-01-30 13:53:32,137
0x6517cf6870963c05ee154fddfa78d0bc808e881dbbab720753d183b6fc387467,t,21544,4170619,,5000045,2018-01-30 13:53:32,138
0xc5c58bcbedcbb2f63e639acbb442641819d9c6dca85a72fb30fd9981f3fdde76,t,21000,4191619,,5000045,2018-01-30 13:53:32,139
0xa50b7f0a6d82ca98d8c8c0dc01c191f4528051022ab9fefa870cec71ea4a80ba,t,21000,4212619,,5000045,2018-01-30 13:53:32,140
0x217cb0f2d17b01bae78301a1c767e22eb3d9ce0e04e25a0e35a0f1399848e231,t,21000,4233619,,5000045,2018-01-30 13:53:32,141
0xeb9625d926d24788ca7342715df1d709430c4968098795401ad0047e5c291987,t,31005,4264624,,5000045,2018-01-30 13:53:32,142
0xa77d84fd49090c3e59e3761f9e20744a1ce0d965819e08e8447347d093025d1f,t,21000,4285624,,5000045,2018-01-30 13:53:32,143
0xd93b16ab3216f8a8363355e81a7f8ae915806ef23712690f88e9116ab16f867c,t,21000,4306624,,5000045,2018-01-30 13:53:32,144
0x7e399f9a4bbbd8ed3f4890ee435a51cb87d1face05cdbdde81a254bc2f8ea91f,t,21752,4328376,,5000045,2018-01-30 13:53:32,145
0x2258a5bf566baa5d9a8931294a66fb4f38bd1547ed6c2b18f49d33635010c0c9,f,30000,4358376,,5000045,2018-01-30 13:53:32,146
0x837d0ae857b91d73172e7ee96bba6d17dacf9cf62734d718edc16c963478f034,t,52705,4411081,,5000045,2018-01-30 13:53:32,147
0xd18a4a20d793fac0bb89d1a7c61a74a8d8d27df3de9db6891e385177fd74fb08,t,21000,4432081,,5000045,2018-01-30 13:53:32,148
0x080ba5759bd338a3c6105e4ad94d81cc94dba975d1ebfab1079352fb1476a8b1,t,21000,4453081,,5000045,2018-01-30 13:53:32,149
0x964b98029589b7f0c42377b916146b2213a0674b9107dc5366bc1d21877155a7,t,37948,4491029,,5000045,2018-01-30 13:53:32,150
0xbda338362f9d1b0acbd7eb5fb6d8274169c5fbf4d91847c2fed963a0118f74fa,t,152105,4643134,,5000045,2018-01-30 13:53:32,151
0xdc319c9536bb7731f7d9e3b85c3f8f2aea0f0455fd2d9203b15f184acf168a25,t,36772,4679906,,5000045,2018-01-30 13:53:32,152
0x945079492bc073e9b1df2e0212bfc026a12e726aa2d828f45d25bcce9cf800fe,t,46574,4726480,,5000045,2018-01-30 13:53:32,153
0xeff8db26126bd5ad254ed879f5dc15506480396884c9ead0caa34ca1ff057f66,t,21000,4747480,,5000045,2018-01-30 13:53:32,154
0x18581edd3eb50e1ba63b8974d22dc6e96788efa45253216b34e9d1d25b553669,t,242521,4990001,,5000045,2018-01-30 13:53:32,155
0xef14930c2321ed4daf45618e4fdc460ff4130f9c0987e88ae76ad793f784e158,t,21000,5011001,,5000045,2018-01-30 13:53:32,156
0xb470f73e02aa06f4e3236b75103415f4c21ef5fc5f3a74704730d3e539534223,t,52170,5063171,,5000045,2018-01-30 13:53:32,157
0x50fbe5f9326bb9a3b05083f1ae8b882ef5eb6a581227bc735e44f9bfaa858c96,t,21000,5084171,,5000045,2018-01-30 13:53:32,158
0x9d631b8cf190ccf21de87e7fde9eb9b1ee02906ee35eccd04e1318b2c94505cf,t,29436,5113607,,5000045,2018-01-30 13:53:32,159
0x348e2639f3ea42a7669c6902f705205f4c41d782269017b671c22fcf136b1c50,t,21004,5134611,,5000045,2018-01-30 13:53:32,160
0x9ac4dde407f214b3de45f57fa54488817b303e8c327a7a22dc1dc19317d55840,t,21000,5155611,,5000045,2018-01-30 13:53:32,161
0xfc08b374be8658bffbe66e36abd450ec10130bde85ebd65ee44dbda948e92311,t,63240,5218851,,5000045,2018-01-30 13:53:32,162
0x5d59bc2dc510e5db5136583debb5a933f3997f34556a4274efff05583c82d70b,t,21000,5239851,,5000045,2018-01-30 13:53:32,163
0xc1badeae68d5b83a67f4c6b1a5fb81f3da24d19700ac63c85823b1e6907fc737,t,22218,5262069,,5000045,2018-01-30 13:53:32,164
0x6e59253651f7ddd0546098cb2af3b8257f26cd0d61e4e6c852a50a1114835139,t,21004,5283073,,5000045,2018-01-30 13:53:32,165
0x49f4fe3832120e6a75eb7f17d6934ca2fb36fa20ab24790cd3c75082c63a9737,t,93242,5376315,,5000045,2018-01-30 13:53:32,166
0x4142b1c6bbc768313e0af3a82e064260093e83060deffd8290fab729a0389555,t,21000,5397315,,5000045,2018-01-30 13:53:32,167
0xf981a5928af3da62134c95050e208ca805eff3465e0b4a1845365d94817ade06,t,21000,5418315,,5000045,2018-01-30 13:53:32,168
0xd0de76783b4c734f13e87342440ea8523c2bae3410fc59dd2434cf9ab15ec220,t,22091,5440406,,5000045,2018-01-30 13:53:32,169
0x78de093804f0540d66df7658d5046fb286da4c05389614c06170f8eb955a761b,t,21000,5461406,,5000045,2018-01-30 13:53:32,170
0x69084d85f394f09d1852a3470ac63110351336f60aa1d515b1efece233fcd938,t,23401,5484807,,5000045,2018-01-30 13:53:32,171
0x26219668b6d747800cb010f39e2ad03001adfc83a46355eb87c65790d16489f0,t,29886,5514693,,5000045,2018-01-30 13:53:32,172
0x96b2cb82787904de8e3e3ab89837eaca4221aee8a5ce1af4a6e7494a7808cad1,t,21000,5535693,,5000045,2018-01-30 13:53:32,173
0xbe39d2254d216bfaa5293ea45082451fd0b004ff99acda5dfa82c2f811c407d4,t,31005,5566698,,5000045,2018-01-30 13:53:32,174
0xc9a6d83a201ab68f8df1aad83d11700551524d8799e6e760165ab44fa96d0693,t,21004,5587702,,5000045,2018-01-30 13:53:32,175
0x2af42d589cef015a4227966cab7b5d5d63ed36a5e7caf268664d0d2266831e69,t,50994,5638696,,5000045,2018-01-30 13:53:32,176
0x1bcdf46415276d1cb53e0b90ae484d389c4ef32a723beaeefbc6c9c3617660aa,t,21000,5659696,,5000045,2018-01-30 13:53:32,177
0xa60d5a7dd1a63cdf7b3f357aae624f0b0ff80a1ee7268b473c17a7fd94f41580,t,21004,5680700,,5000045,2018-01-30 13:53:32,178
0x3dc9f9291ecadcad47bd9c7fd3e7d6d79fde6316d165334e4e89de6a8be9f519,t,21004,5701704,,5000045,2018-01-30 13:53:32,179
0x01c9c253edfe0604383614a4b141a4379cbac396505fd9386dfbd518cf0f6142,t,22094,5723798,,5000045,2018-01-30 13:53:32,180
0x58bccfe6b9427f1e294d94d51394ff5e3c91ab56ad2b6712c4124aa028b6644c,t,37810,5761608,,5000045,2018-01-30 13:53:32,181
0x04ea488e2ec7bdb300e6df018db418bcf1626ee5a7d43ec38e20c62aad55a246,t,21000,5782608,,5000045,2018-01-30 13:53:32,182
0xc7b81945d3a34b84078d6cc7c4f3ff83831da68bec368ed1531e596a6c52aad0,t,21000,5803608,,5000045,2018-01-30 13:53:32,183
0xbcfa99791995060c4550ee8a2a72b3993e1804f3dce77a133d69af1b94491fdb,t,21000,5824608,,5000045,2018-01-30 13:53:32,184
0x5f509f9464cf07b30553c6c4494db78262421a9883c5242d7733490c74554f34,t,45509,5870117,,5000045,2018-01-30 13:53:32,185
0xee9ca4c52e11cf0fb0185205869a61b97fed69f7473a4737f29df6016f60fee8,t,78798,5948915,,5000045,2018-01-30 13:53:32,186
0x10fbc7e8b9fcb66ac6a23c02e7a9b452a8d31541a6ce7718fbd20a06b9003194,t,37148,5986063,,5000045,2018-01-30 13:53:32,187
0x1dacb483d26da5f64aaf621ae1d2ab849dff7212a92461e1a3a23047ff845dd9,t,92730,6078793,,5000045,2018-01-30 13:53:32,188
0x08ee3647716402f94e002820ba07edfa0722e99bd4f6ebc9c3c6d37aebe73709,t,53233,6132026,,5000045,2018-01-30 13:53:32,189
0x31debe710c13eec56142cceac95f1acc8498317b0c3e48408b8fe79f9632a11a,t,21000,6153026,,5000045,2018-01-30 13:53:32,190
0x4bab24e7b7363fb0dd6c04199ed329aa4487db37b33c919ec89c9a77493905fb,t,86688,6239714,,5000045,2018-01-30 13:53:32,191
0xa0a9f3082b851a34dbb23a63c652304d1bb27d842e709b13a2ee5edb2cd5dc78,t,102934,6342648,,5000045,2018-01-30 13:53:32,192
0xd593dca4e4bec05030159be8bc6210b77a379b7b83c57f644d0a5fa81892dca2,t,102934,6445582,,5000045,2018-01-30 13:53:32,193
0xed9540d1cb0ed14725805c9a7c142add8e013347f383024631d3be36933a2d9c,t,38068,6483650,,5000045,2018-01-30 13:53:32,194
0x7f093706af55e6622b20c013f6ba7218e6542e47f52d339f6c58d7a420f43adc,t,21000,6504650,,5000045,2018-01-30 13:53:32,195
0x4f77276b3dc411b5b3678c372b97b378985a58db5b898c41b160a518e5b1872f,t,21000,6525650,,5000045,2018-01-30 13:53:32,196
0x8bfe0a19edcca309de782f857f1c152b02ffef5376103ed7894eb54c147b31d7,t,21000,6546650,,5000045,2018-01-30 13:53:32,197
0x3377e5fd48859cb959e9d1288570a394f8a67659d836fb21da478c53fdc0f52f,t,21000,6567650,,5000045,2018-01-30 13:53:32,198
0xab65804941f7a58b3a5066517d0816083734715d99cc328aaa62801d1354eef6,t,21000,6588650,,5000045,2018-01-30 13:53:32,199
0x243df5b3078444c4b9f9d9fbe35bfa22ad02e101b61d1a9b154078077ef26ae8,t,21000,6609650,,5000045,2018-01-30 13:53:32,200
0x66a136d4c0be0dd552b9818c7f63656af571e932b1b024d6098a106402f4a1b2,t,21000,6630650,,5000045,2018-01-30 13:53:32,201
0x592239ce66e5d18ca9ac7ac61aa5aeb6956abb50140071b5929a73b8489aa6d7,t,21000,6651650,,5000045,2018-01-30 13:53:32,202
0x966444e6e88f93337080070dd7a2123655b7da0a8fea8eacc0e35051a413d3f1,t,21000,6672650,,5000045,2018-01-30 13:53:32,203
0xfad27b9e11f9884834c09f5267302cf8c8dd1b983c210e1c68faa360e7234fab,t,140027,6812677,0x480a6D9ef00a0ed6CED433D9713863290569e5A2,5000045,2018-01-30 13:53:32,204
0x7e18546571559302df7da4ce0d5a5dfd8d6906963fdac0ec5cc49505b731b7f2,t,140027,6952704,0x692d04dA205d377f8B559d87155579f91E8C74A5,5000045,2018-01-30 13:53:32,205
0xffa4953c409c3f7c9e2291d3a18af08f42b86a1cbc1d56a1b43791cf4c1992f0,t,140027,7092731,0x2f01251320A3d33BE3d4b7e710e7086f64B13917,5000045,2018-01-30 13:53:32,206
0xdbd227bf81013c1fdcf97150274ee629cefa528ceccb90d641dc52fb62588637,t,21000,7113731,,5000045,2018-01-30 13:53:32,207
0xfa84aa8f7e8bbc379ed157b08e45050f98eb9e7ba1233ad52cbadd199797af62,t,21000,7134731,,5000045,2018-01-30 13:53:32,208
0x7d13b06ec1c602a101724e1d6d504b2cd50adb3c1eeaf91b100aa002d89f5ddc,t,21000,7155731,,5000045,2018-01-30 13:53:32,209
0x0c7041c3a5526d6ed3d90cd2c7ff8b9a084551570ffb91550a1743afe8cf8290,t,21000,7176731,,5000045,2018-01-30 13:53:32,210
0x62180c9d48a307a8a0c92c550a962e31bffe49d4f8812ca7bd0b2ee83d4b5a24,t,21000,7197731,,5000045,2018-01-30 13:53:32,211
0xefef3367b4dc6ac41bacf54047bc13249d93842025dac3f0576d40006e9425be,t,21000,7218731,,5000045,2018-01-30 13:53:32,212
0x285f2e4bd05fa7ec9c86398b60869e52788f36b8afee9ec6340fbc6c6824e7bf,t,21000,7239731,,5000045,2018-01-30 13:53:32,213
0x9093417b3426dce7eb607b78abcc184c884f2555e4f43971311e7bdcb83887b8,t,21000,7260731,,5000045,2018-01-30 13:53:32,214
0x8d1d50c4dd9d66ee15feebd11f106499348bbd71ad142764282a534a6896f79e,t,21000,7281731,,5000045,2018-01-30 13:53:32,215
0xe045c8f9f66d1672e6a5b5c830db34759205ad99ae36cdb73e2724e3d553a7bb,t,21000,7302731,,5000045,2018-01-30 13:53:32,216
0xc20108593f6b14be07e74ba1a74df184fdcfde865ac25ca5e4d7d823becf5b49,t,21000,7323731,,5000045,2018-01-30 13:53:32,217
0x153a0b4e4aea352cf454100b567d30a7896d74c75f1cc66fb565edf90d793f9d,t,21000,7344731,,5000045,2018-01-30 13:53:32,218
0x8e895f98393935570647219e5f99f545082015b2421752327ecfb6614ed78e71,t,21000,7365731,,5000045,2018-01-30 13:53:32,219
0x221ffce42b8078d68b1968cabf4d43d86ad798e18fa689fba45b0c75b1960789,t,21000,7386731,,5000045,2018-01-30 13:53:32,220
0xe412735b155ea21e76d075a87383231e161bd1913b6f08dff5aa4607fcd3c02e,t,21000,7407731,,5000045,2018-01-30 13:53:32,221
0xa6a2bba581ea4d796ccc46a3f80277678fc33d3644653a2ff6ad76eda9fa7e62,t,21000,7428731,,5000045,2018-01-30 13:53:32,222
0x569a0bf3d140904ccd1738795512d3f487fb647925a1d83c6caacbfc2ce63fe2,t,21000,7449731,,5000045,2018-01-30 13:53:32,223
0x5bddb4d5c323de99edf0565b558bc1beb634c2cc5eb0813610d6a145888662b3,t,21000,7470731,,5000045,2018-01-30 13:53:32,224
0x34972ac06f2474dcd54ddec4050e5f8eff4b07e4ca8a79b221d27aa373443d41,t,21000,7491731,,5000045,2018-01-30 13:53:32,225
0x4bd882f65bc8f3f491de9f30b8b00f519c966d4a4a2b18f89781f344b1095e4f,t,21000,7512731,,5000045,2018-01-30 13:53:32,226
0xf4207d5d7a869096c666bb0ec812f4ba9529c2233b943600dd0bcb4258232ab3,t,21000,7533731,,5000045,2018-01-30 13:53:32,227
0xf94b0567601251e1fabbb996dafb54b03d22fba0e790c0c9299a3d353e54e8aa,t,21000,7554731,,5000045,2018-01-30 13:53:32,228
0xd61d3d41229501274d3863473d3a3e2eb78b747d25a4896c6a200d3199fa9aae,t,21000,7575731,,5000045,2018-01-30 13:53:32,229
0x5b50c1cfaf031c055c314e272163591e8d4e594bbc241bf4a56808195917d0ee,t,21000,7596731,,5000045,2018-01-30 13:53:32,230
0xc3fdd30341e3762b00045bc5e22906e07ead3e8929df16cf3c9c6fbe4baaed25,t,21000,7617731,,5000045,2018-01-30 13:53:32,231
0xe7e39fdf6be388141753cb9293729a1fc3594bacd7451aa8ce56a770d72a0402,t,21000,7638731,,5000045,2018-01-30 13:53:32,232
0xae0e17f0fc041adfe0acf00989932ef42d1bd265ab93e5caf8a4336b1f1a9e34,t,21000,7659731,,5000045,2018-01-30 13:53:32,233
0xb2ee9526381d3c78b2510a53aae6cea7bb8532ac8c59aaaa73e8ffffe7337c04,t,21000,7680731,,5000045,2018-01-30 13:53:32,234
0x27ed7befe2fcd59e634c631c281583921163c288a5d99b383c6a32d2a556a5ae,t,21000,7701731,,5000045,2018-01-30 13:53:32,235
0x89553aacd3058073404b1a28aba8ce352118a2a93de3eb14fdf7e936a555a2f4,t,21000,7722731,,5000045,2018-01-30 13:53:32,236
0xf4f1b18c9bbe8f0242d28c12e25cd1b92c7a61d9791a7de496794d9eea2b636e,t,21000,7743731,,5000045,2018-01-30 13:53:32,237
0x2928c87947cf3cc54254d7dadcb7beb8b8fc0cdc6961171aa8897db0078c4622,t,21000,7764731,,5000045,2018-01-30 13:53:32,238
0x561a1cf867bbdb4b453733a1af5f220c09b00638158cc4a75568b0a2230eb3df,t,21000,7785731,,5000045,2018-01-30 13:53:32,239
0x300796163ec996fd05ded11c68783e352e9fa30df62a63400b984e5a651907f4,t,21000,7806731,,5000045,2018-01-30 13:53:32,240
0x9b4809bffdd91e853cdd63b68165f356cc9ca1e9dc2fefba6c6a7278bffee008,t,21000,7827731,,5000045,2018-01-30 13:53:32,241
0x8af1c4221e600c1bd5f2440d8b8b5047de8187678478b3b1abb300dccc7cadc1,t,21000,7848731,,5000045,2018-01-30 13:53:32,242
0xdb7aab80fea247dcada728c675f90e423a97d5252b47a4aa41098263a68b873a,t,21000,7869731,,5000045,2018-01-30 13:53:32,243
0xef37364cf7780c11c3ca8efd1206d81932d25cf0014ec39b958bdc0067411598,t,21000,7890731,,5000045,2018-01-30 13:53:32,244
0xa80534978dad337d4ea8f525b716aba6b225eacd96d710cea501addaadc3f3c3,t,21000,7911731,,5000045,2018-01-30 13:53:32,245
0x77f53f40169ce7cfd6f855af5c38cc7b29d6794a2b5961041c43d0ba7d10a8be,t,21000,7932731,,5000045,2018-01-30 13:53:32,246
0x8d74a661cb552f9dfab5b2d7b2694ecad63615255fb5b4b6c7fa246c842c3aee,t,21000,7953731,,5000045,2018-01-30 13:53:32,247
0xdb3109e8cf6e8b135e09494746ccb297b3d80b627097fd7023fb519ac10eb12d,t,21000,7974731,,5000045,2018-01-30 13:53:32,248
0xc5ec95766f5ddb0b775d09160ea3c74c9b33b94a562ab3aa2e962c71c35543a8,t,44493,44493,,5000046,2018-01-30 13:53:40,0
0x7317f59af6d32c1e3e6b2ec430ab0df9a54a4981cc6d271abd0178b7882a8e40,t,56544,101037,,5000046,2018-01-30 13:53:40,1
0x252fe33ec507501ca0c0762b2c9249b6c9b3887d25c7dd3bac03cd429c103a6b,t,21000,122037,,5000046,2018-01-30 13:53:40,2
0xcfa655f7047f768c075c923e200a51aac205821816989cd17f1b45414ac904ee,t,21000,143037,,5000046,2018-01-30 13:53:40,3
0x79d3caf0d7b7e288da83f07809e44c31f44951f14ea46f37b315fa84765468bd,t,21000,164037,,5000046,2018-01-30 13:53:40,4
0xa05793fda2b6ca42d7b88caef5f4fc59ab29bfc965ec6441fdba623fa8db9f1d,t,21000,185037,,5000046,2018-01-30 13:53:40,5
0x475ca600619be055b9181460d1fa4a9e67e0370b8d7260f6b6e276f46173f2d1,t,21000,206037,,5000046,2018-01-30 13:53:40,6
0xf7a824409203d547a63a612b9e5879dda3468e6f5f7dd92be93c3bef31a77f16,t,21000,227037,,5000046,2018-01-30 13:53:40,7
0x1b8a8a7e4ed5acbd14c7534fed8835498fd7a3f2d7e201797a97c2aece2b3a4a,t,21000,248037,,5000046,2018-01-30 13:53:40,8
0x08e439a388f4597c878c9cff371ad5d2c13513bf74eea2e9caa09938ba47561e,t,21000,269037,,5000046,2018-01-30 13:53:40,9
0xcba645aa5edf4c942110e0906316171782eb35d69d9365ffcaad3dc198515550,t,21000,290037,,5000046,2018-01-30 13:53:40,10
0x101a22774afcdabcfb4c6354300caf516fd79fb35b7b201dda68ab9866a483fc,t,21000,311037,,5000046,2018-01-30 13:53:40,11
0x8a90ae5238c64f3447ffbd6d94fe6bfd6119aaea46ab7cb6a3bc41928d2ae209,t,21000,332037,,5000046,2018-01-30 13:53:40,12
0x3c7cdfe1828eeb6132221fa94a31010bcca11223ca20fd86d0ede58d6fbd6f90,t,21000,353037,,5000046,2018-01-30 13:53:40,13
0xac31069aabe21d4e3daf0ea34e62264ee41319a28d0ccd3dc0230b692cc687b4,t,21000,374037,,5000046,2018-01-30 13:53:40,14
0x0b8e2984bad5f47fd5215eb49f51b1216b9143baa55f2f0a36fa8e81c77e782e,t,21000,395037,,5000046,2018-01-30 13:53:40,15
0x888fd8486f1d498793b45a8a579ed8a441c37c1f7fbc282a6e0297a78810027e,t,21000,416037,,5000046,2018-01-30 13:53:40,16
0xeaca812591741ed2c892810a9dd41a4a874abc40699d22854505e80711d8c39a,t,21000,437037,,5000046,2018-01-30 13:53:40,17
0x34e2f71aca052e478e50f0dbc590c26c9bc37375298dabf39992a53cc50e217f,t,21000,458037,,5000046,2018-01-30 13:53:40,18
0xfc6a80d3f8613540bd8fe2b41f7f085e0a3be6b0c9ecc3fb9838e280fe4cf180,t,21000,479037,,5000046,2018-01-30 13:53:40,19
0x44f6ca655579d0e7eec8c4e0da0166b8c0fc857f8320e9f10f955b5779c0f75c,t,21000,500037,,5000046,2018-01-30 13:53:40,20
0xce998971c0da1a7f1dba5efdd4a48dcdc189c43e1a5e573816b00b2bbba4f74a,t,21000,521037,,5000046,2018-01-30 13:53:40,21
0x0d5b279a23383e0f6b58eecaf7e4fdbeb1480fc24896d542440bcb1673c90828,t,21000,542037,,5000046,2018-01-30 13:53:40,22
0xa8160825c5bccd5cf9155511b87ccce9dddc1c2069c92666652d4aeec67ec47b,t,21000,563037,,5000046,2018-01-30 13:53:40,23
0xc4085075d59ab6d7df4faee3363a073a6bcb9342948e84c73476e1c5c35470b7,t,142772,705809,,5000046,2018-01-30 13:53:40,24
0xaf32a8375f54c6b01e3826f6ddef234a41843a6dd9f3e568d4191c354a64337b,t,52647,758456,,5000046,2018-01-30 13:53:40,25
0x418ecfd478898ccf9cd511aed6115e95462800c4d939d226736872ea6bbeaf40,t,76550,835006,,5000046,2018-01-30 13:53:40,26
0xf4c313bfe5afeac7f144913e6bffdf733f09dbdd151144f5f228419ba3d1d2e8,t,21000,856006,,5000046,2018-01-30 13:53:40,27
0xe2ec6b16ebc756fe82591f1c1927aa900f41b403b0c7a90c61689f0ac4f4f5aa,t,36715,892721,,5000046,2018-01-30 13:53:40,28
0xcef3dfeeeefacc314878f5fc15019e39da9a284e35f1cf2d16b97700e8eceb97,t,40907,933628,,5000046,2018-01-30 13:53:40,29
0x4ce2026f7bf161988e31f0a736a193a82122053548a67ed97f5d869ae46ed5ee,t,91730,1025358,,5000046,2018-01-30 13:53:40,30
0x4b3124406b47569abd171412fd6d439abcc40c51acc982316f179791acf97dab,t,52199,1077557,,5000046,2018-01-30 13:53:40,31
0x2464e637ed2bac0a325c44c6c358f2c4fcf260cdb12d366e330767d8460bf14b,t,51820,1129377,,5000046,2018-01-30 13:53:40,32
0x2c6fb80f4987518dfed032835c796bd6b5cea4e80c37f03fefc40e2a82c49bd1,t,40907,1170284,,5000046,2018-01-30 13:53:40,33
0xce8753bcafeda82c6da13779c50d83a7b750dc730bbedb313bf7181c7b88b871,t,21000,1191284,,5000046,2018-01-30 13:53:40,34
0xb656af4b9c996ab48ff3801698caa77a2f4ea88c7b1e5059de4bd68b72e4ce35,t,21000,1212284,,5000046,2018-01-30 13:53:40,35
0x24213aca7f3d3957e2870476210209075b6350b769ed9be3e24d56779004f6ae,t,143081,1355365,,5000046,2018-01-30 13:53:40,36
0xdc993400168dfb7c1420c94c402ed06af16eb0aecbd4fb19cb6fb37d0f8d9f5b,t,21000,1376365,,5000046,2018-01-30 13:53:40,37
0xb78a6f41eadb0d2ba2dd74d104ec6e7a49ee4bc9b80896245e4c24d1745feb79,t,21000,1397365,,5000046,2018-01-30 13:53:40,38
0x308f5f61687fe90460422d27a8e3d3791043fe793a36435bc38e242888d7f671,t,53111,1450476,,5000046,2018-01-30 13:53:40,39
0x9fb746e77d49001ff28731df051e3735eb417582540cacb3fc4cc33cb5112d98,t,52962,1503438,,5000046,2018-01-30 13:53:40,40
0x8226bfc5d91603f17533a8a4c666d7c286a2265d7cb22aef05c02b19e481de23,t,50121,1553559,,5000046,2018-01-30 13:53:40,41
0x48871e3005f306d9fc75c5485aafd21df70750c9d00a8a9051dc729c92dae127,t,44354,1597913,,5000046,2018-01-30 13:53:40,42
0xb8feb24f54efd0a68f0286432ebe1c71ae98ca2c619603fe33146b1b45409dfe,t,21000,1618913,,5000046,2018-01-30 13:53:40,43
0x02ed25bed7741f640b678216457f73941742ec4fa9491d86d8c9eed39e3c1eac,t,108178,1727091,,5000046,2018-01-30 13:53:40,44
0x538efab6127f9a330ef76ea7d93437d03879c9f01e01e307bd0250ee635ff8e5,t,107986,1835077,,5000046,2018-01-30 13:53:40,45
0x508cf14281e6d78f5854370510219c6039d10760a76ee4b65bd331a29ade32fc,t,37132,1872209,,5000046,2018-01-30 13:53:40,46
0x60f3bc90222712489efa901d9611b1682473154828c9f7d684f442158ce967a6,t,21000,1893209,,5000046,2018-01-30 13:53:40,47
0xccdc5d77529da264bd3bc6b46d4d22571224d0ce656c3187872f91de7a8db58c,t,31257,1924466,,5000046,2018-01-30 13:53:40,48
0x38f78a5366f54a82afa876e4b3480561325330cd48b65159ca243be3e4e04c3a,t,52109,1976575,,5000046,2018-01-30 13:53:40,49
0x770526c6b9682d60484a8fdbb6d5c153b488c82b1e4b326865162f174e7700f4,t,21000,1997575,,5000046,2018-01-30 13:53:40,50
0x30af1aa559f74370a7fe1b0b68b27dc8bdd06b0cf6dc243005ec5ab856b591c3,t,21000,2018575,,5000046,2018-01-30 13:53:40,51
0xc956379a204142174369edb45e1891ae9d31555efd41812bd5e785cc1e257595,t,21000,2039575,,5000046,2018-01-30 13:53:40,52
0xb20b2bb6ffe832c0a35f3a1fa3eeb141cc4ca8566c85593a92be3196dbeef1fa,t,21000,2060575,,5000046,2018-01-30 13:53:40,53
0xf64c204588beaaba45170393027b6ea81b167d89cd0a03d59b531c62bc1d48c7,t,21000,2081575,,5000046,2018-01-30 13:53:40,54
0x2f9d8ab1f629d2f65e3f20a1788ea5141523aef14f76c9ab09ab6d7c5abf5c48,t,38114,2119689,,5000046,2018-01-30 13:53:40,55
0xb68dc1dbeb699e926ae33e7ca77c952022148bfbe72dfc459f51eea56db04724,t,21000,2140689,,5000046,2018-01-30 13:53:40,56
0x5ab1a527f1d2579af0e9f6d36d2c60a9cd559de9744c618dec4f96bc9c34dfa5,t,21000,2161689,,5000046,2018-01-30 13:53:40,57
0x024c185d2dee48a34d35092dff5c04c81e0f66c557025415a15d9678bebdf0b2,t,21000,2182689,,5000046,2018-01-30 13:53:40,58
0x6e3a49b40bf0bd23ed31bd8a51d784a13363434324bc04726041036e0b0b612b,t,53252,2235941,,5000046,2018-01-30 13:53:40,59
0x57fc0311909a7ec20ce2bdcb5761cb230c3362d9a00235cc9b5d38520f5e7b00,t,21000,2256941,,5000046,2018-01-30 13:53:40,60
0x769014ad046d5b2d97493fdc569c0551771676b798e02cafc554d4e905f08595,t,38318,2295259,,5000046,2018-01-30 13:53:40,61
0xd7e28eeb4a41d32c1f6541cd4f517d30336420384909cb12a3a2cbb3643b8d88,t,21000,2316259,,5000046,2018-01-30 13:53:40,62
0xf31869dc4b181eb894a4ff656d9dc1d48d12d3f534ee7f03f11e872df528c31c,t,21004,2337263,,5000046,2018-01-30 13:53:40,63
0xbf48062c5c94acec945e7f3b91926fe15ea61788c40e519fa783d41a676a87df,t,21000,2358263,,5000046,2018-01-30 13:53:40,64
0x9a40cee628616f749279deebc5cb74e7144a24dcd62c4ca6492c21f27e471d3a,t,21000,2379263,,5000046,2018-01-30 13:53:40,65
0xf87716903c01fafdea09c2cdc1a3fc7fc30e866a5dcef71ddf3d8dd51b014b19,t,21000,2400263,,5000046,2018-01-30 13:53:40,66
0x894c66f0300d49c2f8a10df38530fb73b1d518f064e17a1a5c3592becc093498,t,21004,2421267,,5000046,2018-01-30 13:53:40,67
0x1265d65221a1bf64bb787c7ccd6940469900088fb7a3d6175cf812052bea9ed7,t,36603,2457870,,5000046,2018-01-30 13:53:40,68
0x30676191c197b8add2c79a2ac12284d41646deb844dfea787d9b9730e95e5038,t,26711,2484581,,5000046,2018-01-30 13:53:40,69
0xd24224ea02d58197811c38b750d83449c2d1ca9c751f7c6c5761ed7a0b1eb2c1,t,53233,2537814,,5000046,2018-01-30 13:53:40,70
0xd8621c8461bcce06de2dff1e43bdc1648aab43c5e307923796464a8f5b3a150e,f,250000,2787814,,5000046,2018-01-30 13:53:40,71
0x4b7dc96ec28d171d4ceed76a21115fdf8f5b8aff68d4e22f3568dcf71283257c,t,102934,2890748,,5000046,2018-01-30 13:53:40,72
0x869536c359e121fe7509a34f1227bac818c2cbe386558162cb3f3e84f0e3b98e,t,140027,3030775,0x74C3D5A56D3BDD97d75ab1c8Be274548d2A265f8,5000046,2018-01-30 13:53:40,73
0x226fa09297bfa72ac943e9cbcd5d51cb59d1e6d18211dba209bfe071970e42fb,t,140027,3170802,0x9F24D9b982DE082Dc26c92c1bf16D1C9C742092D,5000046,2018-01-30 13:53:40,74
0x2fb7c2679da5818b5a45827beb360e3bbb6226d9fac8477d616e379061650428,t,21000,3191802,,5000046,2018-01-30 13:53:40,75
0xa982fc973e864c3cb9aa0667aa248969dbc29b73127b4e2bbd10c6e07d5d205b,t,21000,3212802,,5000046,2018-01-30 13:53:40,76
0x9d0d8a425f05c0cee1d2e3018a39566bfabad7c3b4365187f2ab25d5f2399f4a,t,21000,3233802,,5000046,2018-01-30 13:53:40,77
0x49cdca6ca1f8422c0353a2c230d6b2d0e9165cff03facade8e014b88b0f2863d,t,21000,3254802,,5000046,2018-01-30 13:53:40,78
0x7fb43462bb2f0d965b0681f6d5e4914d4f3191e16bb650f83b8cc1340641fcb6,t,21000,3275802,,5000046,2018-01-30 13:53:40,79
0x1b03e80ad2827f4c27474082e534fc2a4b56865dcb2ef92dc6baacd5833473b7,t,21000,3296802,,5000046,2018-01-30 13:53:40,80
0x6445d774c96bc7ac4079d8224048ef02e9a54eebdff0c5234c29d34e8962339c,t,142388,3439190,,5000046,2018-01-30 13:53:40,81
0x6131ed4f038c87a1aaf94f59a09d3567286828c7df911fe9ae419d3972ef2602,t,48210,3487400,,5000046,2018-01-30 13:53:40,82
0x322d28aae5d09fbbc293360dffb93643006274dc4854daf46d3a6472beee59f7,t,52129,3539529,,5000046,2018-01-30 13:53:40,83
0x41fcc55ecafe117531a39b98888437f4f4a9ec95b9b1323286803e140d5e1665,t,38104,3577633,,5000046,2018-01-30 13:53:40,84
0xb6375a382ff5ee3475798cf7608964f1785b96e0acab50865336657b8d927348,t,55907,3633540,,5000046,2018-01-30 13:53:40,85
0xee644be9132d2a3eaa37fc6aa8b5c9c8ef7d48d52650f2defb0d3ee2fd8d6c84,t,37252,3670792,,5000046,2018-01-30 13:53:40,86
0x181cbb774aa3d90a75be1d99c2d2148acd745c55493d0f5797eee7d29863d949,t,53040,3723832,,5000046,2018-01-30 13:53:40,87
0xcdcb9c545f183ac088146e04a99e3ff0d3af05ff3578086952967861e9a7f6d8,t,52075,3775907,,5000046,2018-01-30 13:53:40,88
0xf6f247625f6665659c7127a236afd3a83f9d79418441cd187f5befd96c4d7fb8,t,52886,3828793,,5000046,2018-01-30 13:53:40,89
0x700e5d54a9f643cf5a84a0113fbefbc1b8d4d458ef453f7fb65e3b3965db5aba,t,52109,3880902,,5000046,2018-01-30 13:53:40,90
0xb40fe0444df814196c08224b41d0f4acaad8cb892bc15263777b0231e7d6aca6,t,52356,3933258,,5000046,2018-01-30 13:53:40,91
0xbcfd1fea5e8ca138e6026a4fcda75780ac0a3f1c3d5dd340627955d929babb0a,t,51820,3985078,,5000046,2018-01-30 13:53:40,92
0xfd1b8414c0d4ccf06b3d32d808039f08b6f77ceb6fe85b45e6869a92e6053e56,t,52237,4037315,,5000046,2018-01-30 13:53:40,93
0xa040ce48d54c2a9784d4ee03b80f6ddcf15322e1395d35396ffc855609c0f447,t,58815,4096130,,5000046,2018-01-30 13:53:40,94
0x79413f28c4b3942567640dbe469cb2a1e51d1849437bc8ee722157fde717be70,f,23545,4119675,,5000046,2018-01-30 13:53:40,95
0x10a4c7a8c782aa73e9b23419a54801fb074d9c219f15b1df85f6099211dcc00c,f,25000,4144675,,5000046,2018-01-30 13:53:40,96
0x7c63bf62a4795d8a8f7929aa979fa0d337831bebf887b3a4b09661bd785863ad,t,21000,4165675,,5000046,2018-01-30 13:53:40,97
0xfecadd77ea0f29a3f0f6e689bfc63bcfeb2762fabf289548188aac177c716ebb,t,68931,4234606,,5000046,2018-01-30 13:53:40,98
0x449b9342fd0122d06db1fce2c0965c6892e70433c897f3a6e6cd361e5b7ed713,t,36852,4271458,,5000046,2018-01-30 13:53:40,99
0xb76b9efcb03828a0fca9056ba5c2a86dcd0daa252c6ca9224e723c2fd930ce90,t,21000,4292458,,5000046,2018-01-30 13:53:40,100
0x2f7892c3789ef8f48d3b05e95a55fcd2a552a59ebad595a282da3ea92ffb7a65,f,22073,4314531,,5000046,2018-01-30 13:53:40,101
0x37440d043c8b8fdc0ed9040f427303c2030736a8796956213f6ff4402f6cdfe4,t,21000,4335531,,5000046,2018-01-30 13:53:40,102
0x90bd8191b82b11ea539ec6147772c2e052dbabe3daf75941c601d4e2c907030f,t,21000,4356531,,5000046,2018-01-30 13:53:40,103
0x65bac185195da509a46f566f49ec4c3050e1b1c676548cf9fab45c744c1d0437,t,21000,4377531,,5000046,2018-01-30 13:53:40,104
0x84355a94e5d474b74787568938150e3a2bcdac9ac72f698b53e9758e900f2c4d,t,22091,4399622,,5000046,2018-01-30 13:53:40,105
0x081bb09ef9252c7efc636387ab45cd0542d1ec7dcec53cde1a8ff9a15c36a631,t,21000,4420622,,5000046,2018-01-30 13:53:40,106
0xe126d5685b546e949dbf54681740f42591b80699c6c63537d3933fe3e5b42e01,t,28066,4448688,,5000046,2018-01-30 13:53:40,107
0xb6513f35a97577c2adc7fffd871915854c811e3cb7bad8f1ed1cf4d1494b656a,t,37267,4485955,,5000046,2018-01-30 13:53:40,108
0x61fa63fcc528cc321c9cd966f1d4f002d8bba25ee70b0d97d8c6871d6f90c615,t,21000,4506955,,5000046,2018-01-30 13:53:40,109
0x00e994086d222b619131dcb383d11538f9d3b58914db64ed5b92ddec07f53758,t,21000,4527955,,5000046,2018-01-30 13:53:40,110
0x03d23d4f6e0dd7703e98a273f414eb52dc32345388984e1973cbd3de4933f5ec,t,44493,4572448,,5000046,2018-01-30 13:53:40,111
0xd12410c5b18927853c80d943cd0c9c83aa6facb7881adf709b2c794ebc202c4f,t,21000,4593448,,5000046,2018-01-30 13:53:40,112
0x435549a02168c77a4a183893cd2816cb89ca5cfe7ad0d82752e446bd1b171776,t,36728,4630176,,5000046,2018-01-30 13:53:40,113
0xf1736901281ec0250f5863e9edd838b7030f901200ec0449ac43af5f29ee8251,t,21000,4651176,,5000046,2018-01-30 13:53:40,114
0xa28b1d589f57a8628ad4ade1673dec6345756e240ff79ee215cc9314880ae3b4,t,37712,4688888,,5000046,2018-01-30 13:53:40,115
0xb04bf67cb7f3321dd17822572d49ca67115d27b7dea326f6d6557c4f2699bcbf,t,21000,4709888,,5000046,2018-01-30 13:53:40,116
0x7e05ebf34f816a1fd6faa950660e0a0cf0af89e192d2d5038faae9374a66d10c,t,92621,4802509,,5000046,2018-01-30 13:53:40,117
0x557479257dba3b328feac7a34c494f98781ea20692ad17ce5c5e49d75bb9b0dd,t,21000,4823509,,5000046,2018-01-30 13:53:40,118
0xd79449bd622cfbdc38750e4d91043b793eb579a36979277a968aa342bddb44a7,t,33705,4857214,,5000046,2018-01-30 13:53:40,119
0xaa847a1b7e928c6afe7660aac66d12963ea106d9a6ca523d2bf445a75b866b3b,t,21000,4878214,,5000046,2018-01-30 13:53:40,120
0xeef86b81953e8d3560bee1f6e8494125f3a9f40de9ca9bdcd8adfcc2e7f8572c,t,21000,4899214,,5000046,2018-01-30 13:53:40,121
0xb5852644a194801ad16d741f2b2770f0a6f3603cb57058abbca84485051813e1,t,21000,4920214,,5000046,2018-01-30 13:53:40,122
0x1017631c72e90156eabf0b044047364eed0468b283605723be7a31f7732fa913,t,21752,4941966,,5000046,2018-01-30 13:53:40,123
0x0dd59ad92eb1b9609afb16a2b422ee44ec158383844a7a086af559683210356a,t,21752,4963718,,5000046,2018-01-30 13:53:40,124
0xb0e81d8a989f62d1d304a5f6a77a5ddbb2a1ccf841c35c27330eac5f1a0755a0,t,21752,4985470,,5000046,2018-01-30 13:53:40,125
0xec5699f87657bfc7a956ae970d97024b81a474e6e5fd7c19bf02b3696843762e,t,21752,5007222,,5000046,2018-01-30 13:53:40,126
0xbeb69118097a9de1c80c0b58b674fad433183fc160f5a85427b847d8aa3db914,t,21000,5028222,,5000046,2018-01-30 13:53:40,127
0xdb250d765be7f39627a3e2f488275b9e73ada9f205edc1c525efbbc6c72f7c21,t,21000,5049222,,5000046,2018-01-30 13:53:40,128
0x2308c1c59311bb42b755836cab5ea060b4bde089a1fa6330d0c9db2c1f8d9967,t,253854,5303076,0x81971eCB758E297A44A3a4C89805A9ebC19feaf3,5000046,2018-01-30 13:53:40,129
0xd7d66fce74233174de47045da0299a260b113ddb7d82d13e0b6108689d3ab711,t,53167,5356243,,5000046,2018-01-30 13:53:40,130
0xc35f3800346477862d68b1f160843aa23b801f5babf719464eff41308b929877,t,21000,5377243,,5000046,2018-01-30 13:53:40,131
0x80f031548ed019febb115e90b2bc723bf4630af16705c52d3e1bfc07ca2d1159,t,21000,5398243,,5000046,2018-01-30 13:53:40,132
0xe647df08c5ff9598fb2ec1cadb50d7f4f63bf1b1442a6555dc4fc613bf309af6,t,21000,5419243,,5000046,2018-01-30 13:53:40,133
0xa3b637ed64ca2a237e249a408f247438843ebf8c4f658d3f40337de614c6bd7c,t,21000,5440243,,5000046,2018-01-30 13:53:40,134
0x8e1d8d25354748d077441b779e3ae2f1b8b28d7545bbb6bfaaae4417970b21a5,t,21051,5461294,,5000046,2018-01-30 13:53:40,135
0x0b280723cbb596f2025a8f5df28a4d90bec4efa9c9350be665ff8294883b45b9,t,21000,5482294,,5000046,2018-01-30 13:53:40,136
0xee3b4ca4e7284d00555ed48fd3b875d3b210120c25efcc264f9aa392c1ffa4da,t,21000,5503294,,5000046,2018-01-30 13:53:40,137
0x95a397664cec511b7faa0ef93c0a9de7533381bc5625242bd7bb466ad6f9ee7e,t,21000,5524294,,5000046,2018-01-30 13:53:40,138
0xced55dbea53e656c3ed6658f161f36b39fb5b05bc1f675b860bb99c43d69eaae,t,21000,5545294,,5000046,2018-01-30 13:53:40,139
0x036b50be9b5e13718d9d30f58285b656606eb0955924a8d95b467d5e4f0e53d6,t,21000,5566294,,5000046,2018-01-30 13:53:40,140
0xd50928d2fcc71d88f86827a9f0f8a85416a5af7955b0a2836c1d39e0f3f7b4f2,t,21000,5587294,,5000046,2018-01-30 13:53:40,141
0x0408503c2a57e3ed8ca9cf48a70a994872ebdb3968276b7fc2788317d07df4c3,t,21000,5608294,,5000046,2018-01-30 13:53:40,142
0x45c3cb33640e17d52c32e10094ccd8848d37a46a0223c9c6021301bbbc2c42ee,t,21000,5629294,,5000046,2018-01-30 13:53:40,143
0x99a7e11fb1508c2cc1dc4fc80c0d1f95c6e5b877fea3329ac783322086409057,t,21000,5650294,,5000046,2018-01-30 13:53:40,144
0x307ee1d60a1e60410c4194e3b3527f759fd7bb33d7bf31ad63611f6b4c80b1e0,t,21000,5671294,,5000046,2018-01-30 13:53:40,145
0xf524c11a3b3fe01a1a62b45470ac57de20fcf2a88a6350eacf8bf54545a14c60,t,51335,5722629,,5000046,2018-01-30 13:53:40,146
0xd2feb2fa19dd37bcae41b9c72fdac52bc7dcf1f2ce7f25acc4f8093716e1308a,t,21000,5743629,,5000046,2018-01-30 13:53:40,147
0x8928377eb2385e60b39303c28226bb264890194902e4749b6a16af73d5aec66e,t,37090,5780719,,5000046,2018-01-30 13:53:40,148
0x78dcd0eba0f1d98c64f6cdd480375d6198c52ffa0916f72baa11f9f7cb4f6098,t,52460,5833179,,5000046,2018-01-30 13:53:40,149
0xc2d5717199d7ecca1e63d2b7caf4f38b6e262fd31dca3c1c67f3df840e0527e6,t,21000,5854179,,5000046,2018-01-30 13:53:40,150
0x68e0302cc2d12a61e5443b7b363240f516dddd13f2b41f34688f7942af04c868,t,21000,5875179,,5000046,2018-01-30 13:53:40,151
0xc9c09c81dc8b70896ad6b525f8a33ab6ac222e49238cfaf7b6ce8f123627b833,t,21000,5896179,,5000046,2018-01-30 13:53:40,152
0x902c5be667be9fd8b04d9819ed1da36dcacc09c0a0ce9b97bfa695a27e8200e8,t,21000,5917179,,5000046,2018-01-30 13:53:40,153
0xdd52e019070a22fe45567b91460def8ddca48b817ed06f19864620a381a6d480,t,21000,5938179,,5000046,2018-01-30 13:53:40,154
0x5529a37b3dd539a80beb652406199223c78586549b25a04984b0405a155d0b74,t,43748,5981927,,5000046,2018-01-30 13:53:40,155
0x7df0cfdc48ea88ff5bbc114d91ce3c1959d5e320b65e8e012bfeec113a744cf8,t,21000,6002927,,5000046,2018-01-30 13:53:40,156
0x33cc58ee58da4231c92dabf8cee73ae656a167a56db32903689571dd108b0e01,t,21000,6023927,,5000046,2018-01-30 13:53:40,157
0x70158fe4db8c613f15468c28e3493f54cde758754f95c6802e136533c0fd09da,f,25000,6048927,,5000046,2018-01-30 13:53:40,158
0x8b803d9e9f28f2b424883d597c95ee5c3b444a5d6d6d6bb7c259264ecbcf1e3d,t,21000,6069927,,5000046,2018-01-30 13:53:40,159
0xe0876dd55203473291871a3fcf97e29fb104b4b6a08f3d1f8fb2522aff1180ac,t,52135,6122062,,5000046,2018-01-30 13:53:40,160
0x015d4f760a9e46df5e7534c7f914e90c8b35e42d79623e0cd7930f913883b816,t,52950,6175012,,5000046,2018-01-30 13:53:40,161
0x157840ec48e24b390790d0b7f90c00b0425c318ee7c41a9619d266344cceb379,t,22510,6197522,,5000046,2018-01-30 13:53:40,162
0x9dc3c4f52739d9a6e1aa028874b24c47330358aea64782ef72321b5e51f4cba8,t,21000,6218522,,5000046,2018-01-30 13:53:40,163
0xcc95f3e8f3ccd076f93a5aa1a8d53abc4bc5b9401283507a10f5632263d4fee1,t,79140,6297662,,5000046,2018-01-30 13:53:40,164
0x00cd80402406fea99d3231d500b464ba688eab64e9515d8aae0cedf4c68f1fe0,t,21000,6318662,,5000046,2018-01-30 13:53:40,165
0x7288d7a3d46bb012a2a1efe436b01f6a3a071e4dc2fbbc2f51c710055d8cdda5,t,21000,6339662,,5000046,2018-01-30 13:53:40,166
0x9f2766aa78ab26494525d151fdc23c92ce9deb47c7d9f49ad6a25ae08856ee65,t,21000,6360662,,5000046,2018-01-30 13:53:40,167
0x5753e9878c1ae589353641976e344c4c6f04a855ccb70b93b93789564b6992dd,t,21000,6381662,,5000046,2018-01-30 13:53:40,168
0xffe4afb2676471f5639159de31be18ffc0d7c8ffc162059dab47d184468b4931,t,21000,6402662,,5000046,2018-01-30 13:53:40,169
0xd2606922c9a66960cd7aa55f7119e4ff504adb4c38005aaef28fcd2efe415123,t,52884,6455546,,5000046,2018-01-30 13:53:40,170
0x3c583a6c3e0eddc0aa6ed3d04bc9c1218d1961212e35b01f9d429b1731732986,f,21000,6476546,,5000046,2018-01-30 13:53:40,171
0xfd93bbbc234f1001593e103dabb31f50810b9ebba1f1aeaba6d55edbd7ab7fb8,f,24423,6500969,,5000046,2018-01-30 13:53:40,172
0x07fffa948692bbba657eabbdf43379807758856ba4cb07931d2d5a0effc7edd4,t,21000,6521969,,5000046,2018-01-30 13:53:40,173
0xf9ba6e17d0a9736b7cbc7badbb573295a2394749fe1b19313f96ea7d0dfc2c60,t,21000,6542969,,5000046,2018-01-30 13:53:40,174
0x8101f5a645b91a508944c753bf04809f950ad3bba5d5abba08ec67bbb13225e7,t,55843,6598812,,5000046,2018-01-30 13:53:40,175
0x0f59619a528bf83eabb5daf60694b48d3ce0efed93e13de73b883072ed170831,t,21000,6619812,,5000046,2018-01-30 13:53:40,176
0x20be6187145bb26b17e7b03f3160e2746c93bdfcc7cbf129a857cbdb61336891,t,70430,6690242,,5000046,2018-01-30 13:53:40,177
0x481373b0b38dd74eda878f10244c5a1b5f0e038f77ccfb0aeb4ed884f6b1cafb,t,21000,6711242,,5000046,2018-01-30 13:53:40,178
0xe50fdb2cd847955fe949b300675c4c2929a00658042668f07813adc672ac4e8d,t,21000,6732242,,5000046,2018-01-30 13:53:40,179
0x613173589a6ff9dc8d06f8d268972c3a33f4099c0212f17973d62bc247ea5330,t,51891,6784133,,5000046,2018-01-30 13:53:40,180
0x3799c5c3a05da0933dae8602a0a5388279a0e805d3bf7a8f6c1022b3a75af1f2,t,37795,6821928,,5000046,2018-01-30 13:53:40,181
0xe8722907536fba3d56b07494938c5c7c9300ca038217ed510f4f4d74459bb792,t,21000,6842928,,5000046,2018-01-30 13:53:40,182
0x4219e7b4725a07fa82e3674a2d41f8982d98327869eb3393b8c70958dd4ca788,t,52611,6895539,,5000046,2018-01-30 13:53:40,183
0x2e245ff7911504fff071990ab42291e2ccf8e7b3678c92657c428c64de503eff,t,26122,6921661,,5000046,2018-01-30 13:53:40,184
0xc84a485f0ee5c1a212a3ca9596872713fef0d05dfa38a99e40e676e7be479c88,t,76734,6998395,,5000046,2018-01-30 13:53:40,185
0xe136c90ab6014b30038314a59072206a5d2c5a95b097703243661486a2a13c3b,t,21000,7019395,,5000046,2018-01-30 13:53:40,186
0xb93e3038021577fa1198a1976669069a707a6955f647f7aacab3c60599e880a2,t,21000,7040395,,5000046,2018-01-30 13:53:40,187
0xb6553d5fcda4bcfc0ad24a0dfa41f31bb93048c4657fa1e25d0337e4cdf0754c,t,36411,7076806,,5000046,2018-01-30 13:53:40,188
0xc0e7a9351b7a367160d9e81050463064498acd9302031a5e67c0d528b64e5fa2,t,21000,7097806,,5000046,2018-01-30 13:53:40,189
0x19bf35f59f058482174e494e58508efa0795fa9ae6ba4d88bc94aea3870576da,t,21000,7118806,,5000046,2018-01-30 13:53:40,190
0xcae859b10e3c45610c8c72b2d7c3ee811f089b5abf44fb4e8fe388bab3f92ff5,t,21000,7139806,,5000046,2018-01-30 13:53:40,191
0x72dd9f7fc3af085114bf692a5f3646b78a0cbd81cd77c6a9819575158bdb8b0d,t,21000,7160806,,5000046,2018-01-30 13:53:40,192
0xdcd17f1f5b19fdaa82a6f442ac74f2264560c1b7062eea199ca7c3d742e0b3d2,t,39771,7200577,,5000046,2018-01-30 13:53:40,193
0xef61fbbda981fd18038ec00c2b0ff968c14f66ed247fa140afc5b9064ce6f899,t,37011,7237588,,5000046,2018-01-30 13:53:40,194
0x7a4ef89de1b8129508cc7d6b863d747d74aec9ff2f5578a81783abf2f81ca959,f,50000,7287588,,5000046,2018-01-30 13:53:40,195
0x1790f5c3704597fcc20cb9c119f384fa1b4a3d1de0a7358cffa8647746ced672,f,250000,7537588,,5000046,2018-01-30 13:53:40,196
0xc34bb6d555318ff702f9b19f1370185c2930760865866eb48a11ea2ea2fb7918,t,51938,7589526,,5000046,2018-01-30 13:53:40,197
0x48a18e74c3465b283c2c4f2849faa3bd8c3eb6352a61f9a719a80671f405c4e6,t,21000,7610526,,5000046,2018-01-30 13:53:40,198
0xe1bd9e906e782c1547b96d9fae9b02811584b6e9a4ef483b24921c4cf10dd44a,t,51335,7661861,,5000046,2018-01-30 13:53:40,199
0x9be496d617b8885dc3c76780c6cac483c1c6b2886a897268d1d84b556d80b9ee,t,36925,7698786,,5000046,2018-01-30 13:53:40,200
0x9b9aca7afc3e73ab376cc25ff295e98cba297908fe8f4690ca1926dcf96579f0,t,21000,7719786,,5000046,2018-01-30 13:53:40,201
0x6ebc3fbe20b50f6219f64d33f070d5b462ff0ea8a2abbb7643953d30d07613d6,t,21000,7740786,,5000046,2018-01-30 13:53:40,202
0x258de0ab6a92da3e5f4f3c9f4cf9603f18486b2c5e2346a9e524dd51174b033b,t,21000,7761786,,5000046,2018-01-30 13:53:40,203
0xf03cb0a6babe144bd039d8e709b84386accd4c0586997f9a07988b4cf790e51a,t,21000,7782786,,5000046,2018-01-30 13:53:40,204
0xb813593558b07fa44f084e0da90b1e41c671bb14a18beffc087a959d7e80315b,t,37222,7820008,,5000046,2018-01-30 13:53:40,205
0xbda077b2a577c1e9f976df58d910f6ef707556706df4b0d77e75ffe7ef884a4d,t,21000,7841008,,5000046,2018-01-30 13:53:40,206
0xf8defce4d443a81bf964fdc1793aa34a9475604ee61579afb555e746b66b76d4,t,21000,7862008,,5000046,2018-01-30 13:53:40,207
0x65f523c36d88536d2ded060e021593955c4601853375f8f4e85ea89fade2f74c,t,21000,7883008,,5000046,2018-01-30 13:53:40,208
0xba11a440bebad2044e6b67ac53d0834cef09027056e368d79585dc7c489f7c40,t,21000,7904008,,5000046,2018-01-30 13:53:40,209
0x81bed95103578174b9d0c3c04e38c51d7aab5a5368c4983373f408b3e9fba928,t,21000,7925008,,5000046,2018-01-30 13:53:40,210
0xfaf72f3bdcede58ba663f08bf685139d45eee415165d89d5ef3f420266630acd,t,21000,7946008,,5000046,2018-01-30 13:53:40,211
0x80affa842d77b5136556687c9f7553c9a1d01d3dda4aef94c5ed9a71db12ad93,t,21000,7967008,,5000046,2018-01-30 13:53:40,212
0x821d3054d95c7bae219e387b560ce7685174738d532679376b9c99589315deac,t,115594,115594,,5000047,2018-01-30 13:53:46,0
0x0b0baa06b99fc849317a3044db58633c083adc479387d8d1400f6504e88be6d9,t,37052,152646,,5000047,2018-01-30 13:53:46,1
0xf0198549eca656792d4755302f1fe0f810e70c08e615ca601b32ec634cca3c98,t,21000,173646,,5000047,2018-01-30 13:53:46,2
0x900faa44eda8b6080ef1ff00452ecfea18132bc58d4231da60a0cdb16a1e46af,t,215038,388684,,5000047,2018-01-30 13:53:46,3
0x06d11325358257aaa311edc8aec7ba0e834fc5246ff68a9725aae01604f90fbb,t,34470,423154,,5000047,2018-01-30 13:53:46,4
0x06a9961a9d7e54a2cc9bdfce8ad10fb3d94f13e32579928d506c9945a6c1304a,f,250000,673154,,5000047,2018-01-30 13:53:46,5
0xc5fb0371e976bb1964f863222fb630a8539cc68a4d9892be47bbaa337a34987a,t,21000,694154,,5000047,2018-01-30 13:53:46,6
0xa15f6ffdfd57025e01d9e69f98bf831a81f4840bc55e07b0efc372d15d7c35f0,t,21000,715154,,5000047,2018-01-30 13:53:46,7
0xb42893ef0d2c75dc03a1d0ef92b945fdfa2cfcec0c24a1b316cbfb37aa4d799c,t,52611,767765,,5000047,2018-01-30 13:53:46,8
0x175a029a2e02c799628581736120bcaa2a7075dd34956d08f7590e8e56532154,t,21000,788765,,5000047,2018-01-30 13:53:46,9
0xd06435845097e43bde34eb76ecc9477512225be74ce0dff39068a6219980b0d8,t,21000,809765,,5000047,2018-01-30 13:53:46,10
0xce73f875cafa1325a933e0e4850f228c75aa59b6974c0dc107ba061724358b47,t,37964,847729,,5000047,2018-01-30 13:53:46,11
0x2bb30641ec62c06f076a27a5154559ef44332c8a43b010b8a9a05508970f3e21,t,21000,868729,,5000047,2018-01-30 13:53:46,12
0x3366fceff47c1690705903dd96a9d02f31f2a93ff170a444605fd2566aa02ba1,t,85683,954412,,5000047,2018-01-30 13:53:46,13
0x88ff368a3b9c0a5b6741581c361038b2e14c702d69327f187cb17794588b5c01,t,21000,975412,,5000047,2018-01-30 13:53:46,14
0x5cce9098bc6a94cb7a33cdc4491abca3f6577db6ba03660317cc6b3676c9d5f2,t,21000,996412,,5000047,2018-01-30 13:53:46,15
0x858605afbfdaf3bb83a2b420d86cdec7acde7e9cdba739a66a9f587c8a83088b,t,21000,1017412,,5000047,2018-01-30 13:53:46,16
0x8bbb92704cd2f152fa3dc9bcddf4966253c987fe8d7b94db4c408371a473be05,t,22088,1039500,,5000047,2018-01-30 13:53:46,17
0x03af4f2819f82426eaa0edcced402fb80e96a9219adbd845118b6c1220c7990c,t,21000,1060500,,5000047,2018-01-30 13:53:46,18
0x6fb6b5ee39e28963716ab1fb0d8f2325eca0fc9e61c32ecae4791957a9cb56e3,t,62759,1123259,,5000047,2018-01-30 13:53:46,19
0x5cf710dc7074bff59165d892911160c69b0c921cd12f753c7f5703f527a48445,t,21000,1144259,,5000047,2018-01-30 13:53:46,20
0xcfb73c04c5726aba98668b0b4a764cbf4ff9799341fc1633717673ecd39e5fd7,t,55907,1200166,,5000047,2018-01-30 13:53:46,21
0xba277e0cf658afe8428306a1662bbb676ceb1d8c20c5cea37064a98949051630,t,51478,1251644,,5000047,2018-01-30 13:53:46,22
0xe9fd2bc670c5e1ea3de44c29498d9f438a5d69c29af660ef55a4cd192dde2f8e,t,37173,1288817,,5000047,2018-01-30 13:53:46,23
0x2906f2e389c9faa0b26001a98ce81d91d98058c5e2b1fd7505b785c028274ada,t,91858,1380675,,5000047,2018-01-30 13:53:46,24
0x010a87420d3180ea9ac632b36187077b646f09a5836c350f45fc670d2b6d3e67,t,21000,1401675,,5000047,2018-01-30 13:53:46,25
0xe9b72959248e0e7071d22de70e38830d0bf31735a3f2a3c4a97f928ceb37df27,t,21000,1422675,,5000047,2018-01-30 13:53:46,26
0x675cd6313c8277af55c3f3ba2dcd9d46948dc7942649279d1f6b5a305a3f6e03,t,21000,1443675,,5000047,2018-01-30 13:53:46,27
0xf4b36b7b9455aacea19e96a81cbd447e2f2e2f64d8514fa6741c8c06bbadd19d,t,21000,1464675,,5000047,2018-01-30 13:53:46,28
0x7a30381249e750b2ba28eee61901c8d06a8b091f38442cd536035c5874820729,t,21000,1485675,,5000047,2018-01-30 13:53:46,29
0xd8a70d8ecd4b96c01c4017e2f73411be0e7ae1797f5c534ff751a6b70d1a4622,t,21000,1506675,,5000047,2018-01-30 13:53:46,30
0xba0f97950f1f312beb6a4d21a15b5824cfd1b8cfdd94ce9539c6c6099c3b10c3,t,21000,1527675,,5000047,2018-01-30 13:53:46,31
0x6edb95042c96da2a0b382ee17285521370edef0a7b1907948994cd195bd3a1a6,t,21000,1548675,,5000047,2018-01-30 13:53:46,32
0x8581775e656ddbe72ffd9eebbb09fd67ad6f9beb5a88fa036e3344493f66c4ae,t,21000,1569675,,5000047,2018-01-30 13:53:46,33
0xa6fed3c4d5baef65af5bbbd693d211bfc18ef018ad9112cdd310b625eeb06962,t,21000,1590675,,5000047,2018-01-30 13:53:46,34
0x23c51ea62bd7d1003afa9c5d3f68f9513074108f7d1a39173b696d62dd08ac92,t,21000,1611675,,5000047,2018-01-30 13:53:46,35
0x9b5cb42c634d74bbc41ef44520a9c1dae3f1be0df316d8f5914361d3139c4fc3,t,21000,1632675,,5000047,2018-01-30 13:53:46,36
0xda88e1a82d68f1db71e6848a917e15a2885077f2d83d040178f081118ce09bab,t,21000,1653675,,5000047,2018-01-30 13:53:46,37
0x70d31267ac443150651468ddd0982ebb6cb187e4bf41a067f557205b4f9e92d8,t,21000,1674675,,5000047,2018-01-30 13:53:46,38
0x2126448993aa5479d55521a23a2388eba6a9f19493673f9a8ff2cf0635edc191,t,21000,1695675,,5000047,2018-01-30 13:53:46,39
0x2066aa089faf2a70b4c6e150caef5cbeb6959c05dd9275d401ea3a48d5fa8be8,t,21000,1716675,,5000047,2018-01-30 13:53:46,40
0x9674e56548d0299a7b7b738357b351f8da614db2c362ca7af056d9c0d1bcd4cb,t,21000,1737675,,5000047,2018-01-30 13:53:46,41
0xd57c4e334509cb091394517ff6f30dd315671eb173a7e10afd2be78321061aa0,t,21000,1758675,,5000047,2018-01-30 13:53:46,42
0x65d100db3573a55454556130bf1fef6015a31750bbaae24773e8834b3d3098ce,t,21000,1779675,,5000047,2018-01-30 13:53:46,43
0x7e75c7e139c4b31d71deb315e3e4a26d8169641e5364d865e112f1c8474e2f16,t,21000,1800675,,5000047,2018-01-30 13:53:46,44
0xcad720ee33adb8913f59abf08e923147fd7d9b35a0f42439eebc44a0bf694145,t,21000,1821675,,5000047,2018-01-30 13:53:46,45
0xf30c7dacd9bbe9bdf15c4dfc41e8d419487ebef4cc7cdf81f621df2ae4ae7671,t,21000,1842675,,5000047,2018-01-30 13:53:46,46
0x2d5fb5fdba62f4ac5d20ceeb527e3745fd8f42c58a516346294861cd8b29b890,t,21000,1863675,,5000047,2018-01-30 13:53:46,47
0xf140c645e623c07860c74d4c7e3232ae5e8f1a38d0baede48ccbffc35b423e0f,t,21000,1884675,,5000047,2018-01-30 13:53:46,48
0xfe39bf19b4026248d65f699ea55fa89f20bc59be026b2e4e6f26e5a1f4b9f3c1,t,21000,1905675,,5000047,2018-01-30 13:53:46,49
0x6b912fda69060a046945fd1ac0d654dc240a1cebf28eb917c730556e0fc23898,t,21000,1926675,,5000047,2018-01-30 13:53:46,50
0xf285f63f5317421e38740a3bb33db33b21b2fc18c41f2a9c863b86affccbb0f5,t,21000,1947675,,5000047,2018-01-30 13:53:46,51
0x36ece0b6a692eaa864842f909323b06494fb15d0eac6a082a435dd055d8a2b2a,t,21000,1968675,,5000047,2018-01-30 13:53:46,52
0x6a15dde5675e40599325a9e01ccadb87811edf6f2b5289d891fcae1b210e3535,t,21000,1989675,,5000047,2018-01-30 13:53:46,53
0xf189ea38487a70fcd6e169c018f30bc99b6ab0f5059541d844502e69897625a0,t,21000,2010675,,5000047,2018-01-30 13:53:46,54
0xbf4c5550a43a0724a34bc6f76efa4dcddd155ee82f525ab81fca9b962d5d9d18,t,21000,2031675,,5000047,2018-01-30 13:53:46,55
0xdceb7217a16158d54982b11a5a325378d68d53f95d62bac8f7e4fbb206464b3d,t,21000,2052675,,5000047,2018-01-30 13:53:46,56
0xc470da77964db7c8ea0f3436f7e88e35cc53a8401aa936c374fe40dbf15fa209,t,21000,2073675,,5000047,2018-01-30 13:53:46,57
0x66e01bc7267a9df32359e2f0d6fdb589f2c627b703697e3b1a3204d1bef43c9c,t,21000,2094675,,5000047,2018-01-30 13:53:46,58
0xb0cbcf4a91c76d20bba10785319eed3371300fba764714d1f6005c3987acdc6b,t,21000,2115675,,5000047,2018-01-30 13:53:46,59
0x09d556be256157d48461125a4af41d1382e08f0a6ccc0cc996989903b0a2e9df,t,21000,2136675,,5000047,2018-01-30 13:53:46,60
0xaa0a651aed460405607be7a3eba139cbaf31d63964980dc99103494ac0ecdfc6,t,21000,2157675,,5000047,2018-01-30 13:53:46,61
0x7868b3229b703e3a0f29ad1bfa88a883493c539a1d64dc77d6726ab8b85c7125,t,21000,2178675,,5000047,2018-01-30 13:53:46,62
0xd7203db32f47dc097c89548c8ce650539c26161bf8297b83001c9651db456c4f,t,21000,2199675,,5000047,2018-01-30 13:53:46,63
0x8467605d90f5127876aa7de62785b0fbe97e68b50086385d290efb22c53b71a8,t,21000,2220675,,5000047,2018-01-30 13:53:46,64
0xd115b56f23bc79d4d0dd9449f2632f973ab458383f8d7265d073c67054ac11b8,t,21000,2241675,,5000047,2018-01-30 13:53:46,65
0x2ee6bc38c19c96bfc70113803f6114f0fbc25fa8de911b8967d7dcde5be3b880,t,21000,2262675,,5000047,2018-01-30 13:53:46,66
0xe1425e01f04a1e93403d16acc03fb4f2a43fbb1cd63b946492f94bffedc4d7e1,t,53803,2316478,,5000047,2018-01-30 13:53:46,67
0x786f44c7009c3156bf3911b885dad3f95831d8c57f2a55382c470e3eda9e2b24,t,21000,2337478,,5000047,2018-01-30 13:53:46,68
0x494cea32bd78ef1cdb0f2709a7dd7c8de5e199f9fdab6674e0ea5e2db48c7bc2,t,21000,2358478,,5000047,2018-01-30 13:53:46,69
0xd379fae01225722423bc58b42e2d880e469d76b36409565e5496f757c366838a,t,21000,2379478,,5000047,2018-01-30 13:53:46,70
0xdd19404544ec8e8dca322705b266265c3353ee8d8fd9cbed312b4a359ae413eb,t,21000,2400478,,5000047,2018-01-30 13:53:46,71
0xaad67a08cc4d258fef21823e83117ea174763ae119962ddd2dfaeb0f477f83a0,t,21000,2421478,,5000047,2018-01-30 13:53:46,72
0x2766c5df086248d71b30e5911e907ee656b029c5dbb9b17af6da424f511ca60b,t,67413,2488891,,5000047,2018-01-30 13:53:46,73
0x06a52358dda207c3584912793684060f646871353e2d5794cf223361ad0816ab,t,21000,2509891,,5000047,2018-01-30 13:53:46,74
0x8190f61ad5e9a2d2c634e3b2803db402e924a77112a2adf0d4bcfbe85e8292d1,t,34725,2544616,,5000047,2018-01-30 13:53:46,75
0xf432d51f33efa107c21698bc96c68653618ab5dadce166561f99b6c59f43fd9f,t,21000,2565616,,5000047,2018-01-30 13:53:46,76
0xccc3c3be326cebbbf18fcc418e4551980d34c1b45931dbe6120129e26d5acda7,t,21000,2586616,,5000047,2018-01-30 13:53:46,77
0x34e09e958d48e93dd2e28fbca9b59136394d19e0247e116ad6f448380a837c77,t,22088,2608704,,5000047,2018-01-30 13:53:46,78
0x9bb44e2816788d2ae19f4c089afb1bcc8531758eb202b452e2aa36f244170dda,t,21000,2629704,,5000047,2018-01-30 13:53:46,79
0x4613e5fb3538fcf744b17963e74bf7b5fd4ecfdfe47ce6ed4c2915ad152222b9,t,21000,2650704,,5000047,2018-01-30 13:53:46,80
0xe893c57b72a483ce21568e0b1b09643cb7841018015d3fefde728fc8c86eb4ca,t,21000,2671704,,5000047,2018-01-30 13:53:46,81
0xd8fc530d40a2fbf092a78909532af478e9cda0732fd27233da2f1315fb5187fe,t,21000,2692704,,5000047,2018-01-30 13:53:46,82
0x601f53903d3fb10fcbb56573d380b3fc7cf0208e153b39b6da0c3e2d468e628e,t,21000,2713704,,5000047,2018-01-30 13:53:46,83
0xfc0d498899435f52faddfeac6b947099bfbc0fd062af2599e7906e23e4ec8162,t,21000,2734704,,5000047,2018-01-30 13:53:46,84
0xc65aa90bd1ff0115804038a3f9a192b30cbde3af8ea17b73e9cbcaaa6d0e0486,t,21000,2755704,,5000047,2018-01-30 13:53:46,85
0x33b17baac31de21e1bfcd3220fac2e7a8bdf2af2c682a36153e1617f3b888565,t,21000,2776704,,5000047,2018-01-30 13:53:46,86
0x739dc5d844ed643328b12e9fd63f7e343cc17d4c4e286abb9e8ee71f89c2382d,t,21000,2797704,,5000047,2018-01-30 13:53:46,87
0x9eda26d37e86f53076106d2f40037811543804fbe8eb48f9303ea419ea097aa0,t,21000,2818704,,5000047,2018-01-30 13:53:46,88
0xc38ab7f9efadcb71d8206f3ea1564643fa2c8feb50fe4e41535b8e8de14a7a6e,t,21000,2839704,,5000047,2018-01-30 13:53:46,89
0x02d5aa317703c50cb8298281a3c4546825c43ae5d1858fb93bac3766e21aac02,t,21000,2860704,,5000047,2018-01-30 13:53:46,90
0xe62539dbd6ca8cac9ae90229eba0f175deb298f05e87a3b05e28e288d45fa81e,t,21000,2881704,,5000047,2018-01-30 13:53:46,91
0xbabf4e647a3f8b10a78cf0ae6a4549b947bcfc8095ae19c128cd79bb99a76d92,t,21000,2902704,,5000047,2018-01-30 13:53:46,92
0x5ed59714accd06c681e14e1b6272cb101f1e7eb38741c44e9a85baf2d5e57367,t,21000,2923704,,5000047,2018-01-30 13:53:46,93
0xef52af6d72f10f5a2f7df32e9bc2add2cb48cad3e81e9558d2b61d9c8dde1bdd,t,21000,2944704,,5000047,2018-01-30 13:53:46,94
0xb4594af7c16723b717462de3e89832fa51c48950d36345339a423989af803374,t,21000,2965704,,5000047,2018-01-30 13:53:46,95
0xeac10e66e7ae287542df54a1d3eabfad69d58ab124f3720ef7ebb979719558b9,t,21000,2986704,,5000047,2018-01-30 13:53:46,96
0x008860be0e89552fca55e54a8ff18319500becc984e93dfd96e79551b54a0965,t,21000,3007704,,5000047,2018-01-30 13:53:46,97
0x32ad7144c703b06070af325e8d867ef6ecc701968c45601c1152aa79ea401f09,t,21000,3028704,,5000047,2018-01-30 13:53:46,98
0xe2e7bc059fd18aa60ea3b55ac70e8286429a07fe3778f814348ca7a9d6b6e0b3,t,21000,3049704,,5000047,2018-01-30 13:53:46,99
0x4cc405c184b4fa62cd8e6ee4f76dcaaad577008dd9c4eb5d9262a2265e872dfa,t,21000,3070704,,5000047,2018-01-30 13:53:46,100
0x5b12330228db04ec5144098f0062122b9f44b543739972da77579e301d85896b,t,21000,3091704,,5000047,2018-01-30 13:53:46,101
0x2c99c710dfac4c9b7b82bc8926ec8201eab781a1ae74f04f9c827a3fe953a3e2,t,21000,3112704,,5000047,2018-01-30 13:53:46,102
0x64a1d0072136b6482aebc4e6349e980f6b7b852c7e0cff22d7eee4a47b838b95,t,21000,3133704,,5000047,2018-01-30 13:53:46,103
0x7d3aae25ee03fbd70286eb11de437befe36deef24535785edc974975187edc49,t,21000,3154704,,5000047,2018-01-30 13:53:46,104
0xa86e0b9b4446f7049737d53cbb64b213ed8b2849a826d9e3c2f79119b1749ecb,t,21000,3175704,,5000047,2018-01-30 13:53:46,105
0x5b0c3dd51df6fbd739dadf0b7eb6ffa7e61d73120f2ec29f17ffcec2364dfa8e,t,21000,3196704,,5000047,2018-01-30 13:53:46,106
0xe884a8602b62d04d33da8777e8ba22a2ad067d622a5f5ddbd15e4c139f69cfc7,t,21000,3217704,,5000047,2018-01-30 13:53:46,107
0xaf06b3fae42afde810fd2c8ad35977f52d17be24a4833cbe91d340593677067e,t,21000,3238704,,5000047,2018-01-30 13:53:46,108
0x60fafeb676e3f7d0a4f47d4aaf2c8183b8ef590af2d60d4cff39833f7674a806,t,21000,3259704,,5000047,2018-01-30 13:53:46,109
0x48af65a2baf8c7d041ac5c9326e264a6fa8de095ebba0099f4857f9669c0e09e,t,21000,3280704,,5000047,2018-01-30 13:53:46,110
0xe43cefa7dfe5e16da9089dface6f86d02d108a399bea5a0656230c5407f44f34,t,21000,3301704,,5000047,2018-01-30 13:53:46,111
0x457dd47b25af784ed49714cfc78ce1f89af75b2b89ba4acc2d7cdf7a1e5ad253,t,21000,3322704,,5000047,2018-01-30 13:53:46,112
0xa8ce29cb3068d414941b25952418a738fb2a06da7be6e9259faa10ba12bcecff,t,21000,3343704,,5000047,2018-01-30 13:53:46,113
0x9aff872299ee59fb13bd1097a6eddbd26824bf50197dcb2b6264cc47e5e12b5f,t,21000,3364704,,5000047,2018-01-30 13:53:46,114
0xa3d6611ef43539e731a71227906d5c5232a11e13b7b91f7e9d5f97ec3e9421b0,t,21000,3385704,,5000047,2018-01-30 13:53:46,115
0x78e7c2a20370e1012db56c1e5178e4979f86b8fc1e195b4ca33618bb4bb044ff,t,21000,3406704,,5000047,2018-01-30 13:53:46,116
0xac07d0df25161a9c7de9dba147bf87e0c02e5769748cabb0ad072f072ca4b279,t,21000,3427704,,5000047,2018-01-30 13:53:46,117
0xa42a455d10ef844c785d271b9d7b9056eb9ec6c1abeb86b61472550bc6ef89dd,t,21000,3448704,,5000047,2018-01-30 13:53:46,118
0xc65ac2aea3de5b846496dff9e988d3f327f8d105cfde00d085a5b991518f5f5f,t,21000,3469704,,5000047,2018-01-30 13:53:46,119
0x0015a3d088ecfc16619c774b88f9cc638c1dbb728dd3ab89107a84d8781c0381,t,21000,3490704,,5000047,2018-01-30 13:53:46,120
0x9abbfdbe9c9107a3d79a00675b59e31fe060a15d4fe2666902ad07c3d1edf8ad,t,21000,3511704,,5000047,2018-01-30 13:53:46,121
0x19aac5f81ac1f97250c19dc95a82614bbd428cac53302d12709dca2257be665e,t,21000,3532704,,5000047,2018-01-30 13:53:46,122
0x0bf99aabfe30d34be97e0e80f368aae903c53346e32b6f06595c6a17827f22e0,t,21000,3553704,,5000047,2018-01-30 13:53:46,123
0x2d7a646aea2146b86c50b643edd1d727eb9491af6e644545cd6d62e2028969ae,t,21000,3574704,,5000047,2018-01-30 13:53:46,124
0x55d878859eae078f829bd5bf8a3c023a8997644c53e2614082a8e30b4c51261f,t,21000,3595704,,5000047,2018-01-30 13:53:46,125
0x5548d4613da9d7abc8cf57bdecbc24e3b8b9b1cde6241b566c709b283a4ce882,t,21000,3616704,,5000047,2018-01-30 13:53:46,126
0x4128bf3420d3a73bfe3142c7c0f979d6ef1541fcb84a02fda462335b5d386d71,t,21000,3637704,,5000047,2018-01-30 13:53:46,127
0x3deb70046593a0818ad64b27df9800ad9758e16910734dae4f40ec1d1bfbdcd5,t,21000,3658704,,5000047,2018-01-30 13:53:46,128
0x60c60163b66a1554cac42e30df73abd6bffbd62b613327bed5ac54ac38e7e61a,t,21000,3679704,,5000047,2018-01-30 13:53:46,129
0x401ccc0a501171249c30fd00a512614863262ffdfc14d2c8cdfa91e5b5afff6f,t,21000,3700704,,5000047,2018-01-30 13:53:46,130
0xe2ab92b36c9d47212c42d1ea2ed71f1a6281b2ba6c1f9f1d358e5b75ae495112,t,21000,3721704,,5000047,2018-01-30 13:53:46,131
0x9cee34fb7d4a12941185d891aa020770869a45467f7f05f70c86ee00421c1396,t,21000,3742704,,5000047,2018-01-30 13:53:46,132
0xa59b1d8bafae76f262314a4c5940096145e0b6cdbbf9ce8fb923d47fcddc9588,t,21000,3763704,,5000047,2018-01-30 13:53:46,133
0x9b78a293fc218e74cd517a9560fb478f2eefe065c55a0456ee9a21aa8f6d817b,t,21000,3784704,,5000047,2018-01-30 13:53:46,134
0xdb0940378dd5ca944ba84cf78d5e137e1e93a523e4050c6c93807a31786b321e,t,21000,3805704,,5000047,2018-01-30 13:53:46,135
0xcae309d3e6b079cdc938b6b5a8810e71bb176af2f90fc265e1544e14953d15af,t,21000,3826704,,5000047,2018-01-30 13:53:46,136
0xb571db10f26500f69ac9ed1fd6ac6d430ee07d676f4401ebee6c5bbfb2d0db96,t,21000,3847704,,5000047,2018-01-30 13:53:46,137
0xc87dee6ec7272264dc6d1568f797ed3ccf99a63e0b490ac4529dc2665d9533e7,t,33705,3881409,,5000047,2018-01-30 13:53:46,138
0x75216b31aab122c02129e981683385b1dc9ce93786866b3e6b6a7bb89eb9d56a,t,21000,3902409,,5000047,2018-01-30 13:53:46,139
0xd7610e05a4e1578a7aeb80064ed0374b5659d4e5115cd45d459af687090d0dfa,t,21000,3923409,,5000047,2018-01-30 13:53:46,140
0xc39fe10b5a821c6609bb408d76dba1af588c4fcdb5dd2caa78dd6fe7b03aadbb,t,21000,3944409,,5000047,2018-01-30 13:53:46,141
0xac158ad586cc98c947ac7739405c1cf8ff1bcb904bf280617341a63d2cc35f67,t,21000,3965409,,5000047,2018-01-30 13:53:46,142
0x193da3052c3105b13bd31bfc1c4e758a0899a237ca691fa292e59cb0f5f3d4f0,t,21000,3986409,,5000047,2018-01-30 13:53:46,143
0xb36767e2297a95f3c0c694a848c30a25d7e8774f28b5a826af0ff1d65103b96f,t,21000,4007409,,5000047,2018-01-30 13:53:46,144
0x9e4a2244d52e703c15a2f1a8aa986663a4f24f1498bbe15757a1436968811d13,t,21000,4028409,,5000047,2018-01-30 13:53:46,145
0x281f95b3f940b6a5d6038aae780bbcdc21a9f7d19e5db7fbdbe5e301235069ac,t,21000,4049409,,5000047,2018-01-30 13:53:46,146
0x713231a48e056f2a032d4a0fc08bcb04b67d8a3f37ab896fb1181ac0e6488637,t,21000,4070409,,5000047,2018-01-30 13:53:46,147
0x79e0be9370d7dbe8cbe853bccb8ddd009a0ea6b86060b2deb754b4487a3e8a4e,t,21000,4091409,,5000047,2018-01-30 13:53:46,148
0xe635d1277e90c57d64fb5c139806de4b1c8c78c6a057700e24eacaf5120c62d9,t,21000,4112409,,5000047,2018-01-30 13:53:46,149
0x7ead24e15543cd02da53f66f0734f8f4111c4ddb2ef07a8217ffc5c0109af784,t,21000,4133409,,5000047,2018-01-30 13:53:46,150
0x7eff8a2c53fc9d2ec80903e0521dd1c8a4856cac13667a4416ddedb38e325ef0,t,21000,4154409,,5000047,2018-01-30 13:53:46,151
0x840f42dbd9271dc364b82f481cd5e49b21caa0c0da993f91d5dd90f6d9b58fe5,t,21000,4175409,,5000047,2018-01-30 13:53:46,152
0x1b962eafaf271fda49e929c2203d7aa2e69b035a7139e4f6f306812baf736629,t,21000,4196409,,5000047,2018-01-30 13:53:46,153
0xfb6851c16a8c6725b950675cdd147c8026febdac60f49bb2c889e0d3b883c1f0,t,21000,4217409,,5000047,2018-01-30 13:53:46,154
0x3a5f6d5679524884d0a3063a6e91157d851fe0cbf0eab0ae83a2f2d4114ba6d8,t,21000,4238409,,5000047,2018-01-30 13:53:46,155
0x71a724b55d8c1f452309fbac7f4727f72662d6c1bef5cede398f7b2c1ebf6578,t,21000,4259409,,5000047,2018-01-30 13:53:46,156
0x9f77374b082b8db9642e06b644c075a47921c8b5d1a9a688da1f0e00cea3ca76,t,21051,4280460,,5000047,2018-01-30 13:53:46,157
0xc4eb7811fd224de1e23d3be335d852af71cd79842d38b4deccb4ccb01e1ba7ee,t,21000,4301460,,5000047,2018-01-30 13:53:46,158
0xda323452c89da0d802e003d5230b04c18954274a7c5807f2f563468915bf9067,t,21000,4322460,,5000047,2018-01-30 13:53:46,159
0x7b6d839439466c3fb31fd3625f694503ad733f806a294285c3c869e94c0a4ab8,t,21000,4343460,,5000047,2018-01-30 13:53:46,160
0xbfb92be45475e40947e83c65ccc4829af79e5038bf586cd6b4f6396749e8fda2,t,21000,4364460,,5000047,2018-01-30 13:53:46,161
0xe5786bf57853f04f86d7e624c81b70f261ca36c0d6e0a2924c99028136fe7d8f,t,21000,4385460,,5000047,2018-01-30 13:53:46,162
0x1e4d3307f17e070b95cc496fd87c9246c17083a66a12b6e8211511d8937ee350,t,21000,4406460,,5000047,2018-01-30 13:53:46,163
0xba219c45afbc098336df908b5c980409fe5be51f630819da149e844d93a8d534,t,21000,4427460,,5000047,2018-01-30 13:53:46,164
0xdb9d8a29f5a224acc8d90da4b5d9aa7c21ac6b44e791ccf409d954d51689aa55,t,21000,4448460,,5000047,2018-01-30 13:53:46,165
0x0b25e483ab9ab9e0f7df4ae2c7c139b070412104bafc0a0ca643167268d9d0c6,t,21000,4469460,,5000047,2018-01-30 13:53:46,166
0xf4756d34fe3c184af4433818b8b2222bb78d1993d772c034d240a26f04dab2fa,t,21000,4490460,,5000047,2018-01-30 13:53:46,167
0xbe529b085d5824190c7c83f1d67af62b95dcdb86bad50f2bd676281fc819c8f8,t,21000,4511460,,5000047,2018-01-30 13:53:46,168
0x17d54bd79c244b5510ff5c76d9cedab630c83f15bc5c049eaf353cdbc2a9ebe6,t,21000,4532460,,5000047,2018-01-30 13:53:46,169
0xcf98d79179ff3dfd31cda3962266ddbe697d93e5f33fc60b323554f9d72d9d04,t,21000,4553460,,5000047,2018-01-30 13:53:46,170
0xd127162d67370dbd841efe14aeaa277236a46c515b57ef36d778f61d4d436430,t,21000,4574460,,5000047,2018-01-30 13:53:46,171
0x82a9bba797b101bfe02b2eb46f364a77bf246f8bef557d9fde3ba6c03152686d,t,21000,4595460,,5000047,2018-01-30 13:53:46,172
0x5f106658ba525aba03fa3d2dd614913ed0acfbd6fb6fd8a50ce39a127262a05b,t,21000,4616460,,5000047,2018-01-30 13:53:46,173
0xf11dcb6e548857d81611cc4175f5dbc1503c31cffdf6ce8ee28a33f6c5b72c09,t,21000,4637460,,5000047,2018-01-30 13:53:46,174
0x25fda6e4206af55d3e7e55cb0f94092b0befee82473e2968c0f886b6e8c53d78,t,21000,4658460,,5000047,2018-01-30 13:53:46,175
0xe95cb9b00242feaba825f4eb6a03a13dfc6c720d1b3c372764f58ff84d168d65,t,21000,4679460,,5000047,2018-01-30 13:53:46,176
0x860a56b0ce07312b681519ba3e3fb4756ce7ee29c0e694a133c71af67ec04a02,t,21000,4700460,,5000047,2018-01-30 13:53:46,177
0xe53b9548f6b17c131565cd08e5cf1eeffd6aed9ea6f7f96a7c11ce031b8a80af,t,21000,4721460,,5000047,2018-01-30 13:53:46,178
0x7a107495c432497ea5fbb200efb545c96fc5928e0dbedfded0ac3b417c47e109,t,21000,4742460,,5000047,2018-01-30 13:53:46,179
0x86572adcf3ca28d3b699bfb67606a5b43338c665edde1f594979f9fed5fc2b23,t,21000,4763460,,5000047,2018-01-30 13:53:46,180
0x4a37b91428eab7b4f9c9562890009756c78ea65a8942b9280ee435e209d9a900,t,52075,4815535,,5000047,2018-01-30 13:53:46,181
0x1ee15782c2b880255036723e826ddc1d394afcdbbfb6f5d235b08f7d0f9680c0,t,21000,4836535,,5000047,2018-01-30 13:53:46,182
0x4fe0ceb4710688f6f949694168ed224760473c5d84793ffedf1c42dfcabdf1ce,t,24439,4860974,,5000047,2018-01-30 13:53:46,183
0x351fc45bfa98680e9b63fa9cb4e5f69fbf87b80bc8303d18d7a760c3c89b272c,f,24646,4885620,,5000047,2018-01-30 13:53:46,184
0xd78431c2221b01f4b133a691ba88c44368fc88d330df33da40179c015ac24e85,t,38519,4924139,,5000047,2018-01-30 13:53:46,185
0xa88186acc808c5aa4bc30d5ebb10a0056194708aa55355de5f250b4e5b110561,t,164716,5088855,,5000047,2018-01-30 13:53:46,186
0xf1b70ff69a22bd389b53935c92b79593e49df642834bced01e59f99b85eaa257,t,45983,5134838,,5000047,2018-01-30 13:53:46,187
0x4e3305f007dfd9d2e3f06841956b07efed4523fd659c159700ea5cf32c346114,t,140972,5275810,,5000047,2018-01-30 13:53:46,188
0x3d3403f4e16be2ad5e2c97efbe46ceae2975997ef1c86a5ebf460a3dd325d694,t,21000,5296810,,5000047,2018-01-30 13:53:46,189
0x5516d30fb5a48fa9b7c7708c368d2905fbe68aad542ca7e6621bf319b247df32,t,36756,5333566,,5000047,2018-01-30 13:53:46,190
0x9a2fe225c2763adc6f7f6b557bc11613ceaedcc8311125014d65be4211370057,t,37950,5371516,,5000047,2018-01-30 13:53:46,191
0x59f7ed2ab9ae827bd6437bd9313a8528bb7eaec214b569d44293ec77d419d286,t,31660,5403176,,5000047,2018-01-30 13:53:46,192
0x27c66a40ffdd695d195ffffa342fca2f09908c20ea11689515cb35903acd28ca,t,59354,5462530,,5000047,2018-01-30 13:53:46,193
0x70bacf5574092506e7c249538e8b0e80dc5618cc54ca182896ab5d635760fef2,t,23028,5485558,,5000047,2018-01-30 13:53:46,194
0xfa61ebbfcc2d7e943a91e194de847a8f8de1b3cece4908eaef32447f13f5ac7e,f,50000,5535558,,5000047,2018-01-30 13:53:46,195
0xcad246cc3f0750fa2f5d6b5562cc4956916cd15dc096ee26671cb5b45c66f77f,t,21000,5556558,,5000047,2018-01-30 13:53:46,196
0x088ab6d44c67134524a3fc59050cd611766b1acec8274b49dce4aaf0172d6b59,t,107858,5664416,,5000047,2018-01-30 13:53:46,197
0xa9d75987af3d5d8bcda681aa9e8f588f2b6310be5b692fdebfa5244d6fcb84c9,f,30000,5694416,,5000047,2018-01-30 13:53:46,198
0x18244297e3180f322577690ed06c19c76c41eea09cf90a71ab9a229eadb02172,t,23754,5718170,,5000047,2018-01-30 13:53:46,199
0xfb5d75a4fb84d8b53c97938e3fec7d89f4bc523f7ce0da888fe2da31bdfa81f9,t,21000,5739170,,5000047,2018-01-30 13:53:46,200
0xfe93e4edd8b583dc651c526622dbe91ddd9a4fb0d6006fb88192ed95e2a0969f,t,21000,5760170,,5000047,2018-01-30 13:53:46,201
0x81ee1347d0dca29c1e0b661a6901d7b5c93f9b53e9b57ea8bddbdf93b4ad2599,t,37193,5797363,,5000047,2018-01-30 13:53:46,202
0x8f7750893334d187ab8188e238f63697a72574c05b54172cbc5a0e96893f83b5,t,36942,5834305,,5000047,2018-01-30 13:53:46,203
0x40ab336b5d38991f758f8c36c425aa35a9dba40b0442470c8c0c622273f0bcf1,t,21000,5855305,,5000047,2018-01-30 13:53:46,204
0x10641162ebf609fb6960b27b90eecbd4622542fedf9a328a3de39ffe0556b27f,t,54379,5909684,,5000047,2018-01-30 13:53:46,205
0xc97747b6fe7b636fc52006cc8841b05b248fd0d1c5a616df774565ab8bf7cbf7,t,77283,5986967,,5000047,2018-01-30 13:53:46,206
0x0929eddabb5b90337dc42ef57a21d18f70e72b989a050fab196a6aad02be41fc,t,23316,6010283,,5000047,2018-01-30 13:53:46,207
0xdf57b894245dfd0489f2661737c77a5165f0fb34bf24a2235298d8f99acbb071,t,23028,6033311,,5000047,2018-01-30 13:53:46,208
0x4c09cff6e38714dce5eb501a4b4f14bd51338f5295a2d54ed2351dcc272d458e,t,22193,6055504,,5000047,2018-01-30 13:53:46,209
0x3b094d33366b37bc81de85a48cdfb5eea1f0942d91793b69bc4556ee8940e999,t,140340,6195844,,5000047,2018-01-30 13:53:46,210
0xeb2985573e100fb5fc2ca3ee0620fc346c1d52dd57a1e6e93a9855d0d8fa3fac,t,22321,6218165,,5000047,2018-01-30 13:53:46,211
0xf40b64c7df9e728798c0cd4b479247cc914d061c1238af92a051b61250218f35,t,52969,6271134,,5000047,2018-01-30 13:53:46,212
0x556362a3747b0f81ad2ab6df6da5e9ce79a60c48d885acb254fe54c0c1853a70,t,52524,6323658,,5000047,2018-01-30 13:53:46,213
0x8f1c875d071b312607c8e04db59ade046a46003ebd0e33adb6bc29fd39fe60d2,t,27200,6350858,,5000047,2018-01-30 13:53:46,214
0x35ab689841d186c9a7eaecc618b0d00aa9826a1b531779ed53a43be905ce0f34,t,21004,6371862,,5000047,2018-01-30 13:53:46,215
0x0da8eb436278f276acef7d3adbf89de88b8a7bdef08fb4cbb8781aab533e25ea,t,37091,6408953,,5000047,2018-01-30 13:53:46,216
0xd7df3945b59b5a4ee81ff24f679cb204185dc2b9da83bb5063a7f954200faf9e,t,102221,6511174,,5000047,2018-01-30 13:53:46,217
0x31947bdd6535d67e555ba31ad3d9298922c31292e774656c9eb3132a06877a45,t,43346,6554520,,5000047,2018-01-30 13:53:46,218
0xae92d4a9d2c224568bef3aefca9fd0f75dcbba5c0bcefcd3f044179d0f37a864,t,23679,6578199,,5000047,2018-01-30 13:53:46,219
0x8eb4194ba9263ee925b1ffe182d665e1d93b285c3471eda950bf39070ba257c4,t,21000,6599199,,5000047,2018-01-30 13:53:46,220
0xee740596274b2decf641e5dde38c9b516350b5d8366d2d5eeb35d0f7795b404f,t,36708,6635907,,5000047,2018-01-30 13:53:46,221
0x33fc58961146df979e492ee0075b34b78b30d5e82318eca321ed4f82c884a82e,t,36621,6672528,,5000047,2018-01-30 13:53:46,222
0xa107876d7d5f1afa4679f051cbfa6150f85c9b69fe1222a15f655f7ba3d01e14,t,21000,6693528,,5000047,2018-01-30 13:53:46,223
0xfc770b540e1e42d6517d372a2626550355169f7df7aea9c8e46f3cf231d3fa4e,t,21000,6714528,,5000047,2018-01-30 13:53:46,224
0xf867c1ceaa2a940574defbade8b42714662e200afcdd90659df77e0a3beda99b,t,21000,6735528,,5000047,2018-01-30 13:53:46,225
0x749b77afa217eaeccf929005510e558b22cbdc0ceec64d598bd5bb24c913ff20,t,97817,6833345,,5000047,2018-01-30 13:53:46,226
0xdae0aeb0119a34a87fabc646d50655f4548d5ff0cade34c4867053451d49dc4d,t,21000,6854345,,5000047,2018-01-30 13:53:46,227
0x74d8a718720e234bab931b26391439e375e4bc22b7e12d7e60ded483be68cd13,t,21000,6875345,,5000047,2018-01-30 13:53:46,228
0x5cf2da5a88e4391f8f265c4927eb60ca2cb3e384675a876d4581881671e0529e,t,22460,6897805,,5000047,2018-01-30 13:53:46,229
0x8de7ca1dd89cb486189a658a28b76ba48f4e3e91ee000947773e92c3e0a9d32f,t,23382,6921187,,5000047,2018-01-30 13:53:46,230
0x46f1842bf5de72c3f1ca8637d66b96315ac4b05820a2d3499145c3f71e55f0c9,t,22380,6943567,,5000047,2018-01-30 13:53:46,231
0x1d9ae17ba9ccbfea19a6659d7948cbf74455cc9c5103134e3300632d93c1f447,t,22976,6966543,,5000047,2018-01-30 13:53:46,232
0xef66dcb4392599a9f80d605f7c4318e8c8205fca8c577244c9f2b9f9db52926f,t,23382,6989925,,5000047,2018-01-30 13:53:46,233
0x8ee1b1697b959a49d378495fcab75c826e197b3e55aaf2cf5e61814729e18e99,t,22316,7012241,,5000047,2018-01-30 13:53:46,234
0xee78cb55969b3448723aec3806a2f2b2a84c09d6bc246a664402c93e2093d9fc,t,23318,7035559,,5000047,2018-01-30 13:53:46,235
0x97b7116f40676c948c4f0811557757d5b314b57e75a0f328879c062d6fee4d54,t,22460,7058019,,5000047,2018-01-30 13:53:46,236
0x40571df268f9ab8e46c4f3252336b4b8ff8083a4cf437b3c157825e4d2bce237,t,22524,7080543,,5000047,2018-01-30 13:53:46,237
0x123824bd7cfb2402b463c8bf7587e94af5e118111eead0bddb0575919882ddd8,t,22158,7102701,,5000047,2018-01-30 13:53:46,238
0x8ca89b2de6a6c44587867ec2cb96af14cf27f4b085057f904dcc5808cd4d5733,t,22460,7125161,,5000047,2018-01-30 13:53:46,239
0x0cb06ddb3f584a29c4c7b25f9631914fec57fcb12ebf38fd9f0e4e132f6096db,t,22524,7147685,,5000047,2018-01-30 13:53:46,240
0x6ad73255ba80b315d2bd1c0f344b9dfeeee1294b56cdb97c50e0da6eecc7e81b,t,22380,7170065,,5000047,2018-01-30 13:53:46,241
0x1130508e34810c4c191a4fcc36d166815e4ec682a5adac82640bdd9afee1500d,t,37529,7207594,,5000047,2018-01-30 13:53:46,242
0x946e16b27538add865169b8bbbe2f189b4da79d24143df7ea1cc5d7d9576818d,t,22976,7230570,,5000047,2018-01-30 13:53:46,243
0x2079a40f5c1ad7180113ac195cd19bfdfc926c2a8bdee566dce63432053a91e0,t,22524,7253094,,5000047,2018-01-30 13:53:46,244
0xd61513600244a9227cded9bedb89fadb334c85004489395ff1e749e1f91d2241,t,23104,7276198,,5000047,2018-01-30 13:53:46,245
0xd3b53c455ddb86523f715e29540b2f7101a6d0fdad1ce6afc43f439e8160fd8c,t,22380,7298578,,5000047,2018-01-30 13:53:46,246
0x673a4c88e9665893f56d6142153b19c28f8e2ace0903027829b0f020f1155270,t,92730,7391308,,5000047,2018-01-30 13:53:46,247
0x26f504d587445a6f23088e916289d48deb3b32b1b0fde21df2f3c0ca56f1e738,t,59418,7450726,,5000047,2018-01-30 13:53:46,248
0x261439e7903029fc773ff222454815b0e933b5284c9a08987d3c080564a367cb,t,21000,7471726,,5000047,2018-01-30 13:53:46,249
0xe9c9da59d932db5302484fa1f10f2cf82fe6d78544f32db1f5a7a17609fb0e8b,t,45591,7517317,,5000047,2018-01-30 13:53:46,250
0xfc0ab8f0b774babb20b3f4eab4fc809b24c0f7ca6c00c3002bca634e4773337b,t,165468,7682785,,5000047,2018-01-30 13:53:46,251
0xded3261dee4886791c1abe4f495c9e289f021061d78567ea19061a6394f2b819,t,79985,7762770,,5000047,2018-01-30 13:53:46,252
0x468870fcad0bf317485427ebfdbad922592da61a232ffc7d909ffd1ec862651b,t,21000,7783770,,5000047,2018-01-30 13:53:46,253
0x13654e6edcb2c19ed8140a66fba3c26d246d658207ff0a76e87a27d19145adb7,t,21000,7804770,,5000047,2018-01-30 13:53:46,254
0x6ec8daf6f2ad19b4ac10c12b895e70f4c7cc61a6f22db6d6db7ceae4b654990a,t,69376,7874146,,5000047,2018-01-30 13:53:46,255
0x65d856fa8f65c7d76b255b12c3fdda1b0c5a91df9c5461eee5e4e3f638e4f1c8,t,21000,7895146,,5000047,2018-01-30 13:53:46,256
0x6ae8b5e5a28f6147403d8216f331bf1bee7e3148dd612d8104e5a8a14db25c54,t,21000,7916146,,5000047,2018-01-30 13:53:46,257
0x245b98d0d1ca57c47bb1d4f9d548c03fd65dd9ad5827be7bb2cf3a48d96d96cc,t,52344,7968490,,5000047,2018-01-30 13:53:46,258
0x66e328a4655ddabbd6856f3ce26ed1168d22a897833e1c014a061043e655ebcd,t,21000,21000,,5000048,2018-01-30 13:54:04,0
0x72c23fbf707678b9a66dfb608c9a3eb6bbff8bebb387b85a330f126924c99bdb,t,115658,136658,,5000048,2018-01-30 13:54:04,1
0x6bdfa40e8e99a6fe5912ae40fd119d5e03e18bf6c78d1aa29d15543d68a18cbb,t,21000,157658,,5000048,2018-01-30 13:54:04,2
0x4bdf03af35eaccf322d8a01d1233f802e245f5ab57e6538124729c813e06360b,t,21000,178658,,5000048,2018-01-30 13:54:04,3
0x9f50ee46aef55c49538f6fc562eb528e6a573b79dc06202e08f18921546d73d7,t,37155,215813,,5000048,2018-01-30 13:54:04,4
0x7c01d7c0b77fee1cf782fb24bf8013c319347f30f97f5c7547fc1414344d4424,t,36537,252350,,5000048,2018-01-30 13:54:04,5
0x597008157900e716caca494bcbbd1084db6d124ff2877a2af858b608f9e2464b,t,21000,273350,,5000048,2018-01-30 13:54:04,6
0x83467e3fb713cda61aa76e2b5b13e09c29dcec016b0d3b95e14f70913d3b8706,t,50057,323407,,5000048,2018-01-30 13:54:04,7
0x1abcbe62fb48c37b98174525813fea8620ca0800f2c594b1ca6ccc02ec74209f,t,21051,344458,,5000048,2018-01-30 13:54:04,8
0x5be5198c1338a0f95aacfa0d91e8ef06d294bc2258be59fecca3f0547a212f3e,t,21000,365458,,5000048,2018-01-30 13:54:04,9
0x24cbc6e6de6a02cea536ba1be3be9802537925b50d1bc09647081ab4dd1499b0,f,250000,615458,,5000048,2018-01-30 13:54:04,10
0xe74dcaaf596933f7076f590e70aa8106178f74afe8c6f157cfa9c4ed245119b4,t,40843,656301,,5000048,2018-01-30 13:54:04,11
0xa18b693c496b72723cb77cde4354339fba62c0ec7f56224e7989b1a50752e224,t,21000,677301,,5000048,2018-01-30 13:54:04,12
0x0ce3d85e3d378be68d77c9873a8f0b099aec783795a597e89a6ada6e00c250b1,t,21000,698301,,5000048,2018-01-30 13:54:04,13
0xaac9f452ed417740d1df1717156d712f5738fa6c4a78a8a33f9659b1cb9268c0,t,45629,743930,,5000048,2018-01-30 13:54:04,14
0x2c2b4fadee0fdadfb9e210d695d1fe05039bff1800fc6fb5f0ffc04e402f621c,t,21000,764930,,5000048,2018-01-30 13:54:04,15
0xdcf7c1a5e273b3c6aa93ab737554cb216a0d6c5bc1dcdd5a996ba23f9edec1ce,t,43812,808742,,5000048,2018-01-30 13:54:04,16
0xdc0793d5636178f3670eeac1e5114d4fedce1b867fba380ac6342c5e60dbec5b,t,26461,835203,,5000048,2018-01-30 13:54:04,17
0x095c72708c9384734398e5d395cab59eb7e9fb243a33d313e0aac175bcf58515,t,21000,856203,,5000048,2018-01-30 13:54:04,18
0x3ad506cdcf5db8ccd8a29d5449ad2a837e78690e475c08e58c49b839168ac1e4,t,21000,877203,,5000048,2018-01-30 13:54:04,19
0x56e8e35fb1db32a8315f1086f133b32371bdb5fd6b0789c8f873e8f0f5bb28a0,t,21000,898203,,5000048,2018-01-30 13:54:04,20
0xda0169ddbd9fa79b0afc4af44a0250af133ea9db66dba13d35496ab5b1331fb7,t,21000,919203,,5000048,2018-01-30 13:54:04,21
0xc96f6fe95c2e2b8d3a3c0caecdd96bde8836cae31b53ce8bb8bec93df6c23fdd,t,21000,940203,,5000048,2018-01-30 13:54:04,22
0xc6caa746e51829d6dfef9d57efca4722f1d446d4baf6e1d2bc3c0b8c3a8d9c44,t,21000,961203,,5000048,2018-01-30 13:54:04,23
0x0c9df0e66b7b5803a4f2a940e797404784858a79aa917214919de2c8ba590095,t,25843,987046,,5000048,2018-01-30 13:54:04,24
0x78701b8b98584aa3ceca16e61705150033cb1a278db7925e914563ffa7d662b7,t,40907,1027953,,5000048,2018-01-30 13:54:04,25
0x841f530d97c8138439b51bf21bb63816f1c452c0f2aa7294ea89ab82363cfe90,t,40907,1068860,,5000048,2018-01-30 13:54:04,26
0x20e88374e45ae744de78e272e5e962c9d0da2279527a137c893b0ef2327c468e,t,52460,1121320,,5000048,2018-01-30 13:54:04,27
0x2e31a76c1383203aaec80af1956cad77f9d36472881809f38ae6b285328c86ca,t,51718,1173038,,5000048,2018-01-30 13:54:04,28
0xd0dbb526abd849342850f8cd4fa0995e93e3733cd90764c8d4ef70407a66695e,t,38233,1211271,,5000048,2018-01-30 13:54:04,29
0x5d275ed90b1637c586651b3b6092bc0a8ef81254be8000f082d99f40e311967e,t,101614,1312885,,5000048,2018-01-30 13:54:04,30
0x234e90af02a139f3a7cafef4a4593f3de3b699f161d8d513313055ada3ede8cb,t,21000,1333885,,5000048,2018-01-30 13:54:04,31
0x9a3be20bdc1efd93f731291e04f7592dd2b284463c6cc40cde4f792ff8cf4987,t,21000,1354885,,5000048,2018-01-30 13:54:04,32
0xb17787d8bafc673403f9291142ca15d6013228b0396c9ce684659be1539bb295,t,142516,1497401,,5000048,2018-01-30 13:54:04,33
0x7015d1a192a9f428f6e44643937dfd7ef26eef288881139b00acbf72d30cad55,t,21000,1518401,,5000048,2018-01-30 13:54:04,34
0x54595e607ee88c25d6fb17fc1d684b9a766b9195a096c2ea579a7b43ba8681f3,t,51542,1569943,,5000048,2018-01-30 13:54:04,35
0xec52089a40aec9ec38bd9c28b04383f28ae458e4a47be6e57ce55aecc2519f7b,t,40843,1610786,,5000048,2018-01-30 13:54:04,36
0x8245b9d30191545e290c82f4143e9f8951d87946f6b807ea12fe3ddc4312bdeb,t,52094,1662880,,5000048,2018-01-30 13:54:04,37
0xac7472305d3db82169ac7e8498bb54cd066505b6385e15f3473e29feaad2ad7b,t,37158,1700038,,5000048,2018-01-30 13:54:04,38
0x5ade9a474e21437ac009895db5227c3f5d460526f148bae3275618940dc267fb,t,103563,1803601,,5000048,2018-01-30 13:54:04,39
0x4a74579bff7b7def426af6f5af86f037a9c4b2ec2691e8aabf5a4ab41e97bf33,t,52886,1856487,,5000048,2018-01-30 13:54:04,40
0x9e3071db92b3b2dded73c605eb1f9b828192f78bdd9f049c2403c96db2cbbbd3,t,37109,1893596,,5000048,2018-01-30 13:54:04,41
0x1e304d71067ae9e16baf8cfe6521b832cfafda9f0f1aa1767969d9c7ac918623,t,21000,1914596,,5000048,2018-01-30 13:54:04,42
0x016b8c76c4215874cdd6f486464a40fed98a54efe8d4407bbddb1f2af82fe035,t,22142,1936738,,5000048,2018-01-30 13:54:04,43
0xd24e20f22fe1c86d05f4129c8004f87f85ce0f88d9b41ce0a4307f1162ce6b9c,t,21000,1957738,,5000048,2018-01-30 13:54:04,44
0x77328844510ef48c3e701509e405407730bea12f34de9473f0ba52c2ff6b8f71,t,22222,1979960,,5000048,2018-01-30 13:54:04,45
0x57997a32e146f3af75ffbae5803542f08c745a46f0fc4ce27f8dbe1613b6d294,t,37252,2017212,,5000048,2018-01-30 13:54:04,46
0x5c21f1361cb74eac2ebe4bcc81aefd2daea916ac9109539d189d5afbb9243e05,t,253854,2271066,0xE90F7D515903eD8a27bf7d3DDF4EEB6146dA6Db5,5000048,2018-01-30 13:54:04,47
0xc263c4d355b7eb4dad885628cb01f957c6b073a22443f36c768d53ef1d2a6f6d,t,53103,2324169,,5000048,2018-01-30 13:54:04,48
0x6d8a3f6eb7cabb33013e80abd5608b38ef6cfad5a95368e128d9f8f63813e7b6,t,67677,2391846,,5000048,2018-01-30 13:54:04,49
0xa957152248f2ae78d5b79c1ded82b3743cf0b451971a44401a79779b1a673a64,t,21000,2412846,,5000048,2018-01-30 13:54:04,50
0x6e5f54bf010561a8e8b5c716fb4bd08724be9d26bb2448a7a069e6cc2c0c1e0e,t,21000,2433846,,5000048,2018-01-30 13:54:04,51
0xaa716405738ec90f21307502f89d8c2a9e7de40c894e953820b6552fec31d71f,t,21000,2454846,,5000048,2018-01-30 13:54:04,52
0xb173a29f55c28a00794a0ffebaa3f341fb5ff51402fadd48bc9d8cbc26500f89,t,52267,2507113,,5000048,2018-01-30 13:54:04,53
0xd309664281038fa325c48f5bf0e54e5d84d4e6167094e2a16aede91a48992f59,t,21000,2528113,,5000048,2018-01-30 13:54:04,54
0x6a68ed9e9ac0354e629d647fc92eddecb536d9666c1c068fc24680ddaedd5f1f,t,21000,2549113,,5000048,2018-01-30 13:54:04,55
0xa1549681bcccf170641a1cbb259b7cb8278be2c0f447c38159c67eac2788b8e3,t,21000,2570113,,5000048,2018-01-30 13:54:04,56
0xdc5ab9b84c4d3068ee8bb1220b56110d36cdde841233761029535dbb2b4159db,t,21000,2591113,,5000048,2018-01-30 13:54:04,57
0xf05d59e0817fd3942022319f9e8d7578455f3ce38c124ffcfa209e75a52cfdbb,t,21000,2612113,,5000048,2018-01-30 13:54:04,58
0xee2be8f36cfe84df51ed5494dc4084461e288996ea90cf8cfc9c62241744b1f1,t,21000,2633113,,5000048,2018-01-30 13:54:04,59
0xbe5c007972580500e0bd6e59ab7f2cead0760b8ee84874328fd9820442e6f044,t,21000,2654113,,5000048,2018-01-30 13:54:04,60
0x12cb298dee2e8e9e00cb413c4d1b252522b118de115f36df5bc9c93f022c49fd,t,21000,2675113,,5000048,2018-01-30 13:54:04,61
0xa4fc0607ce0aa6bd5b59e6451d92955be9bd2071533020fcbd4d0668ec21595d,t,21000,2696113,,5000048,2018-01-30 13:54:04,62
0x8424b6c6cc52918b62e9f50693b2b2e3d3559b9e64cae16391577d456d2324c5,t,21000,2717113,,5000048,2018-01-30 13:54:04,63
0xd4134250ba30edea269f5c14d3c6f00f69863ffba7b57aca03f199bfb2668e4d,t,21000,2738113,,5000048,2018-01-30 13:54:04,64
0xf07358b6db4aa02d9a9813f78cc8d1d76f4dd2327ed2127c1d204ea315b30af3,t,21000,2759113,,5000048,2018-01-30 13:54:04,65
0x19b1ec156ea1ba82cdc0c77f953c1ad96c7f908f401a61abc18b2273b3c78996,t,55907,2815020,,5000048,2018-01-30 13:54:04,66
0x184bf2b1d0f457cc8ed9d7fccd978cd90b88121d59f7b45c97defff0cee6be70,t,36792,2851812,,5000048,2018-01-30 13:54:04,67
0x67e19ecfd26536d45c1ba11cf03f1255cf020ad0d606bee6493af132d1090242,t,21000,2872812,,5000048,2018-01-30 13:54:04,68
0xa76c41445a776395fad7b9d3251528e4026c4707397ce849aefc44f2e21ed813,t,21000,2893812,,5000048,2018-01-30 13:54:04,69
0xb41cccfee3bddc8e6f166b6186022383e44fa8374d9d343ed43ff01ed8d8434c,t,21000,2914812,,5000048,2018-01-30 13:54:04,70
0x9ec277e307baed77e801b3135a16735315d9d454b90382a25b1df9db431ad2e3,t,21000,2935812,,5000048,2018-01-30 13:54:04,71
0xc39c1e5fb17b5e3363c1aee826a0e4e066c2fda990cb4824597f8d3114eab188,t,21000,2956812,,5000048,2018-01-30 13:54:04,72
0xda1819a6476678d9244dc277550b8bf0a41f1c834a1a00fb4bf1db13a8bf3d79,t,21000,2977812,,5000048,2018-01-30 13:54:04,73
0xaf1c7a5315d36d4dafad2e5f97d028c82022d4fb8f88384518290d24486b4c9b,t,21000,2998812,,5000048,2018-01-30 13:54:04,74
0xf75f188dd2d421074012e8d96cece856d13a0cc5ac514e16433f2129866312e8,t,21000,3019812,,5000048,2018-01-30 13:54:04,75
0xe0268822ffec972d221fde68d646fadc39fe8c9f8f7727f054464eeadefe9b0a,t,21000,3040812,,5000048,2018-01-30 13:54:04,76
0xbbba4979201eeb7778657f77f938fe9685c223708fbe4dd663b09494b7e70579,t,21000,3061812,,5000048,2018-01-30 13:54:04,77
0x8a9005ac3116136605c4a16e6eb70cde4ce527e4306b28b499b64509fa2a0297,t,21000,3082812,,5000048,2018-01-30 13:54:04,78
0x349d87e75dba55c8609e692a3cb260ab0cd88669b7ccb151028259cf154c17de,t,21000,3103812,,5000048,2018-01-30 13:54:04,79
0xd92bd326509ab1f4a0e74065d78373b6e7244f38d6355afb9e6b03a9b0771aed,t,21000,3124812,,5000048,2018-01-30 13:54:04,80
0x44c9303eb32453a0d118a11c1f263c16acddd22c87fe6db277efc99f5dbd8495,t,21000,3145812,,5000048,2018-01-30 13:54:04,81
0x3cfbc4a639887d856838e04c1eea1fc80ed1ef2bf21a2418b67b125f1e6c801e,t,21000,3166812,,5000048,2018-01-30 13:54:04,82
0x8cb58d60a0f33c4f52118470f76b660c33e8ab092b5140823ead41337e337999,t,21000,3187812,,5000048,2018-01-30 13:54:04,83
0x08d3007dec0cbf59385ab348b5f88f9c4ef11749c83058189e25b95c75ee384f,t,21000,3208812,,5000048,2018-01-30 13:54:04,84
0x353aee40968e3809f1e1c6126ffcc5d7c102ef9910724b79a59da696da3f7813,t,21000,3229812,,5000048,2018-01-30 13:54:04,85
0x7e4e99fba6fc6410dc230db55381248641a79d5a4b5a8f6d5c7435c8f3ffed08,t,21000,3250812,,5000048,2018-01-30 13:54:04,86
0x99242e6dfd7627eb4597dc5dedbd08ed87497744e773282057de937b8701c167,t,21000,3271812,,5000048,2018-01-30 13:54:04,87
0xe2e1c489d338759709040d1e38beb18216d29a0952c9a984acca8626f66c174f,t,21000,3292812,,5000048,2018-01-30 13:54:04,88
0x09a3a69b35bda46e0c1d01d6e09cc46d6dc15a93e3368526409acb6711535be6,t,21000,3313812,,5000048,2018-01-30 13:54:04,89
0x7121f91e959f08620f40a64784f0f1363fcfdd8138eea026a5380d3e13c5c843,t,21000,3334812,,5000048,2018-01-30 13:54:04,90
0x145f83ece00fa96193187d77fa7122dc9a252cf634968932cf3c6bcee2e26348,t,21000,3355812,,5000048,2018-01-30 13:54:04,91
0xe66bd773f8642cf8db09e234e07a8811ef360dc2eb2c67728075252df37dea1e,t,21000,3376812,,5000048,2018-01-30 13:54:04,92
0x5024406824d65e5ace4007330eb7f26da40d8b4b40621ff903cb2147a465fd47,t,21000,3397812,,5000048,2018-01-30 13:54:04,93
0x01e5b7d33608eee97a9403c27cbb14864406da55761e6bf1767f549cc6235a22,t,21000,3418812,,5000048,2018-01-30 13:54:04,94
0x8e05caf8b91a1683d90557ff021a4e11713977dd1756535532e52a00723d5c52,t,21000,3439812,,5000048,2018-01-30 13:54:04,95
0x7d631f73ec8f4fd69924ff253ec2f9033627e4a215270f50c3f4b96ce3990de3,t,21000,3460812,,5000048,2018-01-30 13:54:04,96
0xd944ac53141d9147b5ec80517b99df5f2293d2d35ad7d9dbe387ce0aaef88eef,t,21000,3481812,,5000048,2018-01-30 13:54:04,97
0x0cfa049fb3cd4daf133543940e736d3c05f2bc0f1a5304e6af8c5f4947e2da4f,t,21000,3502812,,5000048,2018-01-30 13:54:04,98
0x0681a9f8a9498348d38d28d62432dfcc3c3f891ba1725b5d2f2e65a9e599e4c6,t,21000,3523812,,5000048,2018-01-30 13:54:04,99
0x6c5d0a2fe680d9da5e7d460355eca6dd1e1dc988b689e129f70bd3720b968738,t,21000,3544812,,5000048,2018-01-30 13:54:04,100
0xdfb3859cfa2bce03cbddb964777f7022a66937d065c3b5e9fbaeb70b57aa972a,t,21000,3565812,,5000048,2018-01-30 13:54:04,101
0x11b9bfd0871ba70d88b933f242407aae3f58b9a03d8a0c4977dfda9b477264d2,t,21000,3586812,,5000048,2018-01-30 13:54:04,102
0xcf6d8ccc9efd2c89b06ee5f829036933333f3e0fd03ed93cd96a1213707f8830,t,21000,3607812,,5000048,2018-01-30 13:54:04,103
0xfd69959e93afdcb2ab15647ca5296ca03f2643215e52d0fdaf4009175a82de08,t,21000,3628812,,5000048,2018-01-30 13:54:04,104
0xd2ca8064ad4a87f31e2d02b72c81de97866b3b47929d0fefef1e7671e9b23730,t,21000,3649812,,5000048,2018-01-30 13:54:04,105
0xea5f86879574f288e404732b7eb0514220a31c7544ef77214dec668c24f5c78f,t,21000,3670812,,5000048,2018-01-30 13:54:04,106
0xa18555af0f917a05fb10b7a33cb9a4c1e4ac69cd8bf44562ed59f0fbccf09861,t,21000,3691812,,5000048,2018-01-30 13:54:04,107
0x8342fee46b84d57a17c663004fcdc6928d9d31b7f2b6388620f544769a4880ed,t,21000,3712812,,5000048,2018-01-30 13:54:04,108
0xa7e5154b1331f0c32d3e140eb39795de933fe78386d030f7a159e608e24bba6b,t,21000,3733812,,5000048,2018-01-30 13:54:04,109
0xc410414363e5a53affb7c0f64dc39e29435e60b1d5d7cf523301fb3a6b73f8d2,t,21000,3754812,,5000048,2018-01-30 13:54:04,110
0xee0d39abca6a77a3916603bace29156615bbf473d7443ae9343e4c13458e2707,t,21000,3775812,,5000048,2018-01-30 13:54:04,111
0x1bfc68a8484d30e0c57d917d546aba73d920ce734c69d7951cf37cee33684184,t,21000,3796812,,5000048,2018-01-30 13:54:04,112
0xe1b1b9faf2353cbfd1b839857e643c2e581bcf019b64017f362eaaec9f229e70,t,21000,3817812,,5000048,2018-01-30 13:54:04,113
0xe7d2af3d44df9741de5f1deea1005c61a1dc23f55531734db5fe76f22ec7f973,t,21000,3838812,,5000048,2018-01-30 13:54:04,114
0xa89bad2d3e431f4a98a57bfb8e8ad21bbdeb44ca5856e8289b3bccf17d07e4c4,t,21000,3859812,,5000048,2018-01-30 13:54:04,115
0xf337ada710bef0e164b9ee08c4d197ba692e27814d3d66016fe7e16c012d278d,t,21000,3880812,,5000048,2018-01-30 13:54:04,116
0x0e0314a30c093158a6a59635fa056828e403bcb4e7703f1723898af471f1ee77,t,21000,3901812,,5000048,2018-01-30 13:54:04,117
0xf78279570c3ba52cb75237dc7e9e363c0c28d350c19a7f6894c2db3142a98034,t,21000,3922812,,5000048,2018-01-30 13:54:04,118
0x7548f37b768eb90de39d179d89dfe79be4b9cf3b83a29a2208f2a16f1929b427,t,21000,3943812,,5000048,2018-01-30 13:54:04,119
0x042f345cc16f767351ee4544fd36b10d88e0fff10af77787491ddcbcde227b39,t,21000,3964812,,5000048,2018-01-30 13:54:04,120
0xbe68e9b05cfe4999dca24610181d77b72a4263ba0e11b92303ec0dea74fa996c,t,36670,4001482,,5000048,2018-01-30 13:54:04,121
0x287b71d5774d01041993103663fa16958fb4fd76a8640e13a2b268de9d8dc1d7,t,21000,4022482,,5000048,2018-01-30 13:54:04,122
0x51e1372881abb5366c1170f8bd622ad65129d447a2f3dd751774f51a0edd9a47,t,21000,4043482,,5000048,2018-01-30 13:54:04,123
0x52573a9fb361b44c94e8e5e53235608034dfaff39a568e7cb804b7aa2df8e3fd,t,21000,4064482,,5000048,2018-01-30 13:54:04,124
0xa18077aac5b8e980f4df43d4a0325037a4c9cb5d752cf5f87bb573a6f914e6a2,t,21000,4085482,,5000048,2018-01-30 13:54:04,125
0x170c8e17d9a1ca626380e7f149160d813ff08d544cabe0c91956e9d1c3e98e5e,t,22524,4108006,,5000048,2018-01-30 13:54:04,126
0xaff5faf592a3fa7a8722cc6cbb0bc3bae0f1d7025b953bbe6d6953ddcd6b5fa6,t,21000,4129006,,5000048,2018-01-30 13:54:04,127
0xa0adfadadf330c33abf57e260428d43b704ce161bc19ff2a324b8510d3fcc040,t,78306,4207312,,5000048,2018-01-30 13:54:04,128
0x6acc2d236efb64b0f5319727400f78173d6654a1204fd2b2a0d4b094293632d2,t,108306,4315618,,5000048,2018-01-30 13:54:04,129
0x43dc7f5580ed8ee01afd6f4a0b52577deb18e286a46cf507e7b0d34144bec512,t,152105,4467723,,5000048,2018-01-30 13:54:04,130
0xa0ebf0ea3fa22694025c47c0c5d9b62fca5ae5825f766d7431698e9b913c4277,t,37900,4505623,,5000048,2018-01-30 13:54:04,131
0xd9408be7a7123adfecd15ba5465bf8389e38a920e29dd0708c970e391745fc37,f,250000,4755623,,5000048,2018-01-30 13:54:04,132
0xf0bd89052e76ebf956297ac1592c84b7fdeae9052815ebeb6df998757de6563d,t,77474,4833097,,5000048,2018-01-30 13:54:04,133
0xdd9b183cac390e79207a529b8a3bfad9215739828178c1029cac001db006c7b2,t,37438,4870535,,5000048,2018-01-30 13:54:04,134
0x7acbcef5c1b44d21204ee60fa46f230f80cbc46b94ea9389bede016a5887e2ac,t,52344,4922879,,5000048,2018-01-30 13:54:04,135
0x092b9d2f7d4a99707cfb3da715e7effdfd519dec412cdf3bdcf51f572f648366,t,45508,4968387,,5000048,2018-01-30 13:54:04,136
0x17757488a53765320da81088f5efc57edeacf13dfd4a428565e3ad010df23b05,t,49359,5017746,,5000048,2018-01-30 13:54:04,137
0x36300d665bdfe52ab1af0f051e2c69c5a9a49885cff4622d0d91eccb7d60d32d,t,21000,5038746,,5000048,2018-01-30 13:54:04,138
0xc97bde88e1514ede601353d00761431a80c21c7ba1e5fd235d4fc3d2274c0ff7,t,29493,5068239,,5000048,2018-01-30 13:54:04,139
0x08b432c9b47b9e37a63344c83f7b54efbe61564802a8596b845cc5cb670b5b74,t,132823,5201062,,5000048,2018-01-30 13:54:04,140
0x2bd2493d0662fd76b9fae451e44e87c96076f8a6ed3851985083b155444eeac5,f,250000,5451062,,5000048,2018-01-30 13:54:04,141
0xbb525be2e4015f82320ed14e7ed1120d459253170c32619e2669a9ca41ca1dde,t,52285,5503347,,5000048,2018-01-30 13:54:04,142
0xa66c0ba7d6e8dc0262a1049b95e5060217999463f0948587caa21d9bc291cea4,t,21848,5525195,,5000048,2018-01-30 13:54:04,143
0xfec937d48fe48e4a5cd079724c9ea1359e60be1c54ad9bc84636040df7c80594,t,51161,5576356,,5000048,2018-01-30 13:54:04,144
0xc9bcaae0109ad64933e3b3abadf56c39e5408aef9753c8ff6585afb95f26c364,t,44493,5620849,,5000048,2018-01-30 13:54:04,145
0x7da8bd64ace7845c1915162968b2c564083ea37e52cee66d70dd23c059c7db96,t,21000,5641849,,5000048,2018-01-30 13:54:04,146
0xde8ddc0d4ad4c7533f14992e0984a23247b7acb45214b59cf9feef66af67fa5d,t,78178,5720027,,5000048,2018-01-30 13:54:04,147
0x36eceb44f7f7bcfd2d2ade62600d2a11709ac5917d1c6b0bc4028813caa1448c,t,21000,5741027,,5000048,2018-01-30 13:54:04,148
0xed38127f575f788c0698015cb45902d1be4bab259a14314e8d5b2f59da2f0af3,t,21000,5762027,,5000048,2018-01-30 13:54:04,149
0xb85cf418ec0205ab4e166655e1e16a980575d384c706fd279147210c726c7933,t,44493,5806520,,5000048,2018-01-30 13:54:04,150
0x6073c81d29adac746e0a4441650a9bb7a8ba85bb79ef85f98bdef345b4dafffc,t,37900,5844420,,5000048,2018-01-30 13:54:04,151
0x6c20e83c6a3ed765e64d62971010426e1b1a128f4e07131cff264ed89c5730df,t,59290,5903710,,5000048,2018-01-30 13:54:04,152
0x9d287a70f26602c30706eb127fca8d3e02d9262bd90fcaced8959b9fd69893a8,t,22900,5926610,,5000048,2018-01-30 13:54:04,153
0x40b17a4c819b99a010052c5bf772cbcf3518c7b0c919aea3e4d1c1d97441a909,t,36921,5963531,,5000048,2018-01-30 13:54:04,154
0xc1c0e4f6fa08b14fc530ed0ab7721e1eeace8cd04c1e9b8c9119e1e3e5cd1d42,f,250000,6213531,,5000048,2018-01-30 13:54:04,155
0x58f9a3d045588e53dd4b87267de62ac97493861ebcf99509806f45b0bd075f3a,t,93178,6306709,,5000048,2018-01-30 13:54:04,156
0x0846d13ace973b79039dbeb8deefe86fcbdb93f8b00ab92e80f26ca09591d5b9,t,21000,6327709,,5000048,2018-01-30 13:54:04,157
0x3432634d67659c7bedbb1a57f4db329ab8f81cce4c94d65616f68f40ffae2ab8,t,21000,6348709,,5000048,2018-01-30 13:54:04,158
0xe2f193e9616e5eb43d8d1304fdaac4c05a6319ea64b707cbdf1240613f79de02,t,108306,6457015,,5000048,2018-01-30 13:54:04,159
0xd367e473459d7148075291b9e8f05cb60d1a78f8fdb069b9a6e22cd7f8ee3d97,t,93370,6550385,,5000048,2018-01-30 13:54:04,160
0x312e450d0e4ae0b91ac948e3dcfa1621ec0f826f7f070b9691d00722b42209d0,t,78178,6628563,,5000048,2018-01-30 13:54:04,161
0x9806af83c11a24f4cdb7b95952d0be0c229b6bd663eb5bb35814bf73fd2b8990,t,32893,6661456,,5000048,2018-01-30 13:54:04,162
0x3f11d02db01003d4ffb372fbe64c6ddd1fbc6bd5d8e19196968b8231e442964d,t,21000,6682456,,5000048,2018-01-30 13:54:04,163
0x3cf0a80ebd39a635624d3318553c17f833b1ddbdfe4c92a60e018f3f4e16339d,t,21000,6703456,,5000048,2018-01-30 13:54:04,164
0x00fc6e90ba6556de0d767e127acc5e6dcef698c6c71beb746c73d6b590995c93,t,113075,6816531,,5000048,2018-01-30 13:54:04,165
0xa49fcf73676ef581cb4337cf0e7a1937dd7bc17eb069bf6759c25fefe0fd2f5c,t,44418,6860949,,5000048,2018-01-30 13:54:04,166
0xb7496a1a278cc2be5e68a7b0119ced88a840a4965a6469d150da89d0ef58ba7e,t,47176,6908125,,5000048,2018-01-30 13:54:04,167
0xa2eb2b04828f34480887df9bf2d7c4db646940dc187830f47cc57feee301d067,t,21000,6929125,,5000048,2018-01-30 13:54:04,168
0x517d8a8c4f9211be00835c478ef024822cded173702e6d3edc767bd232859585,t,29493,6958618,,5000048,2018-01-30 13:54:04,169
0x92e45b93ebc46bfa7892a72f660b2b7241a960d3142856846c683ca7462ff8ce,f,130000,7088618,,5000048,2018-01-30 13:54:04,170
0xed687154703d31239d6cb30d7dccdecb90244b825152cbd99270c04b949ffd70,t,37224,7125842,,5000048,2018-01-30 13:54:04,171
0x501477bdb811480a41379d4d729baaeec07f7beccf6957b507a4916c6bdef38b,t,21000,7146842,,5000048,2018-01-30 13:54:04,172
0xb233b81890573d1b428e1a4d2f335a38b4a7b37c4c4eec9764535ecf56587962,t,21000,7167842,,5000048,2018-01-30 13:54:04,173
0x6f8cea750448b6ca3a1ad94b0116b1e5991b7e00a495c9f2dc80004160fea02c,t,21000,7188842,,5000048,2018-01-30 13:54:04,174
0x14d99a2813c6ab2c102b0bcb4d2197c8d3b29ce199753aa49911d8dcf85e1897,t,44418,7233260,,5000048,2018-01-30 13:54:04,175
0xc7f6f04731aa4208effbcb14c6e656e37111180f246cfa0402794a9413405be3,t,78114,7311374,,5000048,2018-01-30 13:54:04,176
0x87366fb94b5c2a9dd02413003267fc3b16d15fe31f2346825d146d2a4ad9fd8f,t,48763,7360137,,5000048,2018-01-30 13:54:04,177
0x4486fd534406c6b57d19ec2f52067b699948d09e7fa2d0be6fbab86677ab606c,t,21000,7381137,,5000048,2018-01-30 13:54:04,178
0x1322860606da2c3d00cf08cc64002ae3aedea33d7efe751c666cfcecf957bc60,t,37224,7418361,,5000048,2018-01-30 13:54:04,179
0x3f4b92b90b5e067701a4273f50497e30f86738259ac7f9cc620f94d1b9afa474,t,34144,7452505,,5000048,2018-01-30 13:54:04,180
0x77ebc7ba5345a081db6f5dd7c4162d7699242fc2a94fab1ad9d870ae041d0143,t,59162,7511667,,5000048,2018-01-30 13:54:04,181
0x0c89c9f9aec5b956a5c1725c9d46eb1a9ea747b1c89b4e50cb37a46f46daacc2,t,63521,7575188,,5000048,2018-01-30 13:54:04,182
0x7318fefb88d886b3849353e5b46bfc98a2bfb94a8d80b1bb993a60d29fb7706b,t,174591,7749779,,5000048,2018-01-30 13:54:04,183
0x4b1d45d0b482a81c83d5b1ae42e1eed68b59af4bf47470b063c89aba25f4244b,t,21000,7770779,,5000048,2018-01-30 13:54:04,184
0x5be9dff4c023dc769c050292eed1f7489898aea1ea1be66f50d60cb04e42d8dd,t,81253,7852032,,5000048,2018-01-30 13:54:04,185
0xe0e6afddc631126d10f88bcf2cb84b7acc8292c8ac34f11dd18fc4da54281b97,t,23316,7875348,,5000048,2018-01-30 13:54:04,186
0xb0e0338b16f9525f008daf922b6c204c43c0de3c20b46cd80cc5e7b42861f896,t,21000,7896348,,5000048,2018-01-30 13:54:04,187
0x208ba917f8c5725ecde9b0b37a836053a7560568364d3186588c67f8bd6e5630,t,40704,7937052,,5000048,2018-01-30 13:54:04,188
0xa727bc46c9ab336ce4b04fe12fdd4ad3bfbd7563042b415d6028457d88efe916,t,21000,7958052,,5000048,2018-01-30 13:54:04,189
0x236ca646ba55d071152d2fd51d72cb54fe0c19179996d31104601c64ae7b227c,t,21000,7979052,,5000048,2018-01-30 13:54:04,190
0x598a19a67c1b6d35107fc25982a1b698eef5653e6612f19507b4c01efff87fbf,t,21000,21000,,5000049,2018-01-30 13:54:24,0
0x34d0a9ce34d6d9ae1d09bc092704a526a3bf536ac1f7b91dd849270b4d2430f6,t,21000,42000,,5000049,2018-01-30 13:54:24,1
0x5944f6790d16745eea3b196b4c922193c3aebb59f8b5f0a313cb166905d37db8,t,21000,63000,,5000049,2018-01-30 13:54:24,2
0x92769f9606092390d6f6ebbace54ab12eb763ad5265d2347f2440c96d791eac2,t,21000,84000,,5000049,2018-01-30 13:54:24,3
0xa087ddf3cc94b1afa361eb4a364602c5ab8f082f2beeabd27e3d542dde03c396,t,21000,105000,,5000049,2018-01-30 13:54:24,4
0xc6d99febd1a002de51ccfab789b896060ec405820d7299d01fef21417f741fe2,t,21000,126000,,5000049,2018-01-30 13:54:24,5
0x158f69c216089941b67590ef5054bfd1933224329fda23fab62ec040c9c23b9a,t,21000,147000,,5000049,2018-01-30 13:54:24,6
0x511430d47a89b83fb5f6b0a0cc90ab414a63841f7238fd7228f7cc95cf99f575,t,40907,187907,,5000049,2018-01-30 13:54:24,7
0x07998b98ee4452a63ea3c8d38864b14c3f4f3aea5570407c5c383de654b22e2f,t,21000,208907,,5000049,2018-01-30 13:54:24,8
0x468c8549361f579437422c18cb3a5cb5abcfdadc93538d0da5a298699495de3c,t,21000,229907,,5000049,2018-01-30 13:54:24,9
0xedb20dd87bf3b12cc91806f5db603e165af523e15e04502a054854c94dad287b,t,21000,250907,,5000049,2018-01-30 13:54:24,10
0x81846ff3c817301fa92f4681763b3597edc22ede50358befab0d395ac8a14e51,t,21000,271907,,5000049,2018-01-30 13:54:24,11
0x8f3d78fc91b60058d1e8eb0da8a3a3dbfde1e060883f31e9973ec8b80086552b,t,52155,324062,,5000049,2018-01-30 13:54:24,12
0xb4c15ffcab00895c407cf7d6a1c7ef70010343015dea72500457f30eca456b15,t,52373,376435,,5000049,2018-01-30 13:54:24,13
0x6ab5bc539233741ddcb30ed826c1da8530be5fedbbe22a838b7825d2a09ee121,t,52540,428975,,5000049,2018-01-30 13:54:24,14
0x7ac221b6c8c709318a8e20058a5cc2ddf2889ee1c3cb53e4cc4b05363f126bb1,t,21000,449975,,5000049,2018-01-30 13:54:24,15
0xd8f233b73bec6da8d9fc19e3933775c1ddb66b04c9918447f79e56be30186aa3,t,21000,470975,,5000049,2018-01-30 13:54:24,16
0x4992ef1d21c5df520255a34644cd4a6d4bbfa5d5c253918a490dfd740830be52,t,21000,491975,,5000049,2018-01-30 13:54:24,17
0x47283527b569713e87a668326869a7a75c1dcc7d20791b1bc157a63fa7696393,t,21000,512975,,5000049,2018-01-30 13:54:24,18
0xcb8ad93ee9150e3b544c77e316382e077a9946d8e7f0708d7a499bf14dc276ab,t,21000,533975,,5000049,2018-01-30 13:54:24,19
0x49f877e3a90cc4843c76889643192d4b7da5a52a49d3b7cfa4aed623921948f8,t,21000,554975,,5000049,2018-01-30 13:54:24,20
0xa9643796e1c870091a2879149ef42669419011585dade81bf3ed4385815158d7,t,21000,575975,,5000049,2018-01-30 13:54:24,21
0x4f571f5e5c0bb16c772dff9cf4b318acaf01e7057a30f5290181a7ab9e13c60a,t,21000,596975,,5000049,2018-01-30 13:54:24,22
0x993baabb8544becb90f63148e6f1ec1f15f418a01cab310127385c2b70c59a9d,t,21000,617975,,5000049,2018-01-30 13:54:24,23
0x2d38ff5a48635eed47ac5bb15f70e7d057df542a59da9d0159c9e6d1e93446f9,t,52091,670066,,5000049,2018-01-30 13:54:24,24
0xa3e395d6e472b26e50199e086d0cb8b6e81f66c1922ffcff4fb03136cc28b891,t,36979,707045,,5000049,2018-01-30 13:54:24,25
0xa9a198be078f45fc179efff16edaa085747bc23ae7d262bd8667bdec82f7fbf9,t,52170,759215,,5000049,2018-01-30 13:54:24,26
0xfa54e113e98d303b9938199a63e2227e1f941da7adf5903524f25c2faf29fdd9,t,51851,811066,,5000049,2018-01-30 13:54:24,27
0xa5aee4c4f16af6ad99fbb173f0e5634bf3baa895d38c7a78b3d31cb26132c65c,t,55907,866973,,5000049,2018-01-30 13:54:24,28
0xaac20f27df9ba2b1aa393a581b5ef52b2c884f77eaeec4088f5839e3b177ed37,t,21000,887973,,5000049,2018-01-30 13:54:24,29
0xbe753e13d7efd06cfc83c5504c70b41babe809faf60fe3d543bca44da3dc2a9e,t,21000,908973,,5000049,2018-01-30 13:54:24,30
0xd0c818512c9b6f1ab7b800613df066d343de775e8b94ead80de00422aec0f5c7,t,21000,929973,,5000049,2018-01-30 13:54:24,31
0xdc26ec7e1de0516b25acd48f1769f44db26d7b7d673ff72fa557062f5e1b0e06,t,21000,950973,,5000049,2018-01-30 13:54:24,32
0x652085532076e722058e37aad57b31eb2d46687a8e894f5d27a4f864b3941614,t,21000,971973,,5000049,2018-01-30 13:54:24,33
0x7dbe92ccf856ba87a311c1bfd74292a5506c58184b20af116ef3564f8531d08a,t,21000,992973,,5000049,2018-01-30 13:54:24,34
0x33feff6bc8f393a632ce8d1c4b6388250caed091855b934f6cfbfe2343013faf,t,52027,1045000,,5000049,2018-01-30 13:54:24,35
0x8a1bddcdad91f81c6f538fc455380353548b0f86538e4896737552e0891ac68a,t,37091,1082091,,5000049,2018-01-30 13:54:24,36
0xcb189914b2d41feff21926d0e9b90a6de87b54cf92b7c38369fc5709e775de72,t,39771,1121862,,5000049,2018-01-30 13:54:24,37
0x9182157fa6ab1d04b348d5c576ebf7fd8cb64fa255fb8a715852b946dd03f4bc,t,21000,1142862,,5000049,2018-01-30 13:54:24,38
0xad50118400c792dcdff5b4fac6293910514940bcc9b2676a8e40cfd66c50993a,t,21000,1163862,,5000049,2018-01-30 13:54:24,39
0x292fac29524a80a6e0b38522aec8d205dee59dcf4c71361388091694e151819c,t,21000,1184862,,5000049,2018-01-30 13:54:24,40
0xd4c9a67cee392407f7b23eba188b5be981703a8ed6ca7eeaec2d48e37ae3ffc8,t,21000,1205862,,5000049,2018-01-30 13:54:24,41
0x4ae76e74d1e12873db1f8ac12b6c577754069df316a5d576a633784436e64dad,t,21000,1226862,,5000049,2018-01-30 13:54:24,42
0xc26139081992d6e89b7f76c6459d4cf3068b5318ffae22e61e6731a17fdbbd91,t,21000,1247862,,5000049,2018-01-30 13:54:24,43
0xeaf6cea92e9b4137d38b16a02273918340144a69e2616528fb59aece328b48cc,t,21000,1268862,,5000049,2018-01-30 13:54:24,44
0xffbdf48ced14c650db6db1d3397c528c609dad5c8c918920b9ba9fc636598f4e,t,21000,1289862,,5000049,2018-01-30 13:54:24,45
0x9275f76ca877c0e286af48cab68286b1b41bbdb4a9e3d53bcd709f4214bfc1ac,t,21000,1310862,,5000049,2018-01-30 13:54:24,46
0xe93d19a7989337a4fb550cd89dc1d6ec10651aa7f818e3df880224b3331d1deb,t,21000,1331862,,5000049,2018-01-30 13:54:24,47
0x2497bdeb2a8a669b9f903ef27abfd4ebd4f2c0a07edfcd4c372c064a92e65d9e,t,21000,1352862,,5000049,2018-01-30 13:54:24,48
0x308a3e663fe373527260e10a4dad38c9b587efab1b6a124ee579972171cb3bad,t,21000,1373862,,5000049,2018-01-30 13:54:24,49
0xf692d724fb14d3f9a1a68a8c26e7f219e0c1f4cec0276346709bbd87872f4029,t,21000,1394862,,5000049,2018-01-30 13:54:24,50
0x7f1d066b75e49bd21d6252e977b92457cb3923ef463320bcbd23c33932af4cfb,t,21000,1415862,,5000049,2018-01-30 13:54:24,51
0xef5085b93d7f8d309747f21f2b44dff93bec30637151a87dbce96087db6ec919,t,45100,1460962,,5000049,2018-01-30 13:54:24,52
0x24c4c436938640273acef47d4ade81a5cf09be9e5a4ad6b6558086f3060e68cb,t,21000,1481962,,5000049,2018-01-30 13:54:24,53
0x120578b80f33f001e9eed37aa99a05bee20d5f35b16a41c2454bfe95823938a5,t,21000,1502962,,5000049,2018-01-30 13:54:24,54
0x8006e1c5575614033124ea8103514dc85c672cf1afdf1a0d0d2049bbb867e8e6,t,21000,1523962,,5000049,2018-01-30 13:54:24,55
0x0149df903df1172af65a50e84dfc3e64a53ff92e83637769147aed0761bcc5ca,t,52312,1576274,,5000049,2018-01-30 13:54:24,56
0x49fe5e6816a14f44ec79b7dd4eda49e7cf3f263a481440751c3b259c09e7ef94,t,52611,1628885,,5000049,2018-01-30 13:54:24,57
0x9bb92623000482a0100cc0c44dba6b6a4aa70dcc0a1ec645d699f5b7ab9b0872,t,52611,1681496,,5000049,2018-01-30 13:54:24,58
0x87e3ae47d2688a38ed806a9182b1b1ef59a279ce6ea280195166a7323c6086fe,t,37912,1719408,,5000049,2018-01-30 13:54:24,59
0x90104dd822f474351439ab644415cb3f4d2d6a701d68e4bf95b57c26c90a6c6d,t,40907,1760315,,5000049,2018-01-30 13:54:24,60
0xb8cff74bf482aeaf9ab7e009c40f8bfef2e85ae86de6f312fcfdd295988009db,t,53285,1813600,,5000049,2018-01-30 13:54:24,61
0xc22f93fbf0423b821c3744d6c9243be68962478928877a34df1fc9b0d9ec8b6f,t,52848,1866448,,5000049,2018-01-30 13:54:24,62
0x9f30ef3778b79c469984da3d71d7009c6b66389dea2efa015369da8f1a325b2a,t,21000,1887448,,5000049,2018-01-30 13:54:24,63
0x7e2bb8ef80b9d18b4eff75ae308555c0a3b2a05907e5029f545b14e6b19a1592,t,21000,1908448,,5000049,2018-01-30 13:54:24,64
0xfb23e41a860e60717fd77bf14d4dd06b6341db55f42d703823eda8e85e44eeb5,t,21000,1929448,,5000049,2018-01-30 13:54:24,65
0x5083021d8b7694c7b2c45dbd182f316e6646fddbdcb3f02e1587db1f4477c483,t,21000,1950448,,5000049,2018-01-30 13:54:24,66
0xc7246a2568fe5b9ad5190127f7ff9b24c2eccf3e409a1f9091465fd5b27e4f79,t,52222,2002670,,5000049,2018-01-30 13:54:24,67
0xe3c4782b0f7580e6066e6032c0a7545855e6bff5c82f2e0e0f4cdda8c3fd80ae,t,52912,2055582,,5000049,2018-01-30 13:54:24,68
0x59e23363a0bb2eaa527d93d3030fd9feccb596c8a19c3d78aea9ca40f61cbfc3,t,37912,2093494,,5000049,2018-01-30 13:54:24,69
0x5eb6b0749914467595fc3e71832957bebf351a02bee2d04f626c8558007ef2ca,t,55907,2149401,,5000049,2018-01-30 13:54:24,70
0x318a032478dd4ff9e5a963081083f70834c2d9814c6dc9fda251d777c76e5af4,t,55843,2205244,,5000049,2018-01-30 13:54:24,71
0x158d4baac9f307b4763dffad1557c4b13626844db6894fc2484fb0fa3bc38ad1,t,21000,2226244,,5000049,2018-01-30 13:54:24,72
0xb9d4ad2e6c95faad7d74942db365da0ddf48df4d86c7f8edf937f3ae5f8663e0,t,21000,2247244,,5000049,2018-01-30 13:54:24,73
0xd0aca7b3a98ca946cbafa4fbee4669d6fa46c4965ad0b2ac0546cd171bad0cbe,t,21000,2268244,,5000049,2018-01-30 13:54:24,74
0xdebade8def3f479745984e36708ea022784187fca66de9223f599b5b0c1553b0,t,21000,2289244,,5000049,2018-01-30 13:54:24,75
0x44ed6cc86e87d31b149d709fa22ac1b4147f09897ff222c83ac0d8b7d0b59e0a,t,21000,2310244,,5000049,2018-01-30 13:54:24,76
0xbf13cfe7517ee092cf9dcc8e37e16864b294530055f60b46ce7e097b25137fc5,t,21000,2331244,,5000049,2018-01-30 13:54:24,77
0xd8445b2addb7f8ff6b08b1995986a5c4c6dc7b60a3f3f892c7feed8e4f378818,t,52172,2383416,,5000049,2018-01-30 13:54:24,78
0x00ed4afe2d3f90b6d63d5a048174b1c9ad0c0f5f31d8e24943c8e4d58ebedc4d,t,21000,2404416,,5000049,2018-01-30 13:54:24,79
0xe203812ae7277c97d70007c995f8720ec04eeb180428cb49f83f375f0f455612,t,21000,2425416,,5000049,2018-01-30 13:54:24,80
0xfb6be4a1bd8a9bfbe94768068457e5911582ccbdfc2916922597fda203673382,t,21051,2446467,,5000049,2018-01-30 13:54:24,81
0x57719b611f561c70ab2c02ea4a6ba7d0bf50b4c7b74c6daec76caf44055b1934,t,21000,2467467,,5000049,2018-01-30 13:54:24,82
0x61723a991a09cc5003d39aefe6224a697ac7d6407c5d4f57718065a4766c507e,t,21000,2488467,,5000049,2018-01-30 13:54:24,83
0x87a388c523b86cf8fa3714e9e397ef92ba21ec95db917aade7cb57469dad5b8a,t,21000,2509467,,5000049,2018-01-30 13:54:24,84
0x1d06d370767949e8219018bd112a7cc50dd37bf61a065fe396b4c008f45e8218,t,21000,2530467,,5000049,2018-01-30 13:54:24,85
0x71df17f55bafebdacf67b4ff46d924aeae39b89964f5c0407592a20d7ab7ea72,t,21000,2551467,,5000049,2018-01-30 13:54:24,86
0x987ee2384eeee4a88df4f2e557fdbab73db7b5690ff5565116a0c317d0d0f7e7,t,21000,2572467,,5000049,2018-01-30 13:54:24,87
0x12f9ae1e64864759666b80e1c117ce82826a339dadb3820901ce24c17bcc9431,t,21000,2593467,,5000049,2018-01-30 13:54:24,88
0xe35598f9beff23518226193989dcecad1e371d6b4983c06676eb3ed01e778041,t,21000,2614467,,5000049,2018-01-30 13:54:24,89
0x10509eedce6b8161b2dee1a640d2c1a2173f04ff854f42ec6e91fa2896a0a1f8,t,52400,2666867,,5000049,2018-01-30 13:54:24,90
0xd401bec8fc87f5f3965d6985375199008991f8c9d5e49cf1c5722715cbbdd411,t,51915,2718782,,5000049,2018-01-30 13:54:24,91
0x7932de07597b266ad063c621a264771a50edc783c37cc0f1fbd3341b742d288c,t,39771,2758553,,5000049,2018-01-30 13:54:24,92
0xc338492901c0ac47a6f62a511506c666b4f78c5e97de1781b0c4152b9fb95bee,t,52228,2810781,,5000049,2018-01-30 13:54:24,93
0xb1fda60d3f3d6fc0dcdc2ee41a4f7e7b3d9cc0f73a7d22b112f9ddd4ef4894ee,t,51851,2862632,,5000049,2018-01-30 13:54:24,94
0x8153b9108aa6fba5e94dd6ece2e8bd164e3fd62a48ce92192057a2ffdd6f364c,t,103702,2966334,,5000049,2018-01-30 13:54:24,95
0xf1320a295e4f8ba39cf0a2d71cd8016d7dad4324a786054e0fd4515d36432e9a,t,52611,3018945,,5000049,2018-01-30 13:54:24,96
0x8d440652b5bc89fdb71898b0c59d69ae791a2b399eec3a5c958a478c99e69552,t,37372,3056317,,5000049,2018-01-30 13:54:24,97
0xe04223cbc98ce1659ae4b0ac7e62b517dd9b3d01a0d2d9ce99f19bf3de94baef,t,51851,3108168,,5000049,2018-01-30 13:54:24,98
0x0c1713c7d8f9c3cd13c576b3d759aaa94c4adfbf346646618b8200fa0f26bbcd,t,21000,3129168,,5000049,2018-01-30 13:54:24,99
0x867c7462b1083a9522b31e9901571ee1c19bf246e74d780d7d47a992ced3dca3,t,21000,3150168,,5000049,2018-01-30 13:54:24,100
0x251ff6a92b44236493e68a1c2f8a3e3adb5dfd9fc511fa837eb5e93a200d0c40,t,21000,3171168,,5000049,2018-01-30 13:54:24,101
0x4cbba37af17cd10703ab3a7fcc152224c51625986e4bab9468b4129cd1429d94,t,21000,3192168,,5000049,2018-01-30 13:54:24,102
0xa32c7828734ac328b4c09ce6f84165899f5f4ce2c9e8ea5090cab49955bedeed,t,52400,3244568,,5000049,2018-01-30 13:54:24,103
0xf319a9d21c3442058d1d28a311cfe0004c193080b7900e9bb13e6b47d06c6248,t,37065,3281633,,5000049,2018-01-30 13:54:24,104
0xfbd1d748235a0d6625b44bd0ec06c19de9cac362feceade3bc6e744bca81b0b5,t,83046,3364679,,5000049,2018-01-30 13:54:24,105
0xfb4052d675ab205a32886243e08c70675a69a32912b81c8b82f7c9d60bd1ac68,t,37155,3401834,,5000049,2018-01-30 13:54:24,106
0xa83df0caf8ce1a305b25bf37b1f626de73ec162a8b7dc56d787a14df27921367,t,21000,3422834,,5000049,2018-01-30 13:54:24,107
0x2ab641fd10d8a698076883d3a9094d622f5b31c87b1c90e4d7cee3d6b901ccf7,t,21000,3443834,,5000049,2018-01-30 13:54:24,108
0x5bca22289bdb5b8c410ac79271920ae81eb86030178cab327344ec686dcf41f7,t,21000,3464834,,5000049,2018-01-30 13:54:24,109
0x569acd88c80da9d6e507af95482ad511fcc1af9b57e0989a9342220da2fa57f2,t,21000,3485834,,5000049,2018-01-30 13:54:24,110
0xbed36910c864d6e21d18b0a108c097335c3b50e7adf4e7bd40b5eb18a7beafe1,t,21000,3506834,,5000049,2018-01-30 13:54:24,111
0x03bfd1d23e8ead1b47d9b9862520ce34683163a1618915619d11238074608e49,t,21000,3527834,,5000049,2018-01-30 13:54:24,112
0xbf21ec5fdae568bdb5a9e425dce1158d6cf9f7362043357a72a63b8b6d6c8652,t,21000,3548834,,5000049,2018-01-30 13:54:24,113
0xe477ef12ac4c20078091b48786ea238c1e4118240886980c6f3d2b2e1ca80758,t,21000,3569834,,5000049,2018-01-30 13:54:24,114
0xaacddb37caeb85ab4ace6c36db006e41ecb2d68c995b9447edd6bd6af10b5b95,t,21000,3590834,,5000049,2018-01-30 13:54:24,115
0xc0a55133498592340323152682e36a52566eb1ccf275f2eb992a8f2c37d19024,t,21000,3611834,,5000049,2018-01-30 13:54:24,116
0x8ebe8323363e1266072070c6086c34850df127d5a2239c3cec775b5a3414a363,t,21000,3632834,,5000049,2018-01-30 13:54:24,117
0x478e022023588331c222cf23575bb0656761dcdb7b56e163705ee98b2a836d96,t,34470,3667304,,5000049,2018-01-30 13:54:24,118
0x26adb9cb0566c0b9498e49434ba13c3d5fb27ea2793eca5ebebdaafa6046e3e6,t,34470,3701774,,5000049,2018-01-30 13:54:24,119
0xa548fce927d4fa9aa7920af69d980f049a3e990f384023ae5fa23186678df958,t,21000,3722774,,5000049,2018-01-30 13:54:24,120
0xce62d1a1d04e409671f709807d0717376636b9ac6fb3a52043b32ae797d69e8d,t,21000,3743774,,5000049,2018-01-30 13:54:24,121
0x6f10bce0b43df099797cf85c9f5ca84c9dc262d90545cc81e063d00d0e7f2106,t,21000,3764774,,5000049,2018-01-30 13:54:24,122
0x89031000e66adbce4400f0eb7b10faa5b3d59db557d1333dd4bab29a3a02c4a6,t,21000,3785774,,5000049,2018-01-30 13:54:24,123
0x4f94cdda993552933375a468128491197802b2369a9d20cfe623ca7e60bf2a47,t,21000,3806774,,5000049,2018-01-30 13:54:24,124
0x7fbe389283a780338618f4a7bdfb0b645ea74da4341f96b8b395174a8c620725,t,21000,3827774,,5000049,2018-01-30 13:54:24,125
0x98e6831fa4f8a8ca4a2196a53b03f8f23bfb2a271560736a70d2709d2b2abe1b,t,21000,3848774,,5000049,2018-01-30 13:54:24,126
0x860fdae9743db8797ee2e1ea1ec8f9516b17d3c3affc0298594608568b610e94,t,21000,3869774,,5000049,2018-01-30 13:54:24,127
0xd9a1645a3c116d398aff0cd5607342ca594e20e8ea1c618ec7b1b5b90ebf261c,t,21000,3890774,,5000049,2018-01-30 13:54:24,128
0x016c93cce444bdab9b7397b2bcab1e6fd6edce2a747b3c036f6aa82d0f61bb5e,t,21000,3911774,,5000049,2018-01-30 13:54:24,129
0xe019cb14c16e920df2dab8d1e8934a476b2c117238e2192ad47bd62e8a4ec3fc,t,21000,3932774,,5000049,2018-01-30 13:54:24,130
0xe3914da90d06d4593b6a6356bfc85986207fa0d6ad66dcc01921f37a813c4e08,t,21000,3953774,,5000049,2018-01-30 13:54:24,131
0x38b1bda1534dd544a7d622f39ea2441107ad742733438b060c18322cf6e8a7fc,t,21000,3974774,,5000049,2018-01-30 13:54:24,132
0x7d2aab77298295c9d59d8bee11b72eb4278bcd9b263ea2fdd4861003da475d10,t,21000,3995774,,5000049,2018-01-30 13:54:24,133
0x1ddb16487941feea2a113413149c4096ac1f87c24594db48607a18c1c45e5747,t,21000,4016774,,5000049,2018-01-30 13:54:24,134
0xaae2d2e5b29d75f0b04969e90f193c71caec575e8037d9d5c7a016fdb7d9a5e8,t,21000,4037774,,5000049,2018-01-30 13:54:24,135
0x8878a2d61ac8ad0705b5408ddf882c275181baa61e8d89478ad970c40efd380b,t,21000,4058774,,5000049,2018-01-30 13:54:24,136
0x9a18b5e708b393db4ad6586657eae47a41b04291fed7e67e561b39045e1fe566,t,21000,4079774,,5000049,2018-01-30 13:54:24,137
0xa493318c001e26c7d6794a8adf14eba9d790a9bea0693a1e52118f853cdecdf2,t,21000,4100774,,5000049,2018-01-30 13:54:24,138
0x4980c30f54925c9767311ccdb0f7650145cf7078170ac72872ca5782c14d3673,t,21000,4121774,,5000049,2018-01-30 13:54:24,139
0x9c28c3b9e489e43846226ea201e175d4d275b51cf1ba33a7b94abf3e4c045b08,t,21000,4142774,,5000049,2018-01-30 13:54:24,140
0xa264677bf6924e682ebd273c477e77a779d497cd99ae7d2734e1737cf20ae4a3,t,37222,4179996,,5000049,2018-01-30 13:54:24,141
0xd02afa9bb29cc25a6059e7d643b46ab4730af70076dda7ff4fbda56425817c39,t,52222,4232218,,5000049,2018-01-30 13:54:24,142
0x9a32f17654b56e3e6b6e8d7e009aebbbfe46f984738b3ae0bc63ccff6ae1db54,t,37222,4269440,,5000049,2018-01-30 13:54:24,143
0x21fbb3a2317e763368a2cbc4d325db898cae9aa3e16bb10770056ccb6aaf3188,t,52222,4321662,,5000049,2018-01-30 13:54:24,144
0xe04be254fd202cc8ad88013d51fd81cbe36c25d7e0e7475513704bdf7ca6232a,t,46460,4368122,,5000049,2018-01-30 13:54:24,145
0x228b09b9f4f85794351752d650e9d9ac4e52a7db10193a17681a12e84cd6033f,t,51473,4419595,,5000049,2018-01-30 13:54:24,146
0x6f906153d77327a25229d0a5f8fdecae30e194bf0a076430513136f62cdca3bd,t,21000,4440595,,5000049,2018-01-30 13:54:24,147
0x81dad1ac8f0459932307792b3e886822d27f5e3298b5635b3e4378c4451b44b7,t,21000,4461595,,5000049,2018-01-30 13:54:24,148
0xaa3b83084e4418033a01b4ce54902c6fef42273441a06886747bd2984db569bc,t,21000,4482595,,5000049,2018-01-30 13:54:24,149
0xe534768703082485a0dec6a05c1cffeb54d3b3298690511d6bff1a90d071d9b0,t,21000,4503595,,5000049,2018-01-30 13:54:24,150
0x8401a891b2e5c954f617c7852c147182924cd31784b93540c2dfd6efb64db5eb,t,21000,4524595,,5000049,2018-01-30 13:54:24,151
0xc693cc0fda02ce1b29947b6e165317a7e99bad413cd3c267e8bcb07581ea4d52,t,21000,4545595,,5000049,2018-01-30 13:54:24,152
0xcccb2a6ac475182072798a30260250b16cfd29b9d78ac01cc3a4e842cac0429b,t,21000,4566595,,5000049,2018-01-30 13:54:24,153
0xe6b525598a14f42905ed91a1e32c101fd117fe55ed1e6187beae7fc730df621a,t,21000,4587595,,5000049,2018-01-30 13:54:24,154
0x88fbaaced3c38cba2375da56edfe2b82c63ee3beda446c64a62ffd1ea6619b73,t,21000,4608595,,5000049,2018-01-30 13:54:24,155
0x77668359e3d609b0b2f0a5220c6ba7a560f504927ee6161bcf37e2d93034f69a,t,21000,4629595,,5000049,2018-01-30 13:54:24,156
0xe699ae090881a1dbc2520e9d2a068d2e2440b1f2e0195523e42af1304f8d4740,t,21000,4650595,,5000049,2018-01-30 13:54:24,157
0xd06076f378cc92ec00f7fd175842451f4aae1d27e30861fb56765d3c13965449,t,21000,4671595,,5000049,2018-01-30 13:54:24,158
0x52a1a7828ca8034624661a1ae99dcc04b286fc0a142658a981d386a1fe29bffd,t,21000,4692595,,5000049,2018-01-30 13:54:24,159
0xa338185f0ee52bc5aa7f5a2228e27e105317269bebe796b9b40fbfde90ca5405,t,21000,4713595,,5000049,2018-01-30 13:54:24,160
0x6d5dc70db484cb42e4c189c87e9aaa9e8030350535242fb592585e1725bd0ca4,t,21000,4734595,,5000049,2018-01-30 13:54:24,161
0xe320af9aaec5a14fef3be60b93fadd4434a2d69de815e70d11b962562c970c79,t,21000,4755595,,5000049,2018-01-30 13:54:24,162
0x188270477e8a9761488dcb2b02e54c0c5564e96bcbd7e00838206b6ec742be7a,t,21000,4776595,,5000049,2018-01-30 13:54:24,163
0xfa5f1cd83ef73c777dc12e53c57b2d97c563d675cb5e31cf0d140b2299101a2f,t,53526,4830121,,5000049,2018-01-30 13:54:24,164
0xad59aa40e1b286c8a9312d20df05fe246abc7e50d2e8d04ed4fa3e7d9f89ca23,t,52158,4882279,,5000049,2018-01-30 13:54:24,165
0x2368953af5d9a151e186fe10d5e4744b46f802f360533c42695077f8f9e0491c,t,49929,4932208,,5000049,2018-01-30 13:54:24,166
0xa1234c61ee242d846f3d1000bb49dc6b2335a77538b9de1503226ca079991f90,t,50057,4982265,,5000049,2018-01-30 13:54:24,167
0x30bfc98ecef2b2e50a99bf8a9b18f756237a327a4a38cee8252728ca291ccf96,t,46871,5029136,,5000049,2018-01-30 13:54:24,168
0x8a94f14bdf0dd757f0dc1bf8a32a46c1306792aa39443a857b2677baf00a7cfe,t,52408,5081544,,5000049,2018-01-30 13:54:24,169
0x449043b861ee041a0c7e6ed40de203285d98be14053cc19b5cd0b070cae2a25c,t,52249,5133793,,5000049,2018-01-30 13:54:24,170
0x780d65da0a9420b60c5abdf3fc65bc01eb4f7e5f03252920683481fa3614c02c,t,34470,5168263,,5000049,2018-01-30 13:54:24,171
0x3546d39505d17206075a7efd49892afa86f275ff1f27507e2699e965c6c60103,t,21000,5189263,,5000049,2018-01-30 13:54:24,172
0x064e76b1def2963c2ed5ec380da561003845b32bfa0acfaff5f764ab8e601aae,t,21000,5210263,,5000049,2018-01-30 13:54:24,173
0xc578e4270b1160d82ee2fb5b2416ad4321e630b52efd909b003c97297a53f00a,t,21000,5231263,,5000049,2018-01-30 13:54:24,174
0x7c7edd5cb97ef3d5d0f811f3ff089eb8e099645ee247f0549691c4fdadca1a29,t,21000,5252263,,5000049,2018-01-30 13:54:24,175
0x30e0f255498489ca00833096a89b8404eb924ff8036d402faf0961c745b5a0d9,f,250000,5502263,,5000049,2018-01-30 13:54:24,176
0x95da695d9caf11dd39672731c9cb8e1d7b65659b681e18b74cfc05ba15e79794,t,52257,5554520,,5000049,2018-01-30 13:54:24,177
0x36c9820252481c220d8f83858ceca539119dfb669da0ce8f99e8eefa6bcc0aaf,t,104678,5659198,,5000049,2018-01-30 13:54:24,178
0xb8247357dd0bc07dc7a94a015bf292d2de695f61646e9ff8ca6565dd7fecfe7f,t,36737,5695935,,5000049,2018-01-30 13:54:24,179
0xfaf0a967497dd981ebc0473701926c18e3a9d0dbc905be84215e7f256f445ce0,t,21000,5716935,,5000049,2018-01-30 13:54:24,180
0xda185721f5a07dbcaddf63a254e10972d43bd82ae3635303a946d210353545dd,t,21000,5737935,,5000049,2018-01-30 13:54:24,181
0xb267082e54182c992851cb61877da2d6c722aca03e9f4213b9aa04cc9461d512,t,21000,5758935,,5000049,2018-01-30 13:54:24,182
0x33725f3cafe2a7e28c9c66be92c48b2a0787e7076e63668fd2cebe23fdd9a880,t,21000,5779935,,5000049,2018-01-30 13:54:24,183
0x3f151fbc13fc9b73beff994ffbb477af65798e2813be17b3de56d34b4967a97d,t,21039,5800974,,5000049,2018-01-30 13:54:24,184
0x76c123f4a613f9291a1d4d88dd88e7e7601636719689381b5103226475e53e12,t,52292,5853266,,5000049,2018-01-30 13:54:24,185
0xe24e33f3d6d014f5d294661cfd84910fb4fbb9b780597a2879250f339114be76,t,21000,5874266,,5000049,2018-01-30 13:54:24,186
0xb556b75921bba065fd9586098155a764262f92f4dfee21693a46e34c299ef81a,t,21000,5895266,,5000049,2018-01-30 13:54:24,187
0xd79dd411c22cbd1350b1a3185fdf046880942dc3889845503f53d35eed8a5c77,t,140972,6036238,,5000049,2018-01-30 13:54:24,188
0xdc5324fc1a758e730fd96cf90dcbb48fa0b2c532611d2fa157ccb0e6114cffba,t,21000,6057238,,5000049,2018-01-30 13:54:24,189
0x7d7ffa888158850ccdcebd2b285e4beafba1f609af3b30c0aa72ff25128a1d19,t,21000,6078238,,5000049,2018-01-30 13:54:24,190
0xdc266933f087cdccdc88225e633a323dc1effa080ab9d2a005e53efe4f5197c0,t,59865,6138103,,5000049,2018-01-30 13:54:24,191
0xfcaecad6f202d4bc3223a0f0df897278aa515b932e2daadb607257dbab8d3442,t,21000,6159103,,5000049,2018-01-30 13:54:24,192
0xa6fd6d41b9fec9adf2a6f71adaa79895722aa08433c36dfeb2db5b49df8e9891,t,21000,6180103,,5000049,2018-01-30 13:54:24,193
0x5f20b3cc3d48718deda8075f891435c37811de50ba1adeda7f043649dc7254ef,t,21000,6201103,,5000049,2018-01-30 13:54:24,194
0xa7381bb2224a5267412604c7c2ff66dcaabe489eede66c8c34d49ad5bc9f70ef,t,21000,6222103,,5000049,2018-01-30 13:54:24,195
0xde685beb867b96902f0e90ffaa3e9c96eb7eafc45bc869f983fa5f3716d4b512,t,21000,6243103,,5000049,2018-01-30 13:54:24,196
0xa35a82a55f34e70a39d85f10f996010a41c8bf8d0a2d36c11db7920d2dc8dda1,t,21000,6264103,,5000049,2018-01-30 13:54:24,197
0xea43f39a48827394fbb4af68c587a757dabaaf61c18c96845b598f36813490a4,t,21000,6285103,,5000049,2018-01-30 13:54:24,198
0xee45522638d33fa76a10f59075fe5c08c6288db941bc4142ef3607d95a7674ec,t,21000,6306103,,5000049,2018-01-30 13:54:24,199
0xe83cb94941018f99cf42ac37228e41a0ad8a8889a55b71f9f4d4f8c642224339,t,52173,6358276,,5000049,2018-01-30 13:54:24,200
0xd39b44857639ce95534acd47c93efd0307afb6395356d0884597061ace780704,t,40843,6399119,,5000049,2018-01-30 13:54:24,201
0x7323a57feb7655029a939663dcc0ee403c99ea59b0adf8c2208e08a86c4c8276,t,21000,6420119,,5000049,2018-01-30 13:54:24,202
0x0a4a7d154cf73fe980ea422df3fdcd02d3a577a810b7f54efbefa4767efdc97b,t,55843,6475962,,5000049,2018-01-30 13:54:24,203
0x878957a18851a717abc55d0d0cd12b960d1ad494d49350a728ff2ce1c4f6a026,t,21000,6496962,,5000049,2018-01-30 13:54:24,204
0xec5da188530cb213371956f49cd08630ac98544fccbe5da11dde9a0287543789,t,54221,6551183,,5000049,2018-01-30 13:54:24,205
0x7a7eb5ccd03ba0eb63344a19f9b4a0abc5f7b6cfea43c3bcb250e23ae30aba8d,t,36984,6588167,,5000049,2018-01-30 13:54:24,206
0x3b14fd09996746faa0bb536bf508ba0afac265fa5c5b0d5daad464cb7431a9d4,t,21000,6609167,,5000049,2018-01-30 13:54:24,207
0xe8e2cc3b43a40fc8ee946e39319f9f8d37601b3581dd9e76854d42096d686f5a,t,21000,6630167,,5000049,2018-01-30 13:54:24,208
0xc071c2a83d53968edb27a905dae27f66333f0435eceda1f7ef73bc3be75611c5,t,52848,6683015,,5000049,2018-01-30 13:54:24,209
0xb7bc339e16a8842ed744c327e11dc478b4d2cb41d0c7930693aa82eb19d9721b,t,21000,6704015,,5000049,2018-01-30 13:54:24,210
0x179f98ba0cde10831d2f1a806caef8a01ad7d2d5153fe95c5dec5bbc344a35ed,t,102998,6807013,,5000049,2018-01-30 13:54:24,211
0x1ae4d556a7c748138776ccfac4f6bd2ccd6bc7756f01eff2adeca6d4cf2cd7db,t,21000,6828013,,5000049,2018-01-30 13:54:24,212
0xef56a5ce74f5a56d9ed46d7cce6fe048cf05e57e3553af1ed56102b226ad2654,t,21000,6849013,,5000049,2018-01-30 13:54:24,213
0x7cddfbd2c52ce7339a7cf81cec80bfd2ff3dd6ea5128a3f6bfaf78adc735b01f,t,29034,6878047,,5000049,2018-01-30 13:54:24,214
0x1c011195edd3b1cc77f38cc873583736d03bbd08a3dde235a4d3317bbe3584db,t,21000,6899047,,5000049,2018-01-30 13:54:24,215
0xc63d560a97c98b441e445a7c12518f8a930562d9c7452daf83be4348bbda5a72,t,21000,6920047,,5000049,2018-01-30 13:54:24,216
0x9f97386e5c9d8a672ebe35988b9246cd04e2b11ae560568738c9bd9ce80149dc,t,21000,6941047,,5000049,2018-01-30 13:54:24,217
0xa849e3d59f3add8ae6fcf8a64255ae6b75ac91eb3ff5cee012e8ac021fc27f5c,t,21000,6962047,,5000049,2018-01-30 13:54:24,218
0x36e2e5b75aa6a12939988a35fad7cf979c7e846c7cacb00276b224d8c9f95485,t,21000,6983047,,5000049,2018-01-30 13:54:24,219
0x749003708d8efa367d73bfae82f247df5ca40cf501b447ef7669df9a3cffd7f1,t,21000,7004047,,5000049,2018-01-30 13:54:24,220
0x864bc761a160d09f5ad60d9df6b4b0cd40d1860ebf5da420a4f20bd71fe85c84,t,59290,7063337,,5000049,2018-01-30 13:54:24,221
0x1e26d3f514c482964de58b248582165dd1282dcd883fbd0671660ccd4c4e6793,t,21000,7084337,,5000049,2018-01-30 13:54:24,222
0xeb6e69b53aaca83028159b70b4bacd4291b55d9eba08444e25eeb7c6599e45d9,t,21000,7105337,,5000049,2018-01-30 13:54:24,223
0x5187b1c9ce03c6430186f08aacb45725b1770b55a583cdf04336dc40c6b54c98,t,21000,7126337,,5000049,2018-01-30 13:54:24,224
0xc8b336de050f35ec545349ed65c49293b5fc03771769bf0e6cce347399770264,t,25843,7152180,,5000049,2018-01-30 13:54:24,225
0x57d77ffdc354b79f54bff7ba48532ec54caac2d7841d8da2b0ce7c0b92a7b348,t,51947,7204127,,5000049,2018-01-30 13:54:24,226
0x9ac85a005698ca91e37785b431145d52bb367e67bb5a4b9f3654a319c8d0d8b5,t,21000,7225127,,5000049,2018-01-30 13:54:24,227
0x604bc14d0350c1ecb88456c4ade321964dbc8c476f4be61ae89a973c0fded0fb,t,37331,7262458,,5000049,2018-01-30 13:54:24,228
0x256558d3030bbaf544f50d5c6f536d51688ed323821756717b603f5b9fbbe922,t,21000,7283458,,5000049,2018-01-30 13:54:24,229
0x10126ff391f4c8079a29f53f8bc4984ae0942f77ed4c9ddd1c349b4076da1dab,t,21000,7304458,,5000049,2018-01-30 13:54:24,230
0xbc68b686aa85acb7519271b084896bbaa1851c7f31961cc5645e93a93fe442b7,t,52810,7357268,,5000049,2018-01-30 13:54:24,231
0x3e32411a2666b94c434bd2d25605731b7644f1ecbe3da2712be3f55f84ef98fd,t,21000,7378268,,5000049,2018-01-30 13:54:24,232
0x55ad020a54b114aa261bfc845f320b3a07051ebb2990a6489682f550406fe3fe,t,52219,7430487,,5000049,2018-01-30 13:54:24,233
0xf78df03733a44f8c7c2545f61c00f97ecd500427b4a60f757effde954eae128f,t,52267,7482754,,5000049,2018-01-30 13:54:24,234
0x48e05527cd097007bd4883f8b08cf4abbdc5e1e8c056965f72c51224aac175fa,t,21000,7503754,,5000049,2018-01-30 13:54:24,235
0x58b6a8983e84eebc47f2fbf2ac432c12b9caccd965418c0e8a283f0f6d1f38ca,t,21000,7524754,,5000049,2018-01-30 13:54:24,236
0x22e943ecbf5113414d4828b43a85af1ae037b814c04275ddbb46cf14b58905f2,t,52810,7577564,,5000049,2018-01-30 13:54:24,237
0x4981bc08edb75fc7f6ac70df2dc0d9f94e47a37872733d52ea607d9792188c4d,t,52203,7629767,,5000049,2018-01-30 13:54:24,238
0x59ab3c0fb36d2184be27cb7d8d3fb80d610b233596e9b841c59395558dc897df,t,21000,7650767,,5000049,2018-01-30 13:54:24,239
0x833382ec634f89d3ea954f3fe775e35a8020b55493ff786c855dedd246c79d14,t,37810,7688577,,5000049,2018-01-30 13:54:24,240
0xe580d6a5343e4e28b2488f776c291be2ebaaf3c84353a18e1f002629374ab75a,t,21000,7709577,,5000049,2018-01-30 13:54:24,241
0xc48c0a140b8bd7081bb65adfee70bab1b7bcda6cfbab6fe37f628597752d339a,t,21000,7730577,,5000049,2018-01-30 13:54:24,242
0xf113bb9bea788523758c9a33cd3998a60bb362ce4b9dded219a436b2d8cff982,t,21000,7751577,,5000049,2018-01-30 13:54:24,243
0x5e52df2da0851547d1b19807ef015b85c3ede5378cd926d4e29b763bbcf188be,t,52011,7803588,,5000049,2018-01-30 13:54:24,244
0x40b7136eff3149b3997521e38d1925f4299f79ace2a90d3ff54b09defe21cf32,t,21000,7824588,,5000049,2018-01-30 13:54:24,245
0x1162a4416b486fce2eef49eaf93e1c0ce084104c918e9f2699a61be956905fdf,t,52011,7876599,,5000049,2018-01-30 13:54:24,246
0x5f6084e37ef7f2bcfd05c8173bfc9587e069c11a6c2fb28873a14839fbd107b3,t,53318,7929917,,5000049,2018-01-30 13:54:24,247
0x7002033ff36dabe03954f5c338a45bb48e1f06570f37166458199670206021cd,t,21000,7950917,,5000049,2018-01-30 13:54:24,248
0xc0a11130d271e944858586d29f511ff442a0bd2aab51a1d78170ab41cfcae9f1,t,21000,7971917,,5000049,2018-01-30 13:54:24,249
0x65f567586de82ca8cb55ec46e7b72938d2a8a3f5b88baa56284831bb2f074110,t,21000,7992917,,5000049,2018-01-30 13:54:24,250
0xf84d5faad5b57d0ec734f984e16c4aa60a55be10ba24b9c547bf9de990671568,t,21000,21000,,5000050,2018-01-30 13:55:03,0
0x892afee6aa12ebb8237e19cef5712824ef1884375ceb3b9d1ca225d75cc5dd72,t,21051,42051,,5000050,2018-01-30 13:55:03,1
0x87d909aab709407ab9a0317994cbc88e12d093d54cd3e6073662a536c64108ba,t,21000,63051,,5000050,2018-01-30 13:55:03,2
0x87c94efa7e96ef2d44097c3c0611b0cfc9f9f63983bd0e8f3353dc4de9707f3b,t,21000,84051,,5000050,2018-01-30 13:55:03,3
0xb5b75cb2939ad6e22b6b16e5d09e1a19eeed9626d91519d3605bb7634556cbf9,t,21000,105051,,5000050,2018-01-30 13:55:03,4
0x34640293e002136916cfef8d27f0c2c7085a9f7f76875436d08a17ee4c7786b2,t,21000,126051,,5000050,2018-01-30 13:55:03,5
0xc2abb52a13e0acc07797d5e261740d2d96ca35f9366ce303b4fe17f67fd27b6d,t,21000,147051,,5000050,2018-01-30 13:55:03,6
0xaaabec7e4fb7e671017f9580085a28987632131fc63a54db0d2e9dd9b0b09655,t,21000,168051,,5000050,2018-01-30 13:55:03,7
0x811314bbb3b6dad3aafd268a137f71e5ad457f97c39b01c5b726462a7f3efb91,t,21000,189051,,5000050,2018-01-30 13:55:03,8
0x7eef147ececf9ab4b83f7ea46bb2a9ad9b8e5d71d522271bbfca90e1181c4d5d,t,21000,210051,,5000050,2018-01-30 13:55:03,9
0x3ea9b56ca847eee119e3df622369f0385b1e73f63951623802f1c52d425f9fe6,t,21000,231051,,5000050,2018-01-30 13:55:03,10
0x863e4af2a8ded9e1218a533ac085974648c4e626da90b7f87ef20c876b5c0d59,t,21000,252051,,5000050,2018-01-30 13:55:03,11
0x742f28a155e40d97ee0c59bbe22069568796ca89d19236e2daeebed279244509,t,21000,273051,,5000050,2018-01-30 13:55:03,12
0xebd17b9d356a4606a6cc6489d89b8106dbd68dd6f8ca27a9a787d67596dd1378,t,21051,294102,,5000050,2018-01-30 13:55:03,13
0xedb7263140f221e2cc8e3c49154e167dc9066272fe9d37f84705b118d3a0513f,t,21051,315153,,5000050,2018-01-30 13:55:03,14
0xd89167b7becdb7c1220abb1751406a73bc11d140710b17466431081dbf3a623d,t,21000,336153,,5000050,2018-01-30 13:55:03,15
0x2a6b542ec5db8e199d2f0fdcae156b88e3282c82a9c1eeff01a22adb4eb5045e,t,39512,375665,,5000050,2018-01-30 13:55:03,16
0xb38e42fc9ef07179d931812bda2d5c365d16170a39f87afa7c5c2dc37debc38e,t,21000,396665,,5000050,2018-01-30 13:55:03,17
0xa70124077b404ead0df8021aa8da6ebdaf092943b9129b8040316a6dce6776bf,t,21000,417665,,5000050,2018-01-30 13:55:03,18
0x001b2b63e6a6390b7d905851c05a0b19e6ad52962ad416da1e7c5872c4e1a5d6,t,21000,438665,,5000050,2018-01-30 13:55:03,19
0xf6e0747913aa87c3eadb7d3da0e7b8726eda8cc5de301bdb79ced3b1ade1f717,t,21000,459665,,5000050,2018-01-30 13:55:03,20
0x1c4ef96c5e148bb562ac81999384aa2f74707b82f2d9a7db8a6c0a2c27687b31,t,39512,499177,,5000050,2018-01-30 13:55:03,21
0xa1b123e290729bb0b94e866d64d6d65d3b4841e47af3cb55b03e8335db39d22f,t,21000,520177,,5000050,2018-01-30 13:55:03,22
0xc3ccc6061ae4935005f3a565c188f83cfa2bdec0287a4578030ae81fe41dd2cc,t,21000,541177,,5000050,2018-01-30 13:55:03,23
0x64f47646f23f8a18b8a48f57eb55800f16866c26fdb4609cffc1d44717832699,t,21000,562177,,5000050,2018-01-30 13:55:03,24
0x158d48059230a7bde151abf0295c554dbdc71f0d66c76c81e85f0e901d0f99bf,t,21000,583177,,5000050,2018-01-30 13:55:03,25
0x6379e00600985301af36d459a04a0b04c7b93320b510558c3aada752b0f5a354,t,21000,604177,,5000050,2018-01-30 13:55:03,26
0x86e51f6a02b0e45f60a11fd154470d5b030c62f8135aafb099437dcafc5f0986,t,21000,625177,,5000050,2018-01-30 13:55:03,27
0xca23f69e0fbc037e691a9d0f2b923a4fca3ad4c165a9c2bca1d93eb732f62873,t,21000,646177,,5000050,2018-01-30 13:55:03,28
0x82ff93f87761927c4b960075a739fcb95dbbe54e8624ec0158fb73903ad09511,t,21000,667177,,5000050,2018-01-30 13:55:03,29
0x1961946bcc02c01ef36b3646e79606c148349d9a384a493ed28b417b5a4888a7,t,21000,688177,,5000050,2018-01-30 13:55:03,30
0xc4157ab91fc7970b8184bf1c2cd20f2a695a78c84bbb8c385b399a023e3cea81,t,21051,709228,,5000050,2018-01-30 13:55:03,31
0x7cafd1b72f285453d08ec5eb83c35584d00af146023d45eea04cbf3614440824,t,21000,730228,,5000050,2018-01-30 13:55:03,32
0x1bfe3927e8594b85d40f1ded65eba5b7967cdc068e5ab7f71bb75448a3bc4a50,t,21000,751228,,5000050,2018-01-30 13:55:03,33
0x98b634cecb962fed114347e231ed69c5f01a2502c9bbbc4fc8d7e79f80f6da90,t,21000,772228,,5000050,2018-01-30 13:55:03,34
0x929a5f01b5721dfd6c1458196b92b125dae59112bd4181ec5bb1d75ba9c567ef,t,21000,793228,,5000050,2018-01-30 13:55:03,35
0x944d050ce3d046e7cf2262e8828ff9d6367b6783bac979611c46d1e6557496f8,t,21000,814228,,5000050,2018-01-30 13:55:03,36
0xd7b410df57c1b5b28d39b9fe1df5d62312d62ecee0a34573a86a2f10971a2172,t,21051,835279,,5000050,2018-01-30 13:55:03,37
0x271a429f46ba4b10c9417e69ec3aee4c060363f8902dec8b2da2bb4d9f45cfb7,t,21000,856279,,5000050,2018-01-30 13:55:03,38
0x74781107ed3b1efd1148e4adf94af60e92a30386751fd99a346f1b26213ab1b4,t,21000,877279,,5000050,2018-01-30 13:55:03,39
0x375c8e6002902b75eddd35853607b2d2b345eb3acaeea47e404ccce4658a015d,t,21000,898279,,5000050,2018-01-30 13:55:03,40
0x53bed7667e30f6e9a8664e051a8bf89f018be0d9d04997f616e6e5f4cf2ee90f,t,21000,919279,,5000050,2018-01-30 13:55:03,41
0xd55669c4cf64a18127bddb7a6a86a3f74d67d0e920da896aeda8c17d8c1d5e0f,t,21000,940279,,5000050,2018-01-30 13:55:03,42
0x9b2d21d32d331c0ad1971a4c1fb6663d8854abc5d850ee1f8010c53af9ffb6d7,t,21000,961279,,5000050,2018-01-30 13:55:03,43
0x09c27310eb9ab0c62c1bc47634f8ed2347031632a9d1143ec6ffa30c4659dc58,t,21051,982330,,5000050,2018-01-30 13:55:03,44
0xf637fdff401e1bac28067858e7967b6ba01f32f341a5f6dec750b0775b92aebb,t,21000,1003330,,5000050,2018-01-30 13:55:03,45
0xed8be1d605c671f0bd4f67930260908aea15ef98b7f1429fa0a75fd3bb2fcb63,t,21000,1024330,,5000050,2018-01-30 13:55:03,46
0xdad528d13f092381c7e1e882375238a312d0fda4866c66e83fbbbc631ea71421,t,21051,1045381,,5000050,2018-01-30 13:55:03,47
0x841a5fe325f2ad4abf6398a00db50f22b0ca69092808436c4453a90a16453907,t,21000,1066381,,5000050,2018-01-30 13:55:03,48
0xdf9cf87a88a595ec69685b0a0c492ff0e4fc755222da8d71dc3ba56404d15bc1,t,21051,1087432,,5000050,2018-01-30 13:55:03,49
0x7ddc2fd62f3f39245376a695c8bd9a25d8a29172d82047d57c8894b97fa13eb2,t,21000,1108432,,5000050,2018-01-30 13:55:03,50
0x4c28ad4ab41551c97faa3f177e858f273196ef2108372eb7d677c41c3b881e09,t,21000,1129432,,5000050,2018-01-30 13:55:03,51
0x7f583aaa6a660582e3fb8321640e9007b9d3a3e001b752032b5af03623a39cfa,t,21000,1150432,,5000050,2018-01-30 13:55:03,52
0xe218cf0d647ccd882b7da765663cf1de7462d2f100bf0831d4705364d897234a,t,21000,1171432,,5000050,2018-01-30 13:55:03,53
0x3589027a60a14210a3c377b7c02d0783797b77b6b163604d4e34f9bf77145a9d,t,21000,1192432,,5000050,2018-01-30 13:55:03,54
0x6bead8583c94b012ee1b9db9fba51734808291ae3921711db7dfe6fc69e9f764,t,21051,1213483,,5000050,2018-01-30 13:55:03,55
0xe4bf29398e2fc6dbfe76f9ea3898ba8d35f480fef53413381a2db0a3b1c1dc69,t,21000,1234483,,5000050,2018-01-30 13:55:03,56
0xcb9206e28cf834fd29ec0d528e192d6c610c8d37d68224857cd2dfcdcc020080,t,21000,1255483,,5000050,2018-01-30 13:55:03,57
0x1942de910a7b222df16b14875b915a7000811e2aab91bddb1a8419995cc7f104,t,21000,1276483,,5000050,2018-01-30 13:55:03,58
0xda2acb6561f77d9b02ae34fd291095229c5827e113161dc8c88c062b0b68429e,t,21000,1297483,,5000050,2018-01-30 13:55:03,59
0x74aae448d41c3d6360c733b426f753d1ea04e0f4346ff7b382cb502bccf0a0b3,t,21000,1318483,,5000050,2018-01-30 13:55:03,60
0xe4f9c0ca22a5e636e7b38e62de9329112a922d444f2364f517180155fba673b2,t,21000,1339483,,5000050,2018-01-30 13:55:03,61
0x73c30eb7febd0a74a9c50260c8ff826edb8834dfe8104c275589794e33d53b86,t,21000,1360483,,5000050,2018-01-30 13:55:03,62
0xcf9d8d0c9beb4cc1e6b0c81f366e4495c9695ceaa20595fe1c5b3f3ca73dfd75,t,21000,1381483,,5000050,2018-01-30 13:55:03,63
0x5983afe5c1e748b961d98a5f0421aed42858583586cc0077feeded515a37e018,t,21000,1402483,,5000050,2018-01-30 13:55:03,64
0x54da89bce87359d8349f72ccae4807bf0964e6cc98caa0c2a1a051a15e4118d9,t,21000,1423483,,5000050,2018-01-30 13:55:03,65
0xc65eb1d8ed522e9cc0f61715107fd9130f202f9d89bdc512c23e61522563be72,t,39512,1462995,,5000050,2018-01-30 13:55:03,66
0xa11743bd67158fcd32168bb47c0c4cfa3b5248a823be8671997853f16b66c873,t,21000,1483995,,5000050,2018-01-30 13:55:03,67
0x58e146a659539a7e13c298d0baca08bb390f13b775f8a78153e8ecf21b28818d,t,21000,1504995,,5000050,2018-01-30 13:55:03,68
0x18bece6ed4788cf8c54a7be62399359a89a8fdd85abd084765850327a28c016e,t,21000,1525995,,5000050,2018-01-30 13:55:03,69
0x5ea7107dc81850c6d2a1b2e26b0fd8cc3b8b7d9ab4dcc248489522d362624a7c,t,21000,1546995,,5000050,2018-01-30 13:55:03,70
0x0094559ac545d8ace9dcf2bac6300173a17da32718916929903a57af3f62462f,t,21000,1567995,,5000050,2018-01-30 13:55:03,71
0x79627944f6c53b2aee6baa55cb3dd1844c510cb5b7a6b1fe12924925434feb4e,t,21000,1588995,,5000050,2018-01-30 13:55:03,72
0xbc880b5f187035a7fa09fe54c333052d9d60c0843619ac8578fdf76dcb3c1ff6,t,21000,1609995,,5000050,2018-01-30 13:55:03,73
0x398811e7dce5f772f9f79558eedf01c16223653eba1a20bce8997f65ed6e6705,t,21000,1630995,,5000050,2018-01-30 13:55:03,74
0x5fb03aa3f4a875c0bbedc2ad0d9951682a296f89cc2439315a881795490a2a22,t,39512,1670507,,5000050,2018-01-30 13:55:03,75
0xa1bd8027a042bf425a79f6b16c71d2fc1596b857c26fe0b63a9e2a43501d7fa3,t,21000,1691507,,5000050,2018-01-30 13:55:03,76
0x71333c126a55fdc2917c14d6198bd9a1036294f2c8e4a07177a69cb1d07a0b0c,t,21000,1712507,,5000050,2018-01-30 13:55:03,77
0x880afc42d1f99adfaa930b0d06a793778f8b0eb4580ede63971343ae26e5cc89,t,21000,1733507,,5000050,2018-01-30 13:55:03,78
0xdee9647cdcd0801e9f1409a29c7a429eeb8c539f51c64fed4887e46fee20a767,t,21000,1754507,,5000050,2018-01-30 13:55:03,79
0x2cc19280cf053480d49395b57334fa7c4fdf4f81257b27659075bc7293191acf,t,21000,1775507,,5000050,2018-01-30 13:55:03,80
0x4a3956c93ca321c459ec1573c48bc510285fc2152fd752c036072845f62ac414,t,21000,1796507,,5000050,2018-01-30 13:55:03,81
0x87b452586fc7d880586fecf280edd2c461058830e1ceb81ed3518ae4ae30ce6e,t,39512,1836019,,5000050,2018-01-30 13:55:03,82
0xb5722288001f7a8dc6084b8102c5961980174ca864fb207af9447ed0e97e7028,t,21000,1857019,,5000050,2018-01-30 13:55:03,83
0x041bef70e4484c2c0f02f40984182864b3d3fe7ee7f2ae71b0beebc80af667a5,t,21000,1878019,,5000050,2018-01-30 13:55:03,84
0x41dd82d6b08ba93cf534ea3e08c985997711d6d20ace5022a50fcb9436224e18,t,21000,1899019,,5000050,2018-01-30 13:55:03,85
0xf46f70eeba469116930d784a93c8fddfed7e16c8b989123111bde50bf60d5a18,t,21000,1920019,,5000050,2018-01-30 13:55:03,86
0x3903b9e86d2300b164f67bddaf6bc65de9a18bba33b805372031f44ecb82b262,t,21000,1941019,,5000050,2018-01-30 13:55:03,87
0x95cd24794daeefda15e461e5a93fd0d75f41654ec9b26914061a801648eecd8c,t,21000,1962019,,5000050,2018-01-30 13:55:03,88
0xfe9cf9c467c421170f99556bf4519c60718c29678fbb6b99d43278e78fe37f64,t,21000,1983019,,5000050,2018-01-30 13:55:03,89
0x23159b6e6a4fe3ca84e2e4c02f9d8532ee0d5c30c664e1322d94e9428ca216bf,t,21000,2004019,,5000050,2018-01-30 13:55:03,90
0x05a444454d52c467fee3ca890804141eee280c232d8bbc41fa127bdea81c9fea,t,21000,2025019,,5000050,2018-01-30 13:55:03,91
0x3dcc88aa73b4b3f357c83777af3272d09096b0050c7d09f417916d95327f71b5,t,39512,2064531,,5000050,2018-01-30 13:55:03,92
0x2fa07ea4e4389e9b95f4f94a13c66f69a35b3cd8ee9be89ca0d959851ac6f3d8,t,21000,2085531,,5000050,2018-01-30 13:55:03,93
0xce4fa802e673432e3d4b574117e094f47140cd61299a60bd908008715b41e89f,t,21000,2106531,,5000050,2018-01-30 13:55:03,94
0x06d98e5edaeb9fe1880f7cc8b8844db7c8eac86472b3eaa21c5a152d0537d222,t,21051,2127582,,5000050,2018-01-30 13:55:03,95
0x4bce9d6ff34bf854d7bcfb90d8307ccece83d4c27a09ae89bddaa9b349a106d8,t,21000,2148582,,5000050,2018-01-30 13:55:03,96
0x21841ea442f6c18a50ad3568bab3dd917929e31b1f5931a648494c75bf0071fa,t,21000,2169582,,5000050,2018-01-30 13:55:03,97
0x7d3f5024ed1cff95ae046640a2f0f50269f5028116f9b19f048a62e0dd089dbc,t,31005,2200587,,5000050,2018-01-30 13:55:03,98
0xf57a540678635d1bf3e766d8627cbb3d30e472316bdfe9f0ff9072c75ce7a0c6,t,21000,2221587,,5000050,2018-01-30 13:55:03,99
0x640130d99e6eada235ae00afc150ba4cfa07eb3e49a068d56a18d67c4ac15194,t,21000,2242587,,5000050,2018-01-30 13:55:03,100
0x0e5b8f11ecc4bfb07ebb8a94f9df9641bc0153f0416b56176e5bd36d3f6ccfb7,t,21000,2263587,,5000050,2018-01-30 13:55:03,101
0x7783df9b078f3b3d104b1d10829de842e18a0f6ca7a9746e274ab219713948e6,t,21000,2284587,,5000050,2018-01-30 13:55:03,102
0xf6b8061781a7c2965313cdf2b28f70a449202a5aebef46745c0ddceaada98faa,t,21000,2305587,,5000050,2018-01-30 13:55:03,103
0x46b53bbffda94e680e658e7f82dc6126a3a574ea91ef9dcaa64e99c201faa713,t,21000,2326587,,5000050,2018-01-30 13:55:03,104
0x45b66148d3125a3e8d26b5800db3df656f9dab3c3c0c6fb2ad70275559c3e38f,t,21000,2347587,,5000050,2018-01-30 13:55:03,105
0x2866b692e7a44201e43d0fe1437da47aba074e86af400b7b627ab2a69d476911,t,21000,2368587,,5000050,2018-01-30 13:55:03,106
0x9e1f91ff583f4178540c1b5a015af908e56c3b3fdec6db07e21ae871c5993121,t,21000,2389587,,5000050,2018-01-30 13:55:03,107
0xd707a491e1670a65f2645712fb0deccdff8f33493f5758a9fcbe345f9eca8768,t,21000,2410587,,5000050,2018-01-30 13:55:03,108
0x3fcbe93380b81e236756339e41748b7eba3cacebd8155fda1ae7b5a855ef16b4,t,21051,2431638,,5000050,2018-01-30 13:55:03,109
0x07116bb7598e622fbf8bbcfab5af7675da9174e4961e6b486b6e32153a4476a7,t,21000,2452638,,5000050,2018-01-30 13:55:03,110
0x5513db3016a39c16ac2fb630098b0dcc3e59f9eca8fcbb372cb18496cb2e0048,t,21000,2473638,,5000050,2018-01-30 13:55:03,111
0xfd4a30c79835f5156bbf1e8de99f74b66fcaf6412d4513aa567422790bc10775,t,21000,2494638,,5000050,2018-01-30 13:55:03,112
0xb6f7f00aceb919a8fbd40fe2c35865ba74a47e6ad2510a6fa1e48b26af821724,t,21000,2515638,,5000050,2018-01-30 13:55:03,113
0x858b338d0f01a9726ab91d3cfa05b9c205f1ba92c3b5e5770fd73e2df9e6614d,t,21000,2536638,,5000050,2018-01-30 13:55:03,114
0x1377984008bbb5248731e77eefd757630c12e8e5c19beea4fef787c2967d79b4,t,33705,2570343,,5000050,2018-01-30 13:55:03,115
0xb9c3e4808f3b64e9bae9587ffc54d01d73c5aefe642f87fec432540ca55a1b9a,t,21000,2591343,,5000050,2018-01-30 13:55:03,116
0x78e09090833db9c5937a005305e57fea34b85bd3053e60fc776489201e8dca39,t,21000,2612343,,5000050,2018-01-30 13:55:03,117
0x42f867ca177723ef27a8bb0d9394a647811171cd1c3e1518e8059f20c4599602,t,21051,2633394,,5000050,2018-01-30 13:55:03,118
0x955784af29761ebf9e7013ba76d2ea682fd80a76bf4f6c5b197a66d4a1433d1d,t,21000,2654394,,5000050,2018-01-30 13:55:03,119
0x8ad4ae7815b59fa7c15494d253dbfd3dd690e8c5bf084aac93f9ca0bd11c5939,t,21000,2675394,,5000050,2018-01-30 13:55:03,120
0xd88d1e86ae6361213ff145ec09ce6c2b37906d82c56c7d05e95b8d84b059aa83,t,21000,2696394,,5000050,2018-01-30 13:55:03,121
0x9de4ea4701f9be4e6157fa2d7c818a45cd4d3fca7b20cc916b4dadd2c6ed3ca0,t,21000,2717394,,5000050,2018-01-30 13:55:03,122
0x72a287ae4055dd12cee3af4d225fb8b82dbc6eb68b2541d291cad6c6d68aa925,t,21000,2738394,,5000050,2018-01-30 13:55:03,123
0xb6e3d1a69e18671d5f73271d61186fd9a5324b9a9311ed1406c708e3cbb26405,t,21000,2759394,,5000050,2018-01-30 13:55:03,124
0x4c9af776ac2d5e4f07dfe1b38d697e2014ac14e75b543dfac3c9ae86ab817edd,t,21000,2780394,,5000050,2018-01-30 13:55:03,125
0x3493b50896ceecb3867bacc97fca1a19ca8753c276c44839df890004b663a328,t,21000,2801394,,5000050,2018-01-30 13:55:03,126
0x92f2d9b69faf65a228f633f6890a4db2878a2e606958fad474e31f5ac1efcce4,t,21000,2822394,,5000050,2018-01-30 13:55:03,127
0x2d419de77e155b2daab53d6add630d69b2b9e79e823ffd86daf4fdddd11d2a4b,t,21051,2843445,,5000050,2018-01-30 13:55:03,128
0xc78b958878350de4f81c6222404e3c5e3559a52ec6eb34b65427bb52d8aa0022,t,21051,2864496,,5000050,2018-01-30 13:55:03,129
0xe72f0d8276ac4bc3a21ced0a1e502f39814e7bdf1979d873025a9a4c467ed484,t,21000,2885496,,5000050,2018-01-30 13:55:03,130
0x5f5adb6325b94d6a0563f7a302f2a60aa5a8b5394ef2793c504ae7f62e6f7600,t,21000,2906496,,5000050,2018-01-30 13:55:03,131
0x2ffe2fc9b0b65d9bb651ecc43334e363691ab6e591e5ce45096829c47a902878,t,21000,2927496,,5000050,2018-01-30 13:55:03,132
0xd4b2c651674c34321b9665635cbdbda437fad29c08295ef1b4b74a102746086b,t,21000,2948496,,5000050,2018-01-30 13:55:03,133
0x06011f000a5bb7148784a3425d0875f89dfb4680c99e8966a763aa8286ea3152,t,21000,2969496,,5000050,2018-01-30 13:55:03,134
0x76f757ffca20555fe8c709219d4464f1ce80e28d25f7e8d0751604de8fec34f9,t,39512,3009008,,5000050,2018-01-30 13:55:03,135
0xc229bfc41e5eafff7ec942e6cd38ae0b74e99b065e02e0c36ae9fb14d31dbbd3,t,21000,3030008,,5000050,2018-01-30 13:55:03,136
0x0537713ef6718c0713a03faf71e8c9aa5b2139cf3b8bf9624d99cce0f8c62a4b,t,21000,3051008,,5000050,2018-01-30 13:55:03,137
0xff0b3dd618a6a7332c8fd93cb34f82cf9e3bce04cdb25d43142565a7a6fc3bcf,t,21000,3072008,,5000050,2018-01-30 13:55:03,138
0xc65103b0231ad5f26718d55f43a208ae61cee054261abeda1094fbcc48ef3cad,t,21000,3093008,,5000050,2018-01-30 13:55:03,139
0x3048fb5e43903af787fb718708d6ef67480c292f16479762b07c1f6f81e7e62d,t,21051,3114059,,5000050,2018-01-30 13:55:03,140
0xbd5b0cd5809b3be63881df97d286d044c1c010fe89d0f4a335855dab692284d6,t,21000,3135059,,5000050,2018-01-30 13:55:03,141
0xe4d08263aba2a72b2978d79a003252e434112be695cbfc35333f8740f5775d9b,t,21000,3156059,,5000050,2018-01-30 13:55:03,142
0xce7bf3e4528981d98789141bc8487aa9c7125f0a09c67ae73eb5bf9e1ba66bad,t,21000,3177059,,5000050,2018-01-30 13:55:03,143
0x25e719ad658983f9b9e617175732da38130864c5ed91ae01c21053d057a0091d,t,21000,3198059,,5000050,2018-01-30 13:55:03,144
0x8af58c4dc2db423c3db7f42259474ca7f7626adddb2d19d85a61bd809b0da8d5,t,21000,3219059,,5000050,2018-01-30 13:55:03,145
0xef6e3dd20c51160c5e6723ffb59d5575cf52d7f62ef2354ddba7a90b8b0573f8,t,21000,3240059,,5000050,2018-01-30 13:55:03,146
0x1f7a7b22887962d74263a1c438a7c49bdc35744f19c725ecf800c79ed8c943ee,t,21000,3261059,,5000050,2018-01-30 13:55:03,147
0x10e36d86925361dbcd646c09f083b19c347ceb1c7bed94890c42040fa17c454f,t,21000,3282059,,5000050,2018-01-30 13:55:03,148
0xa98718c7844f489de9fb5b0282da52370f55e50bcea2f6b2647e1b3f45c52723,t,21000,3303059,,5000050,2018-01-30 13:55:03,149
0x82184e7b7870a495fa6a930b0be51f5e78c78c3e92ac84bc403bc4cac7035b69,t,21000,3324059,,5000050,2018-01-30 13:55:03,150
0x0cbc737225fb1c60c66bc5f99dfcd39eec4103019e5f128033de8f532e8d5050,t,21000,3345059,,5000050,2018-01-30 13:55:03,151
0x608fc4fa61d235a5ac0aa219af74a8e538191995f3b5b339c577fa5c60ddcc47,t,21000,3366059,,5000050,2018-01-30 13:55:03,152
0xa74543097711ce6cb1549de6fdde4537486341cf381bbf7785ea61e23ea46792,t,21000,3387059,,5000050,2018-01-30 13:55:03,153
0xf57ddc851f6a3b853eaed875b75dae89ec1a1113762503077deed833c6be81cd,t,21000,3408059,,5000050,2018-01-30 13:55:03,154
0x249e03c1fffcffd2f7a04e3d859509e3bed554ef0f61023fcd138c83e960cc40,t,21000,3429059,,5000050,2018-01-30 13:55:03,155
0x8413d05bb8549dd0e9d07ca3f2520fb93f0362e198a1e8107d47c1da844c3183,t,21000,3450059,,5000050,2018-01-30 13:55:03,156
0x50d6bbb0fdf09758f51569a765d092b9e76cda48f0ff0b2122688c3c12983103,t,21000,3471059,,5000050,2018-01-30 13:55:03,157
0xafcfdd503cace45e297c59facdb587c24f7f6a34779745c39d75f84b23143997,t,21000,3492059,,5000050,2018-01-30 13:55:03,158
0x1ed84d15dff247e74fdae49b86e213ed863c0396b9fd8b794abff43961e9ef74,t,21000,3513059,,5000050,2018-01-30 13:55:03,159
0x89bee841ac3bfb2bc67253a4b86efb490bc9a557c86e244cf1ea57c7bcba4098,t,21000,3534059,,5000050,2018-01-30 13:55:03,160
0xb8a6c95b0d22ab523bbd697bb15b5ba8a719a6566b9bfabb4ed37f31a3974c44,t,21000,3555059,,5000050,2018-01-30 13:55:03,161
0xc231e2a4f13a7410db6207a6f30b49a4d4790996e8934d53092d03e87851d11d,t,21000,3576059,,5000050,2018-01-30 13:55:03,162
0x10509e04b46190ace980b712aa029658246f7cca228bd72f421085a475e5ab2b,t,21000,3597059,,5000050,2018-01-30 13:55:03,163
0xb3c6548f23446e23e212fd8dc583032d7b5ea495782c3eb875f4907a79c04ad5,t,21000,3618059,,5000050,2018-01-30 13:55:03,164
0x182240dbf58cd306b4b8873510447965bcd4305c6c389421a901eca5d3fd065d,t,21000,3639059,,5000050,2018-01-30 13:55:03,165
0x72c05941e455ab1844d410fc956230027ab1877cf5b63414d53eb9278a20bf66,t,21000,3660059,,5000050,2018-01-30 13:55:03,166
0x6de5fc94bde9f7552bffda438aeb39271f2645810791f40541e10df0b9810382,t,21000,3681059,,5000050,2018-01-30 13:55:03,167
0x34e3b09f9237d5cadb57b24cae33abdf2e1e8cd7287b1dd0aeadb38f2abdba53,t,21000,3702059,,5000050,2018-01-30 13:55:03,168
0xe893ee88d689acbc3d2ce70cf145e8150d0b59e9c0f476989db47d0080fa7880,t,21000,3723059,,5000050,2018-01-30 13:55:03,169
0x0656ae561e71c0bc47ccf3bd8e8d07665cba31e526ce335a054f5094e533d7b6,t,21000,3744059,,5000050,2018-01-30 13:55:03,170
0xb782162368135a71bfeceb0251c4270f52edc00f5ad5f86b77503b8395f43658,t,21000,3765059,,5000050,2018-01-30 13:55:03,171
0xb9fb84124efc70069a80cd31844e093f1711d340c1270d3bc987a05304001fa4,t,21051,3786110,,5000050,2018-01-30 13:55:03,172
0x48c8f37ce3e2e8aa597baee2133e3eb2b124eb8cf4970f921946e7248f69390c,t,39512,3825622,,5000050,2018-01-30 13:55:03,173
0xfd29f6c2b540677cdd93211de8ace1716fdbe1ffc64f6efeb45b9a86de4ead0d,t,21000,3846622,,5000050,2018-01-30 13:55:03,174
0x544a50542801f96f83167475377c453a419ae091107ab8e17a63f5c6cc4662b7,t,31005,3877627,,5000050,2018-01-30 13:55:03,175
0x636c0edb73108f8ab3ab5a683e85b683a80e71f96e2aa42507997c25ddf6764c,t,21000,3898627,,5000050,2018-01-30 13:55:03,176
0xecdfa2693d5ae93aba3cc4cad6d9fa05660722b64402aca416035bb846afc588,t,21000,3919627,,5000050,2018-01-30 13:55:03,177
0x5cf9fcaa09aa98e7a6a9b2746cc8b553f32fe1a32856b8d50e1703f60b57a206,t,21000,3940627,,5000050,2018-01-30 13:55:03,178
0x749515f94b756f44a1c0db954fe4f1396fd5acdee1f1eb7dc0308a5a9f8c0dfd,t,21000,3961627,,5000050,2018-01-30 13:55:03,179
0x8623084051567f6c29473c90fa02b7b521c4deca76a49f5a193bf2a1347adf69,t,21000,3982627,,5000050,2018-01-30 13:55:03,180
0x1a2c86678c68036f90c16112e44388d768dec1b97f93bc2d7519884a8c209177,t,21000,4003627,,5000050,2018-01-30 13:55:03,181
0x2881872c6bbf4b29158cdb2b49d59c860c6ac9cd528eedbbc8c2d57e0eafe49d,t,21000,4024627,,5000050,2018-01-30 13:55:03,182
0x419868e4f7d5930500daef915dd07a0e1fa9c67959f99a9bc80ce1fc395808d7,t,21000,4045627,,5000050,2018-01-30 13:55:03,183
0x2aab53989202dc482181074e3372404d2f7772051fd5b0c18b1b6acb6e518eb2,t,21000,4066627,,5000050,2018-01-30 13:55:03,184
0x03c968e953225ce4c54d5fa52afc09bcd0216ab95f454324f532577475f1f32d,t,21000,4087627,,5000050,2018-01-30 13:55:03,185
0xc769bd4c30a8cd24dd18a7087f60c2d565af3af32eea1b7717ede65cf3d74eb1,t,21000,4108627,,5000050,2018-01-30 13:55:03,186
0xa11e1d13eadc02cac325324f5b0efd675593aad33508f44aaad96254f9d07c77,t,21000,4129627,,5000050,2018-01-30 13:55:03,187
0xca13486d2de70de03a7504abdd44c3f147c920526f0bcfb6bae7348c23291723,t,21000,4150627,,5000050,2018-01-30 13:55:03,188
0xe30510b7d89b92955f4a494a78db25c3890c335d26550263eaead13acc7f5f99,t,21000,4171627,,5000050,2018-01-30 13:55:03,189
0x10336bf1dbd164f9eb1fcd2a0de1b22e63f66893ad903e73b82016020b11b88c,t,21000,4192627,,5000050,2018-01-30 13:55:03,190
0xeb722ce40b5383ebc9c14806137e5b64b51c0fcc3d929215ac98082376b99c5d,t,21000,4213627,,5000050,2018-01-30 13:55:03,191
0xb06224c963c34ab8792b8e74703a378584324f3c3d44bc659891aa4cd9e828b5,t,21000,4234627,,5000050,2018-01-30 13:55:03,192
0xa7b4ff79fab955367ca6694dd7effeec14dbf3105e1b75803acceadf9d344cd6,t,21000,4255627,,5000050,2018-01-30 13:55:03,193
0x1644f4609418df457fce29ae75dda0932ea3cfce791e758bc8a061d7ad2e92dd,t,21000,4276627,,5000050,2018-01-30 13:55:03,194
0x27d8718dc14ea8d29db2c60ed60314ec645750c636a4b7e3aa07a1b2f6e04770,t,21000,4297627,,5000050,2018-01-30 13:55:03,195
0x9b237812bb2c995396c8a3d5bd71214c47ef8c8e51b988e767d21a10631b67fb,t,21000,4318627,,5000050,2018-01-30 13:55:03,196
0xb2a02319fb3301830bd753ac28a01df5e83310e4f7335e1a1dd7d972a137954d,t,21000,4339627,,5000050,2018-01-30 13:55:03,197
0xecf7786c207ac3bf25a4492e550b99658dca0993bdc7463975676fa1b64f3177,t,21000,4360627,,5000050,2018-01-30 13:55:03,198
0xa8f5f0ecf5d9c2333bd00cd4e8d7b256fca32eca12f11ed574262929da50a784,t,21000,4381627,,5000050,2018-01-30 13:55:03,199
0x35628e08bc1a1bb2a43f013979d093561d6924cacba07b48af615fcdd916d7b0,t,21000,4402627,,5000050,2018-01-30 13:55:03,200
0x6b7aed1c3b7298fe02190829ef635f8e52107b3b4dd8bcbf5fa328bb5191c8b1,t,39512,4442139,,5000050,2018-01-30 13:55:03,201
0x9b4afb875bbd3f6395834f814538bf3389724f90918af792488113a5bb175b27,t,21000,4463139,,5000050,2018-01-30 13:55:03,202
0x00c001f7a4f5c1d78d3b879acee8e37d3fc7bf522a961f9b68d4a8cab0eb5fbd,t,21000,4484139,,5000050,2018-01-30 13:55:03,203
0xdb30d1099d19bc59966125fdc523860ec6463b8565ecadcaef7a3898c5c9154e,t,39512,4523651,,5000050,2018-01-30 13:55:03,204
0x096fbb81da201e70009644ef10b0d540af840c1b3ae08c71bee6a6bffbaa0505,t,21000,4544651,,5000050,2018-01-30 13:55:03,205
0xb92d55ac1541acf3fee8b55e5ed01c1ce6ee8912feec42d7a243640d0b3fd85a,t,21000,4565651,,5000050,2018-01-30 13:55:03,206
0x89490fd5f81ac9e83dc4bc335e5db37247ddd3204e5c6c8c325f1c7d0697b442,t,21000,4586651,,5000050,2018-01-30 13:55:03,207
0xc58d319f1a8395027f93daf20ee09b5547d5506f3f1c9f09c674c2abfcf1ee3e,t,21000,4607651,,5000050,2018-01-30 13:55:03,208
0xaf6c5f0e7baf981dbd3b35741f89c112e7e90cbdf10d9e94f4c2b7b5e2fa0de8,t,21051,4628702,,5000050,2018-01-30 13:55:03,209
0xde983961e42e72742fe433fa120a31b7bfa7f5b318bebf4c6bca97d2ff06298f,t,21000,4649702,,5000050,2018-01-30 13:55:03,210
0xb6102215e0dfb3c7ba1efe9aec9a5d3a1ab72f3a63674ec34cc362fe0f38dd9a,t,39512,4689214,,5000050,2018-01-30 13:55:03,211
0x98c42168095292a5a93fa37ccca316327d88cdaf92ef6f0221448147e7663d57,t,21000,4710214,,5000050,2018-01-30 13:55:03,212
0xeb383b39c2a7d1d65ef228e650e01ad2ade1903463ed5622c8f02c93d12eb10d,t,21000,4731214,,5000050,2018-01-30 13:55:03,213
0xcbb4eba262af0bc2ba000a33e5fb9f1512837a1d11ec09dccc6fee747707166c,t,21000,4752214,,5000050,2018-01-30 13:55:03,214
0x5713467dd21600c1611b89e9e3b41200167b3ab5a2dc6d88dd06f5eee8106433,t,21000,4773214,,5000050,2018-01-30 13:55:03,215
0xf1e7fe3422e94ee8de838d25635dac69365cb84f9ad34cf4834bcf0d585934cc,t,21000,4794214,,5000050,2018-01-30 13:55:03,216
0x257c6650bf8ea2891a1e9efc3055713700fd24bf6050b7ca072ddae036b4487a,t,21051,4815265,,5000050,2018-01-30 13:55:03,217
0xd7bb6a99573b28675008ec2b0d9ce694816abb5286fa8deb0cf834a14ad8d1da,t,21000,4836265,,5000050,2018-01-30 13:55:03,218
0x1859997218cf2c159b34794c8db0c2cb6406ca6ba2ee441a7c6f12b3c787a7d4,t,21000,4857265,,5000050,2018-01-30 13:55:03,219
0xedba030851fd8291a8b992e1da60dd8682601440e74d3b4f108c1ae06f3da3f6,t,21000,4878265,,5000050,2018-01-30 13:55:03,220
0xee8f134a0919e3d8327d0a153316a46d541948bd79fbfcdf3a999d2be6fa2366,t,21000,4899265,,5000050,2018-01-30 13:55:03,221
0xeb7b878e39266341d6de41107ef28735496a346312eec4ea2b45eaba618cb680,t,21000,4920265,,5000050,2018-01-30 13:55:03,222
0x3b7b9f1acd43b4524804649569bf06c73e18e02a5112080c3bf48a12f3099924,t,21000,4941265,,5000050,2018-01-30 13:55:03,223
0x8ab963017141307a721527b58d4bba262fa9bb9e6ea3b259df757aaa403b5f16,t,21051,4962316,,5000050,2018-01-30 13:55:03,224
0x91b8d7c7b305e80db4084ed7a70d3fae90868194420c8a2d114763ac807b478d,t,21000,4983316,,5000050,2018-01-30 13:55:03,225
0xe0c79ee82a7e3e5a80ca847552ba20ba7334d43e928066ceb813a24d12acf536,t,21000,5004316,,5000050,2018-01-30 13:55:03,226
0xbd85705adba0ca5c71704816e4f1caa15e52bb8b36ff64859d3492695e31b0d3,t,21000,5025316,,5000050,2018-01-30 13:55:03,227
0x1edecfa1189f4791f607a2c1a3304f1bbaef5944d32ccc1c9cfa944f6f966a2b,t,21000,5046316,,5000050,2018-01-30 13:55:03,228
0x1f369f18eeb2e40e353cc9bb7922bf1bd72c6e1493c11ddb0030d12b5cc754d5,t,21000,5067316,,5000050,2018-01-30 13:55:03,229
0x061f6383d2d8d5433a26c4b800820ab82b3658d1c9c4f12d0318ed5a64f363e1,t,21000,5088316,,5000050,2018-01-30 13:55:03,230
0xf4fbf8fed04724c217146a1b349c7266b69dca431605759528f95b9592807668,t,21000,5109316,,5000050,2018-01-30 13:55:03,231
0x0735117d35380270e29c3eff20a104318e7603908364612cf79215ceb80b07b0,t,21000,5130316,,5000050,2018-01-30 13:55:03,232
0x017c5eced08ef4d99e59a0cd2f2830be34dd7e5bb4896b54b9b56f2196d71d80,t,21000,5151316,,5000050,2018-01-30 13:55:03,233
0x1bea730ef61f5552a3c4672eff4243186ee2a2ca5c32fabc311e2b5658238687,t,21000,5172316,,5000050,2018-01-30 13:55:03,234
0x8a4eb2e89c35f7fa94b2bbacbd2829de95f729300e19b970c1bda3adb3cc78a7,t,21000,5193316,,5000050,2018-01-30 13:55:03,235
0x2d94a748005afa7d61a01f1c1f4cceab6059d008769a911b462ff2042d429e5e,t,21000,5214316,,5000050,2018-01-30 13:55:03,236
0xb700ef5619ad2d1ffff689ab96fe5957fb9c362cdd0ebecd8e3e53151250af66,t,21000,5235316,,5000050,2018-01-30 13:55:03,237
0xa1d23c97bfd451c54e408bffc505d4843f5abb5a37c85404bc881761f2e5411a,t,21000,5256316,,5000050,2018-01-30 13:55:03,238
0x3e7048a10a7c8bcc2c731cd0a4860f1b83266cff9d6fe0e436fd23b30195df72,t,21000,5277316,,5000050,2018-01-30 13:55:03,239
0x2b09a0e1a4f1045f35a6db7628e5732bd865611f4c785b46f3874a068b448af9,t,21000,5298316,,5000050,2018-01-30 13:55:03,240
0xdc9d03bb60ab26787accb6b95e4485720ccd9f63937d049118b1532bca1d35cc,t,21000,5319316,,5000050,2018-01-30 13:55:03,241
0xc8fa3735f63e8323b013d3c614000bd58725da65580fc2b63eb70e09bf6b5910,t,21000,5340316,,5000050,2018-01-30 13:55:03,242
0x3af6aa8375d1d2a41a9344a971bf6c8b5775e0258b16bf0e187ead33c3d049d3,t,21000,5361316,,5000050,2018-01-30 13:55:03,243
0xd2510e99d1032dac1a0aa3fe670975184bd1d2edfc09f3ae35e11a17c82377da,t,21000,5382316,,5000050,2018-01-30 13:55:03,244
0x54c5ecdaa035176ea8a909b49a9a48563b781228277f33066e05f211f547c325,t,21000,5403316,,5000050,2018-01-30 13:55:03,245
0xb4181083d4fb3423d24712d39df53c9e000efeeb2fd24a1d1889c5be6c849e82,t,21000,5424316,,5000050,2018-01-30 13:55:03,246
0x1e47adf686fc3b693d2415223fdd8ff6e9e9cc5a0091fae2377a8f9acc09d7f1,t,21000,5445316,,5000050,2018-01-30 13:55:03,247
0x56a16eb3ecffd3e14be2a509599b50c0943e78339e58f8bfb23b80341ac56d00,t,39512,5484828,,5000050,2018-01-30 13:55:03,248
0x3baeecb06ea75d0b4878779b61a7b13aef368d7682ecc08ff3ec111b9ccb03f6,t,21000,5505828,,5000050,2018-01-30 13:55:03,249
0x9b2c4318b213b486060aea8b8d26c203fea0c17dd34bafb7fdb26e617864c0bf,t,39512,5545340,,5000050,2018-01-30 13:55:03,250
0xacc1423fd1f6cda02ededf7df9cb3e4d741e4a9242c20879b5508e7d24ceace2,t,92794,5638134,,5000050,2018-01-30 13:55:03,251
0x382070451633619e27feec2a9e62a2814dc4d08ac037a1536212fb5e3de54f64,t,21000,5659134,,5000050,2018-01-30 13:55:03,252
0xc77e1ec98dd7e14977baf7d9b879b55ff21da5e6c6ed9aebe345e4f109c53d90,t,21000,5680134,,5000050,2018-01-30 13:55:03,253
0x86c670943f755a5d13c3c782321e112ba790b04b6be65030cf935ead4aeb600c,t,37524,5717658,,5000050,2018-01-30 13:55:03,254
0x8a4ac86ae0d308a464df20f449c8e047c8e050c69b8dd04913b49811549f8906,t,21000,5738658,,5000050,2018-01-30 13:55:03,255
0x6b021b56dd7839a5e2f71ed01ca8a3aab7358ecd3b3d5ef9770fa07184c91619,t,21000,5759658,,5000050,2018-01-30 13:55:03,256
0xa101254e2b135f166f0db770954f8939647bf091c48f49049c7300e660a14f02,t,21000,5780658,,5000050,2018-01-30 13:55:03,257
0x5ed466381cbc9c6eb100e57584138a6d97fd44e0b877e2b72b4633b34962f412,t,21000,5801658,,5000050,2018-01-30 13:55:03,258
0x9bf0ab70566c8bc95d4dc2787eb52d0ab3651ed07bf6ee922faaeb931a9ad89d,t,21000,5822658,,5000050,2018-01-30 13:55:03,259
0x3a69c70e15cb07079520d2531c58d694703851627dae02e8dd442865e3d50433,t,62434,5885092,,5000050,2018-01-30 13:55:03,260
0xbba59d81e1dffb9fcd0ffd794812c2ffc4cf6f9f1d681d63a33f8a7c64b7b47f,t,104678,5989770,,5000050,2018-01-30 13:55:03,261
0x96b6507d245e7917670e6af8e8915affaed80b11076a6f792e0b7bc8c21b616d,t,38615,6028385,,5000050,2018-01-30 13:55:03,262
0x04775ff2121677c2da902340140d6028a07f4c162abb36d0de2857ae8a595757,t,56377,6084762,,5000050,2018-01-30 13:55:03,263
0x7f535a5751d766114c9feb4b36096079240f7c729f5712c7c0cd24302b91c5c0,t,21000,6105762,,5000050,2018-01-30 13:55:03,264
0x4aae1593e3b917fa40a25e78c4f5058447473dc46f38e7a9737ef65aacfd99b9,t,21000,6126762,,5000050,2018-01-30 13:55:03,265
0xbc751d501f63a1953fbf5407134095edfd6da1819cf48d36bf9a3061c3982e58,t,45967,6172729,,5000050,2018-01-30 13:55:03,266
0xf43ae99090d9ebe5270f41b228bbca3f870b8182d385c4d992aae5e525d6b679,t,23176,6195905,,5000050,2018-01-30 13:55:03,267
0x387262bf5f6a03d954901865da3eeb6912c3447ccdc223d5b22cea2534fc1e06,t,29493,6225398,,5000050,2018-01-30 13:55:03,268
0xb5c4c35f768a199b8a2fc8cf39721c2ef19eaad442c2e0850179de2b114af2dc,t,21000,6246398,,5000050,2018-01-30 13:55:03,269
0x1852e46a5a131d46287f8bc0b5b7b1ec45a1dd0d3def59a5e4e8109324808bb8,t,21000,6267398,,5000050,2018-01-30 13:55:03,270
0xb7b81a6307d8b4f098df32273e16660120a5c56058eee509fbaab13df783623a,t,21000,6288398,,5000050,2018-01-30 13:55:03,271
0x1b237cf3d5bde2eb3de171897ba7aca91bafd5b048a4766d97d461e5fae1f5f0,t,21000,6309398,,5000050,2018-01-30 13:55:03,272
0x883e947f7674ec4001a516c62cd7eaa2f98bfa957f73268b22e31dffbe946f51,t,52191,6361589,,5000050,2018-01-30 13:55:03,273
0xe6d2234715df8a528f3d13be9e0f64c8bac44e9bf0ee49d84eb9236030e403ef,t,21000,6382589,,5000050,2018-01-30 13:55:03,274
0x8956043af00093bccae7bd02bd21e211cb49c760a262fde6310ec95a5fce8381,t,65010,6447599,,5000050,2018-01-30 13:55:03,275
0x9fc2e2854dc5ed5d07aa59d1fbafc437eadc74599d1e1b7a8ecbc9e1f064b81a,t,21000,6468599,,5000050,2018-01-30 13:55:03,276
0x8d88541f89daf8a4862262353b20b9030d01ce757a95f877f676cc1992ed9fa6,t,37898,6506497,,5000050,2018-01-30 13:55:03,277
0x424b809cfc8804baee61b25710b64a66e68ab1b0ef2b6310d87108b27c3fa4e0,t,21000,6527497,,5000050,2018-01-30 13:55:03,278
0x1aa2c5a173e7fa3c4b0d2d147b7850f57ec5e5a24c9437f84d74b2a5c0533fd1,t,21000,6548497,,5000050,2018-01-30 13:55:03,279
0x199fb0d0b5892fdbb60697671969a4f40f4cb2558206dd6042a76288a1898b57,t,113736,6662233,,5000050,2018-01-30 13:55:03,280
0x594b48923640bf9dfbc2d14d2f7403907fb8aba193f323fb3dae5198d612982c,t,21000,6683233,,5000050,2018-01-30 13:55:03,281
0x0f70eeef3d9f56b754528cf8327ae70cf0f7becdbb1d31ecfec3357fea508799,t,21000,6704233,,5000050,2018-01-30 13:55:03,282
0x1728cf1af12549954dee6a7e78c1267fc79df088abad47e5e32d42aea16b1225,t,52712,6756945,,5000050,2018-01-30 13:55:03,283
0xe8ea1332734c2be941c778cab877b14662b305e8cffc5c7e6e5f6616adb0793b,t,21000,6777945,,5000050,2018-01-30 13:55:03,284
0x4f770195392b8f8e852c72f14492e7def61db0a8df590a48ac16235ecfb7ede1,t,21000,6798945,,5000050,2018-01-30 13:55:03,285
0xd2615ea6f70d51cf8086d41224950a2b263c062b07ec82202fa2bcc50792d551,t,21000,6819945,,5000050,2018-01-30 13:55:03,286
0x5fcc60678ff53d9baa5c1f86572602691d018b34ca2f817a9ecf4734b7eecfa0,t,21000,6840945,,5000050,2018-01-30 13:55:03,287
0xa742ac9d042098cd83968f74bb1db98a6ed6d76005e859575c02dc068638ae92,t,21000,6861945,,5000050,2018-01-30 13:55:03,288
0x038d27c0c1917092b7209cdc60d57e431dc75d9e85c7abe88c9f9f06af6a3eaa,t,64725,6926670,,5000050,2018-01-30 13:55:03,289
0x100b02549ead4539b5e7c22c685ecf91dd674ad24344d48a2d7ad76494108737,t,21000,6947670,,5000050,2018-01-30 13:55:03,290
0x1b8c6e2dbd1870de62230984bc47bec042b82f9224cf3edf021530245775c787,t,21000,6968670,,5000050,2018-01-30 13:55:03,291
0xe569647c1630175cb2cbd09585ab143633664bbda5d2c1462cfbe4e286085baf,t,54721,7023391,,5000050,2018-01-30 13:55:03,292
0xdc44ae55d291e359c55542947c4651249af4f66dfd00ec3f0516d46ded01082c,t,21000,7044391,,5000050,2018-01-30 13:55:03,293
0x724438b19f7e8efd04d6d3bcca0c2e4b4c9079c132b7386c0067a54a17c9bb4d,t,21000,7065391,,5000050,2018-01-30 13:55:03,294
0xd701319ff4fc2e88c3d0db83b5c3c31bf94beda7aa1d11184338e022a447450c,t,21000,7086391,,5000050,2018-01-30 13:55:03,295
0x2665326b278ffb9bc170e37f8e4b74f701f67814206a12439dadf274056328e6,t,21000,7107391,,5000050,2018-01-30 13:55:03,296
0x1c5295716b1032bf0931dbc2a8d088cb0a0970dc9fb3a4b08b6ad85abde1d6dc,t,21000,7128391,,5000050,2018-01-30 13:55:03,297
0xe82d3fba4468c10e0f889d24684f22b9d1a37303cb67e6ca397b36397d4e6e89,t,39075,7167466,,5000050,2018-01-30 13:55:03,298
0xa0aefb3379efed2f24c4e03c404641e7b2d9f5fe5e3f6420318a8af0e48a384e,t,21000,7188466,,5000050,2018-01-30 13:55:03,299
0xd3ed36af8198d3c12f1d674426461a5a94dc00881994c5d56e200da00abe0589,t,93178,7281644,,5000050,2018-01-30 13:55:03,300
0x67f08363cf63cdbd867c83498f2bf28f6081cac5bec29ffbce23cac3c98d3bca,t,37900,7319544,,5000050,2018-01-30 13:55:03,301
0x3d4ea4861df9df549c8a78a17316ddefb997cbec582c7fde43343f53c85304b2,t,46118,7365662,,5000050,2018-01-30 13:55:03,302
0xa7e48e3a3141dd4f20a99cba1710f8e38be1ba8ecfb30645d086464d8d30babf,t,21000,7386662,,5000050,2018-01-30 13:55:03,303
0xe7294ed5869dcb158bf5f037ca50f029644bec581d884ad376a59da0660c75f3,t,21000,7407662,,5000050,2018-01-30 13:55:03,304
0xad0b650957109bf6db28c3df9430b326dcc9e71f708ef40549d78ca8162993e7,t,21000,7428662,,5000050,2018-01-30 13:55:03,305
0x89c3cd6cdf4ea6c7a2f7aab4503e135a473aef96493b149d4843b8a04ef0ec36,t,42077,7470739,,5000050,2018-01-30 13:55:03,306
0x09403eb2079576f8795ad99482f48d916e6d48892cb249f6a468df7158ba9daf,t,21000,7491739,,5000050,2018-01-30 13:55:03,307
0xb8e375aad199006857002f6ec494ad298a4806754916b7968c682e74ccc319ec,t,36542,7528281,,5000050,2018-01-30 13:55:03,308
0xfbd3cdd1bfc165feddc9ba7ba351f963d190a6169f885afcd93124df25828750,t,21000,7549281,,5000050,2018-01-30 13:55:03,309
0x6c73af8982967c4df020c1b08c297983549e7cb9c755e1232a7f21dd0df11537,t,22088,7571369,,5000050,2018-01-30 13:55:03,310
0x4bf33ed92ded482785134b3f4282a26fb65a94a423ad07302a54f4e9b97eabea,t,21000,7592369,,5000050,2018-01-30 13:55:03,311
0x3ec53c23e24b4b0f2c44a9069ea03d9e63e42ebf8baebefc24d07accdfca5a1a,t,21000,7613369,,5000050,2018-01-30 13:55:03,312
0xe6cd2000a0bc6e72562d122a633ce5861b250423f13dd8a1608991d029eee324,t,28973,7642342,,5000050,2018-01-30 13:55:03,313
0x6ad4f59af130227af781eb02945f256aad7501815ea245eabf9ad32dd15e0458,t,21000,7663342,,5000050,2018-01-30 13:55:03,314
0xad4f8a1f011af27c1ab8157c7ad52a7cae0b6a7fd4d3a5c26f3164e1f7ffa818,t,21000,7684342,,5000050,2018-01-30 13:55:03,315
0x529a9129ce8081c3aaa094efe41834f41ccb00076b058dcd3a9a2a76adcb8d3c,t,21000,7705342,,5000050,2018-01-30 13:55:03,316
0x7b770f0a279cc77ad0809a024dd66927444573aaff2ae566918395ffba10a3d1,t,21000,7726342,,5000050,2018-01-30 13:55:03,317
0x57a41720557e432843fca1e357acabe9164f3df0e53d01bb8947adb59cd26e64,t,21000,7747342,,5000050,2018-01-30 13:55:03,318
0x6a16946134e5ccbead297f299a466d2c05dfafee5a5b2100a71011e86915d2a8,t,24203,7771545,,5000050,2018-01-30 13:55:03,319
0x200d381adfbb5f22216f8979b978b8d7248fd35f00b7ad371c07c0873c3a128d,t,21000,7792545,,5000050,2018-01-30 13:55:03,320
0x88e4b4e798fbf32145c90f29ced967cca4f89516c58fca6d521bbf6935b21d81,t,36851,7829396,,5000050,2018-01-30 13:55:03,321
0x8129c4cbf3ca9a66c18c5b94d7ee065ea4cb9c99c3acf565f6f78195d9cdb46a,t,21000,7850396,,5000050,2018-01-30 13:55:03,322
0x12bd3d59a53015ee1e189169e0996fdd6d25f1a69395dfe31906e02805095db2,t,29204,7879600,,5000050,2018-01-30 13:55:03,323
0xfa701522ff805d8e7514d82522ce0379f02c41a178ceee4ee4253697d2f17a10,t,29325,7908925,,5000050,2018-01-30 13:55:03,324
0xab2615ccdc1d6d3c10632c55baf3606ed68a5bdcdf35d0920052753fba006596,t,21000,7929925,,5000050,2018-01-30 13:55:03,325
0x4f9d3430be1230db1c04b5f94fd8349cc6efb443d047fdc7e447ab299d963d2d,t,22091,7952016,,5000050,2018-01-30 13:55:03,326
0x18bc4e567313f61294bcdc5cc9c8454751c703b55e5dd121501d26f75fc9ca7a,t,21000,7973016,,5000050,2018-01-30 13:55:03,327
0xe5cdd9142313d2be9add18441063444485d5e23486fead115d6d84c59ced08fd,t,21000,7994016,,5000050,2018-01-30 13:55:03,328
0x1fbcec9712bc5d22f0574f2012b205d38d7c184f5b9a4698e54e78908995c7e0,t,21000,21000,,5000051,2018-01-30 13:55:09,0
0x1bc2ce8c7ef500d102a3b200a4991adfe14493a2fe45dc6d755d75b6936dd05a,t,21000,42000,,5000051,2018-01-30 13:55:09,1
0xd3ddc971c298828ce511fcdb170e84a10273f7cb4ce2723b20be598f3357d612,t,21000,63000,,5000051,2018-01-30 13:55:09,2
0xf4a05625c087cf4de82be85df4eac15c0c8ddb8545f3dd32cc458e0f27735dc7,t,21000,84000,,5000051,2018-01-30 13:55:09,3
0xd9377f90d79a5b815fe37aa08ba0134072b727ff85fe1b650e65d590c03a9e2f,t,21051,105051,,5000051,2018-01-30 13:55:09,4
0xfd9651e028f5ba7015d26e110b5e91e08e5a6f7ef366b4c07d66a0c23607e854,t,21000,126051,,5000051,2018-01-30 13:55:09,5
0xc20485284e52d16711e32b1a0f55deb79576f9786402b34bc53dfafb57212dbf,t,21000,147051,,5000051,2018-01-30 13:55:09,6
0xba9efac7e08c3113b3c713394e6b1f6e514c2f5cda263bebd7dda81416623207,t,21000,168051,,5000051,2018-01-30 13:55:09,7
0x41dcf443404328858d802ab4dbb64c556e751fdb3f9d6773fa2dece0968c2290,t,21000,189051,,5000051,2018-01-30 13:55:09,8
0x8e8e223565d14257f344ac3ff17e47025cd5066f53960caeaf4380ee96b70ee5,t,21000,210051,,5000051,2018-01-30 13:55:09,9
0x727946680f637eeafbece842083b455fe35e7d411ee2ea2f36749ffd2efa524d,t,21000,231051,,5000051,2018-01-30 13:55:09,10
0xf57f3ca72fe602b7b9668b497f01c027830e8bce26c610ffff24a889f1025469,t,21000,252051,,5000051,2018-01-30 13:55:09,11
0xd12160e44ba8e315946c55018b0020f773b277cf0ca7a2128ce998e5c24c4a2d,t,21000,273051,,5000051,2018-01-30 13:55:09,12
0xf8c6330396f1baff8f88da1cfe259e2cd5d3ce30fb9151874818cb07472d0940,t,21000,294051,,5000051,2018-01-30 13:55:09,13
0x6a6119492c01fd082ee268e7a18cfb4aa11515fc1c11d0787257065fc3e4aa90,t,21000,315051,,5000051,2018-01-30 13:55:09,14
0x03b94a80ada70fbaefcebf68fa4c1aa0741b8ff1f1383c052fe98b8fe7477f4d,t,21000,336051,,5000051,2018-01-30 13:55:09,15
0xa707b8529ef2642c51da4e4b0273ebfa63fd8318c4f23653c52d9500ffc03205,t,39512,375563,,5000051,2018-01-30 13:55:09,16
0x9d1dc957ff0c6576c7f28bad2088ff4010169a7c0f6823a66dbbd02e307b9441,t,21000,396563,,5000051,2018-01-30 13:55:09,17
0x9eebb2094329a2fcfe49888b04972ca78ca5e28c5785a3d7c21858d8570d0100,t,21000,417563,,5000051,2018-01-30 13:55:09,18
0x3deae65a7203a6561677f0f62b5280bdc4bea04b74359e48d31808bf2bf7a831,t,21000,438563,,5000051,2018-01-30 13:55:09,19
0x29f2822f20e868710b38ff621a523a7762ef20cb1b526d7e0b7da9cb6107d124,t,21000,459563,,5000051,2018-01-30 13:55:09,20
0x088d37a5e23bcdfa1dbfd3c9d6b89d02afa218685ad7586e0bcd1e8fedc8cd84,t,21000,480563,,5000051,2018-01-30 13:55:09,21
0xe07fc263b82586d626309cd8bf497c277f91cf76a59d2f2082e36cd5771b9937,t,21000,501563,,5000051,2018-01-30 13:55:09,22
0x2e0f724eee102c95a194d2136758b87ec23948bbabf8eb9e79b85621728b8c52,t,21000,522563,,5000051,2018-01-30 13:55:09,23
0x73754c648feb75334d0141b17a4f8abd243991817b01ec3d2e99fd01cf8d33a7,t,21000,543563,,5000051,2018-01-30 13:55:09,24
0x7500974bf11b014b6c9d899a97e1e191a131b4abccc5051ae649e524ea77aa7e,t,21000,564563,,5000051,2018-01-30 13:55:09,25
0xd2921d8d1715f60590f5d3bfcc1343543b80d7e3bfc749354f252b7c501613f0,t,21000,585563,,5000051,2018-01-30 13:55:09,26
0x800243bdc835bb07c2dc1cde53e5d0e1df0013c6ff2ff8c32ce91666a9c9fe92,t,21000,606563,,5000051,2018-01-30 13:55:09,27
0xb758055023470ad3231b7bc830588dabfa06ed34941404ae9d444d39b3821032,t,21000,627563,,5000051,2018-01-30 13:55:09,28
0x44af52f10bedecc9f15a6bd9d4badc44aaffafac5aab299a609daea05a74b2d1,t,21000,648563,,5000051,2018-01-30 13:55:09,29
0x9de8ad6e55f8ca70412397cd2ab0794f2c5772701f5a251484cb3c25dc4b6d3d,t,21000,669563,,5000051,2018-01-30 13:55:09,30
0x47bac37f9ba7f4ec1663d82e8869e89ba777286f0ef61b70afdc8be6b2e1d9ac,t,39512,709075,,5000051,2018-01-30 13:55:09,31
0xf2ee67cf4d2307736fb7f3c0c055b5725ff3590982ce9118e38b18a0c0e803a7,t,39512,748587,,5000051,2018-01-30 13:55:09,32
0xb3650ba979f5bb0f1fb5a775d0c368cd68535eb4680d304d2062c5892771a794,t,21000,769587,,5000051,2018-01-30 13:55:09,33
0xa5aba9491bb001506f8f90947b15e1f922b2bd297c87e5d481b7803aa2741d8a,t,21000,790587,,5000051,2018-01-30 13:55:09,34
0xa72d20daaf605313218b422bf8eef65b60c7a1009f357dc17cdf868ade6d8d5b,t,21000,811587,,5000051,2018-01-30 13:55:09,35
0x6f86fd50e295348c1cb41906374c712a9fa59c1944351648c92f840d53c04d25,t,21000,832587,,5000051,2018-01-30 13:55:09,36
0x591008d3f0d482c0c3213205a944cd20ba18aa3a4b9d2395669b5360581523e3,t,21051,853638,,5000051,2018-01-30 13:55:09,37
0x68d7faaf146b8bacefc3281502492644ee91faade0e8ba9d619343064edc741b,t,21000,874638,,5000051,2018-01-30 13:55:09,38
0x4920716e2a415563f1c7ccc01bfc3adb3adb76f7bb29c42706a35edbd1df035e,t,21000,895638,,5000051,2018-01-30 13:55:09,39
0x18ad5cb6eb23736cb5c5325c57717ce51d01cba9aa6b9facc4a84ad2007ba528,t,21000,916638,,5000051,2018-01-30 13:55:09,40
0x8adb0f1c6154919f7a8d1050206b8c0692ef80877d2e8afa6aa20f2d1cfb58c0,t,21000,937638,,5000051,2018-01-30 13:55:09,41
0x0a52d07135b796548ff674a5f002a67423e4fb1bb840d35332c22fcb7b20df73,t,21000,958638,,5000051,2018-01-30 13:55:09,42
0x5d689d6be5fc4ca4d57eac7518feee63ebaab097a6ff761fb3e86bead6d64354,t,21000,979638,,5000051,2018-01-30 13:55:09,43
0x64edacfb74f1d3e43c296e81401dddf9c12777436706a21489bdec3aca9c7ecf,t,21051,1000689,,5000051,2018-01-30 13:55:09,44
0x892b6319690c4c44a7bafc900a9cb6dddf848402ea1ecd003a85dda6df884481,t,21000,1021689,,5000051,2018-01-30 13:55:09,45
0x98e50f10ddba4600dabcc3fbce4d280a56fc65a2af2ee4a3a88b822a9fd025f2,t,21000,1042689,,5000051,2018-01-30 13:55:09,46
0xaf52358aab1d01f0d0de3ab607e384ff8fca3ff7164925e7099b583efe6effa7,t,21000,1063689,,5000051,2018-01-30 13:55:09,47
0x349c77b77abc3f1025068c7ea0a01f7b0ecf5d7c088737e2f7cd8feeef4d8019,t,21000,1084689,,5000051,2018-01-30 13:55:09,48
0xfa6f7bd1a5d578160f56edd7c478a2189d07030d3911c502591c07a6c1039f86,t,21000,1105689,,5000051,2018-01-30 13:55:09,49
0x81456e9538176dff563b2e4e35358791701c2f0b7271094a46f820404ec1f83b,t,21000,1126689,,5000051,2018-01-30 13:55:09,50
0x45acf4ff35c348913dd80d4c4e44a8dfdeb753b36cb85c64b432b84f42c4cc40,t,21000,1147689,,5000051,2018-01-30 13:55:09,51
0xdd0cb7642ccc7e1be5e557920f7bfc37575505dd124ec58500bf12fdb5df17ef,t,21000,1168689,,5000051,2018-01-30 13:55:09,52
0x60adb3dfa96fa459750ab461999a64602be7b1bee9102d94794fd90f9254e326,t,21000,1189689,,5000051,2018-01-30 13:55:09,53
0xae318d261991a5c22895be2c1565c069cb74405140d4551164fdaf4c4a66057e,t,21000,1210689,,5000051,2018-01-30 13:55:09,54
0xb421a0636ba3c5f62d9690d468105867e1c27359aee320fc25266fed63c5572c,t,21000,1231689,,5000051,2018-01-30 13:55:09,55
0xcdc8abba05d8f765d3167e3083fba653f5aabb5c8ba3407b0c59f6adec894d4d,t,21000,1252689,,5000051,2018-01-30 13:55:09,56
0x4197b880879446730215a56cf65db6052f7f940bb3956e0ef4937a12b9563db5,t,21000,1273689,,5000051,2018-01-30 13:55:09,57
0xd4a127c6ca08428664897b408ade1b14912e0fefc20c5d27da43d3dd01524280,t,21000,1294689,,5000051,2018-01-30 13:55:09,58
0x5df338bb60fdb39983bd420e561143f9df9def5c6c69d04f21e16e54c799f781,t,21000,1315689,,5000051,2018-01-30 13:55:09,59
0x25789ac0aa7c90b7cd0033fff7bc3a337f762ea883d27c97f17e0393408c4438,t,21000,1336689,,5000051,2018-01-30 13:55:09,60
0xa1e9541924ccea8baa8d1fab230e4eebd9a4d1e0d65582e75a0f36bd683cf1d8,t,21000,1357689,,5000051,2018-01-30 13:55:09,61
0xb6b822f6771bf50a59ab111fee5c9b223546d6b2b038bbd54bee9a5ffeb4ae4a,t,21000,1378689,,5000051,2018-01-30 13:55:09,62
0x97fb03f024dd5c78bcb9dbc09ae05da616f21f50a40f9169af211a601e211f79,t,21000,1399689,,5000051,2018-01-30 13:55:09,63
0x15c4e95522d27722dc2a6e10c38eb51e054c453f9dc9267ea32940feaa5bf8fe,t,21000,1420689,,5000051,2018-01-30 13:55:09,64
0xe6945e0f393981cac8803ecbc93c18558dfe788c5ca001c6545f837b04cabb8d,t,21000,1441689,,5000051,2018-01-30 13:55:09,65
0x49c579ffbff38d33f730548063e80cfcb7c2db2e4b86f2a89a4ef5381bb6913c,t,21000,1462689,,5000051,2018-01-30 13:55:09,66
0x887ff24a0ec1e7c9ea3ce1ad0623e9b8e1dbb36c73e866bf38efc9c0c2f2cc96,t,47005,1509694,,5000051,2018-01-30 13:55:09,67
0x24a57531e65181421981573b6fd795e745feba32294cec0b1fba96be8220abfe,t,22049,1531743,,5000051,2018-01-30 13:55:09,68
0x0209c744ccac4b167f7de5c39d6756d16360de23349b57337fd30332e0da5b82,t,140972,1672715,,5000051,2018-01-30 13:55:09,69
0x0b7cdf8057e944077e80f2788e602c7e602d6252ef615e8bc88eb59222d4b8ef,t,21000,1693715,,5000051,2018-01-30 13:55:09,70
0x1da48857715d00daa8a9e2279829ae1a30bdc368bf21edeb5abf5dca03e5ce85,t,37109,1730824,,5000051,2018-01-30 13:55:09,71
0x869ca69591d3e57ed16a7393192cac2e819dc8e56023601a3ce0b696a2e6f43e,t,54081,1784905,,5000051,2018-01-30 13:55:09,72
0x86e784d539c50ee3758c3244fe2ec5872c18029d4d63689720decbddfc328fb9,t,21000,1805905,,5000051,2018-01-30 13:55:09,73
0x2dce574a4d95420589220ea851fc6f228b22389b2a0d968c4903d3c67b5b1e63,t,51657,1857562,,5000051,2018-01-30 13:55:09,74
0xafce1a578836c4d953dbe3f1de268c7c2ee379a24ff6ea8b0d5705bd2b917f10,t,52267,1909829,,5000051,2018-01-30 13:55:09,75
0x002afb05556ef2bc53fff7395ea35c9cec4aff8175834fe6edbed24b79e44e70,t,21000,1930829,,5000051,2018-01-30 13:55:09,76
0xb1ad86825214e1486215ea645c8669edc3c44c020c0596008742523061caa7d7,t,21000,1951829,,5000051,2018-01-30 13:55:09,77
0x6c93d7564ee84e761030f8960e7ec08a79ee51105ea45be12275c71bfd628419,t,21000,1972829,,5000051,2018-01-30 13:55:09,78
0xfdc6eefae1af77d8ca7f28d8873596c870951701a8c2fef0e842a0836a7ecd2e,t,44290,2017119,,5000051,2018-01-30 13:55:09,79
0x057f1e0654d7e072c229bc94c7af774bf5da1e02f5a8bd75f93cc803525c0be8,t,21000,2038119,,5000051,2018-01-30 13:55:09,80
0xf7798fbe649fb6dda0657b5597317be2e7e8c11522f08c0f35a7e8c7b189631c,t,37647,2075766,,5000051,2018-01-30 13:55:09,81
0x5385712678958bd0c677de071e1ac582461e0ce5bb02b2a4fc215bb6e7116ed3,t,21000,2096766,,5000051,2018-01-30 13:55:09,82
0xb275b965516959a3e52252823634be2aa8e904f1d91b9b34b1567d4087308edd,t,21000,2117766,,5000051,2018-01-30 13:55:09,83
0x64e76469166e725445b0e176b4f88a113f5fb52ce44b269b3378c93296d6b994,t,36893,2154659,,5000051,2018-01-30 13:55:09,84
0x40651895c8b9518df8831e150fcbfc79b05905dadf3a3cd067613b3d7ea42f29,t,40907,2195566,,5000051,2018-01-30 13:55:09,85
0x96b964a1b13987ced77a8f2db492607fc16d545313495f5d7c4a7086eaab7e5a,t,63240,2258806,,5000051,2018-01-30 13:55:09,86
0x226599675690d4e26f4294e75037fb975e6b93b3d34366a9961d2e94e6ff4638,t,140972,2399778,,5000051,2018-01-30 13:55:09,87
0xe840c82a086066746e36c6706178e3dfdf42530155925b3ccd0612cbbd44512a,t,21000,2420778,,5000051,2018-01-30 13:55:09,88
0x3aec82b470810723fe0411321d86ae0c967fa3cef79c9548cb6c0c65cb61857a,t,21000,2441778,,5000051,2018-01-30 13:55:09,89
0xc2c6dd9ecb97e44474c9a0d92a2b1b9a37daee9d8e0112afe8d3e01538558243,t,21000,2462778,,5000051,2018-01-30 13:55:09,90
0x585e4752c06e891b9230dc096e17a18692c67e38dafb5e202c1c705691b804a1,t,104995,2567773,,5000051,2018-01-30 13:55:09,91
0xc600f9f3f2ffb662764ee390fd0e5c8dfb27442796d8a449d70f1a7c90c6e894,t,21000,2588773,,5000051,2018-01-30 13:55:09,92
0x0c16ba263282a180ef7ea4f02b4642831d40c4718e1a26e2af4249e6edbb21c2,t,40843,2629616,,5000051,2018-01-30 13:55:09,93
0x33c7f84e5fbc7295a52194dabbe97f925b44f413efe56386ae9ccda11d9ef94f,t,40907,2670523,,5000051,2018-01-30 13:55:09,94
0xc5e9c436b5cac0de89ddfb945d7e0b9cf14ea9ac0d58ddc2ada57e83a1db03e8,t,40907,2711430,,5000051,2018-01-30 13:55:09,95
0xb3d3052524a189e4cbe5fa8ba21fa29aa218c0e42712d2a8127c747f71d8e2a5,t,40843,2752273,,5000051,2018-01-30 13:55:09,96
0x75358456018837568cb94d5421d3ad8245c8fb0372f0e48259beb0849e0619f8,t,40843,2793116,,5000051,2018-01-30 13:55:09,97
0xf703496036cbca293d9ae2618e7ba6af1200c529f156ff24d5d1a1ed8bb0677a,t,40907,2834023,,5000051,2018-01-30 13:55:09,98
0x3e5a86d11d04cd0546ed544947d31969d9a7f6a8238a64f6f71a26efce8aa6a0,t,40843,2874866,,5000051,2018-01-30 13:55:09,99
0xfbfee45e5d357c621f69e07588d9d213783587897f3af71a874b0479fde021e2,t,40907,2915773,,5000051,2018-01-30 13:55:09,100
0xe50b6fd93284523da468061e404995a513108a9cdb7b4ce7ad904271bccda8b3,t,40843,2956616,,5000051,2018-01-30 13:55:09,101
0x13b5f6d72f8d16c8d2caeec1e8208acd1e817042e5e67297ddcda4d8340a7d59,t,40907,2997523,,5000051,2018-01-30 13:55:09,102
0x7fefb0e2ee0feb6ec7f2cbaf6ad79a03bba709b8721a75f882225c0e26d18b1d,t,21000,3018523,,5000051,2018-01-30 13:55:09,103
0xf183db9c51b5d3f666c0b22c48a720e3f31e8b85a17fd8cacc24b666bb989345,t,40907,3059430,,5000051,2018-01-30 13:55:09,104
0x1eaa11a4910c3cdbe8d9928652207d3c7d12ed5d27aa97441491a74df76b397d,t,40843,3100273,,5000051,2018-01-30 13:55:09,105
0x94fc73e3e2f81a51f7b430aadc740297ff0ca84a26985a78adea5535cf50064a,t,40843,3141116,,5000051,2018-01-30 13:55:09,106
0x0090d22668c956f909326c3be6588810431fd072f691f7eefa59ef28e952eefe,t,40843,3181959,,5000051,2018-01-30 13:55:09,107
0xae147b95a7176e7df04786104d21c6d90c343c6f8e0c861f9cb71f9f7f3182b7,t,40843,3222802,,5000051,2018-01-30 13:55:09,108
0xda5af178023ef66ddc688250ccc1740d313e14078f9c55eedbc7069a521a73e4,t,78178,3300980,,5000051,2018-01-30 13:55:09,109
0xf7ea86bae1f34f4912ae21519a5f52ceeaff4de7a09f12f6e83ab03dba17253a,t,21000,3321980,,5000051,2018-01-30 13:55:09,110
0x2f227129746a8c1d878ccfa6a141f1cdfcff0466876da0b9dfc9c205aa19b9e3,t,28002,3349982,,5000051,2018-01-30 13:55:09,111
0xc1f80a82dc9f4756c494a426389945cfe70e321f2f7cdb52169ce76dc336a177,t,21000,3370982,,5000051,2018-01-30 13:55:09,112
0x32ec750ce789d0d044aaf58899c7dfebc82d9d0070a4bc0e04122a30875b6ba5,t,258295,3629277,,5000051,2018-01-30 13:55:09,113
0x12781d5eea20243b1766161b0cd3d3e4588f941e02ca7ca7d3cbf2f18856e3c0,t,21000,3650277,,5000051,2018-01-30 13:55:09,114
0x7c074437c8686435c3464e5e04702cbfd5b624851ab657ea9d737bb5efdddb8b,t,102934,3753211,,5000051,2018-01-30 13:55:09,115
0x655c7eb49d2d2ccac32cb1216725c9c256d25ab234de796dfbd34e2501f8ed63,t,45981,3799192,,5000051,2018-01-30 13:55:09,116
0x8c472f385c8762919722d2447dae2be8405b4287d2025ae21050c7fe703793f5,t,107794,3906986,,5000051,2018-01-30 13:55:09,117
0x6633f80b4df2fe773fa4bd1ced06b680f4936582d5c1fc3e4f632f4ffc047299,t,38297,3945283,,5000051,2018-01-30 13:55:09,118
0xfedf029c8aa0c72b8bde50f01fc61c4f4f2a5cddb2d3cfd19816f604557aa5fe,t,53233,3998516,,5000051,2018-01-30 13:55:09,119
0xd35b7279d9b144955f576f336cc95a156031d2f7b54396741a4fbab82c1756ee,t,21000,4019516,,5000051,2018-01-30 13:55:09,120
0x2bd5e46a87377261cbc8c8f97909f48d57bcfad4f80fa7f5c255493a7cb91cb1,t,21000,4040516,,5000051,2018-01-30 13:55:09,121
0x646cbaea20887d2ccfc7a8db6bc68ffa702edb7840e434c2a0fee4a81f8c5661,t,21000,4061516,,5000051,2018-01-30 13:55:09,122
0x07d66456a4b6461badab432fb97d1fe98137ac3d60c84cf0250912e3f877d2f7,t,37179,4098695,,5000051,2018-01-30 13:55:09,123
0x4a120438fba934b0478cf8009929260e4f7c7c4dcfbd24180e0281a329ec0087,t,21000,4119695,,5000051,2018-01-30 13:55:09,124
0x510137847e610620a2ad137bbb4d8ed7d077806e3ff3df537336b6869bf634b1,t,21000,4140695,,5000051,2018-01-30 13:55:09,125
0xb53ce95a44b11447f4119703d1ccce5e634ed494a65ae22d25dcf4df6a97253c,t,21000,4161695,,5000051,2018-01-30 13:55:09,126
0xdbcab87c2521fd133e1c21b27a3f017ec14cf04fc7a85b7612aef1f2f29bdc9b,t,21000,4182695,,5000051,2018-01-30 13:55:09,127
0x62d727b28c481b848b192980ab9ac4e2f5b82e88ab9bf37f947e936bdd8ae6c5,t,21000,4203695,,5000051,2018-01-30 13:55:09,128
0x36978b8c21c09dfd800e367c8673e1ef63f613114401545f92dd55f518e59a9c,t,21000,4224695,,5000051,2018-01-30 13:55:09,129
0x8eaeb3277444e2ae30d69746a541dc22b71f83a23fb5fbaa1f29bef37d769db8,t,93582,4318277,,5000051,2018-01-30 13:55:09,130
0x561ab2e690f0920445c1a6a960f19aafb547e149e0b37367bb876ee6710548fe,t,21000,4339277,,5000051,2018-01-30 13:55:09,131
0x78ef4cf50d1b75be79085b65ae6c2043a81cc948f829fe3ff37535ca46dcceab,t,242521,4581798,,5000051,2018-01-30 13:55:09,132
0x4b3da7aec9c0185904fe55778a106005624ca2b7e5a1405dcf6f1e79b7e56362,t,31984,4613782,,5000051,2018-01-30 13:55:09,133
0xe24426bbfe620eaaded8866780c2e4a2b5cf90499aa41f8de0beb5459815dafa,t,52886,4666668,,5000051,2018-01-30 13:55:09,134
0x8a39b29a2a4fde32b4655a74f4cd5e9b8d5e5e3f12ee79db0305bda45d809dc2,t,37109,4703777,,5000051,2018-01-30 13:55:09,135
0x7f08e5c8fb577c297542e5df3fa730f632056233a466c75fde2a8317a18b28a9,t,51884,4755661,,5000051,2018-01-30 13:55:09,136
0x31f5f16213d18db2109c4cda885e16ea8aea32d1759ef955dfb2b1167c44c4a8,t,52206,4807867,,5000051,2018-01-30 13:55:09,137
0xd5900644dfda63dde4723f6518e9acd7634023f8bc883683dbdd7d94b84de5d0,t,40843,4848710,,5000051,2018-01-30 13:55:09,138
0x80e41fa320e7cf38c5e1c2e4b00af45e3552cd0df2d2a3d8d7dbf63c7b6837b7,t,52109,4900819,,5000051,2018-01-30 13:55:09,139
0x262ab0f6a5d133e764273a2cc97ebdb625219ed919475ca79e7ca1229e414d23,t,52139,4952958,,5000051,2018-01-30 13:55:09,140
0xe69dd45c5ef327a422d8d946dcf22850276204f77a297e189e2f22181c3834e5,t,40843,4993801,,5000051,2018-01-30 13:55:09,141
0xe839f262acb1bb3c45b78cf165142095db6e9e77e6873859292028554384e52e,t,37376,5031177,,5000051,2018-01-30 13:55:09,142
0x0a00c04633148cf7dd2416b7301b1e791a78af254d94c2c844f003ffa3cf1216,t,52237,5083414,,5000051,2018-01-30 13:55:09,143
0x57ab61499a13912e668420c34f9334cab6a99b1896721ecc0b7d023247e46c3b,t,52380,5135794,,5000051,2018-01-30 13:55:09,144
0xc30dd82e2c6571d4d98be2147e954a0ba79252b5cde0ee889ad1cd2a6de9e999,t,58999,5194793,,5000051,2018-01-30 13:55:09,145
0xbcd49f04c2e23fcd087e6eedac8b0a52f4630b324584527bbd30cc791b655377,t,53551,5248344,,5000051,2018-01-30 13:55:09,146
0x58112e815509458b377d54989a7ee175f05c72c831c8458824c580d53c91b743,t,22158,5270502,,5000051,2018-01-30 13:55:09,147
0xe53627523927ae2cf2adca6e9386f52b1fbde209fc7c5be19da9d61b3124bdd9,t,21000,5291502,,5000051,2018-01-30 13:55:09,148
0x7dde02827f2524ef3a6ffdede43146bf32537a0b5f705c74a91b4bd721f809d8,t,21000,5312502,,5000051,2018-01-30 13:55:09,149
0x8a265572c1e6f136753ae2e1018c6a20c8eff0e50478c6afc84a0692d6097f62,t,21037,5333539,,5000051,2018-01-30 13:55:09,150
0x7cb818e639f16116e2cd3e6798318de4e8075939656b96883d03acc02021c7bc,t,21000,5354539,,5000051,2018-01-30 13:55:09,151
0x47672ca10f11b53e5eb8157852ae6aaf86553912b6424718a6a955d40fed98a7,t,21000,5375539,,5000051,2018-01-30 13:55:09,152
0x4b82dc256dbe37424be26eed38916636938d0cb67add4f4b3f47f21b93740436,t,53254,5428793,,5000051,2018-01-30 13:55:09,153
0x7a2116d9a30e5bfc4c8f77e2fa482501abe3df3720651cd8dc1cab81b8f6253d,t,36531,5465324,,5000051,2018-01-30 13:55:09,154
0x3473701b4becb809f4dfd79e6c354714121beb7853a7336423a644f2b2826427,t,21000,5486324,,5000051,2018-01-30 13:55:09,155
0x21c0721079be5135dd5eae9bff1034cab575006d216fbc7b97d0aab07ebcf48d,t,21000,5507324,,5000051,2018-01-30 13:55:09,156
0x63d1f2a1d6feb1455ee356b6c2492cc3f7549e681d90cb14118273bcec9744bd,t,21000,5528324,,5000051,2018-01-30 13:55:09,157
0x57601fdbea3df512e0b3466a324df0645e1270a63913de88ac338220b0ab8f18,t,21000,5549324,,5000051,2018-01-30 13:55:09,158
0xc0da89a011a131f8c1c31083b82eb7fd06d7ae06fa44d26d7a66e06e489ae5c0,t,21000,5570324,,5000051,2018-01-30 13:55:09,159
0xb50ad7d530bab30659abee3fd8da924772fdb624f91f9eda089f1a1e2347132d,t,21000,5591324,,5000051,2018-01-30 13:55:09,160
0x77de9d935c1dd8a094619fad46e4168b248d6e84f57f5184cc5a54688d63abde,t,51389,5642713,,5000051,2018-01-30 13:55:09,161
0x388d27ecaeb0111a639c909d80b1b32d8f728e596e9fd65f913cd61bb75ab34e,t,36606,5679319,,5000051,2018-01-30 13:55:09,162
0x4102a77af812925fc42c5d9f050460f5bbd460201ff1c7f7bbe2b4b1e70697c5,t,36792,5716111,,5000051,2018-01-30 13:55:09,163
0x4a758dccf783628beb7a1e3d94cb5ebafe13451dfbdd48b7243b777e04c4fd8b,t,253854,5969965,0x5CCE7093B58b4E26d3864aF8A90571e8C07711Cb,5000051,2018-01-30 13:55:09,164
0x340abfd47480f9bd3767758af21c5e8d477b88617980aef9dff041d972c8525b,t,37239,6007204,,5000051,2018-01-30 13:55:09,165
0x7b933578e226a9c3a649839a54f572fd9949b7052700ab9e896b4e8d2e40970f,t,21000,6028204,,5000051,2018-01-30 13:55:09,166
0x427dcacd4bec6efe802516e467c6d6062cd765a20590fb7939faefb4fb569dab,t,53167,6081371,,5000051,2018-01-30 13:55:09,167
0x6f2a41746e48f0f4891ca8fbe9e97dbd598955c4f21649e47a8ec8a86c2716fd,t,92677,6174048,,5000051,2018-01-30 13:55:09,168
0x2bf41b90f54e953fa43efe7a2c29538409e3bf786a69d7f368f80b2040f12fa7,t,21000,6195048,,5000051,2018-01-30 13:55:09,169
0xd97aeff94d6ea4d62d4ecd975da1ea1695e155584d14a147851c9084f5272008,t,21000,6216048,,5000051,2018-01-30 13:55:09,170
0x4482253b68325d61dada33eebcea2ad079203d574452bd01096a3398541f8858,t,21000,6237048,,5000051,2018-01-30 13:55:09,171
0x12768028ec680b3c44e01f0ec5bcfe4ba72bd77d84eee245ae2093746f514255,t,21000,6258048,,5000051,2018-01-30 13:55:09,172
0x8091be2da4253c2c0b8576cade4f0bd3f61ba25b1de39584882776998e26673e,t,21000,6279048,,5000051,2018-01-30 13:55:09,173
0x1a4086a4647564dc57b144656f093447752de2d205a7005efd5270512f392caa,t,21000,6300048,,5000051,2018-01-30 13:55:09,174
0xbfab39955fa0ee1a0a04953ddd98f03aa6554b8c2eceb151e286d10a8d841299,t,21000,6321048,,5000051,2018-01-30 13:55:09,175
0xd49fbd0c887d71b4ee78aa5f819dfec679bbf47de3cf6949c265a3519a7d5d4b,t,21000,6342048,,5000051,2018-01-30 13:55:09,176
0xd8635b3ca75bfcf791b3896ca89a28ff2007f36c6a32bd9ee554e85add49f0ad,t,21000,6363048,,5000051,2018-01-30 13:55:09,177
0xb82cf816c2c65bb5a32664de10686aea6a0a10e6a5adf9130d9da922029e5de5,t,21000,6384048,,5000051,2018-01-30 13:55:09,178
0xcb7fb2868f0992bb391b8a9b95e780dafd2591907b85d0264d1b5d4287c153bb,t,21000,6405048,,5000051,2018-01-30 13:55:09,179
0xcd164d023905176b0d93635ef29e773d7ae20358198170da4e24ac615143ffc2,t,21000,6426048,,5000051,2018-01-30 13:55:09,180
0x792e34b5c8dcddb82fbf78bae4088d6d626e1fd031611a24679807626137e8f8,t,21000,6447048,,5000051,2018-01-30 13:55:09,181
0x331622e1541bb88cd8108901571fce4d58dc2523d380bac59b7c2137ed498d42,t,21000,6468048,,5000051,2018-01-30 13:55:09,182
0xb48c7d56c04ecb68fdea7fa51c550b138ffaafacb80a2472e30e3edcab3e1ad9,t,21000,6489048,,5000051,2018-01-30 13:55:09,183
0xdd1a0ec4baf72f8b79793e5cce9d95ea8dc166d7c7c1fbc96085b021ae243c87,t,21000,6510048,,5000051,2018-01-30 13:55:09,184
0xa769f2339539ab3e3165ff13dd8d6e8aba542c078bb79848ae355a4650f32f8f,t,21000,6531048,,5000051,2018-01-30 13:55:09,185
0x4cc1dca3882e581e86e33405eeb490fd64dc2bf4370d55fe066fcf6b84717531,t,21000,6552048,,5000051,2018-01-30 13:55:09,186
0x78c8d4092941ab98a745f37f086572493e4634ec8dafc4c47bc4a5f8f54edd14,t,21000,6573048,,5000051,2018-01-30 13:55:09,187
0x36f16dd9a1260cf42617c8c3a10e939047bfaae9e588ee44e65fcbad25ae89c8,t,21000,6594048,,5000051,2018-01-30 13:55:09,188
0x9c26f70e2641a6da375063780088e0a0232fbe57e1b764803089023ba4faee76,t,21000,6615048,,5000051,2018-01-30 13:55:09,189
0x657c063dd94af618ced82670f96109389fb1bc25401bb59c9740f46c5e8e514e,t,21000,6636048,,5000051,2018-01-30 13:55:09,190
0x3dcb7f47e89943679e87f66c5a4fd9cdcf134da89841b09250f3c93776dea694,t,21000,6657048,,5000051,2018-01-30 13:55:09,191
0x3fb3af3661a3c6ed70d994628ee6abff0ea9491fd83bafc2c0fab4954f0de2e2,t,21000,6678048,,5000051,2018-01-30 13:55:09,192
0x51fc6ddd17d5ce1dc65b5527ad5893b59b4f53b026226af16815518146f43e88,t,21000,6699048,,5000051,2018-01-30 13:55:09,193
0xd367bd43620e535fa30cbac75c51e9a81e30a329733fb1841b7f4a6b0904c747,t,21000,6720048,,5000051,2018-01-30 13:55:09,194
0x296bcfa9c8defb2a2cb650cba85b545c03381e5e8b197fb2475fd48697494e2d,t,21000,6741048,,5000051,2018-01-30 13:55:09,195
0x9a54c2ed0a0ac38e42740f3f4429ceb71b17e4cfb621e90757a2ea2febe5b658,t,21000,6762048,,5000051,2018-01-30 13:55:09,196
0x963eeb856d5d408d757d0b38da500c402d7e56f0188fe2d0c9a955fbba5de10b,t,21000,6783048,,5000051,2018-01-30 13:55:09,197
0xb0fbfcab9f5811744d3f76a9e3583b26e1ecd275f0e813f9932c45299559b4af,t,21000,6804048,,5000051,2018-01-30 13:55:09,198
0x6ae496975ed6480b22656dd7ff17a29ed7ec677d5dcaae82223af539c7b3f052,t,21000,6825048,,5000051,2018-01-30 13:55:09,199
0xbaa194af4bc523cba43edc5a2589066f6f2d0c51e4dff2ce0652c20d32762915,t,21000,6846048,,5000051,2018-01-30 13:55:09,200
0xce6ae6634eda3aaf622db44d1851f320ac8e1bbbabf2dd08e3e715001e67a38e,t,21000,6867048,,5000051,2018-01-30 13:55:09,201
0x4c74aaa013cac28c216387de2aa8cbeb8e2175aff05e0c2cdea0cc5f7b05bae8,t,21000,6888048,,5000051,2018-01-30 13:55:09,202
0x730f88739f8a427fe1e15affd7d6fa60bf8414c548415637d2a733f09621c79d,t,21000,6909048,,5000051,2018-01-30 13:55:09,203
0xfa0964317be6fd6cdf41cd48011730e42f6ddaeb0f111fbf041ab3244c338e90,t,21000,6930048,,5000051,2018-01-30 13:55:09,204
0xaeddbc59c73767119a1a71559f255cfdc4de95b191f57fd786e2aa4caae39f54,t,21000,6951048,,5000051,2018-01-30 13:55:09,205
0x482916a96c749a355f3cd779e0ef47b27490cbeb692ccd5896b16394b2610f10,t,21000,6972048,,5000051,2018-01-30 13:55:09,206
0x8a6f58c19d801e79713735217bf5e46f177b55b871c49709984266844f2f61d7,t,21000,6993048,,5000051,2018-01-30 13:55:09,207
0xcd06b51d87cd381cce3b72b9b004ccd0ccfc7bf1aad5dc1f065f5876e483494b,t,21000,7014048,,5000051,2018-01-30 13:55:09,208
0x18710011fd4b4aca1acb2e172820e1b2bac6e3bcb6701b737b493ce444124b52,t,21000,7035048,,5000051,2018-01-30 13:55:09,209
0x631efc688afd186f97dd3829bef8c6ea563ba465728532cd3e74abbe87eea1b8,t,21000,7056048,,5000051,2018-01-30 13:55:09,210
0x7479515dd0d87313e50edda3a9902b42bba84d7ee128190233b1963fc4a8379b,t,21000,7077048,,5000051,2018-01-30 13:55:09,211
0x4401c96b75ac31c0c6ab3c0de3b8f8151689517c37d23914bc86368e8c511690,t,21000,7098048,,5000051,2018-01-30 13:55:09,212
0x6142dc6d11d5b01c9a803e75fd25cbabee29a357c798471c079779bb76d98711,t,21000,7119048,,5000051,2018-01-30 13:55:09,213
0x018e75ef1fbd143eb123619f8c06cd5cd3730eb2b0f64c7b6af51957f9a1dffc,t,21000,7140048,,5000051,2018-01-30 13:55:09,214
0x8d3d54e6c881181eefa3bd5ae4840770ea441d2d778a80f13ac15b14ef69d78e,t,21000,7161048,,5000051,2018-01-30 13:55:09,215
0x052291d82c30aa419f5b21a77c7c0020daf5b7a1e345d98f0a9a22f39f3a4d05,t,21000,7182048,,5000051,2018-01-30 13:55:09,216
0xfedf49084010ec036a8f1d6c67c013ce69fd61985b3a8a61399f109fcb00abe7,t,21000,7203048,,5000051,2018-01-30 13:55:09,217
0x12041f016963a79ac40f76ccaaf95af6df5f5f76f602af9d30e0720a9ed98a7c,t,21000,7224048,,5000051,2018-01-30 13:55:09,218
0xe0a8ebcb9180a591f2d39e7aaa9eba81c8627f313dac8ab1e55faaee22e4013b,t,21000,7245048,,5000051,2018-01-30 13:55:09,219
0xf26c5b02cd9720c24ba8503a86d301c2b588aaa4b6e3e8966fdda56a22e3d58f,t,21000,7266048,,5000051,2018-01-30 13:55:09,220
0x5f11c0ee6af583a08b8a32067b1ecc1b04070674f3491a400f1aabd4e89ce368,t,21000,7287048,,5000051,2018-01-30 13:55:09,221
0x73b80507e6436c7d98ac9718f08ae44c096fda815f35917bb314d53d718e3142,t,21000,7308048,,5000051,2018-01-30 13:55:09,222
0x42425f43e3761138a816f3caa05e8abcf9ee79b0fdb8d118a532ca16bb366f58,t,21000,7329048,,5000051,2018-01-30 13:55:09,223
0x98f92891d70be58e2e8f6699a59a22f9aa6a608a867b845294d7775c247abb22,t,21000,7350048,,5000051,2018-01-30 13:55:09,224
0xbe90fb13d7d7a895496c8916ce318a034c60b92620ca62b6887114e2635cdf52,t,21000,7371048,,5000051,2018-01-30 13:55:09,225
0xf7c530db1d32262ae18cc627966ec20e0b83861f3c9521918cd2510d66620dd4,t,21000,7392048,,5000051,2018-01-30 13:55:09,226
0x0c1c6ddda9f69afc69c810beafee95ab496d62091e5a25b08246a5b5d4de5d99,t,21000,7413048,,5000051,2018-01-30 13:55:09,227
0x148717c0fafaf5beb155fe6cdb2d82920914dd40ef40dd5457c76b4b38c9209c,t,28748,7441796,,5000051,2018-01-30 13:55:09,228
0xf836a9a9e2167f86b22282b07d36d5910d652d607a48487677d6d5c324e2f189,t,21000,7462796,,5000051,2018-01-30 13:55:09,229
0x0495d10b94ea3d7a2c51b8a2dec301fd3cc9f931c20e786ca6599f9bfc889ce0,t,21000,7483796,,5000051,2018-01-30 13:55:09,230
0xc42b897e1e639d987d217861c46dc706e3cb268958711994a98a8e9ac596426a,t,21000,7504796,,5000051,2018-01-30 13:55:09,231
0x7c4df9aed28c4febd548db71ac0e9ad93aace12a4b8c404dd1336e8c21947c21,t,21000,7525796,,5000051,2018-01-30 13:55:09,232
0xcfc78fae198503242ac890ec66e5dea9ed5aa6750f4c01e447d13b7a6080f56d,t,21000,7546796,,5000051,2018-01-30 13:55:09,233
0x116215526109d9d839bca89ce2643e1d4bfaa3074d71d00541aad5acdfc4a4bc,t,21000,7567796,,5000051,2018-01-30 13:55:09,234
0xc79c13824cd4a96c6dcadd42091f66e05411ca317aeeaa58efd16927a17c2914,t,21000,7588796,,5000051,2018-01-30 13:55:09,235
0xd5a084486cb7bc700f9f0719ac70ced723e0ef08765e44470388f4168a3e2f45,t,21606,7610402,,5000051,2018-01-30 13:55:09,236
0x29207e073ef3bc78edbc7045a27a712657c40e6a05670a4853650c1102d95938,t,21000,7631402,,5000051,2018-01-30 13:55:09,237
0x22c59d2173065d55642cd35070160571e93ce89a555911d71fbdd868892a5f2a,t,21000,7652402,,5000051,2018-01-30 13:55:09,238
0x540faea482f01ceaf6a509da8bd443a892718e8f74cd0db2cf91c7d57f093958,f,183041,7835443,,5000051,2018-01-30 13:55:09,239
0xe78c25daf6398f686dceb5034de812a0e8899dbb8bf75280af505e927d7436e4,t,52840,7888283,,5000051,2018-01-30 13:55:09,240
0xca90ab83f51b8a427298925fb861666a2e12e22697295dc2b5b46d8b94ae6224,t,21000,7909283,,5000051,2018-01-30 13:55:09,241
0x59d0daae13d21fd8c4c7175a5924c1a50af047a28313812b9946db968889f002,t,21000,7930283,,5000051,2018-01-30 13:55:09,242
0xecb0943b340036667a9735e95e9d7e7430789d74524d43ac153c0d87d7ab95a8,t,21000,7951283,,5000051,2018-01-30 13:55:09,243
0x9935a1230edaab95a0aeff7ef91963831fdafa2fc28cf6f45cdd3c49691cb449,t,21000,7972283,,5000051,2018-01-30 13:55:09,244
0x67e18ee45828054f90df9b772289e49cf0f1333894ea02c542c58956409b163d,t,21000,7993283,,5000051,2018-01-30 13:55:09,245
0x57c52b1305720b959ce96c2d64c3ef6cfe161c5ef176320c853d371c7c78d91c,t,21000,21000,,5000052,2018-01-30 13:55:16,0
0xbf97b0b547400d1609937a688bf430b811d7bc3da4ee9f0ea881a36ddc8f0118,t,21000,42000,,5000052,2018-01-30 13:55:16,1
0xa4314787aaf9f32f3f745c373a893250fa81f9fe3638a323d31a40d5db27bba2,t,52155,94155,,5000052,2018-01-30 13:55:16,2
0x6bb0f3717e86c1e1704635cc1785f3a5a5380b612fbdbafa9667e9eddf928dd8,t,40907,135062,,5000052,2018-01-30 13:55:16,3
0x5dbaaefcd182f9bbe499d7df4fd1edeb061a283e653632fdf4d077b9a43f81ac,t,21000,156062,,5000052,2018-01-30 13:55:16,4
0x4a52aa3363adb03c07f974b4e4b55248a2a8f7ecf792ab8e9239814f57c95741,t,21000,177062,,5000052,2018-01-30 13:55:16,5
0x71539d4ef299cf1f29c80e510892da48800bb81e7b80869f59c33f9869035789,t,21000,198062,,5000052,2018-01-30 13:55:16,6
0xbc31b54d55fcd61209c6f31714b7a6ea726ce4c7f57d63d00c08921a9665e4ef,t,21000,219062,,5000052,2018-01-30 13:55:16,7
0x9b732e06c5c1dd47c6414e3681bb8e7e6595b500c28bd1fe65400c5219820585,t,104678,323740,,5000052,2018-01-30 13:55:16,8
0xb2e2752ab5e655ff26934e940faacda1f62a1430e00486d4cad13ba81a836f44,t,104678,428418,,5000052,2018-01-30 13:55:16,9
0x5c5fd5d6b001896908752f4a681e0214228e74154997f0e647771767f025cdcd,t,21000,449418,,5000052,2018-01-30 13:55:16,10
0xfcf9c3935fe3bcc8205bf27bb72881c6b24ec702ec1f9a5d41486ff2179a80ba,t,21000,470418,,5000052,2018-01-30 13:55:16,11
0x9be3249c8632d8b9fe0dae96987e4c9c77ec7c14cf28ef392e89a802291c69f7,t,51411,521829,,5000052,2018-01-30 13:55:16,12
0xdd12ee77c2835e16e4d1f9b24ca302ec4190e5756d24c2b954340977909fb6b8,t,29854,551683,,5000052,2018-01-30 13:55:16,13
0xb6abf69b122703bafa50abea3dc791b74411354c688e57a973268199f189a7c1,t,21000,572683,,5000052,2018-01-30 13:55:16,14
0x546046efd63448cb7c790a895f50478087f7ec438bec10ae476c46619cbfa7be,t,21000,593683,,5000052,2018-01-30 13:55:16,15
0x3390ba5fa5e7c90b90aa565837c4e47bcb37eb2996ab5269e5e6b307a1ca4262,t,52155,645838,,5000052,2018-01-30 13:55:16,16
0x19b81a7cc72647fac9657809d69fa278f8fa80ad376be447b2a56e4dd54acc83,t,21000,666838,,5000052,2018-01-30 13:55:16,17
0xb6f0b642ea24857e0f86485b0664c65ce94bd29923e4bbc129b0baae5cf076c4,t,23291,690129,,5000052,2018-01-30 13:55:16,18
0x99657a6fd3d42a4daa7a396490a54d8f1f31b381851ccef2a1b28120ce2d2e17,t,309701,999830,,5000052,2018-01-30 13:55:16,19
0x04f8a51bc0d55590969792a1dec330736b42e24cf8c7235ba8e51fe0b3b9675f,t,44095,1043925,,5000052,2018-01-30 13:55:16,20
0x39fb1792a755ec9849d103aa2cc0561482b37e008d4efbc031861c483902d6f5,t,21000,1064925,,5000052,2018-01-30 13:55:16,21
0x5f4413c79b946e1fbf79d0f1db7bdb1f1325fb2e4dcb4d9093ac557462f58697,t,21000,1085925,,5000052,2018-01-30 13:55:16,22
0x4ae542a6d44b3005308ee42eae0da388bf2ccdd74fd826acc1a6dcee90cf1a34,t,21000,1106925,,5000052,2018-01-30 13:55:16,23
0x865c8544cff623928317a36bc9d04de912e52252204bdb8877f8dbc8f8d3de8c,t,52011,1158936,,5000052,2018-01-30 13:55:16,24
0xa5dea0c4704312aa63c4b11015a8e7b8ccd21fff3aa47065f20150646b644c77,t,40907,1199843,,5000052,2018-01-30 13:55:16,25
0x81f78fb17f7c11b0e763eda99bf158e08120ed721eb28030181a9c03545d0afc,t,52158,1252001,,5000052,2018-01-30 13:55:16,26
0xe075f347622b7bd951493107b5fbff29548142181f7209aca154f9dd4074fca6,t,31951,1283952,,5000052,2018-01-30 13:55:16,27
0x76d6aac9f94857b9cebd4da21e487d8d10e2e7a4e0a3ea4747d77166f62d5a08,t,22084,1306036,,5000052,2018-01-30 13:55:16,28
0xbd4c8ca108769289a7ff2c60cbca5d9bab2358c18733d3cf0270c9e91b0caab1,t,21000,1327036,,5000052,2018-01-30 13:55:16,29
0x745ebdc55d46b507032cb5e794077c2852035f7df713f4192acf9646d924a6c1,t,91794,1418830,,5000052,2018-01-30 13:55:16,30
0xf1a1ae8ee59a6ec350211cf53c80d10b9c6eff3671e058f36fbe84e74f44d54c,t,21000,1439830,,5000052,2018-01-30 13:55:16,31
0x1a94c3f42916dfaede4218c6243eab2101d97c50039316f5b1fa6bfc4ecdda49,t,35183,1475013,,5000052,2018-01-30 13:55:16,32
0x935f2069192f64b5072a630a2f20b649a62f6973e951410b799a33a65fcef72b,t,52552,1527565,,5000052,2018-01-30 13:55:16,33
0xc2cd64174ef19b7be19c6843fee16ede931672de0538b912f9709021ee425ee2,t,208270,1735835,,5000052,2018-01-30 13:55:16,34
0x5c9b691ca6ced880a762beda25991e3016df2842c725b769ffe79aaa91f72c19,t,40907,1776742,,5000052,2018-01-30 13:55:16,35
0xc9e57770a4289329757fb54e1d0d6accb6534becbe8171bbfacd7573fa37e62e,t,40907,1817649,,5000052,2018-01-30 13:55:16,36
0x678fcda56b7c5163ec5ee9c4bda82c6e4a6c3792a2a11fd0c5aa8a8ba146638a,t,40779,1858428,,5000052,2018-01-30 13:55:16,37
0x8335a9a5657c25263393e0c4dd275d21568b92a8f65cf7f6191c4e8567a462c0,t,40843,1899271,,5000052,2018-01-30 13:55:16,38
0xce69cddb61183602cca679eac11818938d7727a65066555e7202def3ccd6cdeb,t,40843,1940114,,5000052,2018-01-30 13:55:16,39
0xfbdd5e8162c5c493840bf761764cdcb248e51da5f65fee4cd07c32ed26600e28,t,40971,1981085,,5000052,2018-01-30 13:55:16,40
0x207c7ea1071f046c27609f151733e909ae0fbca9d96630e0a9785608a725393d,t,40843,2021928,,5000052,2018-01-30 13:55:16,41
0x6dd50c444415479acd575f214c126681bf3187b443a0da07836620a689701ccd,t,40843,2062771,,5000052,2018-01-30 13:55:16,42
0x3e61ae6bc04589654f111031daedd712abb9810f2856eb62071980ec89e58e11,t,37158,2099929,,5000052,2018-01-30 13:55:16,43
0x84c5dbd7ad0cf41965dea17940586d3619ac22b4a5410e73844f0925a4a8b10b,t,38255,2138184,,5000052,2018-01-30 13:55:16,44
0x05036a5779478cd04ab488ab244434f01f9d1dbb90fa45df9127d92a1737fcdd,t,77602,2215786,,5000052,2018-01-30 13:55:16,45
0x146a8790346801530e71a1f3d3b56ed787037d5bf85cd7b00d5cdf5718c1d8e5,t,53233,2269019,,5000052,2018-01-30 13:55:16,46
0xcc92e9578ff9503cf995efe1be3c83ba5cf8a877b21de969bc0ee5438e8a15e0,t,21000,2290019,,5000052,2018-01-30 13:55:16,47
0x0cfb342e139adcbb8c3e730ff9828137f3ec8c744398de485069f8a9170010dd,t,21000,2311019,,5000052,2018-01-30 13:55:16,48
0x1b4af7b653146e58c0a08975b275a540ebf0685aa7b9b45901903aa291939b75,t,92917,2403936,,5000052,2018-01-30 13:55:16,49
0x0c393dbeba0fa23fc70aed7d9ac9428afff5e4a5c89186820a35e7f87c37f78c,t,52886,2456822,,5000052,2018-01-30 13:55:16,50
0xbc5283dc065bf080286da10765c95c1ceabc7e45d2c6c1d1974a7dcd5fd6aec6,t,55843,2512665,,5000052,2018-01-30 13:55:16,51
0xc5d7ce93bd009215315a4f616073477fd601d41c73b7b3adac5b395ac38c2405,t,36948,2549613,,5000052,2018-01-30 13:55:16,52
0x77225abe864cc8eba9e19f2c6903d312a508c812effb83e252c57d665dd4b900,t,40779,2590392,,5000052,2018-01-30 13:55:16,53
0x6a7b9926b351e53b6899194e77ead3b7107398885fa315bc361462a79b7a80e2,t,52139,2642531,,5000052,2018-01-30 13:55:16,54
0x8c12ae62e828207f7b19b9b0eb02683b6043cfd9f26abd2b4d236157569a898a,t,37391,2679922,,5000052,2018-01-30 13:55:16,55
0xa768307eeb2e67c73273eaefe79d4de05072189a0778b34776e047800dbe1545,t,52327,2732249,,5000052,2018-01-30 13:55:16,56
0xf382b7cfe8228c7d8ed10af697ab41dd5f49307be01ef2ff95ca63d9fd693347,t,52237,2784486,,5000052,2018-01-30 13:55:16,57
0x16f1673bade1eeea985a62e8c40a3a081c3323b864ee35b49cf085cc764d705e,t,52327,2836813,,5000052,2018-01-30 13:55:16,58
0x09fec5d66a83819648eb4f418031d0438c6fee1f92de1a44bdeb8096691ada58,t,40907,2877720,,5000052,2018-01-30 13:55:16,59
0x01c60f4be6735e3a5bcfa32ca74fe3689ae356aa0b395a064ba5fceb53f8d7fb,t,55843,2933563,,5000052,2018-01-30 13:55:16,60
0x9b5b5069e83fc469e8bc014954d3090f56b8a23e0dddc683021f9458f84458c5,t,21000,2954563,,5000052,2018-01-30 13:55:16,61
0xcb6f7be0336d0e1554810b1c0665e6b0d956bb69bbda4ef6d1aee9f736d56ef5,t,21000,2975563,,5000052,2018-01-30 13:55:16,62
0x92e203fd23b8e7c45e687796a8bbc5bccecaa3c87c44b528bc38825973ff3c08,t,36757,3012320,,5000052,2018-01-30 13:55:16,63
0xf55562f1d4d1817a4d5a70d1ada651b2a364efc7d8ce1ba41cc55a242849b7b1,t,21000,3033320,,5000052,2018-01-30 13:55:16,64
0xc3f4e36875edef7b8d311ee95a5706bbcceb189db116ac4367e44a357c177084,t,21000,3054320,,5000052,2018-01-30 13:55:16,65
0x2a2528a7ecd3d6c55aff89ad17d47563b83a4e2bf771294b79068d03231b3aa1,t,36728,3091048,,5000052,2018-01-30 13:55:16,66
0x9993ff8594398ab7b665b8b87c01dbfba2c7a1c77546dcfb7c28b634ea09caa6,t,253854,3344902,0xC86E8f975F34F9D256A85e0eD6B7C7bc00794117,5000052,2018-01-30 13:55:16,67
0x512a9a067eb42fa2dc9c8ca5d56271a7259e284a3fac3d2ffeeaa8623e975c66,t,103499,3448401,,5000052,2018-01-30 13:55:16,68
0xd7c6794eee23e0fadc714c199c17fabcf99de286ed5aa2c90c0e53e62e1183d5,t,21000,3469401,,5000052,2018-01-30 13:55:16,69
0x6f97d955986fe16edbebd8cb312f8186833fb20637c3e06beff8a85bc8264cce,t,52091,3521492,,5000052,2018-01-30 13:55:16,70
0x72cdfb5e04850eb39afa15a971ab34ec1eeb0abf52fda23dfccc4137b041c174,t,67669,3589161,,5000052,2018-01-30 13:55:16,71
0x0be2795421c2acc29f3346bfc08b291c0a03bc1f307fe16dcb10b5063aaba7c7,t,21000,3610161,,5000052,2018-01-30 13:55:16,72
0xf544e0248b065b226cfafc893211ecffee95b5511edb51a83fb3ff5ecf7ea2c4,t,21000,3631161,,5000052,2018-01-30 13:55:16,73
0x0759cc5492ebd4125df395f1603687209f7c177842f0464eec1d13ac45d751c3,t,21000,3652161,,5000052,2018-01-30 13:55:16,74
0xcafbc33d8c575fd42a89e972bf2aaa5027d79dc7ad587e56068cc7b15cd90a33,t,21000,3673161,,5000052,2018-01-30 13:55:16,75
0xbe6d0bd4cd3d1a246693aa83b18da2a3b5cde90f834f486e39796eea17eeefe3,t,21000,3694161,,5000052,2018-01-30 13:55:16,76
0x42a3b03c0ca9c61ba576f04fe48daa02f851fefba2ced4c91dc648f45d455580,t,21000,3715161,,5000052,2018-01-30 13:55:16,77
0x728c40e213e6832dfdd191a5c529c9d801c4009f29e7b75a3bd60ef7368ce1cf,t,21000,3736161,,5000052,2018-01-30 13:55:16,78
0xe4677c827b628a2ab505180c351e2bc3968bd6561a48993794dff90363ea12fe,t,21000,3757161,,5000052,2018-01-30 13:55:16,79
0xf2f6e71710d96600ae2c4ef95bfdaddcd320336bc1cb3e362b254ab88d98545e,t,21000,3778161,,5000052,2018-01-30 13:55:16,80
0x4ee73d4ca7fe8751bd4a16b9d521d5c739954870bd90185f1894c463cc5bea5a,t,21000,3799161,,5000052,2018-01-30 13:55:16,81
0xab715f19be26828265e29f578a567f1cf0a20d1cfee011fb2e3f188e6c35525a,t,21000,3820161,,5000052,2018-01-30 13:55:16,82
0x5683d079bcfe9693b30601dfc4b5100d93ffc0e5497ae91331f5101291a2eaae,t,21000,3841161,,5000052,2018-01-30 13:55:16,83
0x618e5fd1f9a55fe836d0b57395f23b0f6f64221620d8d3243ce7ada07259ef65,t,21000,3862161,,5000052,2018-01-30 13:55:16,84
0xfb83ba5290545b63bf79e7bac58527b90c487237559ae8a8ad0040d9a27948e2,t,21000,3883161,,5000052,2018-01-30 13:55:16,85
0x78eb28b8b46be5c0e9f639fcd670daa074eecd1f70cf22982225065a4677142a,t,21000,3904161,,5000052,2018-01-30 13:55:16,86
0x92599ac8780ba711598adbed42225fe356850e3cd96abacd8b3dff90d185f1e7,t,46018,3950179,,5000052,2018-01-30 13:55:16,87
0x6bd6d2c9ae67709b2403d65c191992fca472a6f6945ae992a5ae97bd958bde47,t,21000,3971179,,5000052,2018-01-30 13:55:16,88
0xbd1ecb1abfd8eb52f23efac053f61212ec32ad865dc9f6339ae8d8ead8111414,t,21000,3992179,,5000052,2018-01-30 13:55:16,89
0xbdc80a00fbab1df80db7fe1a60f37ea3cd9b6b7a867d578c040e499fe44cfc6f,t,21000,4013179,,5000052,2018-01-30 13:55:16,90
0xacbcad7462f6b8bd6af0a048e297a5f505a253008f7a2bf1ea5b6eefb2943939,t,36857,4050036,,5000052,2018-01-30 13:55:16,91
0x43e08cf14ce0fd8dcef08be8f6323fb8ea4cc7789a202f4a48e225c64188c326,t,21000,4071036,,5000052,2018-01-30 13:55:16,92
0x7b635b67bce863f692c16e9a7f3d3d7e4103747dfe4bb0f61ed42ec3df91342d,t,51881,4122917,,5000052,2018-01-30 13:55:16,93
0xc69dfd0202935c0486ca18baa73178b9cb217c18356d90e813ba7e8530e29b13,t,21000,4143917,,5000052,2018-01-30 13:55:16,94
0xfede54ea2df433ab3e761522791ae1e52a8d292ea1afc066bd69df06d7cf38cd,t,37320,4181237,,5000052,2018-01-30 13:55:16,95
0x563b5bce4615c3e8790d6418ef424f9fa798ffd87cfa5a2de26c20b1bfd1dad1,t,21000,4202237,,5000052,2018-01-30 13:55:16,96
0xf6eea301b0f6d00403877c237a8497cdf183a7f00611f27f71fd26c6f85ce973,t,21051,4223288,,5000052,2018-01-30 13:55:16,97
0xb7ffe841db7f152de06bf48bb29005f26431b181f817a152aa61656d20ff2c06,t,21000,4244288,,5000052,2018-01-30 13:55:16,98
0x44c6f5825a05ec4edf0ce5e8752353cd35bc90a337ea142ce5ec5252a2827523,t,22948,4267236,,5000052,2018-01-30 13:55:16,99
0x147f72779500118bc25f1ae2b6c9b265e686604299b7af93dfd441f34863bfc7,t,21000,4288236,,5000052,2018-01-30 13:55:16,100
0x4e5115602d18eed758ed4496993383ee2e742ef94a5b6058fd28d2857de1fd46,t,21000,4309236,,5000052,2018-01-30 13:55:16,101
0xfd0fbeee550051f774930992d8d061272a8523568a34eace0a281428966e9b7b,t,21000,4330236,,5000052,2018-01-30 13:55:16,102
0x8ac9e7dc0012630136a00cc908bad9c0f1f665b29abcec214c76080956be32e3,t,21000,4351236,,5000052,2018-01-30 13:55:16,103
0x815e1a0a4940a74f456653f342955a00ccc67397231d1001b132cfbb1e25c0ea,t,21000,4372236,,5000052,2018-01-30 13:55:16,104
0xd5e69f95b12b8db013ecbbf264382f82e90e0695de46da88b2a794d085df5d86,t,21000,4393236,,5000052,2018-01-30 13:55:16,105
0x8235f84f2e693976f17442bd19c45b909d9b2b8d623b8c8a9db5c5b3ee1ce94c,t,21000,4414236,,5000052,2018-01-30 13:55:16,106
0xa9d24eeca3bf93b0674e6a93fe8d60b49f63d7f041646dd636864d45cd750613,t,21000,4435236,,5000052,2018-01-30 13:55:16,107
0xe5f68dcafe4d85245c8fadb20bc26cb1e12b126bb63a39c645d50ce391bbe3ef,t,21000,4456236,,5000052,2018-01-30 13:55:16,108
0x25babf5aac828a077352decd9298674f5444b0d9264452c48c75a9a11a2f0058,t,21000,4477236,,5000052,2018-01-30 13:55:16,109
0x40a35bca6a7f992f3b0f04521c536d18f6d42e912dda9d5732b4eeea93477c4c,t,21000,4498236,,5000052,2018-01-30 13:55:16,110
0x05c84878f5d7f68958ae21528d514739e9527f16e3fa0338b0f74b225a898475,t,21000,4519236,,5000052,2018-01-30 13:55:16,111
0x845c843146cfacfd860dce589cd7844d973782a69c9c21e0fae7de99162a75c2,t,21000,4540236,,5000052,2018-01-30 13:55:16,112
0x8bc302e24247208e583062bfaf4643ed60c8c1df92779efa9f55936b6beeac89,t,21000,4561236,,5000052,2018-01-30 13:55:16,113
0x9193d7dad93fb025c328e5d60e80017a5e6ab42df47602fe2b3df925d3b4f334,t,21000,4582236,,5000052,2018-01-30 13:55:16,114
0xfbb2858b8ad17b4ad783f6e79e11152cf9d49c7270d416e0ce265b4a74afb290,t,21000,4603236,,5000052,2018-01-30 13:55:16,115
0xb7bacf1cbcc241c7448c2b1c5f49e22f7f69d5d2fc31c4184a0f49d993760d25,t,21000,4624236,,5000052,2018-01-30 13:55:16,116
0x2c8342565c5940afdbc8983c4bc5ddcd0638ef8694fdcd7bfc3b0929d78b9a8a,t,21000,4645236,,5000052,2018-01-30 13:55:16,117
0x90099c7a290e274b74e647c527789239195b487b2b943082229bcfe3b6fefa90,t,21000,4666236,,5000052,2018-01-30 13:55:16,118
0x530aee17b3633cf1612632182b1fed39989313d006fb5a7c1f08e4e5c06cfd0c,t,21000,4687236,,5000052,2018-01-30 13:55:16,119
0x6e7383ab684617f4eddb62e5fd63d7d824de224ff57cfc0356b67224d482d67f,t,21000,4708236,,5000052,2018-01-30 13:55:16,120
0x3d08857d1e92c1ed5033c7ba4ce469769ba4ded2e06dc9dc49455c721a894065,t,21000,4729236,,5000052,2018-01-30 13:55:16,121
0x74acc6b376775a5a8547627a5bf87a3e66d3b3199623d4dd99ad63577c553428,t,21000,4750236,,5000052,2018-01-30 13:55:16,122
0x93bb59b14388c60bea717b2df9aedaac743d8c7583b2a9d262fbb06550b91dba,t,21000,4771236,,5000052,2018-01-30 13:55:16,123
0xb1d7e742e08922bb08acc530501670517bdaa2b60118d782f9a6d6caaeecaae5,t,45750,4816986,,5000052,2018-01-30 13:55:16,124
0x91e9078c9580de3e61bd4a84dfcc7cd14b7456b34ced730c53686705a55c042b,t,21000,4837986,,5000052,2018-01-30 13:55:16,125
0x6f4af625c1629903ddbca7dc3264538b73eeac5ac9b9371b80d97038041f3a38,t,21000,4858986,,5000052,2018-01-30 13:55:16,126
0x744f6ccb415f62fae8f3975fc44ddacef0f8efdc31cc303925286e5bfaf5cc8c,t,21000,4879986,,5000052,2018-01-30 13:55:16,127
0xa5522b0c8bf0a83f92a3436957bbbb93df701c1845a7135bcd493bf0cd936a83,t,21000,4900986,,5000052,2018-01-30 13:55:16,128
0x84036e0b011c41952ff7170a1bf9be995ecffe06ab0561599bcbeab200d4a2a9,t,21000,4921986,,5000052,2018-01-30 13:55:16,129
0x78f9bd3b8e4eedc1ed257a8be0fac16bfb6b205b1dfc79201459214d627d6df1,t,21000,4942986,,5000052,2018-01-30 13:55:16,130
0x4f45fef343969ef4aefc889feff3868300605ca67ad81692eb4412af788e030a,t,21000,4963986,,5000052,2018-01-30 13:55:16,131
0x407ea455502c77a58d209cd922005557a51e3784c99652dce0a95217ab29e583,t,21000,4984986,,5000052,2018-01-30 13:55:16,132
0xfedb8d47a39c000e9fe9739baf733f6ef1d8e0f2af2e4278d33e45c1c261ef50,t,21000,5005986,,5000052,2018-01-30 13:55:16,133
0xa898a208fd1569e74a3d4c320ca3d0b85be1947ea3ac2be0266d666ee33ad696,t,21000,5026986,,5000052,2018-01-30 13:55:16,134
0xb95c394a9f6fc840b5bc93d53298605cbf17c6a65154a6bb0e8a4ed35d57aa2c,t,21000,5047986,,5000052,2018-01-30 13:55:16,135
0xd5e4e3dbd51969dccfea0296127fbddd27001e1eae852c546b8bb25240a23b05,t,21000,5068986,,5000052,2018-01-30 13:55:16,136
0xeafc8b76124255a9fb51aed2e1763135c3df3b866a21c67d8aa36eb7efb41af8,t,21000,5089986,,5000052,2018-01-30 13:55:16,137
0x6da828aa5cbb1369d517492419676af0b823491c57b7d27af647919fc26b13bf,t,21000,5110986,,5000052,2018-01-30 13:55:16,138
0x48209cf1aa1a844a807578cd14ce47d4272f6c67ad234b55fb52dc1186263856,t,21000,5131986,,5000052,2018-01-30 13:55:16,139
0x8f90abca02375178ec40072f2f2340a173b761db02344b51b33aaca9c28d0f78,t,21000,5152986,,5000052,2018-01-30 13:55:16,140
0x76d2f83beed8ae984247a432993282d69cb831c5d1dbdc7018717afabbeefa52,t,21000,5173986,,5000052,2018-01-30 13:55:16,141
0x229ba3044261d5951daeec5ae7aadf275e037ea70224d425d04b0202e050e3b2,t,21000,5194986,,5000052,2018-01-30 13:55:16,142
0x0a3e92a33dc19f458eda5562dc2a142a682622642fce3a1bd911488cfe2eacb2,t,21000,5215986,,5000052,2018-01-30 13:55:16,143
0x81de995886cc55860b0577b4e4e40f5aa176df8cadc7435a11df6f366d336c32,t,21000,5236986,,5000052,2018-01-30 13:55:16,144
0x84147faea8adc2acfa6a6705a761ae8d2a1d8c9b0d98e2485af87fcb139210ce,t,21000,5257986,,5000052,2018-01-30 13:55:16,145
0xfe129ba87ba9e0e331d18aaba44a784cb83ddfa5bed8958bd553e4781fdba318,t,21000,5278986,,5000052,2018-01-30 13:55:16,146
0x556ec2f805ad1774469071a78a9344c8a09385301bf5ea04165fabd65431861f,t,21000,5299986,,5000052,2018-01-30 13:55:16,147
0xb2df4b95781f4248e947f255459b0a56cf392f20ea3ae95ee609a1dd21207417,t,21000,5320986,,5000052,2018-01-30 13:55:16,148
0xfe3b4ab70458ff206061bc8f354de74276e3b632f529de63c20e9275c039251b,t,21000,5341986,,5000052,2018-01-30 13:55:16,149
0x36c242c1fbf2d4e1a8620b2d6a43b4dc900e86bec459eec7c76c2d8d0c75201b,t,21000,5362986,,5000052,2018-01-30 13:55:16,150
0xde2922737b8077f32960cca427de978605e028a658485e94c742a9bae0c3a0e0,t,21000,5383986,,5000052,2018-01-30 13:55:16,151
0xefc1c50bedaaaeb1d1dbf29a925a5d052946caefc7edc39bc8297d6c5684abb2,t,21000,5404986,,5000052,2018-01-30 13:55:16,152
0xe17ea352094de78999c0bea631e6622ac5b90b21354d8d996077ae1ee2bb4ba8,t,21000,5425986,,5000052,2018-01-30 13:55:16,153
0xa5c64a379348ba4ca30b84b6a4cee330886d541ab69fbd7e77ce0464f0515498,t,21000,5446986,,5000052,2018-01-30 13:55:16,154
0xc226e15cbfb9b11c349289b56f306fb13749eeb01b9f05cb74cce6dadd528e74,t,21000,5467986,,5000052,2018-01-30 13:55:16,155
0xacf66ccbb0eef1a9e5213cb98acc470ec5137540d0d81b6d58c997d336a4e2ec,t,21000,5488986,,5000052,2018-01-30 13:55:16,156
0x1eab0d0ec69ef55aac2a5f65cd3d0a751f1c48c94ffc741cef5c1c756ca87e7e,t,21000,5509986,,5000052,2018-01-30 13:55:16,157
0xcc8a12fe6bb1ed388466652398874aaa30d983ea838f252ff6d67c1141c684c6,t,21000,5530986,,5000052,2018-01-30 13:55:16,158
0x2a3a0c7207669860acfd7eb3d5772fa73359d2de5ced428bfe88a722751965c8,t,37810,5568796,,5000052,2018-01-30 13:55:16,159
0x7b51523a5cf9c193ca1b002475c90961272e43e35cdb63b6ebeb936a098267d7,t,21000,5589796,,5000052,2018-01-30 13:55:16,160
0xe197b4b03acfcb974b662ebec0bf692c8192c59ef4780399f4aea251b075e379,t,21000,5610796,,5000052,2018-01-30 13:55:16,161
0xb45d410ef6ba46d4168d16ff1f293bda0da89cddb8f67fbe6274faf2c9cd9c6c,t,21000,5631796,,5000052,2018-01-30 13:55:16,162
0x49a1b82f6381d247fa0c0fb2dc318dfb3ea4cb406b6db6e669220b1d3fef99b6,t,21000,5652796,,5000052,2018-01-30 13:55:16,163
0xa19ec09e71a2bd1e43b1b36b1b4d3f862dd1c66b9f17bbe0d60a03286dcc2766,t,21000,5673796,,5000052,2018-01-30 13:55:16,164
0xfeb29de173eefdd14a0ef19332df1e022527531a5629a23f01e69c733f83cf84,t,21000,5694796,,5000052,2018-01-30 13:55:16,165
0x07a4fa3e5a6a40a433af55a5d094cb02f9703307f090b0f0cf1aa9c98b3c6bd3,t,37091,5731887,,5000052,2018-01-30 13:55:16,166
0x76bc6584f25bf68a71b2f4873c6f4f9e48dc7abc692ceeeeb827a8728310afe9,t,39490,5771377,,5000052,2018-01-30 13:55:16,167
0x1fa0ee7a9b4686412f7a1784c38eaabb03e2ccd4af04d7ad3a40a55116b0344e,t,87489,5858866,,5000052,2018-01-30 13:55:16,168
0x1d3abe392eb1e35b85ac627ae62d62c5de0c63f67b49dbe4f655331ecf9530f7,t,154812,6013678,,5000052,2018-01-30 13:55:16,169
0xb61bf791fdef06bbc6a4c14071ddb5753e0f2c0c85374d62f1c4f1d45cf11829,t,21000,6034678,,5000052,2018-01-30 13:55:16,170
0xc8ece7284fdb1aadfb094de76849c20299943cf63adabdc6fbaa6f4c9e2633f0,t,21000,6055678,,5000052,2018-01-30 13:55:16,171
0xa19e4ed3453b5e887b5ead0b63597e217e7be16ac1248304fd272ca9c076398d,t,52507,6108185,,5000052,2018-01-30 13:55:16,172
0x1b9794c403e5f3d04b225a27a48d681d0c9f71d203049f45d1a9a2239eb78579,t,23720,6131905,,5000052,2018-01-30 13:55:16,173
0x49ee61c815e2ebb35cc35176f267268c33c186d4b3ea5d14c26306496090a7f5,t,21000,6152905,,5000052,2018-01-30 13:55:16,174
0xa232ea2ef969a7b37c3141fd9226bfbb7ecfd3537a5a569d5b7da3cd6469e49f,t,21000,6173905,,5000052,2018-01-30 13:55:16,175
0x3407c11f6405890baef005717a74d7ccd9edaa7309bfd5c7c27c97a6f78cb09f,t,21000,6194905,,5000052,2018-01-30 13:55:16,176
0xd999affd12137c5ad86fa3e78af8e08e164494c2f6f91512be33919954e69e58,t,21000,6215905,,5000052,2018-01-30 13:55:16,177
0xf9463027b2880c38ea59c18795adbfbe438bba734923e1ae417874f7c9f3dd04,t,21000,6236905,,5000052,2018-01-30 13:55:16,178
0x105e34b32ada1824af9ad3528d7653949037eaf9fc607ab4add9ac1e19f2e224,t,21000,6257905,,5000052,2018-01-30 13:55:16,179
0xc52ce434d4b6d6609d8c892e74050bec6b65f731cbd8cedc4f13dc6fae855dcb,t,21000,6278905,,5000052,2018-01-30 13:55:16,180
0xcd3367099eb7f87a7f8cf771a1233b73ea9c2015f37cbf6d4afdbc637ce11d0b,t,21000,6299905,,5000052,2018-01-30 13:55:16,181
0xb84bebc027e3e2a62d29628581e995979bc7e37bb9f54df1fd2b03fd6fd363c3,t,21000,6320905,,5000052,2018-01-30 13:55:16,182
0x15c1fd426ab6fe4bc6c0dfc6358d7d7aa92f6835242b7f4d5707b86ec1bd95ac,t,21000,6341905,,5000052,2018-01-30 13:55:16,183
0x104de8e2a150343a10567b13f8c97a56779abb7bba8e494e1aa7aa2ee6a3913d,t,21000,6362905,,5000052,2018-01-30 13:55:16,184
0x6f461bf6288cc4e2b6a81088d5b5c71b9e989d53ba781290bba25389f1cf5a8a,t,21000,6383905,,5000052,2018-01-30 13:55:16,185
0xa497651eba2868eae848b9c95158bf5835d78462b4a6c52a675ae1cecf663872,t,21000,6404905,,5000052,2018-01-30 13:55:16,186
0x4b7ac45a738c10988091a4850b7814797ff1b49e5f26b0c2df3dbf53a49efb4b,t,21039,6425944,,5000052,2018-01-30 13:55:16,187
0x0f1272255fe80656b2770a6dd883027e1b43c6bdba35a697306faa9d99a3de8e,t,37987,6463931,,5000052,2018-01-30 13:55:16,188
0x86d44001a294bba81869a79510fa10e14ec0a3423f706b7b164c285d9bc6ac11,t,21000,6484931,,5000052,2018-01-30 13:55:16,189
0x09e60ed7cd8cc004a4773f5365b33b7b5906c14e1e72766e683ef417d949b221,t,21000,6505931,,5000052,2018-01-30 13:55:16,190
0x82b798e4a678e4be74502d3c5a5e874b2e84df90070ddbc11a3511d35d6cdece,t,21000,6526931,,5000052,2018-01-30 13:55:16,191
0xdd50ac09c213e1ad00a47142e68e4614e2aa32d0f735e31b5406a6368e09105f,t,21000,6547931,,5000052,2018-01-30 13:55:16,192
0x6a12750aa1f1213b6239b80ba1e4117b587456222ba89cfdb9b1b9064db5fab4,t,21000,6568931,,5000052,2018-01-30 13:55:16,193
0x9ae6316b65a6ae2662deaecc21fa97fb734d12cf8dedf5b27a325415daf94afd,t,21000,6589931,,5000052,2018-01-30 13:55:16,194
0xe0fc26ed668247d5e2467b66c0686440e855175aed1b6f05ac2d8de578983869,t,21000,6610931,,5000052,2018-01-30 13:55:16,195
0x994955ba38225c2c41169e20d705b8f5a098708406c07b34ebafba1dbf5edc01,t,21000,6631931,,5000052,2018-01-30 13:55:16,196
0xed43dd5b661e2b7089ca28939741bf98c0a5d2d2b6a41292b28c80e3c9557846,t,21000,6652931,,5000052,2018-01-30 13:55:16,197
0x67bc4b9b509a890fdd1fad82da15f6ab3fc4a9e36e138d0e95549968d23c8f1e,t,21000,6673931,,5000052,2018-01-30 13:55:16,198
0x326e1fbc4b6f8ead2d755f681f243cbd675397ea6bc19e7d0800fcf3683df399,t,21000,6694931,,5000052,2018-01-30 13:55:16,199
0x943081d7e74128621e99821b1e1975a2713e4448de88a828e90026a61a6b6e39,t,21000,6715931,,5000052,2018-01-30 13:55:16,200
0x963f5d07b3a1cda30964498384488b875200cf034e8f2dc8bc3321c7ecff8ab0,t,38012,6753943,,5000052,2018-01-30 13:55:16,201
0x36768005b66182ca3f1037436992e6a88bd9fe1b76dec55ed1b598736ae83996,t,21000,6774943,,5000052,2018-01-30 13:55:16,202
0x06fc15c3d64e926775df9f7345dcb129ef9363b8c0bcb9193be0621ff1612f90,t,51857,6826800,,5000052,2018-01-30 13:55:16,203
0xdb220614fea52d34744b753b341a121d3dceebc98c1879d0a8bb397108024476,t,21000,6847800,,5000052,2018-01-30 13:55:16,204
0x051dbab3685869cf89197e6bce816b85cb8c91d1ed9b9b44b0fe0daae3c20c42,t,21000,6868800,,5000052,2018-01-30 13:55:16,205
0xff12b365d54997a42fa3a3228d76e8d1820eef1b64d4af3302573d38599e8960,t,21502,6890302,,5000052,2018-01-30 13:55:16,206
0xe9f0720aa8c8b2168e721e70a41b928d27f09453657e1bdeea928277a62240ed,t,21698,6912000,,5000052,2018-01-30 13:55:16,207
0x351736f06ea41068293a8fdcb09408b916d47a92c0a9615831e72c6b922854b3,t,36752,6948752,,5000052,2018-01-30 13:55:16,208
0xc9e2ea7176057747f721eb5c7116c5f9a05c3d55e1aad263ede869d9226d43ba,t,37323,6986075,,5000052,2018-01-30 13:55:16,209
0xe880012fc57e4c534825d2079cd470cfc017f79c34bcac059fc5c4ba90fbb1de,t,52976,7039051,,5000052,2018-01-30 13:55:16,210
0x15356cb75955940f2d7e0a9fb1f99e30e6410bb598a356742ba84b3df72cb924,t,21000,7060051,,5000052,2018-01-30 13:55:16,211
0x4503ee21008111518eae414fd3ecc7cb345f2b2e1ab1e576ed304065b751ca4e,t,21000,7081051,,5000052,2018-01-30 13:55:16,212
0x351d12b51a9d9773c8d0179b4c75eaf17f2322cdbc84aaa6d5153f1a485a5555,t,21000,7102051,,5000052,2018-01-30 13:55:16,213
0x9eadadae5bc06f5c894697940e0bd7b5e064a87cea2e4dbdb8de440e004e63fe,t,76734,7178785,,5000052,2018-01-30 13:55:16,214
0x8fd34b212e7226172728bfac8f2a69c4a78d1d97a72a87c48fc244d3bb75097d,t,37228,7216013,,5000052,2018-01-30 13:55:16,215
0xc5dc14e1efc449043038c83f76bc1a28894fcadae5cbde67720f6858fb6441e8,t,21000,7237013,,5000052,2018-01-30 13:55:16,216
0xaa200453dc5fbcc93823d59ee3e7cd942b70b4ab3e3e951f48e3c6d4e12e5c5b,t,54379,7291392,,5000052,2018-01-30 13:55:16,217
0x26c7e3b258b7eff8d82a3fe2cebe904be3c51755d4cfc07ec2e7dcc9b0dc0576,t,21000,7312392,,5000052,2018-01-30 13:55:16,218
0xa8be345f6991893b488c3122297631877ef5c76a3aea281230e8785f35285fe7,t,21000,7333392,,5000052,2018-01-30 13:55:16,219
0x8e4453c01fca66b6f63db01a50d8a89c874590a46ad09830a8cecfa5629983b5,t,21000,7354392,,5000052,2018-01-30 13:55:16,220
0x65f915f051ca888206637b212961b00e6148ee5cc3375306c84ab27087afc775,t,21000,7375392,,5000052,2018-01-30 13:55:16,221
0x9ee4068a0480d2d1c972588374efeb04ef6eaf5c263226a53e7efe8157232b27,t,33705,7409097,,5000052,2018-01-30 13:55:16,222
0x28e0a06bc59f0a40f5a57628e5dbdbb464af7d6207906e06907be13278ca2daf,t,51938,7461035,,5000052,2018-01-30 13:55:16,223
0x271886d83d08fc8fad7e648138a7d02c97483970bd5d17a9f9bf4e2e610a3cce,t,21000,7482035,,5000052,2018-01-30 13:55:16,224
0xb7525722a3e364408a77fde54ae8bf7786f51c4af52c3439ca83e83860ac7b5a,t,21000,7503035,,5000052,2018-01-30 13:55:16,225
0x52d4b6cbece6081b2a56eeeb2ec156630fa57fa623e73b7ce71b00246c488a1a,t,21000,7524035,,5000052,2018-01-30 13:55:16,226
0x9717ff42241323d9e8047f1795379b86115acf44ca0d3d342c39b4e10a8bec5d,t,37312,7561347,,5000052,2018-01-30 13:55:16,227
0xa75f7a01de0757116da5f7f54916348ebfed5131b35528b313a0e3035dfa9961,t,21000,7582347,,5000052,2018-01-30 13:55:16,228
0x07419f3bad393655243b6bc0e1e0cf3588266fd74088435872e2e123d40a94a2,t,21000,7603347,,5000052,2018-01-30 13:55:16,229
0x2f937092a3b925c2b0347923b4f9b6c3ffce694a5b32a806a7e3394038d3ce98,t,21000,7624347,,5000052,2018-01-30 13:55:16,230
0x1e1ea434024a2dbc8d180e23763832bcd744c34ef821de33ca2acbb04c2befdb,t,21000,7645347,,5000052,2018-01-30 13:55:16,231
0x5a2b944cf62a22e72ced77c3c91cfa1c6af58d2375c2849e614e8cb90fb481d4,t,21000,7666347,,5000052,2018-01-30 13:55:16,232
0x56b3488968b065c5daab63b8443ffb36d2b1907e6cc9f0e8e678c2a25d054de4,t,21000,7687347,,5000052,2018-01-30 13:55:16,233
0x5988aab76b5be5e8e7029cc02f4fb0f38c7dc63b9bdf6beaf4d3f10971c48fb4,t,21000,7708347,,5000052,2018-01-30 13:55:16,234
0xaa700f3ff319d46d9d105ea96715b5514cec143650af8192bb91e249a87aea6b,t,21000,7729347,,5000052,2018-01-30 13:55:16,235
0x246855adbe8092eafa4d273834a90a4a4f4b99fae11012f6bb13c25dc1ef5ccc,t,21000,7750347,,5000052,2018-01-30 13:55:16,236
0xdddfcee1d95158fc6dc0fe3a92ad2c6f47ad85cab7f1a0efcdab05ec1c69d2be,t,21000,7771347,,5000052,2018-01-30 13:55:16,237
0xaa51e9eb72894711e3f21b9c6411a367ca15a707c515379a09d8f0b94d82bd67,t,21000,7792347,,5000052,2018-01-30 13:55:16,238
0x1ad9d4aaf8d0e1d69df06550a4e6e6536051580a2584c1189dcb5526aa0436c0,t,21000,7813347,,5000052,2018-01-30 13:55:16,239
0xb24db54b40ea661575297400e151b51f5aafd18928952ec9ff68fe6266dd2a80,t,21000,7834347,,5000052,2018-01-30 13:55:16,240
0xcf8127a18cf6ce9e503637109fbf936f16c9c42c46ceb95953357c2688a6d41d,t,21000,7855347,,5000052,2018-01-30 13:55:16,241
0xf0a42d3633ce18cbd8b9cf4cb389ad9e69e578e9622afcfe1088c216de0f3e05,t,21000,7876347,,5000052,2018-01-30 13:55:16,242
0x935d06e5da43b2a0eebbbb3766858cb38635ef1705d655dea56ee7f8285b8601,t,21000,7897347,,5000052,2018-01-30 13:55:16,243
0x54a3ff522943de2d8f1a54b6071f38483d32c34bd21c82566e16eb3d5b04b004,t,21000,7918347,,5000052,2018-01-30 13:55:16,244
0x5412a5ad394978499a81c8668f17bc7756b3f9163ac1eaf33930617e50e1bab8,t,51541,7969888,,5000052,2018-01-30 13:55:16,245
0x1b4632a4679fce77fa122d5142e9587e14f34a325124344a0b92f67b469d8587,t,21000,7990888,,5000052,2018-01-30 13:55:16,246
0xabcdc35cd28c5535b7892ae0db9fda3dde8b50a6295d4333aa9a6addc6083069,t,21000,21000,,5000053,2018-01-30 13:55:37,0
0xd88f69262b17cc3faff24a274bf2de0052e3fc71a331746a05bcd269c7c98fa7,t,21000,42000,,5000053,2018-01-30 13:55:37,1
0x60c7f74ebb9ea6b148934d61c5f95a3508cf78df4ba2506f7d28b71930015e76,t,21000,63000,,5000053,2018-01-30 13:55:37,2
0x0a7b83acde226c73b3ba7c7a29b839b580a56087fed7146afac460efd7aee68f,t,51531,114531,,5000053,2018-01-30 13:55:37,3
0x8b5e1096e551a29a19d880a0e9df2ae77114d52438e1b346c6546218c957dd76,t,40843,155374,,5000053,2018-01-30 13:55:37,4
0x6cd16e9cca12f3baf6c53299fd142dc2436c566b097a9dafd8394cf75b195d82,t,21000,176374,,5000053,2018-01-30 13:55:37,5
0xbb6554e3f8dffb1284043be3174fc503c4250b646e71d728fe9565e021fff3b9,t,37950,214324,,5000053,2018-01-30 13:55:37,6
0x152d4e23da0b1a9e9eb891703102d325c097136e0ba236237485a087493af587,t,21000,235324,,5000053,2018-01-30 13:55:37,7
0x8ae7af6b0b39f5f2ca54a3ea7ec1d862ff9728b3d291ed4ff600448f64d30f6f,t,21000,256324,,5000053,2018-01-30 13:55:37,8
0xe195c685837c6f00f1c7a7109209bdaac3cdde791232dd3e4907ca7c223e8a96,t,21000,277324,,5000053,2018-01-30 13:55:37,9
0x3bb00bb9941b6783e91f3c0ab133d5c5babe5e2ec1e850b4448feb6d49a1f9c9,t,25907,303231,,5000053,2018-01-30 13:55:37,10
0x952c7cfa34380e0ce9b8c723a6e353572a30dade1325cb6ad3ceb53b77ad1621,t,25843,329074,,5000053,2018-01-30 13:55:37,11
0xd7e7df798b161c1bb49450e5b03a3100563ed402623ae4f7112005687fcd6c20,t,21000,350074,,5000053,2018-01-30 13:55:37,12
0x6f1808a1750aa4837d0a74816ef7eefffbc93230c3a4f5acd0ad3b9de55133c2,f,22348,372422,,5000053,2018-01-30 13:55:37,13
0xf0cf190c7c8b265cf40bb6aefceb7a8409735e259a4c6e0131bf9537f9c73ee1,t,21000,393422,,5000053,2018-01-30 13:55:37,14
0x6d8f01013889f16ed5e852531dba9f7876b13b2b1db08b7edaa1771c44a3c919,t,92858,486280,,5000053,2018-01-30 13:55:37,15
0x3ceac201c89ee43d3585f2d49d3c817f7cb04403e6d5165c053eb91458d977ca,t,102934,589214,,5000053,2018-01-30 13:55:37,16
0x576c5ad9368e260bf789350aa7f716673c626b9aab8db33b224937df4f951da6,f,24090,613304,,5000053,2018-01-30 13:55:37,17
0x9ffa49922010d8e840803b6792a4c6a96a874d886654ec6a634dba1117348b6b,t,21000,634304,,5000053,2018-01-30 13:55:37,18
0x9fb8aa47e74ffbf707dee1c5e46210b805e1a721671e02785b3378d875831f1f,t,51783,686087,,5000053,2018-01-30 13:55:37,19
0x4f15dc8912c20e998de8bd12fbde7b33257d4cfe32a6c5ae65f9de3494befec9,t,44854,730941,,5000053,2018-01-30 13:55:37,20
0x2497e64594665d20339a0c35c6f8fc49f731a477dba13fafea60bcab99dcafb9,t,52884,783825,,5000053,2018-01-30 13:55:37,21
0x396a1bbe4482cde148651e4942aa1da3846c1daa3ecb970e6f69d6760dbc674f,t,21000,804825,,5000053,2018-01-30 13:55:37,22
0x461fe680ede8bcbbe60c2654d9a29a955d906fddc2868c126cc32939353cbbaf,t,52117,856942,,5000053,2018-01-30 13:55:37,23
0x6dc5c2fd725120244e6fa0544e3c8145f63d5851b5c5896b970235d19dd923e9,t,21000,877942,,5000053,2018-01-30 13:55:37,24
0x43fda775a4cba7c28c968b3ead43cb72d8cdc55b8bbdbc2eb0ac79f0911121f4,t,21000,898942,,5000053,2018-01-30 13:55:37,25
0x85cee345776b582198800c85eb094ebe1462eddf9eb2f8316490052df166b1aa,t,21000,919942,,5000053,2018-01-30 13:55:37,26
0xfccc1dc051d34adf0220b42854bf1db6a2609b9b09fd9c86b5ef7e7c70045135,t,21000,940942,,5000053,2018-01-30 13:55:37,27
0x631ecc02049cc6bced8cbfd10a06cf782e8a5f440a3094e6578fc85a96e7192d,t,21000,961942,,5000053,2018-01-30 13:55:37,28
0xe117d267a9cc883004741937758a042756556ab7f2ba8aab6cdb94512b84ca04,t,21000,982942,,5000053,2018-01-30 13:55:37,29
0x0d46e2ef9980eef8c2bffdd4687b7e5d9c0bb9d5f6cb369a671219969318c44a,t,21000,1003942,,5000053,2018-01-30 13:55:37,30
0xcf192db0403e98637113b75dee256552513e77106fe7dab1c86d38c1a6739a61,t,52810,1056752,,5000053,2018-01-30 13:55:37,31
0xd6ff78a814adbc54630b3505cf175a06b2da5b76ab4a8b19ca9782484efea940,t,21000,1077752,,5000053,2018-01-30 13:55:37,32
0x32a0eda44daa22e50d40da5cf00f865d48eb91a5a3cdc6c704fbe5ec65f9a534,t,38002,1115754,,5000053,2018-01-30 13:55:37,33
0x54d59d35f146a917e2ae668428351dfdaaac9e88bbead6e53d6aad94874bb8ef,t,21000,1136754,,5000053,2018-01-30 13:55:37,34
0x365ff7b5104dc12bcff494a29d142dfa26db977a0d2491d6afe365ef2d577599,t,21000,1157754,,5000053,2018-01-30 13:55:37,35
0x506014932b17f63569f800ce14f49a3dd19763f0cb620b5658dc425dd125fc53,t,49725,1207479,,5000053,2018-01-30 13:55:37,36
0xaf18783c2d8a581e35a900d9e67ca6c91bdd87dd3f1a5a09813c71718ceef7b2,t,21000,1228479,,5000053,2018-01-30 13:55:37,37
0x8f68af507324bd23287e22b5c378c49271d69f90cd9140d210f845eee3265317,t,22413,1250892,,5000053,2018-01-30 13:55:37,38
0x2c587e1dbcf5f04be280b8b243b68e29ffb9393a255fee6d93e35605e294c2d2,t,21654,1272546,,5000053,2018-01-30 13:55:37,39
0x7b75acc7fe76a223e78c054a55bbe6bb34e7e5052da089ede81eaf5b6d14bda3,t,41368,1313914,,5000053,2018-01-30 13:55:37,40
0x92d601b168fce04a3b072d49cd656f37c213b23bbbfce07cbd24a55f9caeb2f4,t,64725,1378639,,5000053,2018-01-30 13:55:37,41
0xa2431e167e81537c984f9d3b7df1bfe84c471a6bb9309083ef16922fbf014f7a,t,21000,1399639,,5000053,2018-01-30 13:55:37,42
0xf58ed00d5737dffbd3eb83dc1380400937db17c1ded2b43d21dc4db387f9babf,t,108370,1508009,,5000053,2018-01-30 13:55:37,43
0x53a0dea4873b12d8efeb13d31defc793d6896106903b8d8705a908280cd31806,t,55843,1563852,,5000053,2018-01-30 13:55:37,44
0x280f406c403f3c063cd189a5dbff7697ce37c800cc62fe393d4c6166b1e7da1c,t,21000,1584852,,5000053,2018-01-30 13:55:37,45
0xda2223e377602d07d9c028861a513ac04ee1fa0dc0642d167eae04d9d0c6604a,t,49725,1634577,,5000053,2018-01-30 13:55:37,46
0x33315a4b54211ffb98aba8b79c3140864ef4e21c6583b19f26d8628640bea8a2,t,21000,1655577,,5000053,2018-01-30 13:55:37,47
0xa0a16fe69e6372fa67a91b222b7a6ef61f13f31285b98734fc8e39ba4447c16b,t,21000,1676577,,5000053,2018-01-30 13:55:37,48
0x6854417f80416d1759723923f169ed575f8a48daf7dea2e9a3396ef74b187b21,t,52030,1728607,,5000053,2018-01-30 13:55:37,49
0x267349e1fd67e88259e6cd767072835aa74c73e712af9c9f0af85008c01cff82,t,22027,1750634,,5000053,2018-01-30 13:55:37,50
0xabc351f00488117550253a621e5fae074efc6cdc5f8207c5c8f76cc08e2588bd,t,21000,1771634,,5000053,2018-01-30 13:55:37,51
0xd1bcc9d5b6d708290ca8b029f916a397224eca3068046eedf10e4220643d57bc,t,51912,1823546,,5000053,2018-01-30 13:55:37,52
0x63fbbf54de33dffbcb4a7701d02c756dd1f9cae848203afbd6889518983d50da,t,21000,1844546,,5000053,2018-01-30 13:55:37,53
0x1e64ea14fd06882030260d4d58bf66ac0393cc3d559974ab8941113501d57749,t,46076,1890622,,5000053,2018-01-30 13:55:37,54
0xc4f4b2497f9c8b122e4c343c11d6850079eca3a2ed56c7af37f1ff91c1221efc,t,21000,1911622,,5000053,2018-01-30 13:55:37,55
0xfd2441fb2fd5494545d60fbd3be0e7d00b0f0c8a2d558dd55ccd6fbf000a3df6,t,59636,1971258,,5000053,2018-01-30 13:55:37,56
0x9a285786147806cdf5ffb79dc1f517c51038cab1f500ccc8269f24dc8e17a99d,t,37320,2008578,,5000053,2018-01-30 13:55:37,57
0xa564027fc13990e70111ae5085eac45084a218c4cde169319a62e725410f408f,t,36411,2044989,,5000053,2018-01-30 13:55:37,58
0xff3f613f49f6a5ee86c8b4f1ca59966ee3dc2b33eb0973d4bb3e19b74e5f9c75,t,36347,2081336,,5000053,2018-01-30 13:55:37,59
0xe1f972e8e48a549ca6381d0752c85889e93a13cbd0cfc1e19099dd44a2a4db73,t,36411,2117747,,5000053,2018-01-30 13:55:37,60
0xce056ae37191d72700a5b1ae12c10bc7d35c905233dc8cc2bfe3b02c9d58b069,t,21000,2138747,,5000053,2018-01-30 13:55:37,61
0xc49b8b529a3597482bbbea8b91b6aa839a37fa38e7f35d64a085d8d0d593d787,t,52524,2191271,,5000053,2018-01-30 13:55:37,62
0xb3208aae7450eda5a88ae8b3645030cca25ce357a1dea36ca8bfd5640eb16f2e,t,38233,2229504,,5000053,2018-01-30 13:55:37,63
0x5f8ae659928d1cb79e14e69e5b2b296c4e40d7cb486c76d8e36cf7e1f4d73c68,t,21000,2250504,,5000053,2018-01-30 13:55:37,64
0x966ea670af86760af50e0314ddce7b8939eefbadf141aa7181a5f6a90d1c3a4b,t,51654,2302158,,5000053,2018-01-30 13:55:37,65
0x4fe2bb2d15bbeeb1fc5a4a1f123b9fc6d2f570fb453a4e7d7c5be28e48444478,t,21000,2323158,,5000053,2018-01-30 13:55:37,66
0x7c9a672da1d93c497723200a6c7d43442b9a48a013d7d1f61f125e8863da6785,t,21000,2344158,,5000053,2018-01-30 13:55:37,67
0x0491f2c38e1c17d5d4fe15c8d00872d37b051338d26527c725e6d457f0eb31a7,t,21000,2365158,,5000053,2018-01-30 13:55:37,68
0xfd31611dd58c49fcb60a5abe55fdf409e0b5dca07e86ae1837c8c8e2e1e7dedc,t,21000,2386158,,5000053,2018-01-30 13:55:37,69
0x4e51dc771f89944c953b7b912d4af6d7356458af12aba06bae95d5b1b71f2da3,t,21000,2407158,,5000053,2018-01-30 13:55:37,70
0xa1124c1112a8fe143a70b420317d842c8d464b48782f66af8c9954c098ab0ca3,t,21000,2428158,,5000053,2018-01-30 13:55:37,71
0xe766a04f6a49b794b84ac32f390dbd3f075a1faaa2845fbfa54c6cb4139ba9e5,t,21000,2449158,,5000053,2018-01-30 13:55:37,72
0xe6cef46f0a06f73f2154ea5c929a74c8a149616d11509a701dc151b3da1f7558,t,52460,2501618,,5000053,2018-01-30 13:55:37,73
0x79059cbefe73093aea897487024070f31917c8ae355378d05ce4ad45e9b490ee,t,67941,2569559,,5000053,2018-01-30 13:55:37,74
0xf89658a1d480726b48758b91ff5bbf97e2494040e4c7b4e8271dc36f48f45f6a,t,62759,2632318,,5000053,2018-01-30 13:55:37,75
0x08461bfa15bec811fa145fe77d8eb8f3db496e61dd9326267e51e8202cf266f5,t,37408,2669726,,5000053,2018-01-30 13:55:37,76
0xa53d473b0262752365bffbb50f121fd3893cc4a67ebad4f8659f639f340274a7,t,52886,2722612,,5000053,2018-01-30 13:55:37,77
0xef5c94343a541a4f7ec1be54fd3315c2d9519e896d24da43a95c7233bf570b17,t,37094,2759706,,5000053,2018-01-30 13:55:37,78
0xb89c54427bc96145930971300133540a1808b435b817941e24ce1f43833c0a00,t,52109,2811815,,5000053,2018-01-30 13:55:37,79
0x9f218aa5325a2eeba8cde3c965803f9bbe6616e03ce732232ffbe9cf4f9b3945,t,39835,2851650,,5000053,2018-01-30 13:55:37,80
0xf6c3d41e324304b4c158d65e5d65a3f1dc37723c26f0de015b1423dcada1c3ab,t,52444,2904094,,5000053,2018-01-30 13:55:37,81
0xe92654d80e3a45082dbe14ad142c908e1bbbb1804b4e1da15ab6a9460e13c26d,t,37237,2941331,,5000053,2018-01-30 13:55:37,82
0x5c91b690c37fc9a2f9f6139997bd2001eaa5873e6cedb57f4746bb14216536ce,t,40715,2982046,,5000053,2018-01-30 13:55:37,83
0x4eaf96effd7f9507e01e9214fee1906c561f4a9dc6b069b6c789fb1e5283c61b,t,52611,3034657,,5000053,2018-01-30 13:55:37,84
0x351e9931f055daa4d82a75a5fa52226452449c28e98f379a07847823373ee80c,t,52173,3086830,,5000053,2018-01-30 13:55:37,85
0xe62ad11f0d5e16271dbb3164999ec587e4bd4f1597cddf19ff88e40e8c7497d9,t,53221,3140051,,5000053,2018-01-30 13:55:37,86
0x2c3eb03369092f02cfd11e2f29da2040f54632f08408eefcdd10d67eb5b84f61,t,52611,3192662,,5000053,2018-01-30 13:55:37,87
0x65ab6f2baf8483956a4405c9a2b64d7d2a2610a029404b232a119890c3571cd3,t,21000,3213662,,5000053,2018-01-30 13:55:37,88
0x507d5089a1298550e9c28dd9bad3b581ca294bfed66f45cdd0260b8399eb9c03,t,40979,3254641,,5000053,2018-01-30 13:55:37,89
0xa1dc700565083027136e20879718207af31cfaf53714928218f534e5c508e0df,t,21000,3275641,,5000053,2018-01-30 13:55:37,90
0x388a72ad9026d94d05dbc8e212326d48ac78f4913c94ce161a28833c3aac5156,t,52611,3328252,,5000053,2018-01-30 13:55:37,91
0x8a3a2e1943a42471a4a887fa592fff78f90cc8f77661dd4fd729caec2957d51d,t,21000,3349252,,5000053,2018-01-30 13:55:37,92
0x0218a1b3eb2a42f4e71b26b9c03a76230a1ea02836ef20e58560b4854890fee7,t,21000,3370252,,5000053,2018-01-30 13:55:37,93
0xd77d50842e4fd743fcc056cb55736a0cce65e2dcb8bb8efd6e0d07ee70594a5f,t,21000,3391252,,5000053,2018-01-30 13:55:37,94
0x3c3cfca7a4cbdb1422c28b1186369b3bf91ecfd5d7b8491c6495abf3e9b78eb6,t,60109,3451361,,5000053,2018-01-30 13:55:37,95
0x632f753dc37d058e9f807b6324d01642a568ce241e406838723089a114ec2961,t,53098,3504459,,5000053,2018-01-30 13:55:37,96
0xb4d5b734740d2694babd90359c6305d0c47937008b244b8742db4d2ff196e513,t,36792,3541251,,5000053,2018-01-30 13:55:37,97
0x6899a8dc534d068fa1135c2aeadc2feee2ea1b1d341ec244356d83b8ea6c4970,t,253854,3795105,0x18027F7a40154dc7d75297F4eB99d42e8E10574b,5000053,2018-01-30 13:55:37,98
0x5ebc172aaed36fac9317cf437768ee8b97f1978c184c9827d72c1c1e517370ff,t,40907,3836012,,5000053,2018-01-30 13:55:37,99
0x2abfe434c8cdd335043295aaefa3334b3371a7d763ecc66a6f206b446cbff7a8,t,36489,3872501,,5000053,2018-01-30 13:55:37,100
0xf30b69716dd595128b64da28e112614ff45a5963af6eef6a863bedc3bb783e45,t,92597,3965098,,5000053,2018-01-30 13:55:37,101
0x8cc39896f61a8b79d3a334e09f301e38e745f29880b90909bb97b08a94aaf11b,t,53167,4018265,,5000053,2018-01-30 13:55:37,102
0xf2f1178b70a09cda87fbf27f759e2fc6ac99dda411189ffba8fce034af5ebd53,t,37366,4055631,,5000053,2018-01-30 13:55:37,103
0x8ce07c66079efa9bc360201796e7142dd05e9d65f5cec377bcf9d58ef413d7c9,t,21000,4076631,,5000053,2018-01-30 13:55:37,104
0x6ab48f230131555e86425a95e41b7dda9d7e157cfc40a574b1fbe3fdf87876d2,t,21000,4097631,,5000053,2018-01-30 13:55:37,105
0x119f1f9bd24150feb49eb921e87a0540c7562bfea14877fdf6ce8f1ee600dc23,t,21000,4118631,,5000053,2018-01-30 13:55:37,106
0x5e8cdddf2e7ce88caf52833e2fa4a2c4b6ebd37a4b5a151e8e4833f3d19ece89,t,21000,4139631,,5000053,2018-01-30 13:55:37,107
0xa79f6e903c98cae5094c4a05169b604c03db513adc326d41711e4c0b31eb1f41,t,21000,4160631,,5000053,2018-01-30 13:55:37,108
0x13410fd23f3fa85272c7f3795f689f41b16907161467e249054bfb62bd6fa76c,t,21000,4181631,,5000053,2018-01-30 13:55:37,109
0x48a4259bc79337ddc1453021d021081c7ca95a945ffe86e6a5897a5d0edb9344,t,21000,4202631,,5000053,2018-01-30 13:55:37,110
0xf93cf35b5ae66ad6c9605d98ba0bf1d474ebc95bb3318e387f068971fd9d86d3,t,21000,4223631,,5000053,2018-01-30 13:55:37,111
0x3c8f8da5695994192b03c65349bf876347785b1e04c2f3031bd83bae22283342,t,21000,4244631,,5000053,2018-01-30 13:55:37,112
0x0725274be8c101406c531dd44da2d85bbacd55d46f1ac970034ee29844a1bd2b,t,21000,4265631,,5000053,2018-01-30 13:55:37,113
0xce3764221468f355c456db3fc5162bbcda365661dc0b037c4d5f0d100b8efe06,t,21000,4286631,,5000053,2018-01-30 13:55:37,114
0x6c954cca7a79e41b909914a41773e7247acdc5dae52de695a693926539e7c7da,t,21000,4307631,,5000053,2018-01-30 13:55:37,115
0x7da6e1ce0201b30512e049a8b39839932a4353f17b0bc5a8e5813c5ea6f1bf9d,t,21000,4328631,,5000053,2018-01-30 13:55:37,116
0x079965d7bbb9b3598ed245fda3023ef77fb26bb8b933024b3e1e46216fa099d0,t,21000,4349631,,5000053,2018-01-30 13:55:37,117
0xe7728acbdf375155087dc47627c63424c7a2eac3b79eac87c85eb93fbd153b56,t,21000,4370631,,5000053,2018-01-30 13:55:37,118
0x3025fc4a31d71647fa5a37216242a1101c307bf1f38dda7ad0cc6213766e0364,t,21000,4391631,,5000053,2018-01-30 13:55:37,119
0x3c74a655a9a7a39e54b3f97fd04e0c20b7e1bb4549ba93a13eecddce54a7a72a,t,21000,4412631,,5000053,2018-01-30 13:55:37,120
0x823434b7d58fc98821e52e1063fae72d8297b88eded5e5a0f0ce177b28b3f4d5,t,21000,4433631,,5000053,2018-01-30 13:55:37,121
0xfe9172a9278abaeaec7344a2d9d1a870f5b4472b40cc6f7e0f85b4bc2f058564,t,21000,4454631,,5000053,2018-01-30 13:55:37,122
0xf8f32e772f76a4c72ee44c827a806b865ef9813163734964812149cac5d144a2,t,21000,4475631,,5000053,2018-01-30 13:55:37,123
0x31e6de94b80b1b83e42b7476f80c6b1ccf312b7adaffa74da0d60b23e3066d60,t,21000,4496631,,5000053,2018-01-30 13:55:37,124
0x2b888227680a9ac2ee463b489e183048dbc3215eac3a01305a1757780e737a01,t,21000,4517631,,5000053,2018-01-30 13:55:37,125
0x65f6b1ece59a727471bd1b7c5fccdb69261ad76082c33343488d237de7d65e7e,t,21000,4538631,,5000053,2018-01-30 13:55:37,126
0xe8eca9c312c48ce8233f8c6b175ee50bce5434bd065984351e0ff3f5fbdce12f,t,21000,4559631,,5000053,2018-01-30 13:55:37,127
0x1d8a37d3db283daed190529879d9c22de49ee3c696d077dadfa4840775999695,t,21000,4580631,,5000053,2018-01-30 13:55:37,128
0x3da673d897f4e1c8b139dbf7e55d41f7258ff270ec879e3906dd2b77ce037541,t,21000,4601631,,5000053,2018-01-30 13:55:37,129
0xefacd7f6eabc439ecb0704d6715bd3a3afae83ce932dbf057b15d86ad0498d6d,t,21000,4622631,,5000053,2018-01-30 13:55:37,130
0x72a50c857a56e4d291cfd28b6a85d36711513cb1d510060538f3d676118a63e2,t,21000,4643631,,5000053,2018-01-30 13:55:37,131
0xf2075be3cdca03cee0c9329159ba58837150804883bed68f677b13f6e12cc4b4,t,21000,4664631,,5000053,2018-01-30 13:55:37,132
0x025578f2e691b6f7ec6c486456c903a8a11d5bcf4bf40f7e6f4a6f57e422b37f,t,21000,4685631,,5000053,2018-01-30 13:55:37,133
0x1ccc1affc84c540d2d1b7f3b65f4482c790db57b12d76d053b1b2a26e1c41ef6,t,54426,4740057,,5000053,2018-01-30 13:55:37,134
0xe10d005101330292185fbbebce0845268717a5c60a329d4283bc9c657416225d,t,21000,4761057,,5000053,2018-01-30 13:55:37,135
0x0fe819b20e36ddc1df81851218ac2457549f8b91b7dcfd005c9e5edd4f1f8b40,t,21000,4782057,,5000053,2018-01-30 13:55:37,136
0x828519c2d4beb7212e5002693b1d2b1e611dd19702970135d8592834080241e2,t,21000,4803057,,5000053,2018-01-30 13:55:37,137
0xabb24f43f92086c8562e1b10a84d01eb4e34ed458b73ff577453e91e73f878ab,t,21000,4824057,,5000053,2018-01-30 13:55:37,138
0x35f6dbbe1e77eb0b08757e987de2fd0a97efedcb78c549e6e4c57940e769f8b2,t,21000,4845057,,5000053,2018-01-30 13:55:37,139
0x0af9812251b2dc1fdeb8ef57baafd031383a4c66f495d055206d07bda1fdc298,t,21000,4866057,,5000053,2018-01-30 13:55:37,140
0xc2b15bd17377ec9b19d6df0320d6085162c78ba717922958482a4848b84066e1,t,21000,4887057,,5000053,2018-01-30 13:55:37,141
0xc924ec8577a12b4aafdb7ba12ca0ad3dc46c54f5d1ef90dd4f08ebdf6b6a39c6,t,21000,4908057,,5000053,2018-01-30 13:55:37,142
0x2719977139b2a2e1356fecd3c6ad6e6d66193a864cd021696a2c27112c5d34d3,t,21000,4929057,,5000053,2018-01-30 13:55:37,143
0x09e510e733e3e3560604ee6a5799f67dd6f461ff3308a48269d6c8de3225770f,t,21000,4950057,,5000053,2018-01-30 13:55:37,144
0xe4204d5a848f67d11f6f0eae28c37a55b58f87def96a7c4357a7984a30288ec3,t,21000,4971057,,5000053,2018-01-30 13:55:37,145
0xf9d14bf8a7fcb29ea0870262efd5626f87423b75a961abf60a4559f3f805741e,t,21000,4992057,,5000053,2018-01-30 13:55:37,146
0x4a0613219d5ae7f5925b1ab4526c4d16ecc71f4ab554ce9c1e747249fc808256,t,21000,5013057,,5000053,2018-01-30 13:55:37,147
0x3f812a26731ad4105d74521846ada605c4f95923964b7712a628f9e8716a18ec,t,21051,5034108,,5000053,2018-01-30 13:55:37,148
0x5fdf20fe278f9e4183e12a6a11a021f13277f577374a4078e4aac8dafd612cad,t,21000,5055108,,5000053,2018-01-30 13:55:37,149
0xdaf4f36ecbc624fb99153fdc1fc2baf7ca2cbb84fe02fef903bfb05c76331156,t,21000,5076108,,5000053,2018-01-30 13:55:37,150
0x56d0666fe87bb357ae103acfd83f27a8689a4644881fa85b6f25faa4c1ff7482,t,21000,5097108,,5000053,2018-01-30 13:55:37,151
0x8ffd78264fd86f64e26f2f06e631a7340b1ccb06a5e6a471e217dcf52f7c7c91,t,21000,5118108,,5000053,2018-01-30 13:55:37,152
0x6ee96a10ef0e9496cf812ea4d6b017737805f1bcc13b27ee2cf942bdb540fc8e,t,21000,5139108,,5000053,2018-01-30 13:55:37,153
0xd6832712fd0749168782c8ee8cad9891a9ae242425790714624b44fbcaa69b4e,t,21000,5160108,,5000053,2018-01-30 13:55:37,154
0x6a58ae661509be35e5b2a125822954e49b3a7717d0f13787b0b7bb56272f34bc,t,21000,5181108,,5000053,2018-01-30 13:55:37,155
0xc6f867c07713b960ef5769768099a962bcdbc42ce61882760ef995d258bcbfb2,t,21000,5202108,,5000053,2018-01-30 13:55:37,156
0x21db15da4a08da7cfb330e22c6ffc2221851e099ad117c4644538847070bf16f,t,21000,5223108,,5000053,2018-01-30 13:55:37,157
0x9813a55a094da09f06d6f5268c79f1c079a199c1aee503f5159b19b9858d50d4,t,21000,5244108,,5000053,2018-01-30 13:55:37,158
0x283a050e5d89bbf1c04f2e1038e7e47da00a480b2a5aac3b319cf2ea4b428257,t,21000,5265108,,5000053,2018-01-30 13:55:37,159
0x149a020cb60a28baffd1915876d34b9a7e5a6782100172d58e140d547cca8279,t,21000,5286108,,5000053,2018-01-30 13:55:37,160
0xa5220aa2cb9f708790afe471c4249d82b85851d8488ed9fcf986728cceda2be6,t,21000,5307108,,5000053,2018-01-30 13:55:37,161
0x4fd8ac5ac60d393a024b8662d333c1e8395e3e64ba931625058dcf860ca6b0e7,t,21000,5328108,,5000053,2018-01-30 13:55:37,162
0xbb899c8dce07fdbe952fbfef5d19f626c78e6f5194fce4572453e3900a6eea2b,t,21000,5349108,,5000053,2018-01-30 13:55:37,163
0x9a5d2c4bd374ffea4cbf74aa8937598a6636f2aca5110cc9f18f2c926f06e4ad,t,21000,5370108,,5000053,2018-01-30 13:55:37,164
0x3c746504f36d35d35bd909119e2be54ebc125445bc575ef844450df2fc06915b,t,179134,5549242,,5000053,2018-01-30 13:55:37,165
0x74f988e94acfe98370c3902111c4abd686fd0d23e08cf608bf6a7d094a4c15ac,t,21000,5570242,,5000053,2018-01-30 13:55:37,166
0xe6ec0691f79b1062e19a8c9ddc5fff9a2f7fd81c64d90481594b87da069f5ce6,t,21000,5591242,,5000053,2018-01-30 13:55:37,167
0xeff535495a2d7b21779e262aeac62f469fd3adb1a9d025bd0448ff04cbb9478c,t,21000,5612242,,5000053,2018-01-30 13:55:37,168
0xebcba9467414e1def59128f1a0ff2d591cda6a936e9675adf78dd87d94d4255e,t,21000,5633242,,5000053,2018-01-30 13:55:37,169
0xe49fe719495ccda98daef2b69b8d0fbd29a0acfac1c3402064fe6e1be60ebd5b,t,21000,5654242,,5000053,2018-01-30 13:55:37,170
0xfa64dc4f3de32bfacf722afdb81e7b64028ace5d20bb2a0745576caed934050d,t,21000,5675242,,5000053,2018-01-30 13:55:37,171
0xbdaf6012cace536b83d38a792258ba02441bc6fa065652cb05588cc03ec38f9b,t,21000,5696242,,5000053,2018-01-30 13:55:37,172
0x9e3ff10e04df35069e4b0a1a6bbc38f1fd0ba418be45104aede5eda39f628039,t,45112,5741354,,5000053,2018-01-30 13:55:37,173
0xfaa8f13e1e34081a6de78b4bf202b9928afceaa33f1ca58f502b50d909e21d1b,t,21000,5762354,,5000053,2018-01-30 13:55:37,174
0x6b5b881205a4c2259c15d013cd52720b1557785028f5ccaf4ac6262b081205b2,t,21000,5783354,,5000053,2018-01-30 13:55:37,175
0x8202cf65e9c2ada763715f91757d786bbb778e12b43bd309840ae3cb471f6ae9,t,21000,5804354,,5000053,2018-01-30 13:55:37,176
0x9075e05855075f70ccf82df1bb47ccf6c0de4f5b55fc05eb73ee97696bde4421,t,38615,5842969,,5000053,2018-01-30 13:55:37,177
0x7d14b4e33976b2d0602f67ce1e05c481c524e2ce66ed33b3deee3de194a6c493,t,21000,5863969,,5000053,2018-01-30 13:55:37,178
0x777aa5594f00e03269ff2ff55f32cb699b59f9d6884f74252d234a555d372eb6,t,21000,5884969,,5000053,2018-01-30 13:55:37,179
0x5d151704eecad365a4677a196867c8c064be61b1592e3624ca3c0e5802e32420,t,21000,5905969,,5000053,2018-01-30 13:55:37,180
0x4accb44ac1070d9dbd09963b6908f5220ae5c8ecc3e93b31f77fa7de6988814f,t,21000,5926969,,5000053,2018-01-30 13:55:37,181
0x7685a9df2da319447ec0574dcad9a378d7ea9c5162f518d1458a67c19d600def,t,21000,5947969,,5000053,2018-01-30 13:55:37,182
0x5543d5d78067043634b9bac509583137c3982a91dd13cfa6a2bd591801d28984,t,21000,5968969,,5000053,2018-01-30 13:55:37,183
0x13b5373ceb0b1e50d02bd504fa262852a399c8a9987e08a4f8d4ea407a16aed7,t,21000,5989969,,5000053,2018-01-30 13:55:37,184
0xdc7059beb6102db0b5f91cd5149dec3281e925a7e0860f117430a742c4ca6a0a,t,21000,6010969,,5000053,2018-01-30 13:55:37,185
0x2e48e7c5982b775454e3648e8fb0caa87454c34b9155a8da68da76da1656c2e1,t,46045,6057014,,5000053,2018-01-30 13:55:37,186
0x5869944610a49bcc03ef1b5ebbb5e19f36ec02711edc25e0fc9ca34ee3b79b85,t,21000,6078014,,5000053,2018-01-30 13:55:37,187
0xa8f031966c838130b3241a4ff73252421ba0ae84622b40a1375fb666682b19df,t,51955,6129969,,5000053,2018-01-30 13:55:37,188
0xc4e18e130eb97c56315765e0d9a4761397059c282e52d495525198d7fd7240b4,t,21000,6150969,,5000053,2018-01-30 13:55:37,189
0xfcb1a10ad02684ba747886032e99cf41c8335f3f855303160f1e67c3c59f520d,t,52460,6203429,,5000053,2018-01-30 13:55:37,190
0xf3c220fc2c027cd5adfcba317696bf57d24d6425725c6752e1ba5580c1d661cb,t,21000,6224429,,5000053,2018-01-30 13:55:37,191
0xec137dcc04c564ece5c6ab645b7b19a7a6a219ed0e72f794b471138ee0d58e45,t,21000,6245429,,5000053,2018-01-30 13:55:37,192
0xcab1120b68346073336617bd42389994ce1a0cc68c5d4f361667f81f684147cb,t,26122,6271551,,5000053,2018-01-30 13:55:37,193
0x0c9967b51351f062323a16f9635883b5754c5eaddc165d18dd7d1602af305bc4,t,21000,6292551,,5000053,2018-01-30 13:55:37,194
0xabe932de7d70e30f54542c629db297d9067d8e2d6264d63ee9650b2022aeed95,t,40843,6333394,,5000053,2018-01-30 13:55:37,195
0x94f18cfd4d51ad28e4700aa704c94e2ceafcb616d4dc2168535fa1f51a1b9e2f,t,21000,6354394,,5000053,2018-01-30 13:55:37,196
0x300fd612a972e688050d9acf1ca528159cd1cf5723dcd28e7361ee18ad948dac,t,21000,6375394,,5000053,2018-01-30 13:55:37,197
0xd0a08f43f063350a82aa2c158e3e5ee3a88d2941374c315c3c4791fce604745e,t,21000,6396394,,5000053,2018-01-30 13:55:37,198
0x9bdf748884f778fe746d88aeb39bc38b3d27c993decf7cceb47b87cad60115c7,t,21000,6417394,,5000053,2018-01-30 13:55:37,199
0xc3bb2d55df2bdbaeb34f233a21a519aaee563765d21044412f7c794f2fa30da9,t,37976,6455370,,5000053,2018-01-30 13:55:37,200
0xd3f6b70a8c315718ef050d018bbabf12bb1001bff1319562c55612345b84addd,t,21000,6476370,,5000053,2018-01-30 13:55:37,201
0x6bd18e9e18e90fd78221e57281e2e7afa873e2eaa150a6ae3529af6cd72ba61f,t,37320,6513690,,5000053,2018-01-30 13:55:37,202
0x5747da85b5c38845049f0df21d445e5ce8b401068b6e567f38871f2c7043f09b,t,21051,6534741,,5000053,2018-01-30 13:55:37,203
0x1cc8791af40bdcb3fdf9c4a762acbba6cff6b715e07c73d9a6dfcf504d2e8733,t,21000,6555741,,5000053,2018-01-30 13:55:37,204
0xee243c90057d96dbb6cda9b7af00b8b6fcdb103e747de2d209d318c9c3214626,t,33699,6589440,,5000053,2018-01-30 13:55:37,205
0x0df3bd8a755a80cba8d8d27831206a7e85e9c5dba744529bb9694586497f5124,t,21000,6610440,,5000053,2018-01-30 13:55:37,206
0xf8338286c0bfa9d07fe1f0b3509ab146a38d91341206f236a324ead23f04515f,t,21000,6631440,,5000053,2018-01-30 13:55:37,207
0x288c9dd204f022eaafbcd54f963d90e30954ebfae4ee670dac3502ff262d9f9d,t,21000,6652440,,5000053,2018-01-30 13:55:37,208
0x6122ace080096c2b309eed3e94581a455f02dae94719986a54a7985237f7fe43,t,52904,6705344,,5000053,2018-01-30 13:55:37,209
0x56bfd5b9765a2fa23d24c7b0736285b3003a64330169248a7345f2ae36ca8f75,t,21000,6726344,,5000053,2018-01-30 13:55:37,210
0x023689f62754b333a157f6b8a5c2a45bef1d7eae0c702395aea31234493ee618,t,21000,6747344,,5000053,2018-01-30 13:55:37,211
0xed600810a7d87633015eb7645b444007020c7be51fde3d2dafe15d233c786384,t,21000,6768344,,5000053,2018-01-30 13:55:37,212
0x92c7ebdd253d071762b7d541c0728b49e0526cb758fc5ff9b54b449df7b7b777,t,21000,6789344,,5000053,2018-01-30 13:55:37,213
0x1b17b146438b0cc07c991c81c953d7ee0942ad6e05d832b1095101f5deb7f251,t,36606,6825950,,5000053,2018-01-30 13:55:37,214
0xa983acf7d0620f7daf304bd0e8c0f02076d06c38761be17e9edcba1cfb8b6bb1,t,37161,6863111,,5000053,2018-01-30 13:55:37,215
0xef8b74bfb8cd55358625c32d27b833cac4e059434d993cb39208a41463778caa,t,36708,6899819,,5000053,2018-01-30 13:55:37,216
0xd4337e36d772624fce9a7ab420ead2b22ba5e5a1e317c9d611d734479595fb09,t,22948,6922767,,5000053,2018-01-30 13:55:37,217
0xef1a8665722a27190c2028e395b4176670af91c067ac5ea77183abfa34359912,t,21000,6943767,,5000053,2018-01-30 13:55:37,218
0x141038dbc38f5718cb6c382c4b0f0e206e70248908671ead6ddf65f01c010cc7,t,57825,7001592,,5000053,2018-01-30 13:55:37,219
0x020e9a71732b82b2aee814de5e20c3a86fd7079fa16b5959a731a994fd4f6e47,t,49725,7051317,,5000053,2018-01-30 13:55:37,220
0xa7035bd2939ace556b25194dd7f8d413a23bd02088fafbb5dd77c980a6ab786a,t,47600,7098917,,5000053,2018-01-30 13:55:37,221
0x94d2be17407a265b50586b55a9e93dd272652fa0deeb19e842d4a7f03af0c4fb,t,37875,7136792,,5000053,2018-01-30 13:55:37,222
0x83e6162514da27fdebdf2ceabf11218a4abfda2f1d977833b1fe73ac248e4564,t,21000,7157792,,5000053,2018-01-30 13:55:37,223
0xa8b70c2ea3976a2ff3a007beb1807c7804c7da39416c572aec73ac0141c6876c,t,23316,7181108,,5000053,2018-01-30 13:55:37,224
0xea860da8a703fed4ac7c0a946c31354ee7277c1677e54419f3ffdfde0ea9e30e,t,38316,7219424,,5000053,2018-01-30 13:55:37,225
0x31278236512fb5da1ec4b6799cc6ec89e6a72066b2154a869f6dc8bf1b472af2,f,25200,7244624,,5000053,2018-01-30 13:55:37,226
0x187876d52853b624d25c53bff48621143ab08ac26af00589d443bd15ecf1cf27,t,21000,7265624,,5000053,2018-01-30 13:55:37,227
0x9012c1d875e8ad13169aeef1daa296dc73b452605a52564979f7a10383765ae1,t,23231,7288855,,5000053,2018-01-30 13:55:37,228
0x434d42893dd3c8325710f2aad57ba564a542c5c8681be6ec5b0fd922ee457edd,t,21670,7310525,,5000053,2018-01-30 13:55:37,229
0x421d557a86364a180f8dc33dace6d2e94153a6cc3ece748b9c6d6ef6c36a34a4,t,78306,7388831,,5000053,2018-01-30 13:55:37,230
0xb4ebedb31bbc81e62eb2c0cfe8b43ac774dd9cd0ff4d2344fe57eeb6846457d2,t,21004,7409835,,5000053,2018-01-30 13:55:37,231
0x5dca2401c37b5325ee023d37a6f47ba904b31146fc1b921d8b51db64e0496328,t,114039,7523874,,5000053,2018-01-30 13:55:37,232
0x22c67a360e490856444bbdb8661f04211bbca8663ff5e3db747cda59cca7fc93,t,21000,7544874,,5000053,2018-01-30 13:55:37,233
0x6dd5b0ff28a3468b9d9daf519a1a512a07dea7af32dbd3200b242b06381c99ae,t,21000,7565874,,5000053,2018-01-30 13:55:37,234
0x48536bea2c7dc0d3127633573c6ade14ffa9a2150d71981124851d1abf64d308,t,94190,7660064,,5000053,2018-01-30 13:55:37,235
0x74c6953d4d12a951fd3f0558bc307b44c3b04e2c9ca12b823fb9252a5ed37db0,t,23231,7683295,,5000053,2018-01-30 13:55:37,236
0xf3d7d65622d22b1da8759793fd5ef9423b5ae206774413059e6f5cb26441a22a,t,21000,7704295,,5000053,2018-01-30 13:55:37,237
0x5286356c37386b18e109d6f1f5eb8d8bcdb21608d389f458e49249b5830b4d9f,t,21000,7725295,,5000053,2018-01-30 13:55:37,238
0xd06287f01b0aafae9cf11e995ffdf63617a133d804b96e2adcf393654d6e224a,t,21624,7746919,,5000053,2018-01-30 13:55:37,239
0xbe886631460f9a6876b9f20dce1189a6fd9c9ba297dc736f320441d4a8424146,t,51848,7798767,,5000053,2018-01-30 13:55:37,240
0x974b5437b17ae6753f0aa1ad900c9b6c74d6578b2cd13812d1e250fb6e5bbceb,t,21000,7819767,,5000053,2018-01-30 13:55:37,241
0xcae826561dc2ee6d6aaf7ad39ccd7b5184ef082328aec04a74865064b148801b,t,45591,7865358,,5000053,2018-01-30 13:55:37,242
0xeb5eb74be680ec86d9d8f8f4475acefe94aece14b2255d9a193b6cac194d354b,t,69504,7934862,,5000053,2018-01-30 13:55:37,243
0xb1ac6f7c413b0f308aaa006297ddcd5f3a6c518a7ecf3c3b809ff0fb836441a6,t,21848,7956710,,5000053,2018-01-30 13:55:37,244
0x874e4dee7f9decbb51811ae0e5ac20fe0505dbd20e0e681e71bd1cddc92e2482,t,21000,7977710,,5000053,2018-01-30 13:55:37,245
0xdb576d5177cadb37f6c3132349840328f7b1a420b42c563654fd0432bb2c7803,t,37376,37376,,5000054,2018-01-30 13:55:41,0
0x5399ee6c17538e065aaa90c2594a5462af78d2dffc1efb9f073a6e9b15d5181c,t,21000,58376,,5000054,2018-01-30 13:55:41,1
0x461fc9eae23a4312780c19011d317e9864aef4f52ccc37848416a9546d0f294b,t,21000,79376,,5000054,2018-01-30 13:55:41,2
0xb25bb09c783f613a2f0455d71ddb09206c7331845098f1cd8fa5fdebed57add1,t,21080,100456,,5000054,2018-01-30 13:55:41,3
0xcf36018cd1a09338c2c5c15a1750c7cd142982d56c901852b66b25819573638f,t,54280,154736,,5000054,2018-01-30 13:55:41,4
0xd47562d713174d84e9928e45a6e6fad8760c7f4fce2c0e0da1c29cc7566cf2ab,t,21000,175736,,5000054,2018-01-30 13:55:41,5
0x109a42fe67d14ed7f61fa59464aee71f4ef7e0f431c2db0dea45bd57fe85fa53,t,21000,196736,,5000054,2018-01-30 13:55:41,6
0x54154e34dcdefba8fa3f9e1ca852675cde1c8ff7a1d74bf26a6292cd55cd6f37,t,112083,308819,,5000054,2018-01-30 13:55:41,7
0x6364f25847828bc64140a0c80758d73610c29ec24511e3adf90af0a3ccc4daeb,t,21000,329819,,5000054,2018-01-30 13:55:41,8
0x11ac0730858e78718618c8b35f469a6aeefe9382c182dc8821d88cd125eb5c90,t,51682,381501,,5000054,2018-01-30 13:55:41,9
0x006aba4b7519064c8a8752ae60f297aa36d5ee310dd424bf0bf1cb356f3d18f1,t,38233,419734,,5000054,2018-01-30 13:55:41,10
0x454d208fb021dde5056e21297572fec0a4d8ac13da926110127e19a7d7dfa6a8,t,36411,456145,,5000054,2018-01-30 13:55:41,11
0xa7e18996344c254f1228d2b4671357ab00d391f9aa1720f4c7c04f6a547ca8b5,t,36475,492620,,5000054,2018-01-30 13:55:41,12
0x1e627412f6876b2779daf1a903fc67d5daeb190ac066db20d879e508b23b86b3,t,36411,529031,,5000054,2018-01-30 13:55:41,13
0xc2df79bc43db9dcc10e818e9029b6897f8248200d48ca4b91e6ac98f718fc39a,t,36347,565378,,5000054,2018-01-30 13:55:41,14
0x3debaeec4cc9394f0c1fe8536b7d543a4255b0ee2f5a0cb049ba532daad9880a,t,576191,1141569,0x7F9FA692E1b65d2B6d670fEEBD3e6BCC29606f14,5000054,2018-01-30 13:55:41,15
0x1ec64c2895543a50adc7ee5b74d51fefe219edd1e6bfdf993d0af9a7162b2162,t,52257,1193826,,5000054,2018-01-30 13:55:41,16
0xa90e3fd57df57aed56eaff468e5433fb304a45035675760acbf6a6b49a9b436b,t,21000,1214826,,5000054,2018-01-30 13:55:41,17
0x71d2823a5a9ca222396e200205be0688fc7d1d75896c407c631fc7b3bf39b243,t,67541,1282367,,5000054,2018-01-30 13:55:41,18
0x1e24399eaba8e7603e728a411eee74575e83e2aaf84dbd9bf05acd9e79c15cc2,t,21000,1303367,,5000054,2018-01-30 13:55:41,19
0xd959833d5e6d02da79f9871f4b68de31bf60e9a79c9919a370be1cce5252fcf0,t,21000,1324367,,5000054,2018-01-30 13:55:41,20
0x7b2a5074c33ef7bac67bbdbbaa84fb3eff2b6a711d25f936b420a3165dd669cf,t,22588,1346955,,5000054,2018-01-30 13:55:41,21
0x50fb1ae7a473d612330a0680f04cae1ef1f2fd3f927e8a9e639075dc9412d127,t,51912,1398867,,5000054,2018-01-30 13:55:41,22
0x2a2c94a3cdfaa6a699e50bcecdc620825ca6f0311f98911a485c23365f6e0cda,t,37272,1436139,,5000054,2018-01-30 13:55:41,23
0xbe2a6a673721816101417cce28dad4c8d2e1fc13715eccba31a7509f070b3206,t,21000,1457139,,5000054,2018-01-30 13:55:41,24
0x260886958302ac2d592a462ebbb8e038f6c7999a1bef706bda75898060fd98b9,t,78178,1535317,,5000054,2018-01-30 13:55:41,25
0xd17b5f77879458c4c888c07448b8d62611fa61d99b1c082bd1f7b38070499dae,t,4679076,6214393,,5000054,2018-01-30 13:55:41,26
0xd8b2766da6656628927904b30997eaf89a3926de996deb8b1c0269d3c5dd8516,t,42220,6256613,,5000054,2018-01-30 13:55:41,27
0x7be5fed06aef5ceff381e7dfb6475229ba4af57104b1a2b62475d2a804b03ea0,t,44290,6300903,,5000054,2018-01-30 13:55:41,28
0x1df68671a451f0528f21a8755f2a76bc49cae191b095e31dcd836d7e5d71a857,t,29493,6330396,,5000054,2018-01-30 13:55:41,29
0x8070c90a1ce6e3a031b10fbfc86fb48ed4a2e3f42901ea701af8b47eb3d056ae,t,37948,6368344,,5000054,2018-01-30 13:55:41,30
0x1db82f96ba798a9292139b99a84d85c8cc42c623674f2e629b3675702dcde933,t,167406,6535750,,5000054,2018-01-30 13:55:41,31
0xd636958a044657adc36c4093454413d18ae4c339128411ce170b38e0feb6147e,t,23349,6559099,,5000054,2018-01-30 13:55:41,32
0x607e794a6b3ac0b4690f7708d3b2dc112166c7639da70236090ef3c8cfbb6914,t,21000,6580099,,5000054,2018-01-30 13:55:41,33
0xe8ea47dc708708d995811edd377dd5c7608a4d5635a49b0e6cde448389921d6d,t,92986,6673085,,5000054,2018-01-30 13:55:41,34
0x16a6a634d42cbbc318497862fbbf9ba2c7c09275f21a7127070456e542d1c5dd,t,60527,6733612,,5000054,2018-01-30 13:55:41,35
0xcceb75a5c4c0ce1d819bb6a5c3518172e2809bb3df72e603f48fe819479121dc,t,69568,6803180,,5000054,2018-01-30 13:55:41,36
0x707930330938e645aba16f874dc05a4a8350ef340ced1df451265cdb9da0bf0a,t,69504,6872684,,5000054,2018-01-30 13:55:41,37
0xbbb8adc45c3294345e54048b17b585f1bee94abd424e75a52ea15acdc469045d,t,34213,6906897,,5000054,2018-01-30 13:55:41,38
0x96d4d96d7913384bf14b4f6a9e8932f3aa7996070dd344470a237832e5f791ee,t,31322,6938219,,5000054,2018-01-30 13:55:41,39
0x2ef03bb53b0f943c03a476f20e3b5847dabf48a6e681eb9245e9eaa18b23d9c7,t,59098,6997317,,5000054,2018-01-30 13:55:41,40
0x4b3b186bb44646d52f589f9afb5ff174d56c201176a29e423126c48bb824b22f,t,21000,7018317,,5000054,2018-01-30 13:55:41,41
0x73444491fee29e3bd7a858fb2c122a73840b8ccebcd3dfbdab1ecf3bdab67698,f,250000,7268317,,5000054,2018-01-30 13:55:41,42
0x08306c798f978f2755622ac8c3c3b59b6f0010d08357cb25b79dec07c52680ea,t,52344,7320661,,5000054,2018-01-30 13:55:41,43
0xd8400cd19ffe193fe55400dac33ce57f8009e800a520b1fa144b51a14dfe248a,t,21000,7341661,,5000054,2018-01-30 13:55:41,44
0xf7d9e018e0f80be373652630163748067887dd0c4a4b3f1d82ab1e447006e284,t,21000,7362661,,5000054,2018-01-30 13:55:41,45
0x79667ea7b37d6318cc32f16e949a142344768d86947ce5680ef73c4020f6a79e,t,63021,7425682,,5000054,2018-01-30 13:55:41,46
0x4c3d8e6b1a05ce915ad6bdcda19f8b33e5a80b1b789e7adc407cfa1641f76e9a,t,150621,7576303,,5000054,2018-01-30 13:55:41,47
0x827a2b052593cda6b39c83d59e85de96cdfb6d2f449f7532c595f5d15d4055ed,t,41307,7617610,,5000054,2018-01-30 13:55:41,48
0xf86711f5612de4e0b29e118902bdfbc806b25221fa8530f324ac0baaa9c85ccf,t,48091,7665701,,5000054,2018-01-30 13:55:41,49
0x99599047fd6c64a1a283df8357a775f62a30335657a90e4ed09c5fc94b08e1cd,t,93370,7759071,,5000054,2018-01-30 13:55:41,50
0x15a4ad2410b4a64c2742c7ab26023296b76403dddeea569987120960644c49bc,t,21000,7780071,,5000054,2018-01-30 13:55:41,51
0x27392856b8caacd8f8cc02b1f6cdfb81f4a9da12190ee200c37796e4d4b29125,t,21000,7801071,,5000054,2018-01-30 13:55:41,52
0x104efc1cbee8a8c1bf18764a00b26f4264d9733276a72e70e92587e931874367,t,21000,7822071,,5000054,2018-01-30 13:55:41,53
0xd142a0ae643b1243e1a28e592adc5504f6fbe475a343d54ec14a798d2c06fb20,f,50000,7872071,,5000054,2018-01-30 13:55:41,54
0x0c63c3f22afa15083327de0a53d4a846653aabf80276738bbe3e971348b8c14a,t,21000,7893071,,5000054,2018-01-30 13:55:41,55
0xcb9e1836208186f067050aa00b2c95d2b3e04bd5a5084fe35899b99b8405cd2f,t,40867,7933938,,5000054,2018-01-30 13:55:41,56
0x40633029831722d640bad68c101e6efed841ce279517d7804852cda7d667905c,t,21000,7954938,,5000054,2018-01-30 13:55:41,57
0x466bc17dc65adb1a45d25be1c4e0595456731843a064795cbb967b3d4870d40a,t,21000,7975938,,5000054,2018-01-30 13:55:41,58
0xbd4c20178b9bcde2f8fe18ccf02c6de3b9cb373389918db5814cdeb2a8ba99ac,t,21000,21000,,5000055,2018-01-30 13:55:53,0
0x5d786957f50e3ab0c0eb5ea44f8be147fbe608952d129ac10cf953fd5d81d4a2,t,21000,42000,,5000055,2018-01-30 13:55:53,1
0x1206ff533d02bc39ac5797c09cd72358b28a7bcea0da2d9bba95ead01d60e3be,t,21000,63000,,5000055,2018-01-30 13:55:53,2
0xb8088afcb17ed72d2cf847a9b4a8e4b784aaaa2ed482cd0a94eca3d4b6557249,t,21000,84000,,5000055,2018-01-30 13:55:53,3
0xf018e80f4a354936ceac304d8e3585f5dd048dae7fc6910e39618b9cfab0fd65,t,21000,105000,,5000055,2018-01-30 13:55:53,4
0xc8a7a4b0f252a2b478b0cdf9d464b9db3aca0f97c509a5e8f811cf5f79ccc9fd,t,21000,126000,,5000055,2018-01-30 13:55:53,5
0x0148c4fc660496bc34ebcb30746fd37afa377014dd299d6d54bd971da31afae3,t,21000,147000,,5000055,2018-01-30 13:55:53,6
0x88d48eba684763a4be5c260de1d9bf43f838c5f70a12ac8bebb5f76532fe2157,t,21000,168000,,5000055,2018-01-30 13:55:53,7
0x2b7ea56f9075f317ab0caab7639f19a69c53129a1f269e7e6f4c5450f6f7fcad,t,21000,189000,,5000055,2018-01-30 13:55:53,8
0xd6b9044413df0bf8f28bf7cdede919f2db8980a8a16ac21b0aecf9900bddc0c9,t,21000,210000,,5000055,2018-01-30 13:55:53,9
0xd7e0e3e6bf9f8dd2f1f21a04d2a899a0a9c648594ff3bfd11bfe77206cea8d79,t,52155,262155,,5000055,2018-01-30 13:55:53,10
0x5e7ae3a6cd1827d86a342eb63e6a08f83a129597765054864da0bd80eba007cc,t,21000,283155,,5000055,2018-01-30 13:55:53,11
0xf46208633173358cad27e2543ba6218d7320b16cbde72d49356f35c77c5902c4,t,21000,304155,,5000055,2018-01-30 13:55:53,12
0xe1d87cea4594a14424d3a1ac4a3d8719d337acb585aaaccb000437eaf8c6b8fd,t,21000,325155,,5000055,2018-01-30 13:55:53,13
0x128c36e8c684812e91d2a816d2116cace2cbf2196be78ef09f07df80a1b7547a,t,37155,362310,,5000055,2018-01-30 13:55:53,14
0x1a28741f38c30e102d06f55cbfe659bd557049a51f99bfde943c5872945ee7b6,t,21000,383310,,5000055,2018-01-30 13:55:53,15
0x1af2689e7b143944a790e926d67a78b0f934e4ce006a803d20cc0d5330662d6c,t,21000,404310,,5000055,2018-01-30 13:55:53,16
0x0436fa866fbc67a7455b792f88c08584a81bde0ad7421f34694ca7717b8e2e9d,t,21000,425310,,5000055,2018-01-30 13:55:53,17
0x17b7b8d6d9f8d385315ccb1079fbb38f61865d00061f86ad3ea6d5782f334b30,t,21000,446310,,5000055,2018-01-30 13:55:53,18
0x97b2bd6754c9e2149c1a669da10768a6ee6d59b09dcd3d7b8cf20106e3c0fa91,f,66666,512976,,5000055,2018-01-30 13:55:53,19
0x9460b24110e0ed6eb0c8e9fb0eeebbee16a0f784d12a30f3ed098604968fa92d,f,66666,579642,,5000055,2018-01-30 13:55:53,20
0x3c9621cb72f152c578068342e8c1f7f6834f11913db5f371be9ffaf980200ffd,f,250000,829642,,5000055,2018-01-30 13:55:53,21
0xab8203289cb830a9eaf26a505296bd270f75f8fcb47b8187e52c49d12cfe60dd,t,36409,866051,,5000055,2018-01-30 13:55:53,22
0xc756d7338493d5fdef1bc11d3eaa877f83ad989763a6567f7968fca383e17114,t,21000,887051,,5000055,2018-01-30 13:55:53,23
0xe44159595890b477fd3ee6db1a00afab10d8d041b7745d6060d02f61394fa12a,t,21039,908090,,5000055,2018-01-30 13:55:53,24
0xc1517536567b15666509123a0ce73561e0c9a59f493f1a89c3c0ad226bf251ec,t,39512,947602,,5000055,2018-01-30 13:55:53,25
0x5b037dcef2627eee75c64e94723bb06249c7987914ca89be5b2f2b890b703e43,t,21000,968602,,5000055,2018-01-30 13:55:53,26
0x760eed1e1102f952b8ea67174bc88a7db0fb8f04214c240d807f6a822db52984,t,23176,991778,,5000055,2018-01-30 13:55:53,27
0x86671f38aaeec9965c0a19b630e218763a31ccefb0a2b9375879ba3bafceffb3,t,54771,1046549,,5000055,2018-01-30 13:55:53,28
0xd35a20bc3fcf026deee0ac83c25bb263fea86ac74ebcb25ad80ddf86986ef613,t,21000,1067549,,5000055,2018-01-30 13:55:53,29
0x2e1b2112865629273ac95f00cf3c4caf26dff33f1ca39094393cff9707b3c7e6,t,38898,1106447,,5000055,2018-01-30 13:55:53,30
0xbf4f3713760e844168989966a4c994dc73f0c89891c78dbd161715a71291fbb6,t,21000,1127447,,5000055,2018-01-30 13:55:53,31
0xcb3a21448f75a85fb52ad8c8240421423d6631301c25fe75ebf3fe8bbca5135c,t,21000,1148447,,5000055,2018-01-30 13:55:53,32
0x8fc2fd31a2537ba5a634bcd658431f22a9c77dda37086b21d95b2a5627c66ff1,t,21000,1169447,,5000055,2018-01-30 13:55:53,33
0x9512f770bf254ca81df964a948b284956e164bbb111070c22c2ed32e391f2582,t,51752,1221199,,5000055,2018-01-30 13:55:53,34
0x5a06c5802350cde4b87e2743c03181a729dfc26d0eaba51e851e76d1c0df34a7,t,21000,1242199,,5000055,2018-01-30 13:55:53,35
0x4a6e352ca6191b9040ce0d6dd1312db58ecb39f98987b410221897537543645a,f,150000,1392199,,5000055,2018-01-30 13:55:53,36
0xa76a45bd269ab9f1a18573609aad57f090b272a69cd75f53793c4e4f602f023c,t,21000,1413199,,5000055,2018-01-30 13:55:53,37
0xea5fdc03980c8e23421adf82b6ca4d02063b990221ffa8bfb99c634b38094044,t,21000,1434199,,5000055,2018-01-30 13:55:53,38
0xd8280828238f0dd866294a430497259995b7b04a31fd9a02719939b991b54a3b,t,21000,1455199,,5000055,2018-01-30 13:55:53,39
0x169b8fa232a50d44352c6304e959058732906a2d627db13adfc40b142517d8f1,t,21004,1476203,,5000055,2018-01-30 13:55:53,40
0xfc844e3bc0f07babad1c301da8a615e15f4c91f71ad21e1a640972aa78a9e6cc,t,21000,1497203,,5000055,2018-01-30 13:55:53,41
0x6ba6a925e6de5cabb0aa156dfbe50a0a2819f33b232b1a7ef424cab305af49f5,t,22027,1519230,,5000055,2018-01-30 13:55:53,42
0x756f8288a090dd8f856eec4fa477f2f0bf9c8c27a2845d301ed5c7aa26ae1781,f,25000,1544230,,5000055,2018-01-30 13:55:53,43
0xfff5edd6d1f43f5e72128325a5903a2e0fe146c1070fd193fe8ef29fbac4cfc4,t,36531,1580761,,5000055,2018-01-30 13:55:53,44
0x9b6ac332f42a82d465d0b604997fd382e53d612ecc186f6003f34abb6264168c,t,36411,1617172,,5000055,2018-01-30 13:55:53,45
0x7384f2155b42a35719cb4572b23ffdb6ba85d248ddde0333401a8b98533035a9,t,36411,1653583,,5000055,2018-01-30 13:55:53,46
0xf0317e65ae57ab0a069536026ff476d859059d5f7fb4510c0c94bffae0207a6c,t,52568,1706151,,5000055,2018-01-30 13:55:53,47
0x204bec25d73547743181a3a84bd24b9932b7dd421c918dab70e1850369e3a875,t,38233,1744384,,5000055,2018-01-30 13:55:53,48
0x353f20406ad93b9a1cb3ac189ed2933ea38a96038b666a5ecf7bc7bbede34045,t,102934,1847318,,5000055,2018-01-30 13:55:53,49
0x6aa5cfd800f982ad234072cfe9d3b5ba1a9bb3a95b8fe3dd736562df0d36f47a,t,40907,1888225,,5000055,2018-01-30 13:55:53,50
0x25bac7a6cad72308caf518efc48a8dd8d9e3557437f218e37fd31e95fd979b91,t,21000,1909225,,5000055,2018-01-30 13:55:53,51
0xfd723b679b2c128295f20c6bf648807bac407e5a161d3f4c3ff5b4752afd10cf,t,21000,1930225,,5000055,2018-01-30 13:55:53,52
0x494a783b39c0cf996b46ff15b5eba8fa276d2a80a03b604ca905a630c72f992b,t,142772,2072997,,5000055,2018-01-30 13:55:53,53
0x0aa171e18d1dc540c97445f931a8ec06de5f98e8cb3e2fbc8463ee96ed05b81a,t,21000,2093997,,5000055,2018-01-30 13:55:53,54
0xa73a87167149492de7936bae68883561be7b1d1a9f78721aea7563c90ad5ae3d,t,242521,2336518,,5000055,2018-01-30 13:55:53,55
0xc9a7a826d636e0c3443f037204c31d5f014ca2b3f06b61eaad04abffb696194b,t,52886,2389404,,5000055,2018-01-30 13:55:53,56
0xf95375674531c36ad5aa1dc95461878bcddec2d5fa684d528acf84f027b632bf,t,53040,2442444,,5000055,2018-01-30 13:55:53,57
0x2e683719e2e3a7e8c224fb3538821dd679df03c7dfc51822aeb0ee9e237de856,t,40907,2483351,,5000055,2018-01-30 13:55:53,58
0x197e2eb255946330be3c5e61db55729e6882de2733f78f697decc2a8f009d163,t,52820,2536171,,5000055,2018-01-30 13:55:53,59
0x7c74022940cb8ad4e2491ee1c257889ba73807083d38c0039b4b9ea543289f84,t,52173,2588344,,5000055,2018-01-30 13:55:53,60
0x91b34718601115e454941e683ba8efc5dbfc69f3bfc48943a6111dcb0c9eb613,t,37173,2625517,,5000055,2018-01-30 13:55:53,61
0x04102bf7c07c3eb0981bb9a7d66a244301916e87517aa161cd36d83bb0e43403,t,52109,2677626,,5000055,2018-01-30 13:55:53,62
0xcc0fd3dcec7515dddcaad99a17f2935d0195929c64a31d1127ad8adc44def2b9,t,55971,2733597,,5000055,2018-01-30 13:55:53,63
0xc72ef4e3f745871eb5abea340d8a46fc1ff6986714be3443b89bd16326adca09,t,52173,2785770,,5000055,2018-01-30 13:55:53,64
0xfbcd0937c91885f392ae3d906eb8f89894d8e7dc31239ba808a882aecf553e93,t,52173,2837943,,5000055,2018-01-30 13:55:53,65
0x8b3d0b878f832778d918372652f39583ab93a20f5b7e8860cd34b3ae083d4b15,t,55843,2893786,,5000055,2018-01-30 13:55:53,66
0xe1727a2fd2297506079c54479afc5d6fdae0e7b6e41c77b70a1baaf713f5dd6f,t,21000,2914786,,5000055,2018-01-30 13:55:53,67
0x362bb899a0d6c934f495ca7b99c52160fc29922f6d8adb39fa516e9520e31aed,t,21000,2935786,,5000055,2018-01-30 13:55:53,68
0x55c8eaaf1f58c0fb180abd8c3bec1c27602220b05ab111fa2cae1ec40831bad9,t,21000,2956786,,5000055,2018-01-30 13:55:53,69
0x2690f84aa23d526aee627fb4bd124824ac579cdbe97dac0afafdc6336b1ec376,t,21000,2977786,,5000055,2018-01-30 13:55:53,70
0x351d74583722c66190a3d7ac93f05d774e9cf83d5f8c5cc2f87c1ba0b8c65160,t,36792,3014578,,5000055,2018-01-30 13:55:53,71
0x10ae70ce913edd9769db6061aa3133b5c8955fb5f85a62263f1eb5119b18110f,t,253854,3268432,0x3C1a703df9d082Bf7c33B84119c53213167d1b14,5000055,2018-01-30 13:55:53,72
0x9d76f7144fbd3f649399910bdc54215973f2958644619d0f499108cd233037a7,t,37233,3305665,,5000055,2018-01-30 13:55:53,73
0xc858e98fb5bd40fb428b70ad63892b58f0839dbfb3e97a7e555dc0736d88d06d,t,52091,3357756,,5000055,2018-01-30 13:55:53,74
0xfc01065c6962d920c31d19181833e586bcd5bc45f5a0f9472579046fb8eb999d,t,67613,3425369,,5000055,2018-01-30 13:55:53,75
0xa9db35fbf012392fcf61f64b932f332de7e1db018f30376fe4b33d6f57dbb81c,t,21000,3446369,,5000055,2018-01-30 13:55:53,76
0x7c4ae0ab5399b686cc1e783aff3a1fceed4b6ccd84e8eadecf424c93451fb2e5,t,58798,3505167,,5000055,2018-01-30 13:55:53,77
0x5ae8b072f5c6b9714fae25f6e9c409a1d26d334297e91b8748c759324ad76734,t,21000,3526167,,5000055,2018-01-30 13:55:53,78
0x7709c20e484df7a67e7fa19d96ba259a78ca660e550fe8554ef7f16c44cc055a,t,51877,3578044,,5000055,2018-01-30 13:55:53,79
0x275c7b70acc58d58fa062be37a604686b615b6698366935393fbe168a86fddfa,t,21000,3599044,,5000055,2018-01-30 13:55:53,80
0x1168beb9f73c334ebb01a8188fb6c3468f464cd69a99a7da154e471594bc815f,t,21000,3620044,,5000055,2018-01-30 13:55:53,81
0x587ab91b259f096f88d3965d797e7cf0016d0daaae06a1b6b28357dbc8674342,t,21000,3641044,,5000055,2018-01-30 13:55:53,82
0xf74e2a3ecfcb7fbb972859bc9b22b54a83ffc4f8c610ae7275181f319b23805c,t,21000,3662044,,5000055,2018-01-30 13:55:53,83
0x6e66f92a0b4aec1481254a9d6736bb21c8feb4955b2587d2408e47df0256efa2,t,21000,3683044,,5000055,2018-01-30 13:55:53,84
0xeee70a2aac78ea71b08925ef1147fda1b7c075c08d4bf994ddaab58960261757,t,21000,3704044,,5000055,2018-01-30 13:55:53,85
0x5e472af45021ef3796b3ba790f88c506314464ccb1eb937eaca168fefc7f7ae1,t,21000,3725044,,5000055,2018-01-30 13:55:53,86
0x1d365ea2e46d6fe4d4240e0f0e0ee10f122c13d2dceef48b1b824a25e59b5093,t,21000,3746044,,5000055,2018-01-30 13:55:53,87
0xde35e41574535e84609d60ec14f38dc06f8b8303a0f9aad4373666d8cfc698bd,t,21000,3767044,,5000055,2018-01-30 13:55:53,88
0xeee865e7878bb41df4e49600b739e95439b9c6b8fa14ff19ac7981d029854b6c,t,36938,3803982,,5000055,2018-01-30 13:55:53,89
0xf51c5fda6c848f62d0ffba6610f2a3e2bebb5371772dca0e3eded7f60d5acba0,t,51946,3855928,,5000055,2018-01-30 13:55:53,90
0xa7fa5bf239aef38b1c2271fc502ced7a0d46fad43be7714201c08a314494c79f,t,23028,3878956,,5000055,2018-01-30 13:55:53,91
0x757a70366b00e3518257d158bce073a93ecd2e13ddeed2c7027adf635fd94574,t,137310,4016266,,5000055,2018-01-30 13:55:53,92
0x7b2b401a036217fd5a5cdb7a48869b0dd8f2d0c41284b8bd444554978acc6714,t,36557,4052823,,5000055,2018-01-30 13:55:53,93
0x41f5b29ac97be9dcf024eb905c9cfde9c67afee85084112cc8f152770b496e78,t,21000,4073823,,5000055,2018-01-30 13:55:53,94
0xce9739cedf7ea5bdfb38b922684c39fbb2c3b8fa913712f13c191dbf2c546d80,t,21000,4094823,,5000055,2018-01-30 13:55:53,95
0x9238a523b070c83cdeda36e470271b23d0f06a3e9c7ca39f63896d0be924fc36,t,115663,4210486,,5000055,2018-01-30 13:55:53,96
0xad9b6c416caba8f20faeb9eef535daf7dc4acac8942ae5948032b24e5bbf1e25,t,45527,4256013,,5000055,2018-01-30 13:55:53,97
0x5534d751af9fcfec99ed0e48454736d901ae0896a1511fa5bdcff231b1dcc057,t,52344,4308357,,5000055,2018-01-30 13:55:53,98
0x5f1b394a9e2e2d1843ef4bc49bfe11c4a7f3ab065ce0de7db7f2ee400dd4f862,t,168306,4476663,,5000055,2018-01-30 13:55:53,99
0xc891e9be6039fdab1b00bd51bd2bca1fe88fcec92f0eb631cae0ab98534d9515,t,34099,4510762,,5000055,2018-01-30 13:55:53,100
0x78d7161a4778510b964bd8c4b2c42c64b1e5f45519ac223c1424686b35e74913,t,66316,4577078,,5000055,2018-01-30 13:55:53,101
0x8d0a74c4ea20b1be722f48155909f3a502a49c308dae925a5a176c61a4ecd0b1,t,51496,4628574,,5000055,2018-01-30 13:55:53,102
0xf7aa718ce489f01a52738f767c6223ab66aadd482afdbc127194058d5eb2ac6a,t,44226,4672800,,5000055,2018-01-30 13:55:53,103
0x5cce68c8c178686d5083ee26a5f9c6446d8d7f4ec2a98e7dac7f5f00ddfd5445,t,52366,4725166,,5000055,2018-01-30 13:55:53,104
0x901dc9520349708aa30b50177057b5b30c88c74714e07aa4a778863b92cdfc93,t,210700,4935866,,5000055,2018-01-30 13:55:53,105
0xd1a522c74cd7f6650c4888701967c11635a174fda7ecfe1a0c9a7f7f7f3c88f8,t,108050,5043916,,5000055,2018-01-30 13:55:53,106
0x30d45e9c50b5ad56892e8ea68da0d1e69a14c1d4c8a55e6a0c208614ebfd671d,t,44493,5088409,,5000055,2018-01-30 13:55:53,107
0x5ab742c7379c7e38fdb64d55c1be0eeb75845e598d8933e865342eaca66909f0,t,36225,5124634,,5000055,2018-01-30 13:55:53,108
0x3c8aa4179bcbce373eac9fce3be6759fc310512303b97e446b068293bae196e6,t,38255,5162889,,5000055,2018-01-30 13:55:53,109
0x9abab27e157cab44d5dbc780c6d42a205bcb08a999aa882feddf072ce4dd96e8,t,48457,5211346,,5000055,2018-01-30 13:55:53,110
0x7479dd400085e70d3d85fa5b0ceede994752ff2926660c64201f44b2a2137be4,t,59162,5270508,,5000055,2018-01-30 13:55:53,111
0xab6b8f8f52a32cbc09135cd9e644241520377c73b557300cdde1fd6126d12ba6,t,59290,5329798,,5000055,2018-01-30 13:55:53,112
0x3060057df9a51488c33093f3f041d0e602e5287d457454d6c9ad419cd26afd09,t,93242,5423040,,5000055,2018-01-30 13:55:53,113
0x4b6041dcc9a1c1882ecfd65e66246be3ee7738e2e4f34c6d2da9b7d8e83490c1,t,78178,5501218,,5000055,2018-01-30 13:55:53,114
0x04825685d21e4686146c069df92238167b1f0d389f023e58ecc80497eb8fb668,t,21000,5522218,,5000055,2018-01-30 13:55:53,115
0x6a24dba117363040d0718f48305fc25958aeffe9894b2fd8e08714fd3bd336c2,t,45509,5567727,,5000055,2018-01-30 13:55:53,116
0x03d844ea01c600e429527d248b7c44a37b85a0ea6151b374223b665b6139908e,t,48585,5616312,,5000055,2018-01-30 13:55:53,117
0x9ecd29d854e93cd42e976d3a1f60ae26ffd5a7dd33fb7aa016c80861583f2f90,t,45981,5662293,,5000055,2018-01-30 13:55:53,118
0x39ab10a0b1f7f8edfcb2a59e5f7e50ab140a76b9674bb1462555999960abbc7a,t,44162,5706455,,5000055,2018-01-30 13:55:53,119
0xfcc7b405bf3ec6d79346add1b60211827dc8a2dc142d8df95664d39ef28cac84,t,44162,5750617,,5000055,2018-01-30 13:55:53,120
0x7dad37468cb2b8c08d4b83a7b8192f79fb078e62d523ce56611ae164e1080b29,t,59354,5809971,,5000055,2018-01-30 13:55:53,121
0x4276c34965b6e0c1512014533b5ee8c400017fa793f1e46333781870da6010b8,t,29493,5839464,,5000055,2018-01-30 13:55:53,122
0xd41a6708bea19e3a87bd36b63f5faecc02244244145a2ceb24006d7c9ef9a3f6,t,93306,5932770,,5000055,2018-01-30 13:55:53,123
0x650fa2bcf1bd0a310e6324ba64acc82e6050ea86a1c028992a30284b7db47691,t,44418,5977188,,5000055,2018-01-30 13:55:53,124
0x3b729aba5294a43f39da7d8747e36be0258df661dce7e915fe7713dd2dc68df0,t,29493,6006681,,5000055,2018-01-30 13:55:53,125
0x41d2cab6732f1b7701790981a4cbec176b32fe25a59bb6a5d2eb88556640e863,t,108178,6114859,,5000055,2018-01-30 13:55:53,126
0x398ea651e93ecc1befb0a87c4461a6a90af6bcc3c5f52266929198a9f4fe3b3e,t,36708,6151567,,5000055,2018-01-30 13:55:53,127
0xac4c5186250e8c256357a7b52aa63ef469d7983f1a7561b89c07bda15ad88306,t,59354,6210921,,5000055,2018-01-30 13:55:53,128
0xb13d8c4a4518a6088df201aa80eba5b6ade66493b8d2a60de9fe1e838627c375,t,29493,6240414,,5000055,2018-01-30 13:55:53,129
0x9eca51fb36c97f83992eb9a850e2abb0712200e1ef535a238cb6630da37afe22,f,30000,6270414,,5000055,2018-01-30 13:55:53,130
0x6db7cebc91028d4c25ced514c18324aee2848085604228a0e878f84240fbcd33,t,21000,6291414,,5000055,2018-01-30 13:55:53,131
0xdc7829918c9d88f21c333e3773ebc96ebac8dcc1a2b6e9b4a47cd240dd8b27c4,t,21000,6312414,,5000055,2018-01-30 13:55:53,132
0xa4f9b1a44e846c68ecb2c3fe6a5a3e09c6dd282948e3e5f5914d4e46ea25c383,t,45662,6358076,,5000055,2018-01-30 13:55:53,133
0x18ecc79b598a48393736b457e0e2ae7b3cb070008fddfa8a35077c7277633e24,t,132823,6490899,,5000055,2018-01-30 13:55:53,134
0xbcb5e2c0fa470f49b4ea43fc3bfd822f9473ef45681c860b3f6d0374a5ee11ec,t,38419,6529318,,5000055,2018-01-30 13:55:53,135
0x3fe498b2210aac313ad6c1495bd739d32df3c4149dbaa8a5e0b0b72567851cfb,t,77986,6607304,,5000055,2018-01-30 13:55:53,136
0xa62b6f26e2f8274458b675eb0796b5c8f91f49c4ef9557d45d1f21b0cb596ecf,t,21000,6628304,,5000055,2018-01-30 13:55:53,137
0xe76766cd713260c92adf675d5a4d8523d9a0b3e34f2e935d9551315acd1773f2,t,37836,6666140,,5000055,2018-01-30 13:55:53,138
0x0edd4b2ec9daefb07f2908093635e77885224741a86daa625c8c4be881e518d5,t,29493,6695633,,5000055,2018-01-30 13:55:53,139
0x82ce7480abe8c3dcac477e1451999fabe6e487de95c2264818ed1291da18b1d9,t,23252,6718885,,5000055,2018-01-30 13:55:53,140
0x11f25d9eedaf6105b22cee8e3cf1f5834bfd13bf1559ea49088f27f319f8b5f8,t,21000,6739885,,5000055,2018-01-30 13:55:53,141
0x1ddd0a3028756dca71c883f42f63880d797b815520924e96c12744380b9f847d,t,44493,6784378,,5000055,2018-01-30 13:55:53,142
0xd7cf259a4050d7ff551b08665749e10c09b04e5acada0a02ac20396d4ccdcb74,f,250000,7034378,,5000055,2018-01-30 13:55:53,143
0xbb4cbbbf346b5ef4f3236b9eaea228dc9d920e63775da0a2320ba24d850aae2c,f,21000,7055378,,5000055,2018-01-30 13:55:53,144
0x33292a716da9b63f8a7f67be87e69240b7f7db5b5d537b620d13f335488c2187,t,21000,7076378,,5000055,2018-01-30 13:55:53,145
0x31683a360f8e3125811b224bba783fba9778403101ca73556307b3818cb960b0,t,44354,7120732,,5000055,2018-01-30 13:55:53,146
0xc668e847fc642f5fc17d23789fd7eeffeab00273da765ed4fad01b45a09e3380,f,250000,7370732,,5000055,2018-01-30 13:55:53,147
0xf63af078f63e8426d6c0b73ae15aa4806a19c0dfb6e35e10b9d68bdec3f49e8f,f,21000,7391732,,5000055,2018-01-30 13:55:53,148
0x6babf6873b78f9e11da34200ba9768044d4a10fca1bf9869264de34f11f38ef8,t,40806,7432538,,5000055,2018-01-30 13:55:53,149
0xc5dc57e6a8e591cebae62b160dde2fd08a42e18d6e55cb8d8fca002c4bb2d2e5,t,45503,7478041,,5000055,2018-01-30 13:55:53,150
0x13cd9ff27317ad2a5f5cc4d6aa57a83179ecab7bbfe2ce3c2d4f712cc8546abd,t,48181,7526222,,5000055,2018-01-30 13:55:53,151
0x76220c4583a7ffc4b0510c0b2cc22110629445c2f40247e5014e9f29a31b4978,t,23028,7549250,,5000055,2018-01-30 13:55:53,152
0xf1a4dda525fa74338e728b4d4105318117e3b8f09958106b98f9ff714a9137aa,t,21000,7570250,,5000055,2018-01-30 13:55:53,153
0x2443c4bd6ba30c4419a4cdc6364db2ccbf195b2647ad96d1551322a38d7a188b,t,59098,7629348,,5000055,2018-01-30 13:55:53,154
0x993c9f21af920d21fb7b44e892e64104b95dfd76e9d4ef3838e6479b632abef3,t,29493,7658841,,5000055,2018-01-30 13:55:53,155
0x9091d3f0ad8797b7fecdf614bea59a6e0837186192db56e4d688e4fe189fc6cd,t,174591,7833432,,5000055,2018-01-30 13:55:53,156
0x3b7c092985b7ba4b485e35eb9ae33a5172071e216349cb81a2792a803f11db4e,t,76580,7910012,,5000055,2018-01-30 13:55:53,157
0x8b8e554c5632ce7d80c746ff3aeb17185a21069c4c20840168ae9a212151d73d,t,21000,7931012,,5000055,2018-01-30 13:55:53,158
0x4eb75de267719e851642834d152bd9f0e097f2521187af3e90f6ed0603e00c47,t,21000,7952012,,5000055,2018-01-30 13:55:53,159
0xad242c70c2a06d816d4a1dd74c683c5f79fc78087c099d8c7a6fd9eaf571e0a9,t,21000,7973012,,5000055,2018-01-30 13:55:53,160
0x06d09eb5218f9fbaf11af7bdb9c8ec8e30f6860a3906bfa42e292c18ee83b129,t,21000,7994012,,5000055,2018-01-30 13:55:53,161
0x50021a8c3cfcfba9a22eda1c577d51eeb2952f524e3eb10b11c0dd5b4001f51f,t,21000,21000,,5000056,2018-01-30 13:56:07,0
0x9181e3d19c031bbe471395bdff5712aaa8e8c4f38aa2783172669002d5fa0f2a,t,21000,42000,,5000056,2018-01-30 13:56:07,1
0x7e810077be20ae726adc10aef5a74f72cf42dad3860c8ea2f950bb7d2cf7730f,t,21000,63000,,5000056,2018-01-30 13:56:07,2
0xbc2c9fc7c49693a354ebc82044e1c6753caa20e0fa10397c3f6233ee210fe2d2,t,143081,206081,,5000056,2018-01-30 13:56:07,3
0x620df5b369c7a432d3b2796c13e4962d04ee3b0f2f7ff66950e5c8ccca2d854a,t,143081,349162,,5000056,2018-01-30 13:56:07,4
0x8b26f1a5f7674444b070eccaf47bec0c5e0f0ef531cda0802f9542928cd4d92b,t,21000,370162,,5000056,2018-01-30 13:56:07,5
0x066439765211dd8401da3aabd4054d19535b3f43bee56ca1688a3633876a338d,t,21000,391162,,5000056,2018-01-30 13:56:07,6
0x497e9b4d0b4ac89eef4ff99dc905ca62523ff30e574b991bc49a4e3a77c0f80d,t,21000,412162,,5000056,2018-01-30 13:56:07,7
0xf65aa5e3937d3fb10b7bd09e3c50f0a89c840184f0808e2bb81a72d4226406ce,t,54707,466869,,5000056,2018-01-30 13:56:07,8
0x22ec648f8fc053384b53144b3b4cca8c686617f704db46203b704c41f2edf949,t,36915,503784,,5000056,2018-01-30 13:56:07,9
0xdcf589a9150282c7c6746cf6c2c937f88b91930be486ae63cf0848e0201eaca1,t,21000,524784,,5000056,2018-01-30 13:56:07,10
0x415f499df47d069e9c5d515ad8da6335ae8b5ec820ff9a31aa51a4a4edc34fa8,t,21000,545784,,5000056,2018-01-30 13:56:07,11
0x7c9b7d9fdb10e75df70f1ea4c14c9a82958cc77a463a99ae8a7a3e5c7e39362d,t,21000,566784,,5000056,2018-01-30 13:56:07,12
0x7a5a5c53096c4aade084779fe87887f64ea1d038ecc53c2b08acc1f7d2f26b3d,t,21000,587784,,5000056,2018-01-30 13:56:07,13
0xf21f514701be7135f311cf7fea597665f21cf86fe1c6d743193d825724b2638f,t,21000,608784,,5000056,2018-01-30 13:56:07,14
0xc569eba4c6ae6789b6ccfea3e1a85792eec4caf76d63c4f1b3c957cae8681d87,t,21000,629784,,5000056,2018-01-30 13:56:07,15
0xfa339d61982d100dd5251aa8c8275c9b0b5ba1b897a1b481919dec5294578439,t,21000,650784,,5000056,2018-01-30 13:56:07,16
0xeeef5961ceb4c01f04dffd3c61d29e9c9f51fe1536033a7815e33db470f4a18a,t,21000,671784,,5000056,2018-01-30 13:56:07,17
0x4d381f59695ac3d82714ad673c889dd0c4d6d858f5803a3ed6c9d7bbfece15b0,t,52151,723935,,5000056,2018-01-30 13:56:07,18
0xea4e3a2878032dbba66c61784f591ce2c3028f2b5c53dee0826cd622c9cbf773,t,21000,744935,,5000056,2018-01-30 13:56:07,19
0xd79bc5cd9752956ee86da951e547972e460ed96e10d6daa92f1e270621f22328,t,52222,797157,,5000056,2018-01-30 13:56:07,20
0xf9316a7ef33fccbd32357ad03acc29b3c519dd6a6b9831780c4444f6f13bf45b,t,21000,818157,,5000056,2018-01-30 13:56:07,21
0x181a1454702f19eb74812fdb6e491e35fc0a863253bc368be24d12f1b9ecd07a,t,21000,839157,,5000056,2018-01-30 13:56:07,22
0xa6b4ab5913f61f5b9ce5943bb7cbbada0acc2aaa98f34f396f6703e47c467da4,t,54771,893928,,5000056,2018-01-30 13:56:07,23
0x45fe969a76b2837849be96a5d954a540ee4dba9eda75d7158c45c6578d1b03a8,t,21000,914928,,5000056,2018-01-30 13:56:07,24
0x92de8e71d37096511eb8478a6fd372c4b18b459f048ae9e4037c4259bf10334b,t,21000,935928,,5000056,2018-01-30 13:56:07,25
0xe3c4b68a7f3290f0c4d752b157b115cd36737b06ceb9f7c95efeacefc1c123b8,t,21039,956967,,5000056,2018-01-30 13:56:07,26
0xbc7dc5e97d48af585c622a19f2bfbdf30375005db6dfa2f0af829516652cb63b,t,21000,977967,,5000056,2018-01-30 13:56:07,27
0x2186d6c676ed0c0363622b2f28681a55a1acd262e74b5577c712d47c9fdc170d,t,21000,998967,,5000056,2018-01-30 13:56:07,28
0x96ac98b6857f427e0fcd30ad12bc7a1c81401938ede631f4060ac06fab3ed37f,t,21000,1019967,,5000056,2018-01-30 13:56:07,29
0x334f2258f3d55661d196790f5947854abc9331dabe5ed366546342af5d53ec35,t,44354,1064321,,5000056,2018-01-30 13:56:07,30
0x50db428725c841f09238194d92e376b6d1a29b63ecd41ffa0d2cd693a3b18270,t,21000,1085321,,5000056,2018-01-30 13:56:07,31
0x4318f185b49777159a57e6841ae1d28c7ada79a7fea9bf10e90f9969fddc664c,t,21000,1106321,,5000056,2018-01-30 13:56:07,32
0x896bf5016c0a51af276f06bb67016ffcfe9c4c789b271dad0fe6bdf991733a24,t,21000,1127321,,5000056,2018-01-30 13:56:07,33
0x2d237473733baa6a96f97db36efaee911d278a3380f6778e40095342f313e5b0,t,21000,1148321,,5000056,2018-01-30 13:56:07,34
0x34126381ec5aefbbeca5dd0e964f0cb7688126d0c1c2094bf0b43a55966d37b6,t,21000,1169321,,5000056,2018-01-30 13:56:07,35
0x91279efa54b0929ebe536c7d0a5a51042cade1259414a1ccfcf912c774bbd322,t,21000,1190321,,5000056,2018-01-30 13:56:07,36
0xaa4bf502b33b1da3f4b941531b2729a3f4c02a09e0331125f912608b4b2e7d2e,t,21000,1211321,,5000056,2018-01-30 13:56:07,37
0x931a78aa38fd22a042e1d3c08126611768b16fd255df30fc228392717f7d1a06,t,21000,1232321,,5000056,2018-01-30 13:56:07,38
0x6bd1a4066f805e1a7fbbed6f559e7d6f29d4725878e2f19a1bd9ed2a0b7ab0d2,t,21000,1253321,,5000056,2018-01-30 13:56:07,39
0xb06ae23fff49de29dce13978d6832bc9ae82818611a2f525dda8b879c7b5d190,t,21000,1274321,,5000056,2018-01-30 13:56:07,40
0x4c2b4329eeb3f4141c22cb1af3dbaa611ec4ffc8b77e865aad7a81fecb52399a,t,21000,1295321,,5000056,2018-01-30 13:56:07,41
0x5697027805070a7bdd181ec48dfe871d6c9e883ef7186f74f12a8cb45e97132c,t,21000,1316321,,5000056,2018-01-30 13:56:07,42
0x889be041c9f407afde5492b13539e36e286163b4bd36ef7a256a2c27020a02d8,t,21000,1337321,,5000056,2018-01-30 13:56:07,43
0xdf67d9665828694214753e57dac1c69b2aa7e8b8c68f6459768d4a48a70c4f1b,t,21000,1358321,,5000056,2018-01-30 13:56:07,44
0x5e9fe44f382d4f09ddcde904096f0a07e64c64bff4689f402b5bf53f5fd745c6,t,21000,1379321,,5000056,2018-01-30 13:56:07,45
0xe65b55d8c4be1d53ae2786745dd7665bee70cb3be662e6f230836eadefcf8c23,t,21000,1400321,,5000056,2018-01-30 13:56:07,46
0xf3af7032b99f1c7b72f8ca79be607b8f9565d85cc5277a59982e6442d0467666,t,37286,1437607,,5000056,2018-01-30 13:56:07,47
0x1b5df18dc595e70d67b0abca83aa95fe4bb57ffb117c053f3b36501870202b25,t,106449,1544056,,5000056,2018-01-30 13:56:07,48
0x88dda50108e364ccd1a4b76ce5fa9850fd52c7bac30e91b951da7a347b38ae14,t,52678,1596734,,5000056,2018-01-30 13:56:07,49
0xaa174d65e6cd2df052a91bfe19c67f52b63ff8914cbaa07825773399fc5d84f5,t,21000,1617734,,5000056,2018-01-30 13:56:07,50
0x5e3e58c27d17fa37d8acb5b8995c9641c988fefb7dbe5f49f8f5ce1e6f449e22,f,66666,1684400,,5000056,2018-01-30 13:56:07,51
0x9fe6dbf225f10615a985d442e1c8da03ae784db1769982576d5e771e9753fba9,f,66666,1751066,,5000056,2018-01-30 13:56:07,52
0x8395c4417a0e4128351eb911d37bcc43e0802e4b307a84277b1310628f4f6157,f,66666,1817732,,5000056,2018-01-30 13:56:07,53
0xd0b54d01e88300ffd4b3bcc4e5452131573fee836eb3fda735d868ddbdeae364,f,66666,1884398,,5000056,2018-01-30 13:56:07,54
0x5eb9e2e943130b8b32e0ba9c70fe2b24d3a328a891776aa90024db2288342144,f,66666,1951064,,5000056,2018-01-30 13:56:07,55
0xa918f5dda79f5df32c54f70b0c4d53cfd5fc7be956677062c8c069c976d3103b,f,66666,2017730,,5000056,2018-01-30 13:56:07,56
0x28d469c47c94a5ec428065d7f29cf216f85132d56e4054ac99548d57f481419b,f,66666,2084396,,5000056,2018-01-30 13:56:07,57
0x2f92c28d12d4446dd39a318ed178d12b7b8db6b17a1bebcc9d141cc5c48fde93,f,66666,2151062,,5000056,2018-01-30 13:56:07,58
0xcfe0fa9e3d2143276e0d0764636a2ec3d3c465e9da224bd41ec3d6cb05fbc921,f,66666,2217728,,5000056,2018-01-30 13:56:07,59
0xdd7e4711d236453228475a1dd7206f72ca8d5e049a1f5c55b1798250f3fe1378,f,66666,2284394,,5000056,2018-01-30 13:56:07,60
0x4f704c96f0ab9105aa63c299ba4a18d7a476d433f682e7183fe9004dab0b23a2,f,66666,2351060,,5000056,2018-01-30 13:56:07,61
0x7332b4b8cd06d2d44baebc1cb21f90569d133213ab8143e07244d1ab4f82a3f3,t,21000,2372060,,5000056,2018-01-30 13:56:07,62
0xb97e016b14bcb95af1368b4085f64750cb6ad64da6344a9fa6e6c52b719a98d5,t,98684,2470744,,5000056,2018-01-30 13:56:07,63
0xf93c5bb127a0751d510122ceb98258ff5c3adf8f6294bc568cc597b6be2769e1,t,104678,2575422,,5000056,2018-01-30 13:56:07,64
0xc364eec0b3a31d4d52bf0dfc53ba9163f5f6c4a0a73fe515f4e058d35a9ff4ae,t,21000,2596422,,5000056,2018-01-30 13:56:07,65
0x1f533e5e7065fa95be438907d048b903381af8a9e03c4d7a840c5c1b0139242f,f,90000,2686422,,5000056,2018-01-30 13:56:07,66
0x6fccecdbddc54350d22ddc629f164051656a971de795c4effae552489f34031e,t,51912,2738334,,5000056,2018-01-30 13:56:07,67
0x7a2570cf3058e38fdc7c38c0cd22c8c03da63699131463019a247018b0a468a7,t,21000,2759334,,5000056,2018-01-30 13:56:07,68
0xb555e491251722f71842693528563bd0e790aff4b1e3491e6e3884b6f4df9e25,t,52338,2811672,,5000056,2018-01-30 13:56:07,69
0x23877e49a699148f66e45608aa6cd45370fc3a37c4e093862239a072f84ca2d0,t,21000,2832672,,5000056,2018-01-30 13:56:07,70
0x703c08c336d80ea84838eb1f3069c791d677197fa33983677ba3c1945ec64867,t,21000,2853672,,5000056,2018-01-30 13:56:07,71
0x41b30b0bec014319cae30ac81f5c924315be425e4906d95102eb852ee9789472,t,21000,2874672,,5000056,2018-01-30 13:56:07,72
0x2f6d11f326b14b5006aca3f3c188e28ca86a386e90dd41c05d681c8a39b5efab,t,36718,2911390,,5000056,2018-01-30 13:56:07,73
0x7a3d067d2775ebf3b7115a5f06c3c4f9f1278e174fe9652377c97af124cd4e24,t,459790,3371180,,5000056,2018-01-30 13:56:07,74
0x677addbac68b746f416e2620dc1e0e4ecd39f4595a27494b9b3ae0867b693f33,t,23327,3394507,,5000056,2018-01-30 13:56:07,75
0x9095220eba02c9a79082c93c1f008664ffe7a068af86fc9081f4cf1c56df77a9,t,53987,3448494,,5000056,2018-01-30 13:56:07,76
0xb7cd23af23a651be84c22225fa1ee44a21683000d91bf3624a8978afd20edfd5,t,23615,3472109,,5000056,2018-01-30 13:56:07,77
0x8ef4cebd79b54d890c538df0dd312fb6af7b94ab8d62dbf19a015fdee7d879a2,t,21000,3493109,,5000056,2018-01-30 13:56:07,78
0x328791d38f87eee9c0764da5f4a3efb2d27fbee6b7c39c67aae98835dd48269f,t,21000,3514109,,5000056,2018-01-30 13:56:07,79
0xe4cd0f2aa5a24b8fe841942a97285306b3cfe434cdfad72d8add2cba8e5ab82b,t,21000,3535109,,5000056,2018-01-30 13:56:07,80
0x089d6459cb748ceb6f071ff55fedc63912b2c73a72057c7926d4f61c93ab2ce6,t,21000,3556109,,5000056,2018-01-30 13:56:07,81
0x06a490e2cdd142b41dada4e161206c83830b930f19055c614bf9e3a59757fd1c,t,21000,3577109,,5000056,2018-01-30 13:56:07,82
0x02bf8e242714c92b5106dd823cc7a83e93439024625245dc45d4b6c5fc31695d,t,21000,3598109,,5000056,2018-01-30 13:56:07,83
0xa133a04b2a971f1877feee1951161a2d62c9e8dbbe851517c6d08e14b766fa69,t,37151,3635260,,5000056,2018-01-30 13:56:07,84
0x0b159cacfdfb3c7d47b6323cff0f619de3b7dfe4c83bf59f6209c889d0537899,t,21000,3656260,,5000056,2018-01-30 13:56:07,85
0x785371e06045ccafc52acd033d361dc24d154f9693740e96febf581d3165ba9c,t,36947,3693207,,5000056,2018-01-30 13:56:07,86
0x9ea4a0faf5cfe85494b2b50a5767e514a2383fafd0150184ffc7d034fe2418c1,t,55779,3748986,,5000056,2018-01-30 13:56:07,87
0xd5671bfe15c83d4e3dda44fb73c5e85e6a86726a56ad4fa1378d215551b30e2f,t,37151,3786137,,5000056,2018-01-30 13:56:07,88
0xd089f3912b4b01e18bfff3b0a06cc17698693bf5f1b58f985b6fd787470ab317,t,52257,3838394,,5000056,2018-01-30 13:56:07,89
0x2e50e501f35d927eb14c4ea690a22e7f9ac56494e2581a489a6856fcbf7e105d,t,21000,3859394,,5000056,2018-01-30 13:56:07,90
0xba909553239e27920100bb55399ed966ce6b0ca16f572cf699682bcc3ca115fd,t,21000,3880394,,5000056,2018-01-30 13:56:07,91
0xc741a62953d7d96c9e9a7abd797718b0e3dc7314bc8284c3a8fb5befc11a6391,t,21000,3901394,,5000056,2018-01-30 13:56:07,92
0xeea41e255de528bbdfe081e44e95331f07a2614561093221cf6e063002711358,t,52594,3953988,,5000056,2018-01-30 13:56:07,93
0x718649caed161d2ff89d43f91769291f9eb4ab09955e8599bdcd019970108005,t,21000,3974988,,5000056,2018-01-30 13:56:07,94
0x1a41a403b629b3a89f216f414ee03df836efc6e736765058263a5883f1c9d4cc,t,21000,3995988,,5000056,2018-01-30 13:56:07,95
0x696393d8cf5fb0f043ac4e061256061429f6052a3fb40410c8858edd23e73512,t,21000,4016988,,5000056,2018-01-30 13:56:07,96
0x1986db2b8178e82d7a04a197e35381978f56bcc28ee57bb0d7061a4bbce25325,t,21000,4037988,,5000056,2018-01-30 13:56:07,97
0x29f525c6a7321f12f67ab4753e7452d2606341a5c335e2b7945275b570c7a08d,t,21000,4058988,,5000056,2018-01-30 13:56:07,98
0x685cd95aa8e1600d9aad2bb40d7d06d683f6551fc647f579f9ad52c03c2d9fcb,t,21000,4079988,,5000056,2018-01-30 13:56:07,99
0xa8bdc6d82ef6e1e0c6d900592952fd1ee98d086857eec40d49b6e16d068c8385,t,21000,4100988,,5000056,2018-01-30 13:56:07,100
0xc451970416d1b09fbe2f63dafab9da4ef686576e9fdcf39b371a5ad74ff29c36,t,21000,4121988,,5000056,2018-01-30 13:56:07,101
0x3f488e2769f91b91367195174b05cd38f41c04e88007a0bf9bb786d021e29f5e,t,21000,4142988,,5000056,2018-01-30 13:56:07,102
0xda437e8ed3a8228d2e702f0ada3b526c763ba7eae5862671bab02a3e4911c787,t,21000,4163988,,5000056,2018-01-30 13:56:07,103
0x2258d390f80c469316060ae623a18428fa0a0e5744dd733d520d04ad52def662,t,21000,4184988,,5000056,2018-01-30 13:56:07,104
0x22793945b72eb439baf911a47fd2f8141bd2dab5f292b499ff98ecab1b7f64de,t,21000,4205988,,5000056,2018-01-30 13:56:07,105
0x4906ed82a10a32bd92670039fc7571b44852d80b59253237d27b1f070714dcff,t,21458,4227446,,5000056,2018-01-30 13:56:07,106
0x1654e6d048055e69359628fd8561b53b1eac305d52ef01c82555ad870aedff2c,t,21000,4248446,,5000056,2018-01-30 13:56:07,107
0x551fe53ab25a6659154b687b651ba77977c16897e27f98c510048d37fb231aac,t,21000,4269446,,5000056,2018-01-30 13:56:07,108
0x130c53d710fdcf9847010370a5818aafeb05b6a3906c25f95c8124e947756f04,t,21000,4290446,,5000056,2018-01-30 13:56:07,109
0xa02110fe2e343b27e31c554a7dcc8df6f39cc7873189c3ee588a615555e5f6b8,t,21000,4311446,,5000056,2018-01-30 13:56:07,110
0x599e845065152c1dd0bfc33a28470d29e60830bd4d2634707ccacab2d20b92a0,t,21000,4332446,,5000056,2018-01-30 13:56:07,111
0x775b7e6df6fefd1e7a2a4a41a00128e0acdbb576a9c70230cb507bd35c93415d,t,21000,4353446,,5000056,2018-01-30 13:56:07,112
0xe6ab27fd4452594aec5794c0c2cfabf0461cccb3080237b797b8e230e441c089,t,21000,4374446,,5000056,2018-01-30 13:56:07,113
0x40eaf1df65b74ad458380b51d23c595b65381e4fb46a4b321f6490b0c9c2bcc2,t,21000,4395446,,5000056,2018-01-30 13:56:07,114
0x634e0818b317cec6a7ce5264b72c735f0a6e894f588d87ebf65662d3b6eaa718,t,21000,4416446,,5000056,2018-01-30 13:56:07,115
0x3962ebe6058bd5b12703d6efecbe0114bae93e096800afa3356645299427d948,t,52173,4468619,,5000056,2018-01-30 13:56:07,116
0x3513f623394fc1d08e6db06cb236b55d4db74f936aac3934c4d151d19516ffa0,t,21000,4489619,,5000056,2018-01-30 13:56:07,117
0x51721649214e7579148d0c7ec573f032ac2642436d30c5cc2b5e8c6be9f78121,t,21000,4510619,,5000056,2018-01-30 13:56:07,118
0x91347ff76af222dbb49c98f29785d5e9201f7d4c038d60fc5facaf79d6dad992,t,21000,4531619,,5000056,2018-01-30 13:56:07,119
0x3ef54b878acaaf75f32886a3e2847a0842b622f087bd576cc828a2e492aaa7d8,t,38318,4569937,,5000056,2018-01-30 13:56:07,120
0x0d0a64056897774aa0ab3d34c57e8879095eecfd185b88d110e6b559525d24e7,t,21000,4590937,,5000056,2018-01-30 13:56:07,121
0x61c0c2877fd4f882c6392eb61ed29a17d23b69889f6cb72393558706352b34a0,t,21000,4611937,,5000056,2018-01-30 13:56:07,122
0x56b0418a6e3f9d6f0843e99bf8d81e8a49062c1c7c3a6fe53e50e5e2063b5c2f,t,21000,4632937,,5000056,2018-01-30 13:56:07,123
0x6f7be287afd19cd5aaf305668ad94a47c04630498fa8872f75332dcbe740772a,t,21000,4653937,,5000056,2018-01-30 13:56:07,124
0xf052f9cf2453e3506fe1a56cc942826fc895f7dfe2ac94a35e3dbd44bb622b22,t,38382,4692319,,5000056,2018-01-30 13:56:07,125
0x0846b09a0b2821ff5beb713afdd43f35744ad7ca8326d897773d0dd34ac63744,t,21000,4713319,,5000056,2018-01-30 13:56:07,126
0x960412d7c8424ed29f9b085f40a5ed51347fef6ab83166a50c51c75b35a22f8d,t,40979,4754298,,5000056,2018-01-30 13:56:07,127
0x353e65c258af45b9a1e717ee038a20517ea6d94873ce48d8bc48bb8e8b62533f,t,21000,4775298,,5000056,2018-01-30 13:56:07,128
0x439032e58bdaeb263079ddede24dce79de3c7fb56e177fa06c6ad91fc8971dfd,t,21000,4796298,,5000056,2018-01-30 13:56:07,129
0x84713d399bf3a98c92406b7894b0ce558335286716cd8c1ba14b9be7c6d9e7c3,t,38254,4834552,,5000056,2018-01-30 13:56:07,130
0x1c080646b54d2accb291ba33a2c769698adc04fcb43be6f9c4cad1e9eed9cc3a,t,38318,4872870,,5000056,2018-01-30 13:56:07,131
0x5d5dc99551a6095acf97ef80c085ac52390f626424e633f041294b4f9d28f6a9,t,21000,4893870,,5000056,2018-01-30 13:56:07,132
0x4f5ef0b911666e18f1cb78a75266c89a9e39d31367efa4e21314ad2dbd2a71d1,t,52106,4945976,,5000056,2018-01-30 13:56:07,133
0x12b207c39e79b875f1f9cb50fd04c749981158afabe703568a60ff75ba6a1d60,t,21000,4966976,,5000056,2018-01-30 13:56:07,134
0xe6fcea932e7ce5454d5d1e63911f7cc3a3e0c8213b0f911f94401bbcb9999185,t,21000,4987976,,5000056,2018-01-30 13:56:07,135
0xe3230489a30470ae17ab0ea496a8b3117c5dc13442fc382fb8c75bea0838371e,t,21000,5008976,,5000056,2018-01-30 13:56:07,136
0x55fa9d8f3cf3662ac9260b50393c92ae9e430eee3f2109bb05e70382e76ba1fe,t,21000,5029976,,5000056,2018-01-30 13:56:07,137
0x2e4ac6f1d16a69dc27707bced0549b7d29b9336cd13f20bd2fb06e41be7e997f,t,21000,5050976,,5000056,2018-01-30 13:56:07,138
0xd262f362e3a5843fd141d9b7b8c25584adacf4d569cc8e91ca3a5b99dda46fee,t,21000,5071976,,5000056,2018-01-30 13:56:07,139
0x33e823c73101b849c91eca3628f6309b78c3bfdf012412abb278ef3048f483e5,t,21000,5092976,,5000056,2018-01-30 13:56:07,140
0xe9d25cf58ff136b4a1a87345417b76769b57b0633616a37c2601dc97a04e38de,t,21000,5113976,,5000056,2018-01-30 13:56:07,141
0xdb4dae04f3ca63de28456f8e580c1dbe55dc77cf17f0ad4ff326854020445a97,t,40779,5154755,,5000056,2018-01-30 13:56:07,142
0xb784c08da28edce8ade11201606f6f4f7021e3a1a80a3de8949c61884ed68e3f,t,21000,5175755,,5000056,2018-01-30 13:56:07,143
0x5efee9779ba83ace798ccf95af6d5db1fa962d7969a6dbced9f6371f1ad7163e,t,21000,5196755,,5000056,2018-01-30 13:56:07,144
0xe93144f4ffe82644ccc4f74ca03f0743dcae0ac4c817dba8f3d977c9d22c0bc2,t,21000,5217755,,5000056,2018-01-30 13:56:07,145
0x34b413135e21a540eedf7556344834f2d9e6e20f21a3c50917a678a99ce132a1,t,21000,5238755,,5000056,2018-01-30 13:56:07,146
0x00904156038848032187d8fece67e3ec809f64e3c6dd03cb9f73f153343b4697,t,21000,5259755,,5000056,2018-01-30 13:56:07,147
0xf1d660cee2324e0e6113520c08287315cba13ce9a26db34bab73c253164a96f6,t,21000,5280755,,5000056,2018-01-30 13:56:07,148
0xa2692876e0b07e7581a10a8bae43e6051bbc530bb912243e934791256a2cc1e9,t,21000,5301755,,5000056,2018-01-30 13:56:07,149
0x231feba7812ef8cb6d4b4d671f866559134d3492556723d6358c8018113a6b0e,t,21000,5322755,,5000056,2018-01-30 13:56:07,150
0x4546105326fabd245bd430965bfa7245e962e8470965a6deee92ac45cc8a65ae,t,53529,5376284,,5000056,2018-01-30 13:56:07,151
0xc3aaafe3db883243578e4417a8d5870eb1211b9c4954cf3050aefd14a62b992f,t,21000,5397284,,5000056,2018-01-30 13:56:07,152
0xd62d09616fb405e11616bf6e8218f423ec04aaed2d3fee6cbec680f04b88bdc2,t,22155,5419439,,5000056,2018-01-30 13:56:07,153
0x5a74d0d94aa036ac35b24419d98c99a2e86ddc8590c7451f9b8723fb76d1aab3,t,21004,5440443,,5000056,2018-01-30 13:56:07,154
0xa1012e090983ddd12c9703e639406addd708dd85a9cd4636e6bced1d541a36da,t,21004,5461447,,5000056,2018-01-30 13:56:07,155
0xc3801eea53c3d0dbe60b2139ec58f4705edd2106f5cbdf6df13e00014ca96d00,t,21000,5482447,,5000056,2018-01-30 13:56:07,156
0x14a6ea1e843931b97b07521c094b2214e2cf050348728a1dc01ea6c57c5faa02,t,21000,21000,,5000057,2018-01-30 13:56:15,0
0xc414778e6cf0fe4223df0aafb281b3ec822bec64e46583edf0dcf25387e4e138,t,52091,73091,,5000057,2018-01-30 13:56:15,1
0x06c29cf1e2a93ae2778da67ba4f69c8db6e96fa258dd510a8d45bb549f2ecff6,t,52091,125182,,5000057,2018-01-30 13:56:15,2
0x2cc7aab4643a36877865391462ab256404a3ebbbff693e22f644c195af9df118,t,21000,146182,,5000057,2018-01-30 13:56:15,3
0xc7ce4dbf5391a37c08a44ad87e9cccf66494725c2c2aee79b3db2450659792c2,t,21000,167182,,5000057,2018-01-30 13:56:15,4
0xff7e5c6496cc2bb3577a99bb95ec93ae849af4c11851e763efb44a4e297655cb,t,24218,191400,,5000057,2018-01-30 13:56:15,5
0xe6e98c034bf1aecc8057434dd2711ccd61d5bdc0da32e3337145e43a95015a32,t,22173,213573,,5000057,2018-01-30 13:56:15,6
0xf3949e9184e0eec41fcf268a0ae6140926f7c0d55f7daea9e8e293550086bf31,t,24218,237791,,5000057,2018-01-30 13:56:15,7
0x2a87808575389215927963b8b8787ac2899d046f7a40ca5f7718aeca88d5fb0b,t,24218,262009,,5000057,2018-01-30 13:56:15,8
0x47a8ca551dda7dad53127ee92a2b9c4d95e476b8c2227c843c48c3eaab48e758,t,24090,286099,,5000057,2018-01-30 13:56:15,9
0x19d99f87e295b529a2387a4dc2d8741f64cbda21e3e7de43277dad51a825fbe5,t,24218,310317,,5000057,2018-01-30 13:56:15,10
0x56a7b21e72ffd665088a535e62d30844dbc9f049d69f86c2eb8a34295f4bb9e2,t,21000,331317,,5000057,2018-01-30 13:56:15,11
0x3e0d9aa3af65d2e94682c2fb10e7c783ea4458bcad4dd6b0d6a4a441cca75f17,t,21000,352317,,5000057,2018-01-30 13:56:15,12
0x4bfeb863917e93cd90db15210011e4584a5f0888471487382e2a4fb52b62e96f,t,46328,398645,,5000057,2018-01-30 13:56:15,13
0xac510f9f056ab5bb76e323540e3869c9eee52fdbf3c0972a116822f550031e05,t,21000,419645,,5000057,2018-01-30 13:56:15,14
0x33371994388679109b9dffce69fe4c19560eafc96697f73b7739b20102ca5573,t,21000,440645,,5000057,2018-01-30 13:56:15,15
0x7047a26d05b0a5eac43abe26582e433398ba935a668ed70f8c23c9461f1d6499,t,21000,461645,,5000057,2018-01-30 13:56:15,16
0x27268da96b3d32cbcf1412f69757c8c25bfaed800208344ba2d14207c6e00c41,t,37900,499545,,5000057,2018-01-30 13:56:15,17
0x0b2e5988478f4fb63c428cd23ec6138506a7969bd738f8e8faf2dcff53502576,t,21000,520545,,5000057,2018-01-30 13:56:15,18
0x1890d6c991e3139b49842030308417c7713a8550cac3d6054f2d3e2b3b01f4c8,t,30829,551374,,5000057,2018-01-30 13:56:15,19
0xbe028c0b87a56cde3b8e05fca73430e5b4cdf5d8f2323a2bd8ee18064947c4a7,t,21000,572374,,5000057,2018-01-30 13:56:15,20
0x48a271635768466ecd9cc8b1e19510fd40ac17d22359ce7d2dca401640d729c4,t,21000,593374,,5000057,2018-01-30 13:56:15,21
0x7826b0348aaef6978a644efacfaeace84c99ec359db4b53f3609466238fef059,t,21000,614374,,5000057,2018-01-30 13:56:15,22
0xa4d2593ee6836bf4dbc7a4c021405c477e644f60278e8457fde879db02c4c6e7,t,21000,635374,,5000057,2018-01-30 13:56:15,23
0x88b9452a1fa9e88613f2fad1166c794736d3b72c3ce93c68654fd539f5ff65fd,t,21000,656374,,5000057,2018-01-30 13:56:15,24
0xf24874f379cc80446ca36a7f6ded0897d586dd343c123f53280efcef1523a73e,t,21000,677374,,5000057,2018-01-30 13:56:15,25
0x22199d5bdc4d1ab05f2a3bd486c44212482be9cdbc5a65cb1ea23d5910415af1,t,21000,698374,,5000057,2018-01-30 13:56:15,26
0xf682c35c4730b5200661e80aaba1e737c5e7b225ba6e20e8de36f7ad450f387c,t,37155,735529,,5000057,2018-01-30 13:56:15,27
0x9827413ca884eb868db6d0311c140780d46b06c38bcbf2bfce090504c0902ffe,t,21000,756529,,5000057,2018-01-30 13:56:15,28
0xfc9a7f2c949c5639d28a93e61bb2a7ec8e6cf01323bbb958727c5bdf2ff7e2a5,t,21000,777529,,5000057,2018-01-30 13:56:15,29
0xf0c86e49348687a59d26beb027138b709fcb16d41d047cee36918bce5391af17,t,52126,829655,,5000057,2018-01-30 13:56:15,30
0xbbdbadb47360c3920be7195e5e331cdbd96c14db7a85b21b5bef4712228cdfba,t,21000,850655,,5000057,2018-01-30 13:56:15,31
0x257ad8ff7506120258daa5d8f25b47c5def0bddcad610eb53a327c83064469cc,t,21000,871655,,5000057,2018-01-30 13:56:15,32
0xcce4bb2f8fb2bb252f902288fced1152a227110e3441a602aa6e3ed27210218b,t,21000,892655,,5000057,2018-01-30 13:56:15,33
0x86a6fd795ec9cf70ba0a9e9e28a350c3666ddedf536384a8686e765da2eb4ae0,t,21000,913655,,5000057,2018-01-30 13:56:15,34
0x84edfa02eeb1ebe4fe5e8a235c501a62743f0398ef0367709df26de0b3ac4bf2,t,21000,934655,,5000057,2018-01-30 13:56:15,35
0x60e03c2e4e5a03b4edf097e530bcacabbebbf684c95f3c777026fc83cc913cb3,t,21000,955655,,5000057,2018-01-30 13:56:15,36
0x7d510eb999e882813365f55a071dcdec5ef95c56339b999eb940337a40af6130,t,21000,976655,,5000057,2018-01-30 13:56:15,37
0x998cdc4c887956799ce684f887992f15708ee0d3ecc3efe22d6a5705a4105d68,t,21000,997655,,5000057,2018-01-30 13:56:15,38
0x54baf6d59bc585197a0ac4eb32478f2445dfe99c05bcdd1f298329ba6af8e416,t,55843,1053498,,5000057,2018-01-30 13:56:15,39
0x3168dd6cd932d75bc0814413dd0119520b6f744daab5d2e844cf181b32e40579,t,51225,1104723,,5000057,2018-01-30 13:56:15,40
0x3c6b65ec517a31a95c0a424bbaf73e9436bffc3cd02b6092235042fb5d9b0561,t,21000,1125723,,5000057,2018-01-30 13:56:15,41
0x12dc19393fdb735d220f666c08101bbad497e0d2141f5a73a503804209545278,t,37524,1163247,,5000057,2018-01-30 13:56:15,42
0xceeab1c8af54d55a4d77b0350578f2d15e3fbff79287ce8cc1ece1c0a39b681f,t,40855,1204102,,5000057,2018-01-30 13:56:15,43
0x0a96b0be3f1fcff5f3ec4a6549658f9a0fc52be40c360398620d7d8221d57896,t,36915,1241017,,5000057,2018-01-30 13:56:15,44
0x31aa701131fe0985f298947213ba635015f42a6292b62a92d6d580bea480dbf1,t,36915,1277932,,5000057,2018-01-30 13:56:15,45
0x7467ac9deecbbf380aa9e4d53e166bff18e5ac2f30e6b589f1b31594ce142778,t,40907,1318839,,5000057,2018-01-30 13:56:15,46
0x09458400cd4d67e8ca4f6c3e1bc1c00566c049cfeb4b9d4c8e2787627af08c67,t,36979,1355818,,5000057,2018-01-30 13:56:15,47
0xf45e5da1c3c5dcbb2281da02fc7277ca3d95d897e3cd2961b01ad09d5426fbb6,t,36915,1392733,,5000057,2018-01-30 13:56:15,48
0x48462b23f1938bc896e38a2b937784384e35857399b67e90ffcf93c205920995,t,21000,1413733,,5000057,2018-01-30 13:56:15,49
0xada79386e21db1209caddbfa2eaa441316cd90b7bb61dbb44438f5837cb91a8b,t,86624,1500357,,5000057,2018-01-30 13:56:15,50
0x1e44a4d21248467ede3a8ea6b0ad72c3b0846cdbf28ef0c49834a2a5cae75220,t,53233,1553590,,5000057,2018-01-30 13:56:15,51
0xe5370e1b733add85f205f29378efc0ff987cdd57c4fac6b8e6d04ee001d83b53,t,53233,1606823,,5000057,2018-01-30 13:56:15,52
0x2355d7ae9a4ab194f9bc260e56fa3c1b7eec5ad1db84e0fcf4672ddbd80211ad,t,53233,1660056,,5000057,2018-01-30 13:56:15,53
0x5b2f2a7ea98e06cf4e960dee2ff3762693e20ba1664d208bdbd72f73e7aa5045,t,38169,1698225,,5000057,2018-01-30 13:56:15,54
0xa68d69786f7cae09f6992f7920db7e25a09b290fff93d231ca9346bb158a883d,t,102934,1801159,,5000057,2018-01-30 13:56:15,55
0x543d2ce2f3c970c7bcd6a82e8bb0d15c8a959e67090e2f4f619c21b30f3e34d7,t,21000,1822159,,5000057,2018-01-30 13:56:15,56
0x4e7dc2444abb82b3d90d8387b453415024b102a55ad8230089956cfd1ad562a4,t,51718,1873877,,5000057,2018-01-30 13:56:15,57
0x379e68de370c099da7215cf02db95b5a319d0f20941c4f0cb3780aaf2c18e3b7,t,21000,1894877,,5000057,2018-01-30 13:56:15,58
0x9f0624ddd47f2174a4c5b4f85204733e944a341ebfe3cb03108b2d763aaf08bf,t,21000,1915877,,5000057,2018-01-30 13:56:15,59
0xda89ba6f483fd270e9aa2ddef33fa5b8b09dfd58ea6f96e524c7c6fe49b79279,t,21000,1936877,,5000057,2018-01-30 13:56:15,60
0x2116645fbe3886968adda8f3bb2471e613f19fa6949e38e8bbf4fc9bd605b30c,t,21000,1957877,,5000057,2018-01-30 13:56:15,61
0xf8341ef3ebb314461673a2803ea293e3adbb359abf6473238dddcec12cfa60b5,t,21000,1978877,,5000057,2018-01-30 13:56:15,62
0xed6b47aec985a6d93444b068bc60cc2982d10f4690f7b132318fbf96a5b226ee,t,52185,2031062,,5000057,2018-01-30 13:56:15,63
0x3990f3f480cbf9988952f086e3caa850a5955bf3c6551418f293f84a9837abba,t,21000,2052062,,5000057,2018-01-30 13:56:15,64
0xbc25e963ba63decb84a28538b15bf1d352327adda811b6ee54b8345a2e0cfecd,t,21000,2073062,,5000057,2018-01-30 13:56:15,65
0xd5dbc924cc767daaf48aeb30e2a55120db400875ec231c8217851422f9b54af5,t,21000,2094062,,5000057,2018-01-30 13:56:15,66
0x04562682e0d84d035e0bc048e68235de50899f89af18f7f6be771a50e3e60a1a,t,21000,2115062,,5000057,2018-01-30 13:56:15,67
0xc0924967f182c0986e943241039e6f2cd444c387f81c3c44fb80ca16a0978356,t,21000,2136062,,5000057,2018-01-30 13:56:15,68
0x434eec8ef06b8dda6afce561ccb5132902cf9c549b8ae7a7effdbae4593ca545,t,21000,2157062,,5000057,2018-01-30 13:56:15,69
0xaffb0eda01712e1e7bb8304c8e3fc3692a7d9913e3af57fb2e6c80410efd3479,t,21000,2178062,,5000057,2018-01-30 13:56:15,70
0x1a3c2df68e53c7f07cb35c5d8eda164a327da9037dc870598f89413c2b130cfe,t,21000,2199062,,5000057,2018-01-30 13:56:15,71
0xbbac4ce6a3c0fe65fe6ada4b75f6faa602bbea59e507505860ff6b2100a7a474,t,21000,2220062,,5000057,2018-01-30 13:56:15,72
0x2a48fee0aa8a7e9945ad6de68c76a1b5de4b868cb2de458c355e5ea6156a9d87,t,21000,2241062,,5000057,2018-01-30 13:56:15,73
0x63dcc95449001f92f7fb5354a783b182ddae8c8523aaaf72b2d4a446810ac3b5,t,21000,2262062,,5000057,2018-01-30 13:56:15,74
0x726e41545463b6a7c7eafd3fb403688ddf063b96786a99f6f2af6b6e5b42271f,t,21000,2283062,,5000057,2018-01-30 13:56:15,75
0x3d78b95c9619ff37303160c0aef7b773877c3106ed712202993a4d5a015bf120,t,21000,2304062,,5000057,2018-01-30 13:56:15,76
0x64ac2a8e65d492e5f0e1fa2f61c45aa67678349ebe71d05544a3a11368d48d41,t,21000,2325062,,5000057,2018-01-30 13:56:15,77
0xfab69ed4477c24e00a2c0e7bd56854deab877258af8b6be6cc679f10a350810b,t,21000,2346062,,5000057,2018-01-30 13:56:15,78
0x735c57e1d42da99849a4456ff44446369e3e1ea2df5e51b47686dad8b21273ed,t,21000,2367062,,5000057,2018-01-30 13:56:15,79
0xfd9d183149a08c36b63637248927d58a661eae620e58a5b8717bf50fecdc036b,t,21000,2388062,,5000057,2018-01-30 13:56:15,80
0xc37006f58bd09882a4b7fe825ce0d57fd3a2db27b59b295d3ffb825a0950ae0b,t,21000,2409062,,5000057,2018-01-30 13:56:15,81
0x41ce2be074cc540f935be3a71c53f0059289175e74caaaee1f202d36890ed3d6,t,21000,2430062,,5000057,2018-01-30 13:56:15,82
0x8f09648cf0b7dce6fc9b2194213c11d1627d262a8d5461950f8c8ba0dca6fe68,t,21000,2451062,,5000057,2018-01-30 13:56:15,83
0xd0c2473806c7c59e0ee4e932e7359b9203cd52cbd3dedb82b0b233b2ec6076f5,t,21000,2472062,,5000057,2018-01-30 13:56:15,84
0x5846d6c49cdaf29923629213984307c8164af29635019b0650ef264667f9e949,t,21000,2493062,,5000057,2018-01-30 13:56:15,85
0x140b5d66820445317fe003789b498f32c8aab27522bfbd998d32ec97e79503ec,t,21000,2514062,,5000057,2018-01-30 13:56:15,86
0xd054efce6bbeb258dfc2424650e633da78f0db6ea3d48bfe76e95cc8c685739a,t,21000,2535062,,5000057,2018-01-30 13:56:15,87
0xba91783fa92e29b9571ca195cfa0b0c46ac4f380b388d18ac1c8c8e8a8b56ce4,t,21000,2556062,,5000057,2018-01-30 13:56:15,88
0xc235ae7754c75f3e343a19b149dbc436b871785e863c0388647d36a5f456ae32,t,21000,2577062,,5000057,2018-01-30 13:56:15,89
0x165c803037d55367c24ee41f09b40f716676957eeef962fa6141cac0996ffe82,t,21000,2598062,,5000057,2018-01-30 13:56:15,90
0xd06caf3587c4acffd0f9b7b166667193b1aa8badea0294fed38a1e0bb6d873aa,t,21000,2619062,,5000057,2018-01-30 13:56:15,91
0x0cd4ba9b7542a496766a101fad3da2dbbeafd27588ba37de77b8ab36b6030319,t,21000,2640062,,5000057,2018-01-30 13:56:15,92
0x87ea2d1c95f3e36812a5bb8e6a6f294026b670eddf6aad8e99287f0ed6a147a8,t,21000,2661062,,5000057,2018-01-30 13:56:15,93
0x75678ba2f2f8f7e8118a906e8e3a842f582f7a99d792216b3462b872375ef0c8,t,21000,2682062,,5000057,2018-01-30 13:56:15,94
0xcb70c6bd4951c62176562d7a006be6b27fe06264891156df28c8691356232fec,t,21000,2703062,,5000057,2018-01-30 13:56:15,95
0x2aa848e3cf1498bf1bfcaf7482c2bfd79838f1161cfc28f74336d16c0b34f38a,t,21000,2724062,,5000057,2018-01-30 13:56:15,96
0x5fc527403e4b34707ca7d4bf8dded729eaabe2ba973e067e7e647282db034781,t,21000,2745062,,5000057,2018-01-30 13:56:15,97
0x5966a19003680a11adec460d86564ecb2e40007439b9216a0319af5b8e2f917e,t,21000,2766062,,5000057,2018-01-30 13:56:15,98
0xcb23c5861901b9134953c32a1636a712b33418b142bd1f315a1201fc7c42f80b,t,21000,2787062,,5000057,2018-01-30 13:56:15,99
0xcdefa6784f8da973954a8796cbda4fa87f75b4ac532966f862edde9491b4b1bd,t,21000,2808062,,5000057,2018-01-30 13:56:15,100
0x32408fdf01a4eb219f7b06ae0e55fe1be310922b34c4c967dee90cc0576b3e92,t,21000,2829062,,5000057,2018-01-30 13:56:15,101
0x9ed07acbbd1fe8b84f7d9ecf73933f421ceda69e34a38dc90d441f46eab5c536,t,21000,2850062,,5000057,2018-01-30 13:56:15,102
0x7c9d7280ba1a074bd2ebef9a2662938ec7bb3f7bdd66488280f6f794e503932b,t,21000,2871062,,5000057,2018-01-30 13:56:15,103
0x4c3ce6ecef2dc466869cbc66da8b4a780164928eb442b9eafff63e3c74632a88,t,21000,2892062,,5000057,2018-01-30 13:56:15,104
0x20326f6adc8701c1962aa1b3b5184696d7bc91d8c121b3f12eabb5e08dcd72f0,t,21000,2913062,,5000057,2018-01-30 13:56:15,105
0xd9e40c167dd5b4c9190f56b5212d9a7f80bdf0708feb09db18848408870f169e,t,21000,2934062,,5000057,2018-01-30 13:56:15,106
0x0e83ffd2ba8c029c23ac5a52d141852fb56253dad0fb1c52bf9c1169c6fceb0a,t,21000,2955062,,5000057,2018-01-30 13:56:15,107
0x30d69fdbcb6c114b031f90013234a93308a9e1148228aef3f1ebd31ade3602bd,t,21000,2976062,,5000057,2018-01-30 13:56:15,108
0xff7825183dcf4ec893529516d398633bbeb636116e3dd89aa38efdc430ecf8bf,t,21000,2997062,,5000057,2018-01-30 13:56:15,109
0x26acd2c021514cbedc2653859999ae16bffe0a22b5e29f0eeff9deb8df535e70,t,21000,3018062,,5000057,2018-01-30 13:56:15,110
0xad89a6568aec7b463069de01b4dcb521c27f794b30f5ed439777b6dc524a350a,t,21000,3039062,,5000057,2018-01-30 13:56:15,111
0xd9bdcc068e684d7a4baa001bead1d650da35ae80d4f556f4c5668b8e5cc76185,t,21000,3060062,,5000057,2018-01-30 13:56:15,112
0xa8b6cd094087020fa71f4b102c8409bed151c930e5dd276150306fc101038a5d,t,21000,3081062,,5000057,2018-01-30 13:56:15,113
0xaa81387188a0c3c85abbb327d849b6d9a1ed7d52ca92650bffe7efd626a359dd,t,21000,3102062,,5000057,2018-01-30 13:56:15,114
0x90aac3fe77d596a629f6d0111073960575f02ae68a266f737b4960d4945ced43,t,21000,3123062,,5000057,2018-01-30 13:56:15,115
0x7dbcc433f58f1d95c5ebc841e264b4c4e414d752e348e409432249409352daf6,t,21000,3144062,,5000057,2018-01-30 13:56:15,116
0x8449aeb41fa124420609b8cf6ac8e13e63382fd01c49ac0679ae25abac7493bd,t,21000,3165062,,5000057,2018-01-30 13:56:15,117
0xae2ca481e052edf8c345f124d77165b95448aa6d91c04894dc70009d46798d08,t,21000,3186062,,5000057,2018-01-30 13:56:15,118
0x7b62ec20893ddf807d6e11f420b1ab7208cb82f63439fdf92454ce23dad450f2,t,21000,3207062,,5000057,2018-01-30 13:56:15,119
0x9dcee47d869ccb7c2536cebe580316220d84a45ec89b28d9eaced4cfbebbf3e4,t,21000,3228062,,5000057,2018-01-30 13:56:15,120
0xd598cb017c606ce0e7d095d5e42c09f63d6cae1ede892695a659030750ec5fbd,t,21000,3249062,,5000057,2018-01-30 13:56:15,121
0x78cdbc1a759bc8c0f5b36f0bba192f699265262e7e01fb0a7312c2470c31c254,t,21000,3270062,,5000057,2018-01-30 13:56:15,122
0x556babd6ef103a6efaafe8ebe704620615d7894ff5143a8e48e19e5f6efca8e7,t,21000,3291062,,5000057,2018-01-30 13:56:15,123
0xca6989d6c58b91e33d26ed324c8eb3ad1d4115236fdc6b8c018ffb5c2ce5c147,t,21000,3312062,,5000057,2018-01-30 13:56:15,124
0x79e6ac0b544dce6b57b46de6955df3715e0a7a6bf480559d902e70a104a39169,t,21000,3333062,,5000057,2018-01-30 13:56:15,125
0x5df8952bd30ced7cd469d27703446305df1ccece4d14d87108ba753d52ad0592,t,21000,3354062,,5000057,2018-01-30 13:56:15,126
0xdb26256600e68e485b6e825460aa7f1b7929aae6c975c6fe5fe0f419a6059c60,t,21000,3375062,,5000057,2018-01-30 13:56:15,127
0xdefa984e87e71e01d7e94360bbeae62679ea33c519a659891ecddfd947686c0a,t,21000,3396062,,5000057,2018-01-30 13:56:15,128
0x2dda46e497d214db1dfb4a098552179a0b675536007b07a584cab3a68e3e078a,t,21000,3417062,,5000057,2018-01-30 13:56:15,129
0x0ec787c64532ce86e4e5630b9a37e7c78dc0063eca32861067cd0bdee230efc4,t,21000,3438062,,5000057,2018-01-30 13:56:15,130
0x4d3656c9581f5d4e7e78e7480dc19d35e1fc84722fd4b7d65488cc5337c3bcb1,t,21000,3459062,,5000057,2018-01-30 13:56:15,131
0x107a007257c544f98274027332ec53c91b99e4cc5b397b20c68a335443b3cbf8,t,21000,3480062,,5000057,2018-01-30 13:56:15,132
0xcfdb4ebe0a7414fb6d789bbd03cb89130733e32a510d3abe7be2c9c08b015d3c,t,21000,3501062,,5000057,2018-01-30 13:56:15,133
0x1ea50b0b79944152d3caee826fd02ca08c02b49983759d46077d90fae6640cdb,t,21000,3522062,,5000057,2018-01-30 13:56:15,134
0xf57a1efab79d63c04766d92f347e974fd428d865bdf6e38f5c08406ceaa6cf73,t,21000,3543062,,5000057,2018-01-30 13:56:15,135
0x24157223d2dc3a580f6c8862295344b86d41426c7a517dd92cbd7918e79c96ac,t,21000,3564062,,5000057,2018-01-30 13:56:15,136
0x189a6e34649bc9eb1928a226f5b00720c8df43ebb156dc8698ee714aa686d100,t,21000,3585062,,5000057,2018-01-30 13:56:15,137
0xf10143e06ffeaa2683796ce6a273a4ffd8a4f5c1613137a4ef53bd1ab34e1b99,t,21000,3606062,,5000057,2018-01-30 13:56:15,138
0xe0142760c5e9ae9d73ad26e57d3ce3400aa4bfeba7d73200f4d9ac16c7955f95,t,21000,3627062,,5000057,2018-01-30 13:56:15,139
0x20bf58cb4bab6311caacd62c0844d98c44a779a11fbf355a254c8755f20083fc,t,21000,3648062,,5000057,2018-01-30 13:56:15,140
0x6a34259fcdcda1c236d66ae4d9cb585650559732b6533f62968495c2e884f619,t,21000,3669062,,5000057,2018-01-30 13:56:15,141
0x69dc64043dd2ca18fac8c416d64e14d3654b792143d86b5ebb6ce451da158297,t,21000,3690062,,5000057,2018-01-30 13:56:15,142
0x3e3e4aea6d1c22dc689e526aea41f7f7c2e6ce63f7894a3f5a89a87241624ade,t,21000,3711062,,5000057,2018-01-30 13:56:15,143
0x78942cf399f0bc4dec35fc35888625c6107a6be9928cd5e146dfa0ffe1b915d4,t,21000,3732062,,5000057,2018-01-30 13:56:15,144
0x8b9384b6deadbde1256150ba85bca9190ef29a1ccd773ab35e6de905aefe3e42,t,21000,3753062,,5000057,2018-01-30 13:56:15,145
0x8826b7fa48e6d62dcf3599f9ce49c774808d5016f40c04aec280dfc095aeb228,t,21000,3774062,,5000057,2018-01-30 13:56:15,146
0x4b9320c67982e0054c70e9a5838de53c5fb4858aa3baa85217605508c91dbede,t,21000,3795062,,5000057,2018-01-30 13:56:15,147
0x02eaeb9f13176fc6fed0bd770acd7091bce001236173ed1c68af46fb5f8536bf,t,21000,3816062,,5000057,2018-01-30 13:56:15,148
0x66f8faa092dc4c5814c47b74f1cc0092d67641b0e3d1e5681db8dc52a34a6dad,t,21000,3837062,,5000057,2018-01-30 13:56:15,149
0x3492541b7bd9aff9d8e320bf6fc3916277654acd60dbff0614cc85f14b00b16e,t,21000,3858062,,5000057,2018-01-30 13:56:15,150
0x363f705a147021a48c9de508e772de6aa0aa53a3f186f7c7eb2d1f53ed164837,t,21000,3879062,,5000057,2018-01-30 13:56:15,151
0x29f17542c159bb242726069e08417d8f5a88c64ba74c8b9b52ac86f646805c90,t,21000,3900062,,5000057,2018-01-30 13:56:15,152
0x32abc9a5ec868170c3d1868238e2958d5e33bc45b3dce1bb4228bdedf350b706,t,21000,3921062,,5000057,2018-01-30 13:56:15,153
0x7c5bf7c733e6712d90eb8a768e2b8b763ca95fdd9a0153aa9da552e63b6b03cd,t,21000,3942062,,5000057,2018-01-30 13:56:15,154
0x3c5171e524f3be681ee9f077564a6fb3bf54833e0f4e254121336e85e440c84d,t,21000,3963062,,5000057,2018-01-30 13:56:15,155
0xf6b49bf80ec08e59cb272b6dc6bf7a2e15e66e08a3314aab77285eaa59b344dd,t,21000,3984062,,5000057,2018-01-30 13:56:15,156
0x6b4dd31e039a50df59ac276809095a45cdbce6911e06231c1797199cb2e4a909,t,21000,4005062,,5000057,2018-01-30 13:56:15,157
0x5f7939364fd4b3397d1af851420962b5fc4afe53e3bc5cd98d87e859a95283c0,t,21000,4026062,,5000057,2018-01-30 13:56:15,158
0x17df71416f1b20783621da38b014772e50a5a6efbe61ad96d6df3f4692e2ddeb,t,21000,4047062,,5000057,2018-01-30 13:56:15,159
0x0236bc371314773c5f2e5e9fd77f514f694ce785a77ddececdf468b4bab4819c,t,21000,4068062,,5000057,2018-01-30 13:56:15,160
0xbddd40fb87c61dcce3695e0cfcce790e37555f6ad1479bcc4220aa3377da2210,t,21000,4089062,,5000057,2018-01-30 13:56:15,161
0x0d9426aaff3c2209c1b3a9367e845f2d151e7ed518bdbc626700fd23114c3dd2,t,21000,4110062,,5000057,2018-01-30 13:56:15,162
0x2a9db8dc2bb8828fc7854bd9f54b43b194c1114c94977b9b6186e740dff68028,t,21000,4131062,,5000057,2018-01-30 13:56:15,163
0x0b9812a8b62059a0c9b5b8ab0e42b5e1c9f838ac08c39e15462b24ad94212c82,t,21000,4152062,,5000057,2018-01-30 13:56:15,164
0x119e0cfe4eff5d7e817f5fb2f086ea60d7a875bd79f82ce1860521a7735b0d03,t,21000,4173062,,5000057,2018-01-30 13:56:15,165
0x01692c67dd6b501d30250c3f57a9e3441fbad1a0f88dd2c101e4f0d70adc2889,t,21000,4194062,,5000057,2018-01-30 13:56:15,166
0xb6f1fb9a32c6e5561d28bfbf14a86d0e16f3bafd1f89388c7322b9c03ea60a55,t,21000,4215062,,5000057,2018-01-30 13:56:15,167
0x8673dc9bf3f009183b1188de76008e8f647bf68d67db338e5c3c9842480af0c0,t,21000,4236062,,5000057,2018-01-30 13:56:15,168
0xc201b4d813c23b801fba4dbb69a30527c18615aee1b8707ee4fcfa67eeab0cd5,t,21000,4257062,,5000057,2018-01-30 13:56:15,169
0x8f375be19a00611f0767e6b5448de6fba0000d2cf59d9529b2f9181ebb3ce872,t,21000,4278062,,5000057,2018-01-30 13:56:15,170
0xb56760ffd9b6bf7e851a96fd29e17d568c7c0e0d2a1f8ee4f390f647c80c0b83,t,21000,4299062,,5000057,2018-01-30 13:56:15,171
0xe0202e62ade2f5108fb1b124547d7f4f483bc4a3d9865f9f5e038fb7b31d0103,t,21000,4320062,,5000057,2018-01-30 13:56:15,172
0x6c0df38bdda4b037f701052febb5f9e2499016559de2bdadbbba2d24c81e12ef,t,21000,4341062,,5000057,2018-01-30 13:56:15,173
0x39eeddcfb5436eacb5cb165a7f076ad6544c3a9f0f1cb4ec966d7a4ddddcc6cf,t,21000,4362062,,5000057,2018-01-30 13:56:15,174
0x065fbe8afb5f98500c9b12de05cb682ba83b2295f632d78f7471be2fe9bba5f4,t,21000,4383062,,5000057,2018-01-30 13:56:15,175
0xf86ab18c434aa9bbd080cb08fda93e2ae17ebb6a8fdc29a2339f4aa41e0fe40f,t,21000,4404062,,5000057,2018-01-30 13:56:15,176
0x3ad37d16a5f15dad89bbfd7cc1b2866597001640b2358b16ceaba3177a68e7bf,t,21000,4425062,,5000057,2018-01-30 13:56:15,177
0xe2e5ca849555c67906efa8ac2441303ef04f9006264ed4bb6246151a662d4758,t,21000,4446062,,5000057,2018-01-30 13:56:15,178
0xb64c62833b5dbcefb9057d4a9948abe4faab6c4de92d30601ee4370168261845,t,21000,4467062,,5000057,2018-01-30 13:56:15,179
0x73f6e036f266374855858a2f6ff1d3189d8100ac7ead78070e859c4ef7e22ce9,t,21000,4488062,,5000057,2018-01-30 13:56:15,180
0xb1ede6b95884bf2b1664e6758ed1852cb98ba5172f97b6f6c56eddcc15894c99,t,21000,4509062,,5000057,2018-01-30 13:56:15,181
0xf170c15a494e349f1f77c15ce31b01b2796c1b13ce3f6ed82799ea11e5f59420,t,21000,4530062,,5000057,2018-01-30 13:56:15,182
0xf2ddc3492d0a944c788e18c727c5e8b8004bcf83f8a663f61fbf3010a29d6f97,t,21000,4551062,,5000057,2018-01-30 13:56:15,183
0x48daf358a43abdb526923f78cf869987543acc9d7280e806cd1fd6ad978e2d9e,t,21000,4572062,,5000057,2018-01-30 13:56:15,184
0x3078d8809023ffc647aadf837b08a2e74e8069a89d28315c5cadfd39fa095744,t,21000,4593062,,5000057,2018-01-30 13:56:15,185
0xe39bc08959806eadc80dc6b2320574c7899b4a94df5452030b6fa8608e908b4d,t,21000,4614062,,5000057,2018-01-30 13:56:15,186
0xf521ef53c462cca0cbc72545d4295c6a63435adf1ae8380a8884105c09cc95f7,t,21000,4635062,,5000057,2018-01-30 13:56:15,187
0xfac61d8f5735e20b01876296cd55a393b8e0482e3a153de211bbf71a0b67364e,t,21000,4656062,,5000057,2018-01-30 13:56:15,188
0xb5e01b3c4389c018059d015f357799184b034360fb23f779424fc684e01fcb60,t,21000,4677062,,5000057,2018-01-30 13:56:15,189
0xcdba9f99316f504a6f47e7b9aef424de85091bdba933b9c9661c50a63eae9d8a,t,21000,4698062,,5000057,2018-01-30 13:56:15,190
0x12280228d61b00e1e110d90c8f5e109f41a66b1b47f8be4f5af0ed8c76bdf3a2,t,21000,4719062,,5000057,2018-01-30 13:56:15,191
0xd868f92fef36e1c25a69476f88909384ff8525dcdcb4a23aa9225cd776f4dc46,t,21000,4740062,,5000057,2018-01-30 13:56:15,192
0x3253cb99d374aa2a46582e055a27e764fb8dc0f3c3b6ee66b13e9c9f20d8f0a1,t,127644,4867706,,5000057,2018-01-30 13:56:15,193
0x946d67a546c1c6238d76adb2bf1f5402404cac886c6b474d8a2a462e9c5bd61c,t,68005,4935711,,5000057,2018-01-30 13:56:15,194
0xb029006388d834b40ff9887d2bce1d14c250a32d03586a9b65f0e7118cf95763,t,91568,5027279,,5000057,2018-01-30 13:56:15,195
0x591730bd93dbf9ae61df79ad700fc96d1130c36cb142df6da289db147fa532a4,t,157708,5184987,,5000057,2018-01-30 13:56:15,196
0xd6d6e186e54c70b866c2446346d1a21e3b31c7e12781e0e82517f1b9d4eadc3c,t,142388,5327375,,5000057,2018-01-30 13:56:15,197
0xacd2de213ee1885a02e5814d1fd4a595d6c05f7e1fb6cbcc39ece3c0cdf7e15a,t,157452,5484827,,5000057,2018-01-30 13:56:15,198
0x6f20af626ad992983019ceb8934bd6c5675c340f53b8b56ea8ff4518f85c9a69,t,92853,5577680,,5000057,2018-01-30 13:56:15,199
0xbd550b621aa624be09c96c8270a2ff9fd2cd54ec18300f9ee392ee39866aaad5,t,67941,5645621,,5000057,2018-01-30 13:56:15,200
0x46ceba4af95a335c0049903b2b4aa8c0580410dc6b3fdb4fd4ec071b09309f17,t,67877,5713498,,5000057,2018-01-30 13:56:15,201
0x3b5382ae7caf500f6bb3ae219f9879eed85b89e76daf3597c0653956a3814c8b,t,93031,5806529,,5000057,2018-01-30 13:56:15,202
0x45f8ef58416b2f8cbc2678c41cb8e4060633e1bd22d301f88db99e5c25f36494,t,157772,5964301,,5000057,2018-01-30 13:56:15,203
0xa015b254a0363332403b0c76878112eb5408c2fe8e51ddb1917ccc9bdd4dca1a,t,142772,6107073,,5000057,2018-01-30 13:56:15,204
0xae221b8587d3a3836aca91bbf9bee34a93d6a88a320c5c13d1a82ed840aa5cb0,t,142516,6249589,,5000057,2018-01-30 13:56:15,205
0x723b15f1f3b5a58c5894953addd1f1f1c565d220c597ac07c85072730848c57f,t,76955,6326544,,5000057,2018-01-30 13:56:15,206
0x06f4eb3d823a407def04c06955bb37141a15815688c798208b35cdc5719ff8f4,t,127772,6454316,,5000057,2018-01-30 13:56:15,207
0xe7a3774d4fbeee0c84d4e3581c63a2984438f60c088dc7e36a2ad487f5d66e56,t,157836,6612152,,5000057,2018-01-30 13:56:15,208
0x057d3fd7e6499ab077efb47a583e539245bbdcd4917daf2ee36a43d69ba208bd,t,82685,6694837,,5000057,2018-01-30 13:56:15,209
0x7a564bb24005a1d7f7f743355b7543925379551fb9570f99b647ee453ae3682a,t,142772,6837609,,5000057,2018-01-30 13:56:15,210
0x2cb26255962a408226c2f00799959eb52f722c2b383fbd206e79d2f41ab6b13b,t,67813,6905422,,5000057,2018-01-30 13:56:15,211
0x65e87e57b2f998ca38f69aa0c733b61797c1ba12099ecc3a7fca5f6d3c32ca8b,t,92248,6997670,,5000057,2018-01-30 13:56:15,212
0xda20822731589077ace753f2b3334248f4721ce2f754cd1b0f2a33569b4282fe,t,142580,7140250,,5000057,2018-01-30 13:56:15,213
0x4ffb6cac63c1d18f9c6707402ca96216ea73b4a93445d1e3becaa1339dba8bb8,t,67941,7208191,,5000057,2018-01-30 13:56:15,214
0xad77360dda3b55110f597f97f0a2c7195626d7383228cf64f2603dce192aa8e6,t,142900,7351091,,5000057,2018-01-30 13:56:15,215
0x8f5fc7e2b1383375f5120ccaf0fa1dc3b65ed7f28ebe6c7047bd7a89a8adb315,t,67813,7418904,,5000057,2018-01-30 13:56:15,216
0xa255d0598f08314951e5cbbf9832c448636f48d530e94bb235511788c67d6e07,t,142836,7561740,,5000057,2018-01-30 13:56:15,217
0xe2858883f4a6ecb5b7cabf1448e6ea0049f4a211d82eb11fdb5a84913ddd9408,t,67877,7629617,,5000057,2018-01-30 13:56:15,218
0xe114a27a3c32c65671a13a1e77566781dcb5cd49da91a96bd4d4844e8a5e0d7f,t,31984,7661601,,5000057,2018-01-30 13:56:15,219
0xcbfca60716f75f1488fad471fed5c5f7ab0bf84e9bd55e6cce48c14b09ff9e6d,t,52139,7713740,,5000057,2018-01-30 13:56:15,220
0x585b1600e40eb56b1fdb8e9f6bbe2f9dc76652d978ab426fba122456eb736805,t,51347,7765087,,5000057,2018-01-30 13:56:15,221
0x4485424d7601defa5dcc31732b7628f2b783c10856886e37189fe407441c510c,t,36347,7801434,,5000057,2018-01-30 13:56:15,222
0x0abfa52aa5b08e09423ebcfa9d381ab0ab526056714f0b023105473db581715b,t,55843,7857277,,5000057,2018-01-30 13:56:15,223
0x538e14db39a6b4f89354fbc50a1bd2738d8e10c0bcf35f7a533f981711d14f29,t,40907,7898184,,5000057,2018-01-30 13:56:15,224
0x647e106e1d85e3eaca0b16f34fa2316b93bba8457be8928100ca68f2b3afeaad,t,52380,7950564,,5000057,2018-01-30 13:56:15,225
0x27bfa15ddf02955dbd326c2550b61d6463b69854a65e486285fa20687f4191c9,t,21000,7971564,,5000057,2018-01-30 13:56:15,226
0x48798a71d7376f5658f347ecc78ae152e8a005ad36e172241df3dc96dbbc68ce,t,21000,7992564,,5000057,2018-01-30 13:56:15,227
0x9124d60c53f52470df5236ce94b43e77584a7cabc95c1cc2750cf8bef52d33cf,t,21000,21000,,5000058,2018-01-30 13:56:20,0
0x1e59f21416079a4dab60dac0067e31184b4219affa6703c4ba8e450632e5621b,t,21000,42000,,5000058,2018-01-30 13:56:20,1
0x22371ab193de7f0853720b56dfa4e99253f9f9f2c9d350fdf8e30c47ec28e5fb,t,21000,63000,,5000058,2018-01-30 13:56:20,2
0xaf0584b52ac712d174bbd05fc44db1ec40f5d570e3da464706fab7aa3734f165,t,21000,84000,,5000058,2018-01-30 13:56:20,3
0x8b4f4be341152b4c6ec154a526a20b8a58e386873f3f403b65bc1bc045821b23,t,37402,121402,,5000058,2018-01-30 13:56:20,4
0xe6f21340ff48ff308191e56bc409a9be37f71c70bfe0a844580191fda853a3b7,t,36915,158317,,5000058,2018-01-30 13:56:20,5
0x263d4b54b37b23c2175ea0d338289a126467e528f710179d3c55420daa638721,t,21000,179317,,5000058,2018-01-30 13:56:20,6
0xc337e8543338e87b9780d30b3b9a2209250cce82718bb6dc925eae51bb1dd109,t,21000,200317,,5000058,2018-01-30 13:56:20,7
0x610b5b035305aefef9f6b7ef14e070ec5a4dad45c2b1d3e7b6ed8692a9da28d1,t,52886,253203,,5000058,2018-01-30 13:56:20,8
0xa33793eae3bafaa5e9dbc1c5a5c7eb19d6acdadc637e48d5b51cfc305f9fdb86,t,37048,290251,,5000058,2018-01-30 13:56:20,9
0x84e8699c8d374766d2d2fe678d8d9ef2069092993ff97f35cf13c4fe9ceed4cc,t,54835,345086,,5000058,2018-01-30 13:56:20,10
0x97c04ecb08b0d7819e191a7da213c7c9817425ce19bb03cc66776e07d3f26a55,t,91794,436880,,5000058,2018-01-30 13:56:20,11
0xe31581e78191b0e0027c44cd6ca6c5995c04b4242235506a5fde5985d37c5298,t,52237,489117,,5000058,2018-01-30 13:56:20,12
0xbe05e1c838dbb601dd536e834f923e67691b8648d0abf174767756e356329a59,t,37019,526136,,5000058,2018-01-30 13:56:20,13
0xed7643468bce9aae40bdf46595c2c42bfdfbc67094d5b43bb7bc82ce65e51747,t,40907,567043,,5000058,2018-01-30 13:56:20,14
0xe0b24ec66ffbc61ad59edcd3e08091612402019d69b25a5caeaa3eab8518fc00,t,52313,619356,,5000058,2018-01-30 13:56:20,15
0x8c721add531252f74022601c348cfbb2ff17797d54468b0d0170459ef87bf56f,t,53590,672946,,5000058,2018-01-30 13:56:20,16
0x3c68353f0ff8ac3388a5007dc8ba2184efbe6dba9b19e4c2727a6675320e888e,t,40907,713853,,5000058,2018-01-30 13:56:20,17
0xe95edd9d2c281df2ad2a00ac131b3bf4d59584e892696338d34450da700b29ef,t,52766,766619,,5000058,2018-01-30 13:56:20,18
0xfec425dbeb0ecf44f2eb68df88559034e69373ac87d724fb9e168b88542dbf47,t,21000,787619,,5000058,2018-01-30 13:56:20,19
0x2435085433cea1b3118116bf5e7cfe4fb9ccd10f7d2b5b8e666a5b7b5d788e56,t,253854,1041473,0x1bb1C5c6715b1c6d9eA758DFF7d1ea9C44b9a66f,5000058,2018-01-30 13:56:20,20
0x9a2609cef8640f03d8fe2f9893e88113896d4a152948342325c32df05f9ca50e,t,36728,1078201,,5000058,2018-01-30 13:56:20,21
0x767f66f84a5d387b0f3b707cd726420c92d6148539905d12329dc3149913018f,t,53103,1131304,,5000058,2018-01-30 13:56:20,22
0x11351e6f4e5ae854946f7b311bb7772aabed1f724ab925351713a11c63959aac,t,67621,1198925,,5000058,2018-01-30 13:56:20,23
0x479546a13d00ad2f4c0a50caceabe9ce57ed0c5f71054ecf9fc207bd2d5c57aa,t,21000,1219925,,5000058,2018-01-30 13:56:20,24
0xe161f32affefd29682bda00cdc289941df6f41658cf5300bf06cd3edd640fe55,t,21000,1240925,,5000058,2018-01-30 13:56:20,25
0xe095ea33224af35cd873757ecb31ceac1ba768a571f7adae8db510bb4f7d2d3c,t,21000,1261925,,5000058,2018-01-30 13:56:20,26
0x9a5b097691447082bf0ea98c37234ba1553c8f72458b788a8b294918fd512e07,t,21000,1282925,,5000058,2018-01-30 13:56:20,27
0x1d3b0e92cfc2b8c10c3aeb8e34d90f2a87db95902547bbd4e38aee6e7af80772,t,46045,1328970,,5000058,2018-01-30 13:56:20,28
0x061275a43c5ed62eed25b3ce209a0161fc6256bae8616a0e2308063ab053e3c9,t,52148,1381118,,5000058,2018-01-30 13:56:20,29
0x5805ca7c9f604758f0f62fa9dcd02802ecc4b87c62898cf063b4c65a8001a03a,t,21000,1402118,,5000058,2018-01-30 13:56:20,30
0x8457306bcf9d18c663cfdac9e35b71a1144aa8d61daed0520eee377110edb970,t,21000,1423118,,5000058,2018-01-30 13:56:20,31
0x5cf4c5b87515d8b408b35396de3cb09790b6f05b5504c4a7d5d7910bb1386117,t,21000,1444118,,5000058,2018-01-30 13:56:20,32
0x32abef25035588bb0262b6595a449fbc8fd33f7d5c4a18edca42e2d80332c11f,t,22219,1466337,,5000058,2018-01-30 13:56:20,33
0xed8758d3b40bda1b36458fce5503c3658af9cb009d422451b58a7c7f61a72c8d,t,22282,1488619,,5000058,2018-01-30 13:56:20,34
0x8913acade568df518b9a7c8cab0766a0bf7014c313577fb51f1a0587c1bc2401,t,22155,1510774,,5000058,2018-01-30 13:56:20,35
0x123ee7306baeafa0be11c0527c2a9ae199e8b7455e6ef60877779115bdac16d6,t,21000,1531774,,5000058,2018-01-30 13:56:20,36
0xadb7a356a3686fa5803cc4404e9aa706342ee6544fa6bda6a83d6642b7e78073,t,30327,1562101,,5000058,2018-01-30 13:56:20,37
0xcb623db5559e727e469e16f1768d4d41476776456631a608592ddfb9476c3815,t,22155,1584256,,5000058,2018-01-30 13:56:20,38
0x4556c0dc2a5013f878c2966c6d7863feed89c63b978ecaf3f5ec6a35c2e43845,t,21000,1605256,,5000058,2018-01-30 13:56:20,39
0x7cedc89927c5fd631a830deff54a8db46af36ed9fa8447bb7eab58cf541148c6,t,21000,1626256,,5000058,2018-01-30 13:56:20,40
0xdfd8504f1802d88d7c1595c7687ab6fa6d138667131810eec1b3bb2e5d8fdd9f,t,53162,1679418,,5000058,2018-01-30 13:56:20,41
0xa38875b0761f304e31cb10565ae0eb7087fb1236f31999aa33be1f39fa86e16d,t,22495,1701913,,5000058,2018-01-30 13:56:20,42
0x95e95fd941ae41b792659d30dc52e98ce22c7b7da174cdeba01c75589b8c4755,t,21000,1722913,,5000058,2018-01-30 13:56:20,43
0x4f816e316c6497ca728bd2ffe47146358e9201229e9709256555eb5d359d0c4b,t,21000,1743913,,5000058,2018-01-30 13:56:20,44
0xea05b61d53602f2f5ab02983dab7a0b52c0eb2c53313126bf1c0f3a74ab764c2,t,21000,1764913,,5000058,2018-01-30 13:56:20,45
0x0cd13f4cdf07a503161fe242c27d66a5c7149815781c6175859269ce017eb5bc,t,21000,1785913,,5000058,2018-01-30 13:56:20,46
0xc692950c95a2d9709c9b488751bbb7cdcb358ba8a0e4c64fce85be699804625f,t,21000,1806913,,5000058,2018-01-30 13:56:20,47
0x036a6baa82dbd72511a475af88c04f08c14106e8092e1fa01918b575d5780fe4,t,21000,1827913,,5000058,2018-01-30 13:56:20,48
0x0aae15e3b5fd900a05642ce53c862a7bd53ce0e334db1595c89444a1649d7561,t,21000,1848913,,5000058,2018-01-30 13:56:20,49
0xdfecaa4af30773c0df82b6fb2ebd51d3519b440cb0dc5ffb82859e1d5d11fa24,t,21000,1869913,,5000058,2018-01-30 13:56:20,50
0xc8c193c82d9ff5120909b21ada4140de5f127cb743a6935d41b48bda834e94d1,t,21000,1890913,,5000058,2018-01-30 13:56:20,51
0xc565170dc463218f96433699968a9dbc9b3e90e265c8479165c53f04dd842b80,t,21000,1911913,,5000058,2018-01-30 13:56:20,52
0xe456a099d390c4d937daf0422e9e56545e0f20de152e52c421efc34e54b48727,t,21000,1932913,,5000058,2018-01-30 13:56:20,53
0x17e3a15264090467cd99540884e086f5b4f695501d4136eb68b8f4601149e615,t,21000,1953913,,5000058,2018-01-30 13:56:20,54
0xa8a332bea4f8200b950be7d8da76ec06b28c6cb1978ff4e472e17065a7395855,t,21000,1974913,,5000058,2018-01-30 13:56:20,55
0x405166d3718582cb45d9db3f272349785d83651484af7c9fea5ed6837310abc3,f,21000,1995913,,5000058,2018-01-30 13:56:20,56
0xd638891359709e460585f3672d5cf95ab158f214d503eef0006b52e0fb4b4779,f,34293,2030206,,5000058,2018-01-30 13:56:20,57
0x9f82210e8c9dfb18d51db95a363ba3252f9649807ed4a1ad8323f20e8ebd6e7c,t,21000,2051206,,5000058,2018-01-30 13:56:20,58
0x1fc227a590dac678c3da26bb6bd6879fc9ca947806b26a4968245993830280bb,t,21000,2072206,,5000058,2018-01-30 13:56:20,59
0x08dae1e1bb68ef62ff3223314b1063034620cb9af36d7bc6ecd924fe7e724110,t,21000,2093206,,5000058,2018-01-30 13:56:20,60
0x3de9762a4ccc3c2d229e4be6dd550c6b2145eb916a2e2ec117b26d8d9e356914,t,21000,2114206,,5000058,2018-01-30 13:56:20,61
0x604295dc7682e092bcdb1e99d7ebfbca5f739cadb8df8d21d177bbd6554dba73,t,21000,2135206,,5000058,2018-01-30 13:56:20,62
0x03d2329edab3b13c28d768b0f90b71b1d6c792917916cc6ef66be42fd6b55db6,t,21000,2156206,,5000058,2018-01-30 13:56:20,63
0x1bdba53f93701382ae9f954ba895dbd47d20e4e020cba23ddd5f076848c113aa,t,21000,2177206,,5000058,2018-01-30 13:56:20,64
0x282c4c6a2e9f4bfc3ffef3aa9ea1cbb3fac1722c3435828152c10131e9bb5512,t,52396,2229602,,5000058,2018-01-30 13:56:20,65
0x1abb13c75f8481ca6e7bb9dfddf1840fefce5942dd706a17893bf0e9518ac4a1,t,52068,2281670,,5000058,2018-01-30 13:56:20,66
0x9917976b4e82a04c9d59d9fb1548a3c2360e049bb8174bb334934a0ff9c87ff3,t,4679140,6960810,,5000058,2018-01-30 13:56:20,67
0x566776cb5735c24d7ab5a219cd7078752c2d4adfa7c5653aaa73c0c9f65c5935,t,45508,7006318,,5000058,2018-01-30 13:56:20,68
0x5ab96ded6bc9765d78e3d265d19c9de2c293521cf9f150df5747380644b9d5e6,t,113421,7119739,,5000058,2018-01-30 13:56:20,69
0xd7cfa0f7b395aa0f25a5ccf32f1e318d4901df025f741e4385f6d0ef5482d120,t,78178,7197917,,5000058,2018-01-30 13:56:20,70
0x1316b6121b592be778b35ea6d84401ac71576db38844f8cd43cecec6624243e1,t,21000,7218917,,5000058,2018-01-30 13:56:20,71
0x63fc7615b9593c940eb896d6705d6678e49408cd764aae28cd6fc665521b044b,t,93178,7312095,,5000058,2018-01-30 13:56:20,72
0x75cfb62288b775070f8b7b8cf1cb9322a32f9b238c7af89e4e3dbf47c99dc851,t,45591,7357686,,5000058,2018-01-30 13:56:20,73
0xe7c80112cba590566967ebb9a78f463628365f362fc18ae3d8e84f63993a746f,t,45846,7403532,,5000058,2018-01-30 13:56:20,74
0x777091f26ff5d3e18aa9b9bb8478e0d14238e93c5f40c8dc60db4c1c2983c49a,t,59418,7462950,,5000058,2018-01-30 13:56:20,75
0x3412495a734a5b9dd6e5bf0e970b9489a6ac6f58946c0040b508fc3beb13e955,t,21000,7483950,,5000058,2018-01-30 13:56:20,76
0xf6f204a24f8ea3c45fb6f6d07953cd174d49bd5b7e8aec0d697f5183716b2156,t,79985,7563935,,5000058,2018-01-30 13:56:20,77
0xecd34ffbaa5700231ea6e9ad83c002f5569bcdea7b5c7dba526c3cbb564b6c7c,t,34725,7598660,,5000058,2018-01-30 13:56:20,78
0x90d7870ec10a22ce19193887e621f141af1655f251b6473cd762f2962e5e3247,t,52344,7651004,,5000058,2018-01-30 13:56:20,79
0x3ca87d8dacce334186cd30d3bd6a6ed1b548f7231eaac7011ccfc04d7c824c30,f,250000,7901004,,5000058,2018-01-30 13:56:20,80
0x872f77c7fda03956e14137d75ea3cc3d58ea2a1d70d8e4b248cc014621de58ce,t,21000,7922004,,5000058,2018-01-30 13:56:20,81
0x175a8948bdfa6d58d8e23073edbe05bf8a6652e2ce1b8553302143e0583674d4,t,21000,7943004,,5000058,2018-01-30 13:56:20,82
0x0663fb9c68bd3d75df734e22a0476f4ace46c5e684024db80ad6dfba6ba7474c,t,21000,7964004,,5000058,2018-01-30 13:56:20,83
0x76dfa353a30f1adf6d063d1cead3f39fde0fa1c5310d3a2d6f4342d2e35b79fb,t,21000,7985004,,5000058,2018-01-30 13:56:20,84
0xd42e3617b46c1d772ebacb28cfdab95f071afabd74adfa38c703a674d835236a,t,21000,21000,,5000059,2018-01-30 13:56:43,0
0xce6ae38b5c3b69d705c52bee9913a6ef9247c25e1c46ab6ef9109867a8376c44,t,21000,42000,,5000059,2018-01-30 13:56:43,1
0xa208f019afad0cb1c4a7ee63e1cd0fbd64fd3dbcc27d5d96cb4e6e37f2937fba,t,21000,63000,,5000059,2018-01-30 13:56:43,2
0x6654c093a52c3fa1e1ecf081d114783332f9673d22f0c4479f309410420d2fa5,t,51703,114703,,5000059,2018-01-30 13:56:43,3
0x9923936a3078582f3bc61fc7afd78690d40e85e1b3fd3b56a2bb2c78c606bae2,t,21000,135703,,5000059,2018-01-30 13:56:43,4
0xf54e4a2a089e32f6197c020ae2f263c6121f8035083e74918413ced5cca168c2,t,52640,188343,,5000059,2018-01-30 13:56:43,5
0x8cbf6acb7cb34617fc38db2d3124a67608b18fe88a794a11b1b1816fb3c990c9,t,52249,240592,,5000059,2018-01-30 13:56:43,6
0x0f6b5d75d5234bd991d6d90c248989894fe143ff4209e4c9fbc5e0f603ac194a,t,34470,275062,,5000059,2018-01-30 13:56:43,7
0x020acf0133183424e0d59ed67f923443cd217fc0c125eb40a14e7422a84a722a,t,34470,309532,,5000059,2018-01-30 13:56:43,8
0xc11732d0b6402ef79417c46826eaf2a2dac7a83cfaf7627b8f6ffe21d2dcf530,t,21000,330532,,5000059,2018-01-30 13:56:43,9
0x3a7c7e459f1de12f57d06ea858c9d3a09d8f09c9da4ef8903e1463c0b7145df9,t,21000,351532,,5000059,2018-01-30 13:56:43,10
0xa2600bf01c2ac528def20ac473e8ba7ede1129b99fb7932801b9d6b8133faa7d,t,21000,372532,,5000059,2018-01-30 13:56:43,11
0xeb780d45c5a94bb9ce1b9c3a87e4f39072dae92c7bee735dfc08d738ff45c1de,t,297240,669772,0xe40Ebe88ca258CB2f4eBae2d79530E57D57E6dac,5000059,2018-01-30 13:56:43,12
0x09fe1677d9aa28c1541ee4e45d09329ad01dde3dbf408f099a19d924602b2794,t,36772,706544,,5000059,2018-01-30 13:56:43,13
0xec56f4346ab77ad3ed58212dfe4d438ef8c66ae6be98688931c6d1a62e8df020,t,21000,727544,,5000059,2018-01-30 13:56:43,14
0x5aaafa0757111912782be4e87eddb5e50dc930563b7a959465640a5ff9e9a8bc,t,21000,748544,,5000059,2018-01-30 13:56:43,15
0x1594a2da9d1a7c3e3aac2832a45d2837cf56117359ecf06a6b76344442851481,t,51606,800150,,5000059,2018-01-30 13:56:43,16
0x2d160ce5bbb9062220385ad827e82c66555b19578decc02217ed7350a0ccdac1,t,21000,821150,,5000059,2018-01-30 13:56:43,17
0xa3dcbb475ce911869e965a57cd7a828587d3d76e3b8faa2f240c549b6cdea032,t,21000,842150,,5000059,2018-01-30 13:56:43,18
0x1ca948f2e31ffc8812dcf3af6ba6cfcb88f50bd80dbd25478b39f64fc9193866,t,21000,863150,,5000059,2018-01-30 13:56:43,19
0x314a2553c7ad0324b790a64c354f5fb1c2a4fa973e0de745466d435caea5abf8,t,21000,884150,,5000059,2018-01-30 13:56:43,20
0x8e045547e2189ea04b124553a69af7de2fc10afbd4623abbad4510805027420a,t,21000,905150,,5000059,2018-01-30 13:56:43,21
0x40d60ddf26893541e1231b1b345f5c9a52e82bf93a042219aa3d9783af8a34f0,t,21000,926150,,5000059,2018-01-30 13:56:43,22
0x9c38e49ba6c5f22f3755420eed63be2bc8db5f4559d666ac1a798791e31cb5ae,t,21000,947150,,5000059,2018-01-30 13:56:43,23
0x77865bf3a73034fd28bdb477c61029f1a218709f2cbed7aceea59e72852a0c22,t,21000,968150,,5000059,2018-01-30 13:56:43,24
0xcdc040fa2f7455f0db237ca6966ba33d48c0c823b9a8b8bdfbb2097c056c3ff2,t,21654,989804,,5000059,2018-01-30 13:56:43,25
0x611170a432dd4fff5a327ad6e40dc2b006987aa481d556475ef46d96a618c8c6,t,21654,1011458,,5000059,2018-01-30 13:56:43,26
0xa50792afff4c6d5d923832ab083871ffadecc377b3379195d3dd0b25cd98cc2a,t,25937,1037395,,5000059,2018-01-30 13:56:43,27
0x7d15c57535c4a63b96d1ca835098cc23f06eec4735248d7d61866366efbf00f3,t,46446,1083841,,5000059,2018-01-30 13:56:43,28
0xc20e551ad769cd147ce7b99bed0fd7101943381fb0321a0637510d0d45cdbd3c,t,21654,1105495,,5000059,2018-01-30 13:56:43,29
0x4eab6ac5f763182fd5956cdd9f9a94a950731d0d4ceb041ad6ca702261030625,t,22129,1127624,,5000059,2018-01-30 13:56:43,30
0xce06f2fe1232d36eeb85b732bb877a74e74fad6c59b10346f9f6d148193ab698,t,21654,1149278,,5000059,2018-01-30 13:56:43,31
0x9a0b752898bd95b06a3c18766dccdd3d72f95c1c05aa6c06fdce43c0c23aa732,t,21634,1170912,,5000059,2018-01-30 13:56:43,32
0x6783720e9f269a4ddfd9e4f161f0ade9df496ed98636d1e1f7d26658d422676e,t,37874,1208786,,5000059,2018-01-30 13:56:43,33
0x73d1be02ef1912d239bfb12f33d7e1eb5cb572f28fd3f4e688d5abb18b9f2344,t,24574,1233360,,5000059,2018-01-30 13:56:43,34
0x5b4a07f63662e6b557fae255d5a8535b563bd17fb180d44f2900b843b6c46614,t,21000,1254360,,5000059,2018-01-30 13:56:43,35
0x3f30c33bd872ec0160ceb4f5b7d853a6da98f9d8d3b5143749d3692d91fba5d5,t,21000,1275360,,5000059,2018-01-30 13:56:43,36
0xd46f4877f2a420a13e5827fdd4de487a3bdeb1477eb706f07fbb6572c6d26b54,t,21000,1296360,,5000059,2018-01-30 13:56:43,37
0x2805268d1f3f4241fff3a601df911b74b485c6e5dc6c423d7f83c57d5f6a653c,t,21000,1317360,,5000059,2018-01-30 13:56:43,38
0x47c32cd56d977e02f6953f1376260e7f52d53d9b343f923ae8dbf7428cc2a1a4,t,52337,1369697,,5000059,2018-01-30 13:56:43,39
0xa4d67a6f35136100e03e2d9185a524c64737546843e497245b0cf31b32db2f50,t,48240,1417937,,5000059,2018-01-30 13:56:43,40
0xaedb67f788000350618fc92220f41cf91e23aef3e8b607f7fae739af9d62520f,t,21004,1438941,,5000059,2018-01-30 13:56:43,41
0x1a9c9b1a4584712c8471ebc13a61764619ecb47ced4d7cd1fbbd24608679124d,t,21000,1459941,,5000059,2018-01-30 13:56:43,42
0xcafc343406cc7c62df1a9c9ad0b95fb01291c81fafb220c330131a51b502f643,t,21000,1480941,,5000059,2018-01-30 13:56:43,43
0xf8d299baa5513b6e9319cded8ffb4d26f92ada1b76b8a16852f0bb60de823b0f,t,22027,1502968,,5000059,2018-01-30 13:56:43,44
0x732cd4dbaa376f26d690fe8ebf63d162edc92ea20a3d511c7a94c56b170125e3,t,21000,1523968,,5000059,2018-01-30 13:56:43,45
0xaa2bc1be47338298c960f02aea54cc9909e792d55870a326d2499d5f890b138d,t,36915,1560883,,5000059,2018-01-30 13:56:43,46
0x611164c63f7dffdae730468e359ac4ac79572eb6af3a37eb107a7eb9aef481e5,t,36915,1597798,,5000059,2018-01-30 13:56:43,47
0x3dee83eb6ea378bdee572757e434cb73ec8ec6a8dc5d24a636fc12140c1e392d,t,36915,1634713,,5000059,2018-01-30 13:56:43,48
0x356c5c49c7e4da9d896274cb0cafcdc88c702b7c06a01f1b7a3412a7ffc6ddd0,t,36915,1671628,,5000059,2018-01-30 13:56:43,49
0x9def72a52ff2624b88b8f1fff4f4f3b2805f3fd4a8e48d321bf285df28b23599,t,37065,1708693,,5000059,2018-01-30 13:56:43,50
0xd36ac1d94fe77d7d921a0b5a34ba27709b28345dcd6b67e8378e18a8282ccecf,t,21000,1729693,,5000059,2018-01-30 13:56:43,51
0xa109aef803b7d55f4d9504abffc9625e10bdf94c14bc605857437347f0b677cf,t,21000,1750693,,5000059,2018-01-30 13:56:43,52
0x879b0baba81ba3f0c81f35dbb04ce3f6f35ce3ec75805b708f301d5870e46734,t,108178,1858871,,5000059,2018-01-30 13:56:43,53
0x0359d3727e683047d4631682dfc774467e5972f07128d6d0963bb7726d233a4f,t,92730,1951601,,5000059,2018-01-30 13:56:43,54
0xecbc34358c95deff6fd1d28aa2397e5df85c7802666fb622e126fb0075b86fcc,t,21000,1972601,,5000059,2018-01-30 13:56:43,55
0xfdd5eef6cfe39703a1f72b026d3f772006f366e2a5d3ab37d05922a9f6c3ca52,t,21000,1993601,,5000059,2018-01-30 13:56:43,56
0x054c915e15ed5ae093f1d3b6f416bef32a469ba327e418d7bd6c0ec87f3b0ba6,t,21000,2014601,,5000059,2018-01-30 13:56:43,57
0xeb85f603545cfadcc0041805c9279f962f2ceb4bfc39c314088645242a244e17,t,21000,2035601,,5000059,2018-01-30 13:56:43,58
0x99ae5334832228f9109c0bc3adc37738bf5f26c84bec575a6bcbde4139000f7c,t,21000,2056601,,5000059,2018-01-30 13:56:43,59
0x6c9beb98969221e7bb114a5ff7ba0e02a4bead6d34201f9cc7b0737e3aa1e84c,t,21000,2077601,,5000059,2018-01-30 13:56:43,60
0xcc92c467552deb4be0091de0dab6423a27f3c51f5118074c6109642a7fc6e558,f,51000,2128601,,5000059,2018-01-30 13:56:43,61
0x4b74739be260da814dcf14fcda356bb3545067b11e7bb00fa755eee1ccafd119,t,21000,2149601,,5000059,2018-01-30 13:56:43,62
0x9f44d56863fb434a1f6fd5823a7efc814d3813534b2d84a11b4e70d193e15cd0,t,52886,2202487,,5000059,2018-01-30 13:56:43,63
0xd7eebeeea978d51807a08336e7ebc17b10cd2c7957a9b1d34e9d66a1dbd29d5a,t,52158,2254645,,5000059,2018-01-30 13:56:43,64
0x9050b734e21448d887ebdede4b435be612b264e64b3fbb9dcd003a343708a3b3,t,51948,2306593,,5000059,2018-01-30 13:56:43,65
0xf09add7101624983e67ad81d8b3a8512885b25a0f51f28dcd4f6d5d9609eeb69,t,55843,2362436,,5000059,2018-01-30 13:56:43,66
0x45e1284a7bd41df9a9ac3091dc3e4a325ed45d0850853a4ff2f0859cb5fd4e91,t,40843,2403279,,5000059,2018-01-30 13:56:43,67
0x2ef7fd14842204aae2f379eef3d00ccc6b02b20a8f07ece7ba7eee00b05fc3eb,t,52912,2456191,,5000059,2018-01-30 13:56:43,68
0x97178392890d81d329b9cf9f67f0c3a0e87c4dafacad77103a801e7aa65178a9,t,52109,2508300,,5000059,2018-01-30 13:56:43,69
0xbfc8514be991c6b5312a9a5de7caf4e069fda04105ca57bc66ffde13f24f0071,t,55843,2564143,,5000059,2018-01-30 13:56:43,70
0xca60c5947467cf740daf3c49de719b7718b35abd064e1c926f06a2a2655c40b5,t,51948,2616091,,5000059,2018-01-30 13:56:43,71
0xcd526b39f987540ec62a3c87cb82a93a542048959c2f4d8c4605760646b99d9a,t,55843,2671934,,5000059,2018-01-30 13:56:43,72
0x95504c389e43ffaf7912ffcc385a140548f22e05f53a4f55b1fcdac26387874f,t,36930,2708864,,5000059,2018-01-30 13:56:43,73
0x810e78ab5be9d9351123bf7bbaaa16cb3c435a8f5c7eeaa5f36c0fa6479a904e,t,21000,2729864,,5000059,2018-01-30 13:56:43,74
0xba11744f85209cab564d058dda2605c47c9adb4a110f7b096b6ebf38d0fed0cb,t,21000,2750864,,5000059,2018-01-30 13:56:43,75
0x5ecd00211ed9ac0898183839efc5e2a224dc3476c387594dbe08106189ddb7fa,t,21000,2771864,,5000059,2018-01-30 13:56:43,76
0xc3d191563af5f820292f687c8b834b01d82835c432adaed707c353bdde42590a,t,21000,2792864,,5000059,2018-01-30 13:56:43,77
0xd61a1121c0d5eac92d4f680adce4f2e7c22fe4b69ef13384f6d750419938049d,t,253854,3046718,0xdd1845DF0e380fEe433254a94f908D8E6007bfbA,5000059,2018-01-30 13:56:43,78
0xbe3b87ecdf876a9bc4625395312262f46c1039fdb9669dc646eb50d6cf26dd07,t,36728,3083446,,5000059,2018-01-30 13:56:43,79
0x8e491e9843f2cb28014b9826d378020120b740f2fe5112c15ff6a5502a5754af,t,52158,3135604,,5000059,2018-01-30 13:56:43,80
0x9d44dfe864e498917076895fc315c426b9edf8e5e1e6f1e3a79e9f35e8ad157f,t,67677,3203281,,5000059,2018-01-30 13:56:43,81
0x3cbf46c69e4d2000f88975ca194b7409bca10ccff721335dc1ab0818d093589f,t,43798,3247079,,5000059,2018-01-30 13:56:43,82
0x782b28b9b966a3059c398d85135f46c4d9ff7f7dee650e69e986c9f61a81f1ca,t,21000,3268079,,5000059,2018-01-30 13:56:43,83
0xe5340b199551d8411eecb8c17417ffb5b7f94f33985629108aeed5ab9060c8fc,t,21000,3289079,,5000059,2018-01-30 13:56:43,84
0xb3673961730ca3aaf1e2e64cf19b87c873170864591ad32907aecb72e3f972a8,t,21000,3310079,,5000059,2018-01-30 13:56:43,85
0xc5d0390344ecc8aa6d5c538db739fea9d24b5d5484d6352b653760fd668954aa,t,30327,3340406,,5000059,2018-01-30 13:56:43,86
0x266f90fc9682537f8b45815862d99a6aa011b819a869839b4da7b8d70e248883,t,21000,3361406,,5000059,2018-01-30 13:56:43,87
0x539755932b5c2a0ee35abffe65d3fa3218be9080f7897f01e4438188b5fb05e6,t,21000,3382406,,5000059,2018-01-30 13:56:43,88
0xf0e3e69b7966f7d9c1ad4519308dc9b10c30aa8ef84d8ac2223db52712dee71c,t,21000,3403406,,5000059,2018-01-30 13:56:43,89
0xf3dc98ef88e62b37cb465c04d6f01b6afb097831c6af561a48b3e9e06b7e11db,t,21000,3424406,,5000059,2018-01-30 13:56:43,90
0x9b603b10a38db23029e7f1a531ffddf292c846dc873114818478b5a4bc7802ee,t,24036,3448442,,5000059,2018-01-30 13:56:43,91
0x898e47eac5d0c707bd87b6846db648c4df9f7eda84ceacebe7e3aa87d078e221,t,37282,3485724,,5000059,2018-01-30 13:56:43,92
0xf08b8f70c5f46c07c5e077980d895328a1244ebcd7da65fdb13219e5e96a9c8b,t,21000,3506724,,5000059,2018-01-30 13:56:43,93
0x0010d376ba1c38b5c683b50e9fc4a1e77a1e9902ec9fb8c77232183f111c3769,t,21000,3527724,,5000059,2018-01-30 13:56:43,94
0x83420996b3d25dda39c290d48bd9bb3c96249ba00f8c486d83050699b4bb8026,t,21000,3548724,,5000059,2018-01-30 13:56:43,95
0x287114fbc7c61628a0f1cd8c2d1035d1b3ad1aa70f9fb0192a8d7f371dc31f0c,t,21000,3569724,,5000059,2018-01-30 13:56:43,96
0xf37dbce897421d147b1b763a736e4fe6ff66152d36bf8e2c97cd61722d2d67f7,t,21000,3590724,,5000059,2018-01-30 13:56:43,97
0xa9ae864e40ab292440b13369c7873554164433d10ddcc2d21afcf2e3b1af4893,t,21000,3611724,,5000059,2018-01-30 13:56:43,98
0x3c804380bf0b12eeb24e4312bc0a7f5f14821bc414df9fa395a9923b3d719c1b,t,21000,3632724,,5000059,2018-01-30 13:56:43,99
0x2eeea40231cde5aab54bb3f2ddd06c426e2bff47663c3c41b96b07a3afd727fe,t,40995,3673719,,5000059,2018-01-30 13:56:43,100
0x7953da7808e089af4a24532325e80eeaaaf48d4abf4f2a50fac26e1d38f668f2,t,21000,3694719,,5000059,2018-01-30 13:56:43,101
0xd1ba47ffb248954e3c20497e1dafa669eb0ca5347c631cad912920870ab16828,t,21000,3715719,,5000059,2018-01-30 13:56:43,102
0x3932972616a383f84633001f9e9d292a8c78609c65c7e228d46740018164e24e,t,21000,3736719,,5000059,2018-01-30 13:56:43,103
0x3388c530b09ee5c5f60e58cc82f1a80cacbf17d7a2b637f68fd03207866ff388,t,21000,3757719,,5000059,2018-01-30 13:56:43,104
0xdab8763d5fd107658f8152dbb900a0f393d108fe8f4b800155158fb094b08848,t,21000,3778719,,5000059,2018-01-30 13:56:43,105
0x94f45a7be2cee289c504f1270cb26202e7f1a8fe79a08be748eee34e1c45a453,t,21000,3799719,,5000059,2018-01-30 13:56:43,106
0xbab6e6067173650c25e57c813caf1d8920bf3234d43963c9110ce3291cea3292,t,76670,3876389,,5000059,2018-01-30 13:56:43,107
0x0a2b14158711acb148237c99f9d9b037fd6fac912611f4f6aca875ee38f7e7eb,t,21000,3897389,,5000059,2018-01-30 13:56:43,108
0x5b20a0db7cab05ff6f1b87d47674d45f2e8aa453644ad96c2d471c09668355cd,t,21000,3918389,,5000059,2018-01-30 13:56:43,109
0x6766d9c6bcadf3070108c6b5652f95618b9e7e60609b05a3cf3bf047c816edf1,t,36644,3955033,,5000059,2018-01-30 13:56:43,110
0x71f72417383ef84a99fd6d8b2595a764ea0ad2f8f4893f04209f0e9718a25b41,t,40843,3995876,,5000059,2018-01-30 13:56:43,111
0xe8ab28add94b236a352b95e8c11881f24cb103c19b5a2d9ed97ef37e0e16aafa,t,51955,4047831,,5000059,2018-01-30 13:56:43,112
0xcd24e96b80503b8b56f4c60dbf9a0448de76396c0721e144404e07eca2483d36,t,21000,4068831,,5000059,2018-01-30 13:56:43,113
0x1038f6f5f32461c408857cfc6aca676ea697041538e6f0040149dd25f0702f4f,t,21000,4089831,,5000059,2018-01-30 13:56:43,114
0x1bcf98b0b1f07bce8e592a42fe899b06def40c93c999c82f1ecc49e30e08f896,t,164716,4254547,,5000059,2018-01-30 13:56:43,115
0x0ea78f682e087411c47ce344e14e06e472006adb309c6464a4a4b9ddf51b30b3,t,43842,4298389,,5000059,2018-01-30 13:56:43,116
0x3c89c1e1759bfd21b8e989aef65a71af8f4c7fc1904bd9c009f460558e19aea9,t,21000,4319389,,5000059,2018-01-30 13:56:43,117
0xfd2e6a24c498340a73f0b39544619962db6f93ffea0c126f486f674f46e68687,t,21000,4340389,,5000059,2018-01-30 13:56:43,118
0xa0facbd655dd24f3077e9182e9932031b41602b5e783fd4f33d465df4db325db,t,21852,4362241,,5000059,2018-01-30 13:56:43,119
0x7c018362e43c43a61f835b8b528463c57d60810fbe3e7890fe85660d0b43283b,t,44246,4406487,,5000059,2018-01-30 13:56:43,120
0x8ee298481b09875710eefce653e1bdc00f068a5893d5e97e036a827a4d5a37c9,t,21004,4427491,,5000059,2018-01-30 13:56:43,121
0xbe0369d9f88ad282ff4b322714e24bb42712be59df3a96f03c6595051e1997e3,t,142076,4569567,,5000059,2018-01-30 13:56:43,122
0xdc3ce6a6a6241fcf9f7b0e84e7be8724c3780502c22bcc52a87eab8e7f2da2f8,t,23615,4593182,,5000059,2018-01-30 13:56:43,123
0x7b17149362dfc16084ca0d4ab39cb63cdf9b8e545c30469f9c0d577ac70e4d1b,t,21000,4614182,,5000059,2018-01-30 13:56:43,124
0xcc361cd083748335248560892e5a6ad91cec7de4895d471658c3b2a3110ac97d,t,108114,4722296,,5000059,2018-01-30 13:56:43,125
0x95c13630d5bb310316a55304a8d4921de4d05f98133168d395297729a9b8601a,t,45591,4767887,,5000059,2018-01-30 13:56:43,126
0x9df1cca83ea64b5911b307469c40e10865b2d888116d4c7d2eff3c40788d16c1,t,39069,4806956,,5000059,2018-01-30 13:56:43,127
0x5dfa51f3161ac02dd77c9bef012a19efd0303ae593da2964b4618fd8d85228ca,t,79985,4886941,,5000059,2018-01-30 13:56:43,128
0x5d6f9673f8a085c0629f6efd80273a87cf0bc82392e121ff7ee8feeb6b250988,t,52344,4939285,,5000059,2018-01-30 13:56:43,129
0xf89480463adb3876cdd9e3fc9dd7afa03f691bf88c4cfdc86ca736ae6d96bb78,t,75284,5014569,,5000059,2018-01-30 13:56:43,130
0xe8029932c10305e6c6dceaca1b312d383387a7393ac8e643cd4a8d4313b2db7a,t,35701,5050270,,5000059,2018-01-30 13:56:43,131
0x610933ffa171905687c29b5e53b25dfe1556eca05219f0301fa68a551ce297d1,t,45914,5096184,,5000059,2018-01-30 13:56:43,132
0x05675eda69af2224bc9ce3aa87b9ccd32729f16a528e6b5edfd7047c9b557e73,t,37957,5134141,,5000059,2018-01-30 13:56:43,133
0x99e94a998a78a76bea0d6cde8e2603578a7bf15a1cecbd2023438b403a982fe2,t,66316,5200457,,5000059,2018-01-30 13:56:43,134
0xc13cd590ae7086f754f7bb4945bc9d59203f418027cb6056f4c9081f524a508f,t,51560,5252017,,5000059,2018-01-30 13:56:43,135
0xaaf17a786721fae1a1ebb1e910a2339fcc90751f7c46f0634cdb453d81b4f23b,f,250000,5502017,,5000059,2018-01-30 13:56:43,136
0xb8907a7288b4d8e6f266ae03dcb5b9046435b1a657a0d238a9a697aead80b903,t,59290,5561307,,5000059,2018-01-30 13:56:43,137
0x7637c807bcc289376be439170c7fcdaa3dc5124e03bafd7e20f73889079e2cae,t,21000,5582307,,5000059,2018-01-30 13:56:43,138
0x5379fd559e8ae7bc77f1b7624bd7e3d57f42c9be3b941f9e4ca51ca211822e19,t,36353,5618660,,5000059,2018-01-30 13:56:43,139
0xe95c69531c4684883a9fc65445ad541ad544dcd7ab2f28411187d7ec4bb9bcba,f,250000,5868660,,5000059,2018-01-30 13:56:43,140
0x12b19b338a6401c952632ac6298c4213fe3168c5da1b38004b64e8f4995862ba,t,53422,5922082,,5000059,2018-01-30 13:56:43,141
0xcdc9bcdffcf032374b6d969ce4100ad1966d8d195fc083e65595f249c4d4b63f,t,52661,5974743,,5000059,2018-01-30 13:56:43,142
0x8d98604644917492285bd3fced2f7e00781fb068dd1d95b0761dccf52d4ac583,f,250000,6224743,,5000059,2018-01-30 13:56:43,143
0xadb795ca570d6016754598071e629b619a7e52635c4ef7c16d55e4163734f8a2,t,42758,6267501,,5000059,2018-01-30 13:56:43,144
0x40c87fbdd182c6acb60bfd8ccfe9066cb24eda5a5a85a657a1aa2258d5f3cef4,t,92986,6360487,,5000059,2018-01-30 13:56:43,145
0xbb51d4d09f3c22fa90bf3b5d6a169e10f49c121c6e80b1507be67120cbaf9727,t,44162,6404649,,5000059,2018-01-30 13:56:43,146
0xe5cee260c8efce2fb070a9b3b3b54f70b2c0b2b07ce1e7fc5ec819fd9b31eac3,t,93306,6497955,,5000059,2018-01-30 13:56:43,147
0xee4ee5c8d4f2b84521a6a78d69f7b0d2604eebe00358e860cb186a25b4bb17cb,t,42494,6540449,,5000059,2018-01-30 13:56:43,148
0x076212a43f6410939c5188b7ce6c4e3935dd281c22c633783c1cf8e358ab5d7b,t,77346,6617795,,5000059,2018-01-30 13:56:43,149
0xaf83ba93dcc448bfc21a9df771a367b4ecfab105f08b50b41528236294c70674,t,48537,6666332,,5000059,2018-01-30 13:56:43,150
0x5427a6e6bf4da9a6c163711c65f7f5d3ec00234b55d894ed61ddcde89900027c,t,93050,6759382,,5000059,2018-01-30 13:56:43,151
0xdd18c5a1cd9509a59b4b72d1a5664e43a4a05234cfff471f13b7bc13b3d899f4,t,59226,6818608,,5000059,2018-01-30 13:56:43,152
0x11053de85d0ecc4ed2473d2a555d5cd393a4468f5d6c28e813ab67a025260141,t,68350,6886958,,5000059,2018-01-30 13:56:43,153
0x43ae88b51542b4815ce42631048b5a588a7988248b618efa66f5eca1ba900267,f,250000,7136958,,5000059,2018-01-30 13:56:43,154
0xec2a942b6b385656a2dfe8b9241fca57a20544fb2589f6ef4540a57c7dde8270,t,29493,7166451,,5000059,2018-01-30 13:56:43,155
0x64156b70d98bb4f785d18d0882b7df9329aecc9f46da73f89b86ad7a662f463d,t,37900,7204351,,5000059,2018-01-30 13:56:43,156
0xbdd0a0a9875ef07dd034d4d1d76f96eae138b8b31c5d0fb5c8f0e8a731856b56,t,76516,7280867,,5000059,2018-01-30 13:56:43,157
0x4bc25d49b0c9af2643c710f5e39fbd5f7839c30e792b1af412f3165d852052af,t,23028,7303895,,5000059,2018-01-30 13:56:43,158
0x82247b2ae4511989d2878c0b0f2a38009d4f46a195204622694e95f7613560bd,t,44493,7348388,,5000059,2018-01-30 13:56:43,159
0xba713424ee2ebff835518e8f44857692722b81a9c4b6092590a98129eb2b66fb,t,78242,7426630,,5000059,2018-01-30 13:56:43,160
0xbd97738662ff8b844d67165d454c3ec94f3ae750c790492404aa4a9a86a23a54,t,59034,7485664,,5000059,2018-01-30 13:56:43,161
0xf95ce62ee61bafd1b993978591d9d1a95da29b3d29c0f777aa081f934061fe7e,t,108050,7593714,,5000059,2018-01-30 13:56:43,162
0xcbf818cae9ab952b8d96c9c2f4299b4f31dee4bce180aad6620fa232cbabf1e5,t,46465,7640179,,5000059,2018-01-30 13:56:43,163
0x75d0f864c2258bce9f67329bc1fedc3d5a30b9e3ba1946cf6cb1141aca859f1a,t,21000,7661179,,5000059,2018-01-30 13:56:43,164
0xa292f03e38b9a8aec36b0ab18f4519a4dd7cfce85ef90318b98f0360e9cd5b2c,t,21000,7682179,,5000059,2018-01-30 13:56:43,165
0xadd9c0c097fe49b771ceb07bfd422a823099f3c36d5aca7f63cd93ca571193c3,t,63940,7746119,,5000059,2018-01-30 13:56:43,166
0x21860909476c6629dea6809cd6bb4739219dbede0cf163f78e8e9a8116182ed7,t,21000,7767119,,5000059,2018-01-30 13:56:43,167
0x99248ba8ae1928c67ec8aeb68bf6c1c261b6fbabbb94b9abb6b5218166ad5884,f,21000,7788119,,5000059,2018-01-30 13:56:43,168
0xb3b0ff9724e1df0057235084a3aeb02c1ff7e7d11d568dc78acd8e83d68942ad,f,21000,7809119,,5000059,2018-01-30 13:56:43,169
0x1416bb9d2a9641a6154f2f99c3efc086986d6334776582ff0e4044883d20dc46,f,21000,7830119,,5000059,2018-01-30 13:56:43,170
0x711c4a160dcce127242644eadfb06f7f513c6253d0176dcc295ede603c0a62f8,f,21000,7851119,,5000059,2018-01-30 13:56:43,171
0x42052b7d1e62403bb1412fb0021939d4b297588d155cf2abc9d638deb05f3b38,t,41035,7892154,,5000059,2018-01-30 13:56:43,172
0x2fe7f0f70eb49eb67342a7f0a89b74395026ea3789bc88103e40138d87ef91a4,t,21000,7913154,,5000059,2018-01-30 13:56:43,173
0xc04206ecb00c31ebda3bae032a0ddf1e8e7b8e5d48757887842e8972298a09a9,t,21000,7934154,,5000059,2018-01-30 13:56:43,174
0x47b58522d5011f0ed34c1f0fc41e0b4647a13cbb993c0888d76c119dd93888dd,t,21000,7955154,,5000059,2018-01-30 13:56:43,175
0xfbf0f32603552e49d518dc801ac5dfdfe00cddd12521cffa39344e40ef91f181,t,21000,7976154,,5000059,2018-01-30 13:56:43,176
0x262987272ef58b255dbbd8a28b2b73fdda363b18ebde6e8e4451b0c109eaa12b,t,21000,7997154,,5000059,2018-01-30 13:56:43,177
0xfb463a3498dbf1139a6f2d7a2b0b08a6057b4e32d263976bb55a39f927f17ad6,t,52155,52155,,5000060,2018-01-30 13:57:12,0
0xc1510ea541054b46ef8c020c69059cce56633123d0a9da08964044fb1799da1e,t,52158,104313,,5000060,2018-01-30 13:57:12,1
0xfb144b7a82c6225f9a64bbdce254e99524423c7b8e7cdeaf461b3edc3f86a402,t,103638,207951,,5000060,2018-01-30 13:57:12,2
0x3dffee00608a9903560a40d8030c7ac174cf798a903f8800372552709d08ddd5,t,52611,260562,,5000060,2018-01-30 13:57:12,3
0xafd8ead86866775f970b6091279fa4753b963fe4f19516617c2a87d4ae4aa9f4,t,37912,298474,,5000060,2018-01-30 13:57:12,4
0x858f0d628ec6bafff5c8f96867271dded309834c011f807881e3ea8bea1c6aef,t,21000,319474,,5000060,2018-01-30 13:57:12,5
0x71aae67f26fb0365bb78f255e45e7b5f185a3c8bc8d0c5843d1a2d359abac612,t,21000,340474,,5000060,2018-01-30 13:57:12,6
0xf174b06ab6b2a31189d4f780be824c73f0640ea342d3cf4d8fea4bd1f9086107,t,49993,390467,,5000060,2018-01-30 13:57:12,7
0x93855c30bdf0da027a6462676b74848edb0ceb9db80a2ae1d3aafd6cfe3731e8,t,52155,442622,,5000060,2018-01-30 13:57:12,8
0x7ef57a0c5fa1b089aa40785ddb0d7d7f056bc3a521d10317f666ded83f7f4b24,t,164823,607445,,5000060,2018-01-30 13:57:12,9
0x527dca760a0f4265738eff0b870acda6bd609f583912f3f41d7c930ae6b7554c,t,21000,628445,,5000060,2018-01-30 13:57:12,10
0x0f1a7718c60b44d085470577ec1878a3c157445bbd86167cc523f8b680f07a4e,t,23419,651864,,5000060,2018-01-30 13:57:12,11
0x5754e2d4b6fd09b420ee3fd1fa9e0dfe83fa221160636ae08dbdd1dad1c134bd,t,21000,672864,,5000060,2018-01-30 13:57:12,12
0xb7773bfe10f5a56bb7c3fa1d295ab082f81e92ff619aac21ba5c01fff9d5d8af,t,119850,792714,,5000060,2018-01-30 13:57:12,13
0x624a6f33b6f7f15b296f436ab99c0bf077728b5ef5cd8fc2898fef4c5fb279a1,t,21000,813714,,5000060,2018-01-30 13:57:12,14
0x29e80be35a91579c38f933acb0db9643a1c2483af3d470a7f581679d445b45c1,t,140972,954686,,5000060,2018-01-30 13:57:12,15
0x76826a4cf0d63e793027cb4a89b4e18a668a15d920c5c04520b822fbc1ad7304,t,21000,975686,,5000060,2018-01-30 13:57:12,16
0x6a93d7c933e2e7f60ebba528e718f2ced33e640bb8d5c0e7da647961b9653030,t,71117,1046803,,5000060,2018-01-30 13:57:12,17
0xcaa997a173d570f0fd730d298771c0890f802058d5dfd3a78a8c1523439c1867,t,21000,1067803,,5000060,2018-01-30 13:57:12,18
0xb4a133b3d11e4f171edc470b0755088ef21f4d8f2baf9a567042656e4113d35c,t,21000,1088803,,5000060,2018-01-30 13:57:12,19
0x3816b9d3f560412a178859300062a5d925baa4ec3f0ec49a9bc1362ef5133456,t,297240,1386043,0xc6b9354C1Cdc394591324Cf631cD181f67fa129F,5000060,2018-01-30 13:57:12,20
0x6d4581d3ab2343c3aa05d318e20f5de06bb1cb6a6a9992704fd5b9775bdcba89,t,59290,1445333,,5000060,2018-01-30 13:57:12,21
0xf2d1c59a219351c4c2f8c0764b1da934875c987dccc2ab25b30d6f27f5ba0277,t,52020,1497353,,5000060,2018-01-30 13:57:12,22
0x28500b38543c2da159e1b6513dc01fb9d299d7b53849630dd0f7423d35069648,f,21000,1518353,,5000060,2018-01-30 13:57:12,23
0xe46722304a8d41160866fbe6bed502c2fac7e2de273d306c6e8d8c7bdcdfd8c1,t,52091,1570444,,5000060,2018-01-30 13:57:12,24
0x7871afd44560f50acfeb4145ef9d9ca400fb3e395fe14c6bdb894ec7855e89e7,t,21000,1591444,,5000060,2018-01-30 13:57:12,25
0xdf9418cd1a172c3b8c5a1106ea9fdda6f7ae70347e32a277113df4792e677284,t,21000,1612444,,5000060,2018-01-30 13:57:12,26
0xfbdbc97fc360da5ed9c90b0dbde976c62bb880bc5d7d376e4113724a86a744e2,t,21000,1633444,,5000060,2018-01-30 13:57:12,27
0x3dc4fe1625bcda6aa2e8da5288bfa568b81416f0d69b2fbaed572d4919743ddc,t,21000,1654444,,5000060,2018-01-30 13:57:12,28
0x1de1e7ed2ec0d6d8839867fa509f52ac158309022cfc0f05ad07393ed775c862,t,21000,1675444,,5000060,2018-01-30 13:57:12,29
0xa3b905cd222ffa1e79c4c9ba71ca0ae870132205db782d030c0a7a7ef338722b,t,21000,1696444,,5000060,2018-01-30 13:57:12,30
0x61d1892f8079b8b753ee556ca29aead10cb6c1f3c55e3a5c2502bb127f37fcfc,t,21000,1717444,,5000060,2018-01-30 13:57:12,31
0x2e15888ba35b30fd1229c4651f717e84558dc7a46bc2cf524d1e062d02d3f690,t,215038,1932482,,5000060,2018-01-30 13:57:12,32
0xa7db72d60dba7b161116500afcb311fc9ff5039bd72665ee369ac43b7f4fb8a4,t,21000,1953482,,5000060,2018-01-30 13:57:12,33
0x7256af772d1764d4bba501825de0c756d457de87785eebfe5b01a4c3c2e47262,t,344388,2297870,,5000060,2018-01-30 13:57:12,34
0xd56ca4a3083e78f245ed4ff5e8dac6f40cc7f0e552c2cdf397a1ccaf33bcac3e,t,40907,2338777,,5000060,2018-01-30 13:57:12,35
0x33607d0920128b9657a253cade65236e2ce2c3d8e860aff270ffce570e165bce,t,57994,2396771,,5000060,2018-01-30 13:57:12,36
0xe9eb56e8ff0231b536183a157cf13ec620b9af9a0a73eec75f8ab510753dba1a,t,21000,2417771,,5000060,2018-01-30 13:57:12,37
0xffadff523604ff645d49c519f11cac3766503ca7b117718d95d4b81eedc1513c,t,21000,2438771,,5000060,2018-01-30 13:57:12,38
0x84b81ed01c546cce7b62bab979abebd750a8ca5e74623a22a9295a8971e30552,t,24574,2463345,,5000060,2018-01-30 13:57:12,39
0x459a1a69a4884eaea3b113ef50d685d6b247fd50da402727ecbaa95cb3b37e24,t,21240,2484585,,5000060,2018-01-30 13:57:12,40
0xfe1b3323edef152aaf40733d9773fc6d673b2e68af72d4c44e5d134b50d72ed7,t,21950,2506535,,5000060,2018-01-30 13:57:12,41
0xc7848e63b88ad6b4c92ad3d5013786b6b85350730dc212a8c6ad8a6b1ce716e3,t,53311,2559846,,5000060,2018-01-30 13:57:12,42
0x7fe06207587d6b21ff282e6ad75e338c69a20345907c44cb0faacee3607a6c84,t,22239,2582085,,5000060,2018-01-30 13:57:12,43
0xe241809dfaf313594bd5261f782ebb3303820b5906123bbf4bfdce0e64a765a2,t,21725,2603810,,5000060,2018-01-30 13:57:12,44
0x25ab43f6134585f966500f638be46f16e31f1427abe28866e7cf328a469864f1,t,21000,2624810,,5000060,2018-01-30 13:57:12,45
0xebb6fbbe1d8dbd9de161a21018e30e7cdba11d2ee57178655577ee97452e4a20,t,21000,2645810,,5000060,2018-01-30 13:57:12,46
0x85c31ff2d0ff79012e4949285027543f4814e9dbb0424c6c2394c624c88fea84,t,21000,2666810,,5000060,2018-01-30 13:57:12,47
0xb83395dfaa86bbbd8996c4f0e772f9ad762e996f763392d892e59db87d67652c,t,69504,2736314,,5000060,2018-01-30 13:57:12,48
0xd8f074804c010930b5e722b223a5848c08881830e91acc34251c080f8bcf59fb,t,21000,2757314,,5000060,2018-01-30 13:57:12,49
0x465268fbbfa6f1c60939261c2cdf91ee2810505a6176017f846ec8421ef07e17,t,21000,2778314,,5000060,2018-01-30 13:57:12,50
0x5166506b59c1b91ef2e55912a73292d1678e5558fd92e3d9e6ee318d6bac0008,f,124760,2903074,,5000060,2018-01-30 13:57:12,51
0xabfdd49a3ee674b1206b26e624773784e41d000e3f38528721e9be185dd1ceb0,t,104123,3007197,,5000060,2018-01-30 13:57:12,52
0x9ee22f49d124fc64a9d6ad631acb097bea3fe769ff7f2fcd5cec4b653e89cb86,t,21000,3028197,,5000060,2018-01-30 13:57:12,53
0x317cbfec015dd4589df276851ec7d99567322a866fc10ac3e845449e7bffc122,t,46146,3074343,,5000060,2018-01-30 13:57:12,54
0x4ae25be148c7d40a54c6215bdac6cfbeef868768508cc7dd7e018f32906d9960,t,21051,3095394,,5000060,2018-01-30 13:57:12,55
0x7cb365b423d46aa5c63b6e7592d069b481e3e6d1ddb761ba6c73fa31160b66f0,f,40000,3135394,,5000060,2018-01-30 13:57:12,56
0xb5137b42f806a2d5da296b3f7f564131b55cb720845f7ecdf8a3a867bf8e0c4f,t,22091,3157485,,5000060,2018-01-30 13:57:12,57
0x56141262492121de0da1c32799dbd10bcf8d27cc196a3802681ab2184f3f9aa9,t,22027,3179512,,5000060,2018-01-30 13:57:12,58
0xbed53e8df7f275af1ca47c06913d7b031311c2b61a8524fc546c5a1a3a214da3,t,37155,3216667,,5000060,2018-01-30 13:57:12,59
0x73574383e9bc942648244b5f8bcc5e2d382a8b04e1d31000a83366677774f622,t,37217,3253884,,5000060,2018-01-30 13:57:12,60
0xc3cea35fb8928f5077308bfffb854ce73e3e3e39da08808ea9cb2d160a8a9640,t,21000,3274884,,5000060,2018-01-30 13:57:12,61
0xbd5513785085fb4dfeb5ef6d0ea674efbb84debe09ee5da632a7fef9320e1ec1,t,37715,3312599,,5000060,2018-01-30 13:57:12,62
0xc29a14bea8de5f8e8be1d9a41e96e1b425af628015eb5712fcfe91ba5eddfc9a,t,91258,3403857,,5000060,2018-01-30 13:57:12,63
0xb4a61f89261dcd5007153f7b8d32cde0f62bb726840db99bb9d013503e474843,t,37112,3440969,,5000060,2018-01-30 13:57:12,64
0xc460880a8c122351f38d2a7cb7461f803e4d7554f9506794b9b6887cde5f44d0,t,37048,3478017,,5000060,2018-01-30 13:57:12,65
0x4451459403e72b5c2d5e471ce724de8ea3834a559d063a88c2fd31d1bb2b74a3,t,37048,3515065,,5000060,2018-01-30 13:57:12,66
0x267a1ab9a49171800bb77dfdfde0b9f3fae691cd07ba2d00e421eb92aad945da,t,37112,3552177,,5000060,2018-01-30 13:57:12,67
0xf1f0b0d558e215434dbfc72c247fbe8a1a763e498f8479c423062afb0f95a146,t,37315,3589492,,5000060,2018-01-30 13:57:12,68
0x3c79a43fd385328f71e9b61ee7b6ceaa455b4ca0643e4b11c1b48b456e75a0d7,t,37251,3626743,,5000060,2018-01-30 13:57:12,69
0x6faa7916087e3c32c344dae4655c6290d9ba086ddf344812bb5a5b368c3214ff,t,37315,3664058,,5000060,2018-01-30 13:57:12,70
0xb791adef268ac474e260ab87c90fc8dd53aef6d2f9e73a8bdb76474050bb3e77,t,36696,3700754,,5000060,2018-01-30 13:57:12,71
0x8dd129c908b4834b4788491cb0ac68b44101faf961b24aa7bc9ee568215b3a1f,t,21000,3721754,,5000060,2018-01-30 13:57:12,72
0x80d520d79686dd448e6fed0336a36c604faba775d4b06665be7b92fe98317ea1,t,51654,3773408,,5000060,2018-01-30 13:57:12,73
0x71dc39526ac812e8fe5cf487804dd61c2ae707cf1587bab1ff9c33d77820a438,t,28916,3802324,,5000060,2018-01-30 13:57:12,74
0xcb8a4d3dffd31780b251a9253354b4303b697da80e4efb6c3494df91944e432d,t,43748,3846072,,5000060,2018-01-30 13:57:12,75
0x3b8b72ad62088bc91244297c88260af16ca1e693788788302ae6794621250835,t,21000,3867072,,5000060,2018-01-30 13:57:12,76
0xe3bd47e12007111ef7d54d29497c9ab0b47101f2bcb46b586d78769f3696c437,t,21000,3888072,,5000060,2018-01-30 13:57:12,77
0x9013f579b87dcdc541ead04db834c662993d0e31bedb6ebc6fe78e5b831d4a8d,t,52524,3940596,,5000060,2018-01-30 13:57:12,78
0xd7cabd12d0276ce3e52bd8b8e4b3335ab371664dee1d6741be3d4185383adfaf,t,21000,3961596,,5000060,2018-01-30 13:57:12,79
0x913acebff766384f02d0bced3f6e9eefa3e5a2397f6089e484435de00089c56a,t,21000,3982596,,5000060,2018-01-30 13:57:12,80
0x1f5b9634a809309f4c75af72613e3cffacdb9655645ce45d6df4056e665b62b1,t,21000,4003596,,5000060,2018-01-30 13:57:12,81
0x48879bf21eb4a8e3aaeac460c15ca01f03309b10386de94f71d7e09c68cea140,t,21000,4024596,,5000060,2018-01-30 13:57:12,82
0x795298b74ed00876f6e7850d1deeaa0364b877a9f62075e6779aef34a106b164,t,59985,4084581,,5000060,2018-01-30 13:57:12,83
0xdac249649e86bb2af0bf29450983bdbcc4128ce30a287473fa9ec4083a87dd6e,t,55715,4140296,,5000060,2018-01-30 13:57:12,84
0x2b2e9491e02bebd059ce511691eaeca519701dfe86df5eb98939f565a272882f,t,37126,4177422,,5000060,2018-01-30 13:57:12,85
0xd29ecb998a10058b125df334c2693acd2cddf0591a29aec4a62a05bd9b7e9d1a,t,52316,4229738,,5000060,2018-01-30 13:57:12,86
0x50af4850d29487647beb0ee97c62cb7810fbafa7efdb91eb54b329e0fbda5939,t,52106,4281844,,5000060,2018-01-30 13:57:12,87
0xcc4f3010b39c3b0834fd6e437cc1bad643e711085230de7506c4b91c39bd1086,t,52048,4333892,,5000060,2018-01-30 13:57:12,88
0x8c24c4815c2d89b18280846d32f30cda3cbe68d5dace2a3b2c8145558ab56665,t,37356,4371248,,5000060,2018-01-30 13:57:12,89
0x27fa51f107042a945617311ec85ed33e59b69154f87d5e8f2f791182adf75edd,t,40907,4412155,,5000060,2018-01-30 13:57:12,90
0x0dcc8d20f99c3edd82e9e3326b2af6a2b9820255b59d975247b6ba0036f813c9,t,52263,4464418,,5000060,2018-01-30 13:57:12,91
0x6330e60c3cd71e34c7c8e92dfbacf11e5a232c813d1f692232f936a01efd9aa2,t,37267,4501685,,5000060,2018-01-30 13:57:12,92
0x3d570cfaadba5172e4251ea6a32facfcb323c8398b6117f1dd871bcd7c5e94c7,t,21000,4522685,,5000060,2018-01-30 13:57:12,93
0x7e69a3e600f644cf258d67b940157a102c93cd6bb42a2ad20eba3a1fde67c766,t,52886,4575571,,5000060,2018-01-30 13:57:12,94
0xab3253b0beb5029d8e4221ef0497850be312065fe9c10c9974b5a34d6fbbe19f,t,22540,4598111,,5000060,2018-01-30 13:57:12,95
0x4803aa48a4993b01ce8c8732a9079d6930d6dc1134a6c7973208f2ee2d484c3d,t,21916,4620027,,5000060,2018-01-30 13:57:12,96
0x0e5323cd10352a666c36b59e75375217839400454e9c2daa9690e99801756762,t,55327,4675354,,5000060,2018-01-30 13:57:12,97
0x6216722af253b336c68bcb6ec550fa694ee7778c725fd763c7b95447947b4e99,t,22476,4697830,,5000060,2018-01-30 13:57:12,98
0x8c9249a30ecc206d9372e675fb36a44f13dfa90e31432232b88c95ef09d4ead8,t,51712,4749542,,5000060,2018-01-30 13:57:12,99
0x052b59d305d759cdc7afb9b8c478702b4f6301dc65a984fc908465e49b638075,t,21000,4770542,,5000060,2018-01-30 13:57:12,100
0x61e953b45a20f87e7900af22bbbb544fdd68bd4e7fc4f227fd8c2ec90863169a,f,21000,4791542,,5000060,2018-01-30 13:57:12,101
0x98a82f9010350a891532f75cc27843df302d4c4fe666226819e601eef346bc49,t,21000,4812542,,5000060,2018-01-30 13:57:12,102
0x13a97479729a0ba5c6510c6f3f0b0ad153e7b0609e3d271d4285b5df4d5006e2,t,21000,4833542,,5000060,2018-01-30 13:57:12,103
0x83d4b0c5c325dd99645ee6d77cb45b47f06bd1fc9a0f97f52ba0f22adcea5fc2,t,21000,4854542,,5000060,2018-01-30 13:57:12,104
0x786043d6215e88dc800890efc479f3544bbb9ac3a0ead573e96eed70c1837596,t,21000,4875542,,5000060,2018-01-30 13:57:12,105
0x807576b78ae04015361c052b2802c71ecdc25a989bfa7a427bd0dbaf0cdfb7c8,t,21000,4896542,,5000060,2018-01-30 13:57:12,106
0x59f583b4f6f472fd820ebf55f970c8b2dcf69af213c0d13019af176698fb7a10,t,21000,4917542,,5000060,2018-01-30 13:57:12,107
0x6f9ce8a1eeb8cd0d20aebdb8862f730d2f3293ca4d7e21f7decc401c103210bf,t,21000,4938542,,5000060,2018-01-30 13:57:12,108
0x66b6b87739e5ccfa51df11071b0073200412da23ab858040ca8200ce3a8cc0f9,t,21000,4959542,,5000060,2018-01-30 13:57:12,109
0x4ca2bbb3086f555a630473a6077de05e201bd6e2799cbbd982421f6c01275d5f,t,21000,4980542,,5000060,2018-01-30 13:57:12,110
0x04df5797ff38adb48102ab8fb3b0d02f7940e718e98b0df3059a4b379cdfe863,t,21000,5001542,,5000060,2018-01-30 13:57:12,111
0xa832ee079d7a231baf404684f669d20106c1d383dbd94ba4817dbd79ac6f1c20,t,21000,5022542,,5000060,2018-01-30 13:57:12,112
0x1e5c52688c3f17a67671a08747c7153c915d63afa705478c443bbcb4797e8276,t,21000,5043542,,5000060,2018-01-30 13:57:12,113
0xa19e646867f8ab1144a31603bb0878672ee3ac6a90e58827567073dd2e8a0208,t,21000,5064542,,5000060,2018-01-30 13:57:12,114
0xe56a9da0568fbb14ded72429ad0c9a65f091adc926c4d863da6cae5b08b1ab0a,t,21000,5085542,,5000060,2018-01-30 13:57:12,115
0xfa27d4ecde0455948036ec97a43c3500caa56f9be05e7945734defc8e079f387,t,21000,5106542,,5000060,2018-01-30 13:57:12,116
0x316a6529dd4b1b646845cb8e07512136a59c914ef86f8ad4ea5f49426d5ed9e3,t,21000,5127542,,5000060,2018-01-30 13:57:12,117
0x447cfad7ba0f149f1c7a6334eb6b5387e82a2cfc0a19262703e20eef7711b323,t,21000,5148542,,5000060,2018-01-30 13:57:12,118
0x3b39a70c0341299c152e9464ff325169866076c95b3879f5c919e009ee1af040,t,36792,5185334,,5000060,2018-01-30 13:57:12,119
0xe29a40ca752cd9a60cee996b9bf4889e04fb1d3d2ab849a10c20b96bef939813,t,21000,5206334,,5000060,2018-01-30 13:57:12,120
0x58b010fdae1e4cda0c812acb513765cd472b6d9c61030df4d641839e916687c9,t,51606,5257940,,5000060,2018-01-30 13:57:12,121
0x874782c0a394d7a89e40071df34762235ddd0d3169123a977006501c9b50c062,t,21000,5278940,,5000060,2018-01-30 13:57:12,122
0x7d7a73dfaa53584819f28f358723de6a6d1fa7faba6d03f4325cf930d7318a46,t,21000,5299940,,5000060,2018-01-30 13:57:12,123
0xec599ddb6a36f315d6e2db2d2d1fc4e30514aab7377cbeaf4eb9a605f3913adf,t,21000,5320940,,5000060,2018-01-30 13:57:12,124
0x99895009578509c47e9dc6c8fb56f9b34be79a1f2ea00a3b41d9612b6e4b4f1f,t,21000,5341940,,5000060,2018-01-30 13:57:12,125
0x7f6a122031d89620c0e163166d6fc6484957efee3d658d6de4d8e51e35b601f5,t,21000,5362940,,5000060,2018-01-30 13:57:12,126
0x0a4b959b4f3f51711b043e9ea6ed97af41cb88fdedb9b71c6b424e2554a7a97b,t,21000,5383940,,5000060,2018-01-30 13:57:12,127
0xf26bbea5c9a4de2b6669abea214861f5a4db0c472e2b56c357ce2e13df7591d7,t,21000,5404940,,5000060,2018-01-30 13:57:12,128
0x77f47ba0af4fd69865318eb06f7f177765148a5a7c6f22c9c8522589b2cbc78d,t,55779,5460719,,5000060,2018-01-30 13:57:12,129
0x9570de7e5b76fa22eec21014502a326d58242e12951968d1fbb9b87f50398481,t,21000,5481719,,5000060,2018-01-30 13:57:12,130
0x281a595100e98af8c7bb01ec5f15fca6b17468439ca835a4f4a7c1b177a82232,t,21000,5502719,,5000060,2018-01-30 13:57:12,131
0x8d3e0d6153e05ff000203e2e6f6b2635929c0a008b4cc8f7ec79b25cb00ed315,t,37939,5540658,,5000060,2018-01-30 13:57:12,132
0xaec8f37c5b27a6f18747f006dac257f94a0c61cd88bf1f9862dc00b7f6ff65b4,t,36938,5577596,,5000060,2018-01-30 13:57:12,133
0x9a017967de3c1eed1f3746edaf37b5bc7895a3de691ea8a556b131b15e8c84ba,t,21000,5598596,,5000060,2018-01-30 13:57:12,134
0xcc2b80de598513e020dc6e8ed671287de554b609f2b7f0098d50404121488114,t,21000,5619596,,5000060,2018-01-30 13:57:12,135
0x52a46968ec0a52ca9951cb9257c4cab9bd2a8ba4fcc8bdb99e2f63aec212d284,t,21000,5640596,,5000060,2018-01-30 13:57:12,136
0x46aa0d8e4512b1bb8b7056a84dc106c72f9afc7035811236c086f90a5ec2b45e,t,33705,5674301,,5000060,2018-01-30 13:57:12,137
0xcb792b4dd1a5d98efd84dd1da413779d240c7ac852834f53626ec09c27ad24d6,t,21000,5695301,,5000060,2018-01-30 13:57:12,138
0xd93f96b22221e26ad4154964608337f89a5c7fd887a1cad70e1d15c5089a64b9,t,21000,5716301,,5000060,2018-01-30 13:57:12,139
0x00ed137fe8a060f51a209024252adef75354e0ed43d4f53481434176fd013bab,t,21000,5737301,,5000060,2018-01-30 13:57:12,140
0x7d1b8f7ead17ccb38e57c5bc6067e70d4cd2197bb45e2daa223e8fc175fa6774,t,21000,5758301,,5000060,2018-01-30 13:57:12,141
0xf0ae3f320a62f154a63d48e9e3a5241a9d115e295536e9341e488d0ee50deb8e,t,21000,5779301,,5000060,2018-01-30 13:57:12,142
0x62997ee3362433ac7b698cd780a140716e7832226c49e403dd886795a921eb70,t,21000,5800301,,5000060,2018-01-30 13:57:12,143
0x04a97965d740c0ed0c5b5dee2b7275ed72fd2ce3d22185aabe24cf8692c0f78f,t,21000,5821301,,5000060,2018-01-30 13:57:12,144
0x7e353b820b41ad593a8c355bd850067783e673f7bbbafbcf37bf997c356f5c3c,t,156601,5977902,,5000060,2018-01-30 13:57:12,145
0x7817f7dacf8a8e6db6b420aec6136dbe05d780430c75c54603323e8e90697f65,t,21000,5998902,,5000060,2018-01-30 13:57:12,146
0xdca935ed0150b233647c6814ee3a091d32089ec466b24e2decbb35a672cb23a3,t,21000,6019902,,5000060,2018-01-30 13:57:12,147
0x1341facbd36931b00d6ba2fc3a1c7ff5a047107fb91b7d3324602fd01231a0c0,t,21000,6040902,,5000060,2018-01-30 13:57:12,148
0xcc7277ef2cdf738680bf783a0b9b35c6b02dacab131c174007ef606fb54c4d3f,t,29653,6070555,,5000060,2018-01-30 13:57:12,149
0xcf8db65f6130706a43cd4ca518bb295a7452a0e67be921b5da1a687537888e00,t,23316,6093871,,5000060,2018-01-30 13:57:12,150
0x55f1eebaf7f353eed3f95a255fe360480456b41c98a53886762451887f9d49ca,t,36335,6130206,,5000060,2018-01-30 13:57:12,151
0x304ab649a97b89f415dbb6c6f7132da262f458416e7d5ae325d281870c3d4ce2,t,53252,6183458,,5000060,2018-01-30 13:57:12,152
0x707b48aa50ea0124dbda4d4a2ed207d1414261962e627768a6db291523ab924a,t,21000,6204458,,5000060,2018-01-30 13:57:12,153
0x52d7280302110c91210ec8201f90bbe79b0cd352d9737a5968413941fb1ac046,t,21000,6225458,,5000060,2018-01-30 13:57:12,154
0xfa96d15a0f93978b1c7f393c1a42e60c736c3c5f25d374881e1039ed2cb0d6ed,t,54005,6279463,,5000060,2018-01-30 13:57:12,155
0xb1d1d510a84773ca4d67e4875fecd2c5a3833608810747ed85b04dcdf1dbe2ca,f,23192,6302655,,5000060,2018-01-30 13:57:12,156
0x8e426e72f813e1b031bae16bb7dcd9a2211d8ccf22480e85f3fa17c0904e057a,t,53470,6356125,,5000060,2018-01-30 13:57:12,157
0x87b32c59f61d0143cf25203114bd661f444403fa0e6b0c07ebd19ab6e15fd242,t,21000,6377125,,5000060,2018-01-30 13:57:12,158
0x6a642edc612278b23c6581a7e79a6afde6dcfd02a18029977dab5d46665faa5b,t,45591,6422716,,5000060,2018-01-30 13:57:12,159
0xc42ca9219f0acdb982b0bef8a88919f8554cff17502e537f56ee97e596f579f3,t,93050,6515766,,5000060,2018-01-30 13:57:12,160
0x73fcdc0b4ac2c88d86ac8619d17bb7814a4ea6bb3abd81456d4b02bb226606fc,t,59290,6575056,,5000060,2018-01-30 13:57:12,161
0x7fe24d7be1b55fa51f12089ef8af9fe52246ca6f276e60c93a585cbd92b9e94c,t,23028,6598084,,5000060,2018-01-30 13:57:12,162
0xc72804331614195808cb6b4fac3600f23ec02c925301eddee3c14f242e51fa1d,t,77666,6675750,,5000060,2018-01-30 13:57:12,163
0xcadbf265e47fb793dd7794e903755cf330e5e0f6c395848d045cfad5d26cf63c,t,52344,6728094,,5000060,2018-01-30 13:57:12,164
0x7dd9b95b6a1380c48da1ffd63194bcd9c9d52ab315b84e464c3e3b258170a848,t,21000,6749094,,5000060,2018-01-30 13:57:12,165
0x6d6d75fbe9ed0d7ba8c7d2fbb841ee1c0aa5bd6de8e5679f29b5226c31e7c8ae,t,45893,6794987,,5000060,2018-01-30 13:57:12,166
0x960b719dc6fbbefca16faa8c80267bfa15ce0c93c0b2d428eae99edf938dc5fb,t,21000,6815987,,5000060,2018-01-30 13:57:12,167
0xc467469893405126d244ef485ea3e740bdfa4b905508e5d37f4c58bb4e2c53d2,t,121754,6937741,,5000060,2018-01-30 13:57:12,168
0x17f0744bdadbe452266cb9d13dd5372eeec5bcc8630356833c8a024f0547d747,t,37900,6975641,,5000060,2018-01-30 13:57:12,169
0xeea88a273fffdfc0b64e5da74d6134f14997e415bcf5c27bd12f386d2c9821f7,t,21000,6996641,,5000060,2018-01-30 13:57:12,170
0x62c183bab39273c84484304be7fa91e69b567d45299e60e8e8e4b050e4135900,t,48418,7045059,,5000060,2018-01-30 13:57:12,171
0x7126c78fb1b177e2b70f86f3be178ca2698705cd5689381f8be9a72d026b6795,t,132823,7177882,,5000060,2018-01-30 13:57:12,172
0xf4bbd812bfe2d796d38a2406c62c92d51c04c5c9337a0dadb08ffbce12358e31,t,59162,7237044,,5000060,2018-01-30 13:57:12,173
0xe7cc7d4d80dd7107d517ebb101fccec71890ca21bf5891e03e5c70e31d37027d,t,51913,7288957,,5000060,2018-01-30 13:57:12,174
0x9e97af1a6f55db3114f77a94c590958412af86f6e78f17739ff6ca509ea8625a,t,78178,7367135,,5000060,2018-01-30 13:57:12,175
0xaf643d93805a52fdb5cfa16a72907ece6add8ec6797ecf088392885c69f9156f,t,59354,7426489,,5000060,2018-01-30 13:57:12,176
0x9f525002021dc8fe5e2d64f5032017ae4ba1772149211e523e987f794b2bc4c3,t,37797,7464286,,5000060,2018-01-30 13:57:12,177
0x9afa3790045e1083842ebf7414f06ed2b9c3b7d0b7f48b2f8e441a9eeb9b1d18,t,22568,7486854,,5000060,2018-01-30 13:57:12,178
0xeb9ab7b8bb89c737fb733d7fc80b9b80480cdd0798d615a0a0961297d55ca10c,t,29493,7516347,,5000060,2018-01-30 13:57:12,179
0xc3d9eb792609c8b68ba29b4c0de3c07d1691bdb96a689385bef420277dcbaa76,t,66253,7582600,,5000060,2018-01-30 13:57:12,180
0xd38b82443c92c833864b596562070b6c8eef37c10d2495a983caad9c68186e5f,t,37900,7620500,,5000060,2018-01-30 13:57:12,181
0x1f5cc254de5716c1fed11a7d16f2d45fba16461b9b0d7b2b798aad473f75df31,t,93306,7713806,,5000060,2018-01-30 13:57:12,182
0x40f6c1fa14334e8d3b0379f01782b404b11ac63b6ea14e5c5e5e9db9fb398176,t,46032,7759838,,5000060,2018-01-30 13:57:12,183
0x97d082e536b04ccaa649abef3286b3c7646c33f6b4e830e97a2e41632c001d90,t,21000,7780838,,5000060,2018-01-30 13:57:12,184
0xdbbbb0d9e27857f99baf8b0f7281ff7b5b3490d41a84728be300a53ccf4ad5ae,t,84005,7864843,,5000060,2018-01-30 13:57:12,185
0xc9b383f2753f752a199706cd64e3ac0ec3919885df25e6fa672bc0c8d215f94f,t,84005,7948848,,5000060,2018-01-30 13:57:12,186
0x49172a199a2a8cbc79ff2767a537d2845f31b0b9f1e2efd87dfb71ede6dec0b2,t,21000,7969848,,5000060,2018-01-30 13:57:12,187
0xf2ea31c2ec49fca176667cf5b27f36a9a84b67289e8d0eae8840b9bd22d49123,t,21000,7990848,,5000060,2018-01-30 13:57:12,188
0x2b97cd965490d31d83d13c36d70de1c8bc242ca4fc8fe1d24d655439165ebacb,t,21000,21000,,5000061,2018-01-30 13:57:21,0
0x99462e6b3b2f7b0c5de43608f880e4c342b6549d4a7ec6f6214c01f9c497ca79,t,21000,42000,,5000061,2018-01-30 13:57:21,1
0x45e8fa8e5a67264c8aa1ebc9a522f6f8db9de1a2ebdddb2232e8792ddf48981a,t,21000,63000,,5000061,2018-01-30 13:57:21,2
0x2d7e471fa031690b4c56ba946311396167be8e8bf354d1fe4125388d8c8dc5a3,t,21000,84000,,5000061,2018-01-30 13:57:21,3
0x0d024f7ac1f21015e51cf10a3e00c02bd452c505923832168f14ab9b0f1f928e,t,21000,105000,,5000061,2018-01-30 13:57:21,4
0xa2968cfd9117a83c8dc6763b0a4a06cc64afb57ac8154ffe2bd518fa572fcbe0,t,21000,126000,,5000061,2018-01-30 13:57:21,5
0x6f5646ac8628f7de0d405df3d5fcea9578b2622ee4e4d69994fe90e6d65c9cae,t,21000,147000,,5000061,2018-01-30 13:57:21,6
0x27995ad294c9c471b260dc25bc6bfb83570232c8686995f333c5130a7700d7b0,t,21000,168000,,5000061,2018-01-30 13:57:21,7
0xc9ebad883627fba9735949a9a03a2e848b1fd05d378c02b7f4f5ed680ceeedbf,t,21000,189000,,5000061,2018-01-30 13:57:21,8
0x7cae3ab99c907d24623d6681a4d2bfd7aa60acff0cae325f011172c75dbb80f5,t,21000,210000,,5000061,2018-01-30 13:57:21,9
0xc00df6c73a3aa7610d27af4826d91b038abc468841b28a23f4a320639fdf7c1c,t,21000,231000,,5000061,2018-01-30 13:57:21,10
0xf77bc553822a0d3d409b8ed33bfb53229d579a401427c33c0ce17dc91cf66c59,t,21000,252000,,5000061,2018-01-30 13:57:21,11
0x0c9693c6a68d8d5556f020353c24aa79a82a3cf904df5f3e1de70481396f54db,t,52091,304091,,5000061,2018-01-30 13:57:21,12
0xa4a0d6fdfc6e21420b0edb337fef1244eacf1807693822f72e14519d95465af3,t,52027,356118,,5000061,2018-01-30 13:57:21,13
0xbf47eb088601b8bbea52577c05e198a9dc8d42efce7591484022070f698549a5,t,52155,408273,,5000061,2018-01-30 13:57:21,14
0x089b68a3d6c16cbc565daccadf7b87e02b2d167d6f1071d4ac2048ef7b15f6d2,t,37155,445428,,5000061,2018-01-30 13:57:21,15
0x79242fde09df3f83dfc8254a5d14a28f754a13ac07639b65df460f489723cff9,t,52155,497583,,5000061,2018-01-30 13:57:21,16
0x7711efa95176f79528fe9a7a86de44abb7e6c4b10ee26ebdcb73ec3a195ddaaf,t,21000,518583,,5000061,2018-01-30 13:57:21,17
0x07bb4d224db30992bc3c8ba0e7a1073ed557093bd20f48029a636e9ce33b9c80,t,21000,539583,,5000061,2018-01-30 13:57:21,18
0xa26683d63318c63e9901fd5bfabbba911c27ab3ec01f8edca8b6c06e309c6adf,t,21000,560583,,5000061,2018-01-30 13:57:21,19
0xdc9c97b4ea0420e62fa419828c087a1410b7d038b40032328ce628e5d0f4ae7c,t,21000,581583,,5000061,2018-01-30 13:57:21,20
0x8ae07cc69ea94d698a5bc8829954c89239e3c40d601d3564f9e3f50c5ca7bd21,t,21000,602583,,5000061,2018-01-30 13:57:21,21
0x0b73899584936f764644b549d0a907731679ce745402324da720b255de06aeb9,t,37091,639674,,5000061,2018-01-30 13:57:21,22
0x7968f9e59521daeeb31656fa8df6f0308bf6400016de62edf85021283d18723a,t,21000,660674,,5000061,2018-01-30 13:57:21,23
0x3f3440d4746f495430e2fdeeceedf34f477456bc5683a1caa8317534590a452a,t,21000,681674,,5000061,2018-01-30 13:57:21,24
0x5468b4a5200cbbe7612b1b964c9ee2d68f9908f2ca5eec1115ef9caa70962700,t,21000,702674,,5000061,2018-01-30 13:57:21,25
0x122a5d86d285ce0a54ee374c029d4d4c11eb2b79f4d1de9be31aed6486186e4b,t,21000,723674,,5000061,2018-01-30 13:57:21,26
0x5360c2d9c6c05ffe1a93f0ad25e28bda09e256297a50a5acf5cd6bbb13a12bd4,t,21000,744674,,5000061,2018-01-30 13:57:21,27
0x13c43e8560ac9f199af983fe63cfbd8eff6e8710c6c3b93ce48bd245fa81b140,t,21000,765674,,5000061,2018-01-30 13:57:21,28
0xb24deab8b90ca7bc6562661ca4385ad0546cfb98e9e30e0e0209216c657e3657,t,21000,786674,,5000061,2018-01-30 13:57:21,29
0x0355ddc0808302a8bc0c8d04b9b992bcb02c8caa7aeafbfc775fc603960b6b09,t,21000,807674,,5000061,2018-01-30 13:57:21,30
0x5834621adf6e593cf44a3960d5ede64924040d0144bbc222ca319848f00c0627,t,21000,828674,,5000061,2018-01-30 13:57:21,31
0x3a48dfed99f52ecb55284fe24b3b076fb8f35114a4370d93f65d93f07509cdd4,t,52027,880701,,5000061,2018-01-30 13:57:21,32
0x156bf878b68021ccec651275931a7096f1fce6e86201c36973209ecd8b7a94ba,t,54771,935472,,5000061,2018-01-30 13:57:21,33
0x281575c80f75baf53ab69df7f419ed1c6a7231309111c87c6eac6d472ead452b,t,39835,975307,,5000061,2018-01-30 13:57:21,34
0x20b59a0256a6cccc974e3e45c84ca798429b1c21e6d1c3b9f8c2f65ef133a94b,t,40843,1016150,,5000061,2018-01-30 13:57:21,35
0x67db056a25ad4f5cd5e0dc23de9f6bfe95dc5b7aae9f728f40d90b08dba1d016,t,21000,1037150,,5000061,2018-01-30 13:57:21,36
0x88214960b9d7bc955d8f63e1200cb8debba568652651049289130a04d25aa6ec,t,21000,1058150,,5000061,2018-01-30 13:57:21,37
0x2f911c0077cc18b6ef59e1dc23ef9be75200a484beb9a22cb0eff3ffa397fa86,t,21000,1079150,,5000061,2018-01-30 13:57:21,38
0x88e3ca3397756df8f3302e74954fbae4f81ee3e1ce00494da0502ba718fd48b3,t,21000,1100150,,5000061,2018-01-30 13:57:21,39
0xa0fcdf6ee50696190094d01f368b1468925e7760617f202ec4303714ed2463c9,t,21000,1121150,,5000061,2018-01-30 13:57:21,40
0x63c7e66b67f8bd202324d57709cd60d46171fa3d018296d9ce7c0dc5a186723b,t,21000,1142150,,5000061,2018-01-30 13:57:21,41
0x6401f28e8640bd0bd79fc05bd90171d17d38c5bb15ec6abc37650ef6bc2ebe5e,t,53615,1195765,,5000061,2018-01-30 13:57:21,42
0xf6666bb80220e9a75bc66cf0783ddf216c4ff6e6f382b123d117761c2876e593,t,50057,1245822,,5000061,2018-01-30 13:57:21,43
0x5fe753e10e436e457593517327f664fa5a07c60ccc5491dae1c5481adedc0ce0,t,49993,1295815,,5000061,2018-01-30 13:57:21,44
0x3a67a2dc9fc35683b3a71595bb552b08378502a359ab518c44323b4daf03c5c3,t,49993,1345808,,5000061,2018-01-30 13:57:21,45
0xf7d2254a8dab79d77261aa48b440cae364694c6cb28580e875f76fcdbaccf1d2,t,50057,1395865,,5000061,2018-01-30 13:57:21,46
0xf2f247e389100fe86ffb64867e0f24befa189791c29c84ee2481bdf5559db8bf,t,50057,1445922,,5000061,2018-01-30 13:57:21,47
0xfc5df6cd57f6284c74bcfe0de6dc3e08a257c4bbc4d3b1f63af8e5acb35dd6bb,t,50057,1495979,,5000061,2018-01-30 13:57:21,48
0x150f2e41db40c88fb51326d767867b38d6f3d3666e15ca8e0279fe62813fec2c,t,99317,1595296,,5000061,2018-01-30 13:57:21,49
0x5857ae4bdf6c286f16223a554439b7c86694fc0b183f3c22ce7a3b9d2fe4cdcc,t,21000,1616296,,5000061,2018-01-30 13:57:21,50
0xb86b37618716de8d099facf4d065d2c98920077c31f71e18200df076c9606a40,t,21000,1637296,,5000061,2018-01-30 13:57:21,51
0x68d9cb6d3312184c8cf64b855a01dfdc154e8093645771ed1bb87fd8449cd38f,t,21000,1658296,,5000061,2018-01-30 13:57:21,52
0x91d7fc8378cde331dda23607c681050c7648c6f39f04ab2d145a479fad809576,t,21000,1679296,,5000061,2018-01-30 13:57:21,53
0x980977080348f7d91988f26ba859906c3d0c4f114abb62ccf87d54be6af76ce3,t,21000,1700296,,5000061,2018-01-30 13:57:21,54
0xb46798cf48ce476e3fd160314bd969dcb7ed87b8eec86953315d2f695c7abbcd,t,21000,1721296,,5000061,2018-01-30 13:57:21,55
0xe06713e8b201f0d2dda08f5b3af2a76ee28a8990024a210e299f125bdfb0993b,t,21000,1742296,,5000061,2018-01-30 13:57:21,56
0x286a9c371a43d1b570511d0e0655d25e5268e2ffc407cd0a567b3564df599320,t,21000,1763296,,5000061,2018-01-30 13:57:21,57
0x1c52113b22e7a88dce5698d637f347f6f246f16ec9a67126fbb0c3595eceab3b,t,21000,1784296,,5000061,2018-01-30 13:57:21,58
0x6b60f6454b09757915bde2ecf98d478b5e6b05612acebe24ada52c9374363143,t,21000,1805296,,5000061,2018-01-30 13:57:21,59
0xe9df5a25e0a42eb084dcd3a50cc6969877ce80d0e5ddf597f28d6ec5e3793f86,t,21000,1826296,,5000061,2018-01-30 13:57:21,60
0x4b3ecf65b6d4661b1bd1e2ff00350f072649de7f3b034eb5db0e71c15e596d52,t,21000,1847296,,5000061,2018-01-30 13:57:21,61
0x8fb54f00d0612cb8f45eba663e5e5fa4209a12860c78b99ce7c0f2bf84f6b4fc,t,21000,1868296,,5000061,2018-01-30 13:57:21,62
0xab380a9c873b6a47e197350f434b93dd3881e862a55ddd1d2c000519cf29269b,t,21000,1889296,,5000061,2018-01-30 13:57:21,63
0x1cb122f1e2e45fe257e5f44fc98cdcc6b5854ce355408b4b41acae0dc8f21c0a,t,21000,1910296,,5000061,2018-01-30 13:57:21,64
0xe1f2e71d265fee3c3db5240592b95bbf982484143f3518ed0da3c39a95c6dc17,t,23028,1933324,,5000061,2018-01-30 13:57:21,65
0xec3dc818b12449bc27da06aa329a7b08c400531a04fc9fe5bc1820025c08f2c1,t,55779,1989103,,5000061,2018-01-30 13:57:21,66
0x2e258ddcb550da47e9f6261b6ab542c4ca11d95daed2067b8dacc35a67e4646c,t,52950,2042053,,5000061,2018-01-30 13:57:21,67
0x9a32d93ca6f47209e927dcf5add16e6d2d87c76987f068c73294a96cf4927868,t,21000,2063053,,5000061,2018-01-30 13:57:21,68
0xc598cbf050052d84044699fad846b499e9bcf8cddf7deeb3d2a977389d7816fa,t,21000,2084053,,5000061,2018-01-30 13:57:21,69
0x8a07bce9e2c228ff291d8ba54166770d67f5dbf5a2dd4b78c3520e54badf907e,t,21000,2105053,,5000061,2018-01-30 13:57:21,70
0x9640149253d41b1ddb0983c4f0f84bf898e8ae40dc685ab3003631302673cb22,t,37091,2142144,,5000061,2018-01-30 13:57:21,71
0x0bb2f1561ad6323603530b1c85d5a2c1bc1445b92df589dc9a6f5007d1128baa,t,21000,2163144,,5000061,2018-01-30 13:57:21,72
0x7eeaae461a9ef7dacee95a6c582ca2ef68699f0abdb0ec8a0b4db96e6410ba72,t,311961,2475105,,5000061,2018-01-30 13:57:21,73
0x18893fcd2b5d3f36911e7ab8bb118fc2dcb4a8f614430d3e22717c9930c61410,t,44095,2519200,,5000061,2018-01-30 13:57:21,74
0x045a9bc885081bca935fbd67d5021247fafbfebbf514bb3b93b86aa81a6229d5,t,21000,2540200,,5000061,2018-01-30 13:57:21,75
0x88ad6ee7275d77fe2693926178a5ac623fca665a0c61d9fc81f6fc035dbc8c44,t,25438,2565638,,5000061,2018-01-30 13:57:21,76
0xcf44ff5de94e0934905890a6fe20639e944006b4f466183b381730f40a679e8b,t,46045,2611683,,5000061,2018-01-30 13:57:21,77
0x1962e2a1945a0302fe1ef10210a42158911600ddc31b08f81600b5ef591a082f,t,21000,2632683,,5000061,2018-01-30 13:57:21,78
0x8075ac12c9ff5f516dcffb5fdeaa929034de72fa89e05c8b1656d18c036166aa,t,21000,2653683,,5000061,2018-01-30 13:57:21,79
0xf9b3012ffa9c24a02a879c2b6f46b48c9c86005159b7e03f38b62c17813e8d1a,t,52158,2705841,,5000061,2018-01-30 13:57:21,80
0x659b7f9366f97441101004fc989907bac00dd19a6489d7a2b8e2f387d97237b9,t,37188,2743029,,5000061,2018-01-30 13:57:21,81
0x5621f3a5daa1b44b164c88480a976a7d864397f2141c4b6b27ad7395f8e01624,t,53252,2796281,,5000061,2018-01-30 13:57:21,82
0xae66fc6f9ad80e93b79250ee753540d77279f163784d9491bb515c3c0bb155f3,t,52321,2848602,,5000061,2018-01-30 13:57:21,83
0x1ad8b3f56bd955855a9500ebc727048ae0efb772b03b318b4b68b188ff41df58,t,51397,2899999,,5000061,2018-01-30 13:57:21,84
0xb6bf7bb34e88a2034148b676e24ebbf3baa3ef955685c6d52b52109accfa490e,t,21000,2920999,,5000061,2018-01-30 13:57:21,85
0xf8e8d41f8b72f74b78af3d6c8afdae7107007e2af67510a29b0103971c8afebe,t,21000,2941999,,5000061,2018-01-30 13:57:21,86
0x2e0bc5689e8956eccf8dcdd268bf47d1af8e30536a3ca5e6215bc0f01dea8e33,t,34568,2976567,,5000061,2018-01-30 13:57:21,87
0xe5ce125c82309d99b7d236d3154cef8dbddb695f9f34466dd8152549e92e75f7,t,21000,2997567,,5000061,2018-01-30 13:57:21,88
0x0fcdac2c85d8dbeb4396602d0ccd92dfd85589eb7b0152e8ec4a49ad98782cab,f,250000,3247567,,5000061,2018-01-30 13:57:21,89
0xeb0f5216da19399b5ab3cb0db5dc5f6ec16b575d69adf3d4eed32ac0a1287afb,t,108562,3356129,,5000061,2018-01-30 13:57:21,90
0xc8e8c53fdc7f35426e9d9bfb9ee4850cc7428185375feae883cc8bb5ef773f36,t,21051,3377180,,5000061,2018-01-30 13:57:21,91
0x364decebc7f5d57380abae9d7ea4eb30af7bb90d681047dfa4d9328317cd8712,t,21000,3398180,,5000061,2018-01-30 13:57:21,92
0xf06a8ad8dae9c649ef74f7457a418039f18a40dc8f022544797bd9213d1cb8f1,t,21000,3419180,,5000061,2018-01-30 13:57:21,93
0x72dfbea6a8b8d29b72a39d8ad1fea605487a51448abe3b23d2cb1a37fc1abbc4,t,21000,3440180,,5000061,2018-01-30 13:57:21,94
0xba48868809d1fd17fdbeca96c799a6926adf9d7910e3d4d671e18beca2b85097,t,53047,3493227,,5000061,2018-01-30 13:57:21,95
0xd98428d8d38206be16020dc5428a3710369c26018ccfa00b4038ac9cbb849b6e,t,21000,3514227,,5000061,2018-01-30 13:57:21,96
0x2c2cedad538b8a895a35e5f8685ea6d78177f4180b8bdce5bfdb4e23e0d7e162,t,21000,3535227,,5000061,2018-01-30 13:57:21,97
0xa0eeddde0a2feed54985e6f752aa314f68d906ffd154f0cd0feee0c7cea5f44b,t,21000,3556227,,5000061,2018-01-30 13:57:21,98
0x18d80b171c6489dc48656d95b26dbd1ab1f995bdfdd38cf82ffa02d54000b9f0,t,21000,3577227,,5000061,2018-01-30 13:57:21,99
0x710a736b715dbbe487e94ae767743091c0a5178b7276661cbd68dba5adbf55c5,t,21000,3598227,,5000061,2018-01-30 13:57:21,100
0x183000b4d942dccc6864121a9e8ae9a7efd2b845de22de8c1dc114b12a12d928,t,21000,3619227,,5000061,2018-01-30 13:57:21,101
0xce54f8a342544dc69c4af5127b9b96e6a0eb20272eea35a289492cb4c8fc1c51,t,21000,3640227,,5000061,2018-01-30 13:57:21,102
0x7ff086db718abbc3141f1fea2237d9d243999e55c58dd0f98af0b61b3df7378f,t,21000,3661227,,5000061,2018-01-30 13:57:21,103
0x6b7d1ad2dfb67591437ef5735d9ce450fc44ac5665d084ee17d5bdb47ab0b94f,t,51765,3712992,,5000061,2018-01-30 13:57:21,104
0xa670df68019047579219f8c0ad7f2be3f993c02a4ed2f3400c63d39812b83fae,t,21000,3733992,,5000061,2018-01-30 13:57:21,105
0x63f0c2669cc4a7802b1998f4dbb7c78734c79ab208850842db1b5775f4fc634e,t,52524,3786516,,5000061,2018-01-30 13:57:21,106
0x32b4ea564fbc6d189baeca3a249033eea4e74d840dcf55b1c4e2b5447f7a4a57,t,51590,3838106,,5000061,2018-01-30 13:57:21,107
0xee1f30e23ba61b03195e83a16793b7120b94637bdeec4a22560770369f559cbc,t,39157,3877263,,5000061,2018-01-30 13:57:21,108
0x2edbb96aae67128eb2a2cc72017ff77f43407355b21dab03caeed815cb41425a,t,21000,3898263,,5000061,2018-01-30 13:57:21,109
0xf9a89ba850c23a4e73e431e26f9e5319e09e6e606fd9cab3035c516ae36e3da5,t,21000,3919263,,5000061,2018-01-30 13:57:21,110
0xd7e04bb29de81d565f7fa860d7380d003defca14a1b07ffea1f31e2060a6aa20,t,21000,3940263,,5000061,2018-01-30 13:57:21,111
0x04768c34b44e7a544675815472b3a1bae2ae7f1ba7c7247547c3f913f03271b4,t,21000,3961263,,5000061,2018-01-30 13:57:21,112
0x5888832bbe39dd9fa34420d26cb4fdf2d0e173ca3eb70f293b75528508dcf00c,t,21000,3982263,,5000061,2018-01-30 13:57:21,113
0xd6f1f6003ed918db5b64ac8d848b5d32d3a28455d3eca6b42e732c5f47c206b5,t,157004,4139267,,5000061,2018-01-30 13:57:21,114
0x4a6939b9f1cf6332cb46a3e267b88f5899f80d07e4b3a5d040382dd6a4e9424d,t,79055,4218322,,5000061,2018-01-30 13:57:21,115
0x35aaf9ca552ceaf61429014af0ca6d3b17874f6017700813f4b9171270306171,t,127580,4345902,,5000061,2018-01-30 13:57:21,116
0x257ec42e292ec8001ddb68fab59df9764d8056795cc5beb9a6e1778c3c87b53d,t,142452,4488354,,5000061,2018-01-30 13:57:21,117
0x9d2b6ae2051b67d48285aebb13961c08826429e0318503a3e3c6d5b8453c60aa,t,48297,4536651,,5000061,2018-01-30 13:57:21,118
0xf072861005913747b7aba4e14752e3ab7aa10da4d849ae434871092997be587f,t,59354,4596005,,5000061,2018-01-30 13:57:21,119
0x1ebf6bb28c10a8fc7238aa084e17e7558944fb7210c7d952876e2bf57e4db70e,t,38679,4634684,,5000061,2018-01-30 13:57:21,120
0x80c376b4b7da63dcae09deb9c24a698adfac942d686cb662ae49f679582bea29,t,40907,4675591,,5000061,2018-01-30 13:57:21,121
0xa08b0b60c432f21f890ad6dd87025e5dd8b4788f8ae72f94c2b44ef5cb375d7e,t,52252,4727843,,5000061,2018-01-30 13:57:21,122
0x7d0e13310e8875b54e4670f61e45c2c2466c9798915767367711bdc87c7ad3d8,t,52886,4780729,,5000061,2018-01-30 13:57:21,123
0x19bc933e01e479e9de3c19312d9d05a1fcea6833cde8b5080a789a6f2c2d3f9d,t,52886,4833615,,5000061,2018-01-30 13:57:21,124
0xe3d736d708f490b82592d27e056dca191e2136f60ac08b16fdede149f4e999e5,t,52822,4886437,,5000061,2018-01-30 13:57:21,125
0x8e4fb9fa2ebc75aba8b55b994f75fd5496398867fb83496971cb3d521d77ef39,t,52271,4938708,,5000061,2018-01-30 13:57:21,126
0xd5f23e2200e6431cfc7061dc701cace2f09c754b963bc6816f5ad5936490ec07,t,52309,4991017,,5000061,2018-01-30 13:57:21,127
0xbf13f85ab40e0787cf0b055823f25873a2af6bd4e6747af92f1d39666edca2d3,t,52075,5043092,,5000061,2018-01-30 13:57:21,128
0xe19620fcf5fae3af430cc61ab8e80a3e5c4d2ccf2f714497c1fdc615bcaf586f,t,40907,5083999,,5000061,2018-01-30 13:57:21,129
0xf22df702c34985e5468b18a4a0c57ee48c93ec61d92772b69910bfd7f1c007ec,t,38754,5122753,,5000061,2018-01-30 13:57:21,130
0x5745ee4c5f0667da07d2d52c8296339b379fa137a6db2f3130208220bae372ae,t,21000,5143753,,5000061,2018-01-30 13:57:21,131
0xd32ab909187ee2706dc5fc25f892bf45ed18bc4b6fff6cdcac02d77423dad49c,t,21000,5164753,,5000061,2018-01-30 13:57:21,132
0x891d070f9a82fd589afc0015a1d770001202921a7cabeaf3c9a24fde7c2f8e49,t,37356,5202109,,5000061,2018-01-30 13:57:21,133
0xe6d997042c1082d5ae312608a31d0134258528e09dc34b79e228750644738ac4,t,36948,5239057,,5000061,2018-01-30 13:57:21,134
0xfd00cae12200b833b42bb2fc6ace69e97d21fd7c76171c24a2f1b14ac7e84e00,t,38690,5277747,,5000061,2018-01-30 13:57:21,135
0xd395d62f72be470963dc900067f5e32b3617f1dc4c82ee8685ce7fa1b008e409,t,37270,5315017,,5000061,2018-01-30 13:57:21,136
0xd2d6b3ddba222111cbe54a27f8cdd568a57f33d4670bf6dce64d91e8936e5f4e,t,37309,5352326,,5000061,2018-01-30 13:57:21,137
0x54b17197ac049c8d8c9dddae125032550015ed2276d2d8129d1b4d1b783353c2,t,36925,5389251,,5000061,2018-01-30 13:57:21,138
0x862d99a408db3eb2404f184271f0e8e09b1ff4623eb577f3e39d1eb0c2c18f7f,t,55907,5445158,,5000061,2018-01-30 13:57:21,139
0xfee92b433f2b88633eaa2479b9d45be26dac2c8db6dd8ac00f9e1a33b88554e7,t,55779,5500937,,5000061,2018-01-30 13:57:21,140
0x75c59f7e7bfaa35e39fb34243243d010c3882e42b5f2f80a1b55f7b90cbbfa44,t,51606,5552543,,5000061,2018-01-30 13:57:21,141
0xd2aaf5fc284f8e3a21cc9c48d711170cceb80d88f11014539afff1dff29e1750,t,37030,5589573,,5000061,2018-01-30 13:57:21,142
0x897cc8b6b2a5e2e414feb70ce7e89cc58baaa44b80d821a7fec077e3b69b3e4d,t,53040,5642613,,5000061,2018-01-30 13:57:21,143
0x73303a70164ead412ad684143baf37adfa1bd1a9126c5ab95cc4e55d0e32cb12,t,40907,5683520,,5000061,2018-01-30 13:57:21,144
0xb3d058ad023d97f6ba249203912614be249e99c05586579e4c6237ea22a90411,t,52611,5736131,,5000061,2018-01-30 13:57:21,145
0xdd1c66cf1515c896969e303aee57d09766687e3c8d1c04e16b2d487f90ec0c91,t,52030,5788161,,5000061,2018-01-30 13:57:21,146
0xc3d3cc24f5673b5f5c1d404ff525f0868ace196ff8539f31c69ced3d908e2790,t,110406,5898567,,5000061,2018-01-30 13:57:21,147
0x391c5655bc388b00d8ec67ed5562ca8ec6d88845c69e7f3e3bab42a939c1e707,t,37886,5936453,,5000061,2018-01-30 13:57:21,148
0x505b0163954456f6cf4f4dcb6ec952ee232899efdff4bb3dbee50003373ac832,t,37886,5974339,,5000061,2018-01-30 13:57:21,149
0x2fe5b251a6c7c3a36aa4ca9a37d405f72cda4bf55ca5ef034a13fff8c0ee91f7,t,52886,6027225,,5000061,2018-01-30 13:57:21,150
0x0457da4659d71ee570875da4d7bac6ff4b17d10d6e220f43ee647a9c34ec9291,t,52886,6080111,,5000061,2018-01-30 13:57:21,151
0xd84533e5c428a7e06f03c6415ae0425685d4e25426354053a5659b03398fba45,t,52886,6132997,,5000061,2018-01-30 13:57:21,152
0x5b061d8592ad61c1949a3bceb7d6c665cd6523f61d9d2997575c9ebf0cf5ac93,t,52886,6185883,,5000061,2018-01-30 13:57:21,153
0xa7f00a6fda36707bb1a3f71a08a0172018ddb187c71216a2a5e5813a75f6bd4a,t,52886,6238769,,5000061,2018-01-30 13:57:21,154
0xc7761960e4c1ca56c5b5894159adcd1172a562f7e4c40703b87e0d56869298f0,t,52886,6291655,,5000061,2018-01-30 13:57:21,155
0x20e0c28b180f4a5d2e127365842ef69a2e62f109b7514dd639ac7f02ac621b51,t,52886,6344541,,5000061,2018-01-30 13:57:21,156
0xd6112a755cb7f2449b8e94157e5331e9822369277601aa71037dcd3893bfdd7f,t,52886,6397427,,5000061,2018-01-30 13:57:21,157
0x0417a6987c629256841b26ddaf3da853578bbaf8918c32238254f5903466bc38,t,52886,6450313,,5000061,2018-01-30 13:57:21,158
0xe602dcce902f7459a28614178e5f158d2af05ba8695a294bf314831bf830b2e8,t,52886,6503199,,5000061,2018-01-30 13:57:21,159
0xd775c0e386fcb0c1ee4e189f4a7823a6127ef48d0aa04649a81dcb1590e590f0,t,52822,6556021,,5000061,2018-01-30 13:57:21,160
0x720075231a76d1a391c283c7ef5133355751f9ee4d0c06b30aed1bd855319618,t,52758,6608779,,5000061,2018-01-30 13:57:21,161
0xb8b5fe4b043439a8ee49e5559a7889cf1d01cb3d09f3039ef2e220d95bb80d78,t,52886,6661665,,5000061,2018-01-30 13:57:21,162
0xa48450e400c9ef106fa5d73dc0f63a6f1d7dc98d177926578e0053acf0d9744a,t,52886,6714551,,5000061,2018-01-30 13:57:21,163
0x5afeaef3d1d2c39c5b43c3c9c8ec08c19fea94b1c456d7a1c1f2e6a216c1284c,t,52886,6767437,,5000061,2018-01-30 13:57:21,164
0x71a1d3e18393d3b622eef846d96c39061de436867b96934f20614113b6e5ca98,t,52886,6820323,,5000061,2018-01-30 13:57:21,165
0x09b3fecdae36f724fbf922fe4c8c7bddec5a80eaaafe73e93b04e929bcb9a2ec,t,52886,6873209,,5000061,2018-01-30 13:57:21,166
0xd14daf7f445573caa1b0b866f0ca8e83d7236980a18e06218c357f9807a66dff,t,52886,6926095,,5000061,2018-01-30 13:57:21,167
0xb3da86388a7ad93d8be09c677bc7abced443bd95e8930b88f60cdb5464567b6d,t,52886,6978981,,5000061,2018-01-30 13:57:21,168
0xc19a2695541f4fab6399047353170884374ec569bd7aa7b6736d38b2b35ca93f,t,52886,7031867,,5000061,2018-01-30 13:57:21,169
0xcba0354ac8011fe94077c01f1e4132b37514879d1af7f4ddde24fe99487e4640,t,52886,7084753,,5000061,2018-01-30 13:57:21,170
0x532fe09875393cd6fba443d989a11a90ee1a00f8db5a8882dfd5225a7bd5d064,t,52886,7137639,,5000061,2018-01-30 13:57:21,171
0x8487d1d7d712d83c70f313dbb2a61c310c00e1937f0985c1de135bcb03abbbed,t,52822,7190461,,5000061,2018-01-30 13:57:21,172
0xd48873998c6a2dac8cd2e5e30bd6f0b4ba8bd3d9124b387b8d3f2d9592776365,t,21000,7211461,,5000061,2018-01-30 13:57:21,173
0x784c330b7a532b9daee3ba48f90a42a2ed0aba799bf7c2d04f1a03db7f82c9ee,t,21000,7232461,,5000061,2018-01-30 13:57:21,174
0x674ad89aa541b79981c2024c013221a6f16d5f0b800acff9394f82bffbffb102,t,21000,7253461,,5000061,2018-01-30 13:57:21,175
0x5c8bfaec88c8224f3597827ee854b722102258081aedee4410b4071a9a619463,t,36792,7290253,,5000061,2018-01-30 13:57:21,176
0xa4d362f71ddae800e81163a82de35d13f487d7df8d0e855fc3c9a397884ea229,t,36792,7327045,,5000061,2018-01-30 13:57:21,177
0xffcb4b816d23153fbbdff64e42650a5671bbe77964a9dd38140fa7d067f9c3d1,t,36792,7363837,,5000061,2018-01-30 13:57:21,178
0xa9e1eaef2f39a243c7074b38514f0d0fc6d21d341515dcf63be9a57dfe5e5923,t,36792,7400629,,5000061,2018-01-30 13:57:21,179
0x25a242b4f8e0df8a3a14041db0e032a250f702cdaab5351972a9b0208ccd0020,t,36728,7437357,,5000061,2018-01-30 13:57:21,180
0x004e26dc27ef3ac835d26a83801298e14494ed11c597bd014cd48d057f435dc8,t,36792,7474149,,5000061,2018-01-30 13:57:21,181
0xab8e4100133493957f0efeb89b6dfd7db5e18ba3bd353c993c10a6fb2f6e8e1b,t,36792,7510941,,5000061,2018-01-30 13:57:21,182
0x61bb8a43894b2db90dbc01b51e0c5046429ebc3c3b7b6ce38f0ffcd9de57e17f,t,36792,7547733,,5000061,2018-01-30 13:57:21,183
0xf88773052301f8233b4e3942589ca50aec12bf6bcce1f69a0606113e6cf1e06f,t,36792,7584525,,5000061,2018-01-30 13:57:21,184
0x47ab1a7c7c3cb9faba2d0cd2ad5fb9fc8bc67e23b1ac741422101c08cc960d72,t,36792,7621317,,5000061,2018-01-30 13:57:21,185
0xa0849c1235bf5289c89cbd958bd23dc629ae604919ecda8294d6dafc257a2d9a,t,36792,7658109,,5000061,2018-01-30 13:57:21,186
0xaefe7ebf46432c58ed32dc59c8ccf4bd651e5c806c3c9ee0d7c41a2639e8a533,t,26712,7684821,,5000061,2018-01-30 13:57:21,187
0x541356cb8c3b7d13906b24cb77d9bddd48fe5902451c93c6c2639275c1f52bd8,t,21682,7706503,,5000061,2018-01-30 13:57:21,188
0x1de7ea3ceaa83ed1ab66416f7d1f5498ab21866640250d4de037f10d4b510277,t,21000,7727503,,5000061,2018-01-30 13:57:21,189
0xa880a568e65c435bc28231fb331e6f9e88c1f458d571b8514db0c678c68eed6f,t,21000,7748503,,5000061,2018-01-30 13:57:21,190
0x552fdc24b942283b870cac419e44c7f7017f8c532d6466c018bda7a1522f62a9,t,21000,7769503,,5000061,2018-01-30 13:57:21,191
0x7402105f32fc2bcef234f2a66840de1a8a8ee596b51e26618cd7f1d90e64e34e,t,52886,7822389,,5000061,2018-01-30 13:57:21,192
0x84d834c0f8cba50f9de26dc1c5ac5de5290fbb639d6d5aecd19d54113b561fd4,t,52886,7875275,,5000061,2018-01-30 13:57:21,193
0xaf647e8f332dda9004652fd4a3950af22b5cd1e4d7934616de33a58fc7b87125,t,52886,7928161,,5000061,2018-01-30 13:57:21,194
0x7e1bf8b894b2578f5c2319287fa7c058ff59661e33b6218b7ff8fa2018f4e1e3,t,21000,7949161,,5000061,2018-01-30 13:57:21,195
0xd8207970d83e1682ed2b76d6dba0d9cf8351765b8e3a88b0369ea4c6464c753a,t,21000,7970161,,5000061,2018-01-30 13:57:21,196
0xe803824191c5559a5241295b9284a0f3e6d64334d091bef7e34cf4200fd82462,t,21000,7991161,,5000061,2018-01-30 13:57:21,197
0xb929f55cea09c1ebc5a77143ffa9ca8670bf657779a6f1aa4d491b66e9eb869d,t,52158,52158,,5000062,2018-01-30 13:57:27,0
0x13acc5f3acb376a872f70b8aa4291f853a50ad09e5294dcadf273e9f758beb9d,t,36579,88737,,5000062,2018-01-30 13:57:27,1
0x824d07cc49c048b5426091155b4212bb6d096b1accfdfc0d195d025ad98ece9e,t,21000,109737,,5000062,2018-01-30 13:57:27,2
0x94aca2d27f60b6475558378c151a974e406b1f558348cf17dba0defddfbeda97,t,40907,150644,,5000062,2018-01-30 13:57:27,3
0x88a5c754c3519fd6fe712e3ed6fe03dccc8bb2d66175cd99a7f6f2da65c76b5a,t,51416,202060,,5000062,2018-01-30 13:57:27,4
0x645f897755bed3057c21a5750c24506b114b905c10baf86fc5a47d91b4dc0c2b,t,21000,223060,,5000062,2018-01-30 13:57:27,5
0x0a98fbf06e36e33bbecf9fcaa92664b39f60fa7f4f11004450ecffea7711f54d,t,21000,244060,,5000062,2018-01-30 13:57:27,6
0xf2c561a6c7ce9c8c7f8669aae23c353ca96bf9431afa564db8bf3ace95ffb958,t,47623,291683,,5000062,2018-01-30 13:57:27,7
0x07b4d7e2d6ef8a54326555993c88ce655bc670a8c14c0a95a522ce4715938efa,t,21000,312683,,5000062,2018-01-30 13:57:27,8
0x55549e6a2ac25d44a8ab2116b26a22b175f6ea054e5f682b5b8e8545da6b0eff,t,37372,350055,,5000062,2018-01-30 13:57:27,9
0x3cc07b541aa1e12f68cd40a3ed2569cc9754d241929fbbe52fbdbf1985955d29,t,36632,386687,,5000062,2018-01-30 13:57:27,10
0xd6a6ced3cd910d89b45c14c83e4ff3be2a0ca1ea7d3dec66e409a63626e8bede,t,37135,423822,,5000062,2018-01-30 13:57:27,11
0xae58622bf1f198b307e10a220dcde1b7dd5f116c4261944f17de82486555e25a,t,21000,444822,,5000062,2018-01-30 13:57:27,12
0xdceed3dc16c672f4df09a9333058748d6b6cdd618366fc467b8e4845604e619a,t,21000,465822,,5000062,2018-01-30 13:57:27,13
0xe4edf09bfb7aad7eceff84d60879347e45c6f286514524ddb4800ae239c8f94e,t,67877,533699,,5000062,2018-01-30 13:57:27,14
0x3caa54ddd548a8841761d8cbc6fb901dd3e85ad2277234984668c1305842a01b,t,59418,593117,,5000062,2018-01-30 13:57:27,15
0xa4f61197be09f8d3a642c600854abeb1bf31d149c5b47a6b1cac817aea1d0398,t,53105,646222,,5000062,2018-01-30 13:57:27,16
0x7223e2e63dc155886561115d899879e2cd46c22f8e168b95c233b02a289b016e,t,62759,708981,,5000062,2018-01-30 13:57:27,17
0xf844af1b1631c940dfca1867945246a390e8d9b586451571bc44c8d3b288741c,t,21000,729981,,5000062,2018-01-30 13:57:27,18
0xf2144d87862f6302d1bccdb5e09aaec3220d2b8af166d6746949c7e7e2de29f7,t,21000,750981,,5000062,2018-01-30 13:57:27,19
0x711b4bdb07b903ea8ae845b58a47c09705effdb7b09bc71446b7a104dd8d23d3,t,253854,1004835,0x8f2E8ac0d184596E271c6a7D31E51e62A50D9cE0,5000062,2018-01-30 13:57:27,20
0x3f2161f072397feb70068b4715621b327532e5aa5d49162836de61008c44ae83,t,67613,1072448,,5000062,2018-01-30 13:57:27,21
0x13ee69c8c8e6fbdafec030d8d61fd7657ff32d92fd369d38937b04eb7cc96d4b,t,21000,1093448,,5000062,2018-01-30 13:57:27,22
0x322ec5d7a6d1fb875ab380374c6e778e321c66206351bc4195eebf774935d081,t,21000,1114448,,5000062,2018-01-30 13:57:27,23
0x83b92560077ead7a2d17bf65a5f9038fffa52325778476867b6059692e565065,t,59290,1173738,,5000062,2018-01-30 13:57:27,24
0x1ea02c4f507e30283a4c75269fab3614037f33f644623cd43d1a175e9424f923,t,21000,1194738,,5000062,2018-01-30 13:57:27,25
0x28b50e5e30350f815162c0e09c20422c3f14ef4e706e1d1d3281780b8581fb4a,t,52904,1247642,,5000062,2018-01-30 13:57:27,26
0xc0dd431e0d41b8ecb9c644cf29312b9b01552b98ce50c90be7f562d9240d7090,t,21000,1268642,,5000062,2018-01-30 13:57:27,27
0x7940f1bceeb2c1a0785ec42bb6710f840394efe94b1e889a0bd830d989689157,t,21000,1289642,,5000062,2018-01-30 13:57:27,28
0x10f2ff9840554ccdce4c29f0aa83645910194ef3f55a57d908e77357393777c6,t,52810,1342452,,5000062,2018-01-30 13:57:27,29
0x26f37d5fc7b849e47b0738b94cc989569f4c5fef1daa89571570bd0d8369b57c,t,154812,1497264,,5000062,2018-01-30 13:57:27,30
0x8d743517e3949f67dd31869ed0067f0f90720c7232b817497d4e5210d1c12a67,t,37446,1534710,,5000062,2018-01-30 13:57:27,31
0x6e5a35219cee3c1db3a2045602945d116b3f78ff58c97d176a3e6d348c1a7fc2,t,21000,1555710,,5000062,2018-01-30 13:57:27,32
0xea2d05b4043e77ce06f93c498a88149411c106e12c0d2d2ebf7bb5b0280961e5,f,90000,1645710,,5000062,2018-01-30 13:57:27,33
0x2b1dbda8754cb2484556f66c6305399714c8f484f03c96e2a223ab96f1422005,t,21000,1666710,,5000062,2018-01-30 13:57:27,34
0xdaa13767759b2dc3b5141429de4fa6c37d7c28cb4ed46e675a57bc19ffadf7f3,t,21004,1687714,,5000062,2018-01-30 13:57:27,35
0xd2c1f3f5cc87dd23f3d105f795ca6256af507f2956709bc1804b41ca7fc9a009,t,4679140,6366854,,5000062,2018-01-30 13:57:27,36
0xfb76a9664dc22515ccb4f8e3b867a19a38f85306a68704896d8db428d5ec5b2c,t,36367,6403221,,5000062,2018-01-30 13:57:27,37
0x499fbdbd0c87425bd14f85b72c5aa2c5010a516aec571878f8e41863e7fced03,t,51814,6455035,,5000062,2018-01-30 13:57:27,38
0xfde002b0b51ecaeaffa106166f2345588279a4a8f2d7daa4fecbc97aed04c33c,t,44025,6499060,,5000062,2018-01-30 13:57:27,39
0x1b08d24cd333a092ba4aa6cec970a2feb1fd787e6b6023cdb262da9b5e083b49,t,46045,6545105,,5000062,2018-01-30 13:57:27,40
0x1d457d7619852989862f5c8588e78086e378fbdec1219a4c81904ad02df676be,t,48274,6593379,,5000062,2018-01-30 13:57:27,41
0xaeebe01c2a05b943b1fe326ac62c3d127ad96bc99e9cdae684d4228dcb6ee938,t,152105,6745484,,5000062,2018-01-30 13:57:27,42
0x7fc08f73eca86ec45aea5e306e8a7045c1cccf70ffed99662aed806041f0605a,t,45591,6791075,,5000062,2018-01-30 13:57:27,43
0xf60deeb1fe82259d75bbe79918c010b5194ff8e1959909c9b10a55bab7413f71,t,69440,6860515,,5000062,2018-01-30 13:57:27,44
0x750b303ec47d6cbe33088a9924cd0454cac015e3075abdc13da9c624e8108917,t,37518,6898033,,5000062,2018-01-30 13:57:27,45
0xebd5a3ea1f474f8e5c5005cc400e7320a5552b68eb9479171022b8ec5f456eba,t,21000,6919033,,5000062,2018-01-30 13:57:27,46
0xcd096c7624794ec65ffcda73801f98ae82d49fd338beae77c51f7379bee4ecf8,t,59354,6978387,,5000062,2018-01-30 13:57:27,47
0xa17eee14c78f6f6ce3b9d8b2f3e105a7d7e8afba8a2c09c083ad8b0b52825023,t,48664,7027051,,5000062,2018-01-30 13:57:27,48
0x61bdec2416322b3c6a32c2f0c8a08aac6bd3800e7bde07db67e5f1f399fd68e8,t,52240,7079291,,5000062,2018-01-30 13:57:27,49
0xc3a9e8d64079f1380926aef40caa4e74427ef049963e94bbccd8d1fa8febc511,t,108050,7187341,,5000062,2018-01-30 13:57:27,50
0x6916582b19686bbc710c7f950202d7f659635e27dd5418f742a0b0a15077fe83,t,79985,7267326,,5000062,2018-01-30 13:57:27,51
0x217f8ab804f0506e632f4759733e444c75824be01ec0da4eb737a7536b0bc608,t,108178,7375504,,5000062,2018-01-30 13:57:27,52
0x23690de3f5a5fab055b305604d15393cd5869782476df08507fcc5334934efac,t,23316,7398820,,5000062,2018-01-30 13:57:27,53
0x59242f5858eeb7dfac1f99112727158910d45b4f42e53b072df274516afb335e,t,174591,7573411,,5000062,2018-01-30 13:57:27,54
0x066632481b48c4535fc35ccbcfae453bdc53565b38c4faeaf7e0c66063102fee,t,45548,7618959,,5000062,2018-01-30 13:57:27,55
0x0c979a29a141224c869e70c0e195f29d3c286e77218aa1835a54c272cb13fafe,t,44162,7663121,,5000062,2018-01-30 13:57:27,56
0x24b576f1f0bfa87ed5e3f5d8af78b139173a9b5d44aef8d636999de595a322d9,t,63220,7726341,,5000062,2018-01-30 13:57:27,57
0x8e923a1b982601d7c3e866baab4a624efb992de92cbd257ea2fbb932fd51df9e,t,22900,7749241,,5000062,2018-01-30 13:57:27,58
0xaba397a5ec06c67fa7f43fd081c653935b6049e7505da4476c4d56ffc848e8a7,t,102998,7852239,,5000062,2018-01-30 13:57:27,59
0xb42e0120de4a0a51603d1e49d02eb810dfaa3e68914ac85c78102dc86747278a,t,21000,7873239,,5000062,2018-01-30 13:57:27,60
0x317858f95c55ec8822aac39fcb9ffe3ffcf82bef40bdf501ee2069c568b8747b,t,63240,7936479,,5000062,2018-01-30 13:57:27,61
0x5c0a18f1582afd3f132e7797d95e9fa630d12c082013c24164d54ea6337cdb08,t,21000,7957479,,5000062,2018-01-30 13:57:27,62
0x0e49179f015f1e15b743bab247acabc0953dd6f44e8187764d6f201aa4404f12,t,21000,7978479,,5000062,2018-01-30 13:57:27,63
0xb4c6a12b741577f74ed20a944582b5f42e979262c8e853434d176df40ef881da,t,21000,7999479,,5000062,2018-01-30 13:57:27,64
0x78aca8dcaac8e104c98ba3895fc58c0e696815686f88b327afa7704590f6587c,t,40907,40907,,5000063,2018-01-30 13:57:42,0
0x4511994d7e03cbfaa03ab6fffc1cbd7559072e59bb00afc896e60a234aa1d99f,t,44098,85005,,5000063,2018-01-30 13:57:42,1
0x801b896504f6a845ab13fe1b50c79be3f6501818ec1aed236335de1c1819ed60,t,37320,122325,,5000063,2018-01-30 13:57:42,2
0xfa4222e44b15263f7f16e7c5b3e6af13a98e1897e8700a6367f72cbfe1bd202e,t,21000,143325,,5000063,2018-01-30 13:57:42,3
0xc77a626283a357b028ddcb6c41a082a6ea7c626419f2d37b28bdb8fc2e40e2a8,t,21000,164325,,5000063,2018-01-30 13:57:42,4
0xeab006085cdd1ee96b56c1f125742b86d2da56ad5f608d65259820e7bbc58ddd,t,21000,185325,,5000063,2018-01-30 13:57:42,5
0xcec5eaabf52a17a6d91e84a66ab8469f94ffdf5ee6193bec9bfd471b12ed222d,t,21000,206325,,5000063,2018-01-30 13:57:42,6
0x67ffeff6f2d8c7b1117e2af86783d467edd8a1c31adc34da5ffdcc19e882e154,t,52170,258495,,5000063,2018-01-30 13:57:42,7
0x6adfebebc53022a6f08fd4a0d768bae04801243872af4c40a2839c6dc6ac8277,t,21000,279495,,5000063,2018-01-30 13:57:42,8
0x6e8c61869c3cb2692fcf71438ef6a3235415a8b07b2ce719e512a99f0286c200,t,21000,300495,,5000063,2018-01-30 13:57:42,9
0xedf520b839929e91c4c85c8de9c930fc7e9982a030098604fab88fb1c88ad194,t,21000,321495,,5000063,2018-01-30 13:57:42,10
0x365883bb5f16aad540b5e5d7d852c25e10c9319fc786f4cd62988d0463b0caca,t,52200,373695,,5000063,2018-01-30 13:57:42,11
0x9b12685544e7d0e5c43cbe22ca6aca275b53a35db62aaf4657e7116606e9bd89,t,70404,444099,,5000063,2018-01-30 13:57:42,12
0x8f1ee65e56ff79530cc4ce8bdcec0e768031015f69649b25310809e2f773f3f2,t,21000,465099,,5000063,2018-01-30 13:57:42,13
0xd6c151685d92151ae5a4f6a63c402807da8539f97d19f8014ba6322ea3cc8f8e,t,53690,518789,,5000063,2018-01-30 13:57:42,14
0xfddcd71b21d3484bacd24c0fa1fa04052311deb9f03e2bfcf2d5cdce2a64539d,t,21000,539789,,5000063,2018-01-30 13:57:42,15
0x6009b7218c763b5ee7c024cc80b5ea9765e140a7896cda975d608a1b5c4372cb,t,21000,560789,,5000063,2018-01-30 13:57:42,16
0xcbd64bea079caa3ba6a6ac390e1067d5fc4a51858890766d0a8016eb57811722,t,38319,599108,,5000063,2018-01-30 13:57:42,17
0x4606a7d744a9f09c3b32b9dfff9fff8c7f7b020d47bf6ac39e80128188e4deda,t,52148,651256,,5000063,2018-01-30 13:57:42,18
0x22c16e548547d7430f4345a25c57d515febd7a4f293f71ad544a2cce5cb533e7,t,92666,743922,,5000063,2018-01-30 13:57:42,19
0x51fe6e4e22be36d88cf876a95f73dda3217d38930386fe76848a61251da4dde5,t,21000,764922,,5000063,2018-01-30 13:57:42,20
0x7fed5b675abfe56f852d272b9c91308510adc1578dd6d5dba2ff173ccea4c138,t,28757,793679,,5000063,2018-01-30 13:57:42,21
0xa9e720e5d5dee8e75b3b27e516b547328f34b3dc6dcb625165581602f287d90b,t,55907,849586,,5000063,2018-01-30 13:57:42,22
0x6a41e3d93a0ffe3836c5f3ad743d37a4fbe1ac0c37b1db0cc37ff78060b46919,t,21000,870586,,5000063,2018-01-30 13:57:42,23
0xd81069c6aa8f9170c984bfcac02bc1fec5a8709a34275ad00efeb8a8dfd40ee6,t,46031,916617,,5000063,2018-01-30 13:57:42,24
0x499b63ed44d2df0df130b8cafb23bc7a85c2f97078d659f34402af43f76cd2c8,t,21000,937617,,5000063,2018-01-30 13:57:42,25
0xbcf0b33955ba933e28427de2c1f2824b7cd3cd195f137a78fb698d06ecb7cd4b,t,21000,958617,,5000063,2018-01-30 13:57:42,26
0x0966c0641d5516f90149ac45860742db87df6de3ff283856fda3b3c394be8b41,t,37536,996153,,5000063,2018-01-30 13:57:42,27
0x5f5f916abf66531993549b03709108a955c045172a5d32dc8c6b84f4086e39b2,t,37420,1033573,,5000063,2018-01-30 13:57:42,28
0xb73d96ab5858171657636524d055813df38831e46286b09d8b8844237f6c8a35,t,37373,1070946,,5000063,2018-01-30 13:57:42,29
0xfc393d6bd761c0229ea4ea5e302b392d04fd1e869acf21d94236703bfd8040c0,t,37373,1108319,,5000063,2018-01-30 13:57:42,30
0x0161ca68dd1cb596c03f9e65b38bd2f42324ad83a84706ed6d774c12593acaed,t,37420,1145739,,5000063,2018-01-30 13:57:42,31
0xab76dcfc749d3281d141f30cc73a3f6cc387a469779a23224cd87353d0110e4d,t,37356,1183095,,5000063,2018-01-30 13:57:42,32
0x1e358ec122e985e683663460b6bc42b73f5b6343a79c33005f9dde20aef7dbc7,t,37420,1220515,,5000063,2018-01-30 13:57:42,33
0x0aafb8e87855c219bea69e64ac630b017e1c1b03bc4f3fbe64af0bea2b0cc2e2,t,23028,1243543,,5000063,2018-01-30 13:57:42,34
0x3cf548d392a78d1eb2177334629ad4da8c48688b05aea2bba68083d92b10ed8a,t,102934,1346477,,5000063,2018-01-30 13:57:42,35
0x4678212a7c4e4f766bd976a7b58f60f1516f9233d0394b18d25c3d64f514ea1a,t,21000,1367477,,5000063,2018-01-30 13:57:42,36
0x2d4f35508a3be28e61885a73da0f89d0b869118c48b9dfb8aba54aa78c57a2c3,t,21000,1388477,,5000063,2018-01-30 13:57:42,37
0x8b7116e35275e3331faa123fc39525ae4cdff06e2fdc20dbe6176b63c570983d,t,21000,1409477,,5000063,2018-01-30 13:57:42,38
0xeaa14253e414adce3ef61a995363dd18ddd3154153ed21b83fe0ae5ac7ff5717,t,21000,1430477,,5000063,2018-01-30 13:57:42,39
0x3770850fad349bba0d9f7a81aaecf1475e439fd094ad0f0db6fc12237ac2a226,t,21000,1451477,,5000063,2018-01-30 13:57:42,40
0xf54136580a0ee59f1374f25e012cd422633a7c719d6a17aaf9789325d502994b,t,21000,1472477,,5000063,2018-01-30 13:57:42,41
0xd8489e4577e9b3bc9f3a65c26441c2439a0e39318049a1055d7a1c4bce32770d,t,172772,1645249,,5000063,2018-01-30 13:57:42,42
0x3c366ae4a9e1cb7a34b9a00b48b43b6ad93c0bb259c5d5383c35ff441ec14f95,t,59921,1705170,,5000063,2018-01-30 13:57:42,43
0x4e0e70313883bcf9f363c05189047c206b12f4b5cc01185f0f642c6debeb4177,t,31984,1737154,,5000063,2018-01-30 13:57:42,44
0xa66d130069b1b3caf6957f933a970fa280194336c9a15775811f60b45778dabe,t,37886,1775040,,5000063,2018-01-30 13:57:42,45
0x971e3127fcca9a51f272d375147dfd1722cefaed73eb8ee936c92d05c21cdd97,t,55907,1830947,,5000063,2018-01-30 13:57:42,46
0xe2bbade7e26c9683f97460a7bc0437073799f7075f4da1d9efe8731998816251,t,38679,1869626,,5000063,2018-01-30 13:57:42,47
0x73f0cf327d6cac3bd54c6587f78b94f7187696827fc0897a2cba753a4adcac9b,t,21000,1890626,,5000063,2018-01-30 13:57:42,48
0xf84cc920fca4b46399da360105fa20065830a5cc8993575c34b88aa66f683538,t,52309,1942935,,5000063,2018-01-30 13:57:42,49
0x83e1ccf5c1b331804e56b209c124f7e73790c6d7b6fb2e305441d275f63d6e0a,t,21000,1963935,,5000063,2018-01-30 13:57:42,50
0xd249cba580509b7a4b2c5d2383e5248259f67e405c18b506471b594f9440cb62,t,33705,1997640,,5000063,2018-01-30 13:57:42,51
0x075332624631af6548a16d86ac2a372e656be34026131a7d8ca75c9b147324e0,t,52488,2050128,,5000063,2018-01-30 13:57:42,52
0xd5b0e2d457453053f8025b8f7ca039974aa712190e0b3446c22b6634b2db1752,t,140972,2191100,,5000063,2018-01-30 13:57:42,53
0x604d00fc2577b27a0ac15e5bd3bd271adf2ef4914bd95111360d2b25e21c1175,t,253854,2444954,0x6cFA339C260E9b2443DD26F3D3E67F3960428fB7,5000063,2018-01-30 13:57:42,54
0x3380d7bfe25b11c8b1a90668f8d725476bf4a767592932d69be7fe9ce143e128,t,67685,2512639,,5000063,2018-01-30 13:57:42,55
0x341e9b06614656fece933f624483951f3471c0761f1248e0bf4429c595328364,t,34124,2546763,,5000063,2018-01-30 13:57:42,56
0x99d3f4a370e059c75be527c3d36f9362bd1636026bf9c0a5005301a512bc7e9b,t,21000,2567763,,5000063,2018-01-30 13:57:42,57
0xce24d0d198aaa58e327009b6b3d933095a4864f137997d0d1b3943f670156418,t,36792,2604555,,5000063,2018-01-30 13:57:42,58
0xd62bc2454a6b3a41c8696663ec840b69722f89217448084b18c58105be1ba0c8,t,21000,2625555,,5000063,2018-01-30 13:57:42,59
0xcdce6a2dc4e3b29dbebe0fd0c6583e49ef1509aaa1cd1cfb29b69e1daaf0e075,t,54064,2679619,,5000063,2018-01-30 13:57:42,60
0xf9ec7a62fd879ab86f0d197823b70e4d3e70ca6254cb9bf23541f454dbda949e,t,37078,2716697,,5000063,2018-01-30 13:57:42,61
0x702a7a1a4fe36978f3c2265bc8a90ecf9ce2fd447d8394be0c57e470dc78195e,t,21000,2737697,,5000063,2018-01-30 13:57:42,62
0xb8434afccfa7ad7f41f59fd6c4f00e6057426176fbe8856bfadd267b8cacf4fa,t,21000,2758697,,5000063,2018-01-30 13:57:42,63
0x77634913f1f9c0286210d4bdad85d323d7887e00c683275f7a7aab376e5f0ff1,t,21051,2779748,,5000063,2018-01-30 13:57:42,64
0x79f680c6f25eab2850902386295d5ed28e761467a9d68151e540cf6c4073ffaf,t,21000,2800748,,5000063,2018-01-30 13:57:42,65
0x39a8af25d1649dff6b9c809b7bf590e26cf41f14679c8dcc8510e0672382f72e,t,21000,2821748,,5000063,2018-01-30 13:57:42,66
0xfb3cdf07719bacc5b3d505b2757a3e20b2a8949a923ff60503fc26a3e3c3a9e7,t,21000,2842748,,5000063,2018-01-30 13:57:42,67
0x855ad760dfb6cff6385d1690be6884c10c161c2033041d14d21ddc17ccee3932,t,21000,2863748,,5000063,2018-01-30 13:57:42,68
0xdb3adccce7b5767f277beabefceae7530d27a25c15982635f16c17000b7ae9b1,t,36770,2900518,,5000063,2018-01-30 13:57:42,69
0xfc891e9d17d7f4c0f2739a563947260651b99d85b0d1e186628ff9d28a3602f5,t,64725,2965243,,5000063,2018-01-30 13:57:42,70
0x4391291134fa13b218c55cf502e5210c4ce1e5f56424cf6fb78d8edf4b03505a,t,21000,2986243,,5000063,2018-01-30 13:57:42,71
0x92dd47cb4afbdb2c196755f40346b0827b5c64a9722f4d7e80b4721d48104da3,t,21000,3007243,,5000063,2018-01-30 13:57:42,72
0xc5031c8a6ce9ac1e6b3b7c8e83ded0abb17a97b12fc9a728fde3ec29daed179c,t,21000,3028243,,5000063,2018-01-30 13:57:42,73
0x7f24457c46825996dc802a631af00c9b8f46583c5d01dd51bbac8c7472d723cb,t,21000,3049243,,5000063,2018-01-30 13:57:42,74
0x569b154d559903174b82b9e1ea4a5724c410837e707628df9392d6e3fa015c61,t,21000,3070243,,5000063,2018-01-30 13:57:42,75
0x6feb2a33b54e27d694d9929cdb38c8d78879dd487acfa760239b0cdb7865cf32,t,21000,3091243,,5000063,2018-01-30 13:57:42,76
0xcfef25057520e2d98bc334752865fe5e4100f5a4c3e58b3e1217f5b94f33db63,t,37089,3128332,,5000063,2018-01-30 13:57:42,77
0x21fc70df0e3c6df0376c30d0ad6b6edc9caf5789f46b4c4c0fda755e56cf013d,t,21000,3149332,,5000063,2018-01-30 13:57:42,78
0xca3383c4e2a4b92230431ee5d1f34c1df1fb376397699f9f98c78c912d687356,t,21000,3170332,,5000063,2018-01-30 13:57:42,79
0xe260b1e65b023038996bddef1b893e88778ee4a020a1ea3c644855a33cef8406,t,116134,3286466,,5000063,2018-01-30 13:57:42,80
0x574462734d50f0d19d85cd59eb2d8970a02663a34c0ec94169da39608d38bbc0,t,21000,3307466,,5000063,2018-01-30 13:57:42,81
0x1bb5de27c9ff8b36f6986841185377c22b243921ee316aa81c7c49c609cdba7f,t,102998,3410464,,5000063,2018-01-30 13:57:42,82
0x0d3b6e96f533d84516a200eef55446f50d7941c114cdebb5fe9d988cd99cf5d8,t,37305,3447769,,5000063,2018-01-30 13:57:42,83
0xb35f04f8ae3ef133a69f4e9340f87bff34847c43221a6b5c28e3429ab4b269ca,t,140340,3588109,,5000063,2018-01-30 13:57:42,84
0x81b01ef61d84883530683667082ace7a6c1e7677e461933d81c16adbf2c0b9b0,t,38319,3626428,,5000063,2018-01-30 13:57:42,85
0x159659ba53573e1f64abbf15b1d793083f937c5b7f3fbf14f1862eefe32914fd,t,77730,3704158,,5000063,2018-01-30 13:57:42,86
0xeed42b0252b927c97f1e1d7b9eeceb2af6fb2a11009b9d8dbe01578b26a81576,t,45591,3749749,,5000063,2018-01-30 13:57:42,87
0x810f91c21d07c491a550e2c3eea3e9a1d3606190b383ba3c0513b4e741f207d5,t,51542,3801291,,5000063,2018-01-30 13:57:42,88
0x6f3d4f925962595060211f5988e210012e10fb877441678c5465f4a86f62abc0,t,54005,3855296,,5000063,2018-01-30 13:57:42,89
0x410a50218c513f7c2a80226ad62e126ce1aeb2c319878c78019d725f470e3197,t,28002,3883298,,5000063,2018-01-30 13:57:42,90
0xabe5978ad078cb39b392de6475fbdc4271815c1ae215f40d9258c34dca5f2cb3,t,30289,3913587,,5000063,2018-01-30 13:57:42,91
0xfb8adc0d6a24a96cd7fc1e9b4c308f456e82bd22bdf453104e8845cc4b1c998f,t,66316,3979903,,5000063,2018-01-30 13:57:42,92
0x927f9913d699f0b26d4dd40df6f4a5718253b161925451f3aeb8bc677b42ef11,t,51560,4031463,,5000063,2018-01-30 13:57:42,93
0xa43af8b142d0fe294fde6105c037a31313d31ea942d7acd8b5edc1b961094bc9,f,250000,4281463,,5000063,2018-01-30 13:57:42,94
0x0e3e0f00ef8f1cb849666810249c92d2174d8c580af47339dece818fca75fed7,t,47174,4328637,,5000063,2018-01-30 13:57:42,95
0x65bde39b4ab3459c350ae257098b9562e34ba9e194e05457ec9c4edb5f2774a7,f,250000,4578637,,5000063,2018-01-30 13:57:42,96
0x433aeb54ccfa4ab05900aff5575c04eb78afbe965e18fb39564a278fcfb4df91,f,250000,4828637,,5000063,2018-01-30 13:57:42,97
0x668442b3761e99720c7bcef640e952bb0ae10c30a2ae3ade0b319df598a4686b,t,37900,4866537,,5000063,2018-01-30 13:57:42,98
0xabd89e687a8f3e2b29bd912500fe0da7915f494e7dae7adbd8d31acb75d3c520,t,44354,4910891,,5000063,2018-01-30 13:57:42,99
0xf9e0691fb378c4fe8266c8d8ca9f8ec1617fbfc0ad9eb89513055439f8178801,t,59162,4970053,,5000063,2018-01-30 13:57:42,100
0x98cfbb52ff1ce33a6b206f4b5f1e10f5874d4b82c8c0fb00e63d09bb9bbd3259,t,37579,5007632,,5000063,2018-01-30 13:57:42,101
0x2a393602470415fd3e3ac1e9f562a82a845c7442f14fefe86be743c01598363f,t,66253,5073885,,5000063,2018-01-30 13:57:42,102
0x36906e91a9dd2a1b62ecd9115ed2110d758711b86788fc8ba3638491a361e6c2,t,37622,5111507,,5000063,2018-01-30 13:57:42,103
0x727eb8e083833519c62a41d842342de0833280630c8515395814afbfcf86163e,t,44226,5155733,,5000063,2018-01-30 13:57:42,104
0x48acf82569d9fd865f645f3d1e28d31571ffb3e9d0ea57015c152906dbe30116,t,90558,5246291,,5000063,2018-01-30 13:57:42,105
0x7e1c5253de25d0c9fa6399e250708fd0de03691fb7d461310ed084b4f82a713b,t,37900,5284191,,5000063,2018-01-30 13:57:42,106
0xf3c9ebbf205c7e13b47ba6f2a47fb6db2b4baefa5051037f193b253a11d672a5,t,59162,5343353,,5000063,2018-01-30 13:57:42,107
0x1853faaccbe92b6ba0bcb56519b0347037e4c28ee9e3725b87d9f1e38559be6c,t,46401,5389754,,5000063,2018-01-30 13:57:42,108
0xa7b6e165d71d32a88318114f46b9ba02a067275004b889ef55e72c8b9b013711,t,91971,5481725,,5000063,2018-01-30 13:57:42,109
0x529ce444ace734550dcfeab62f4bd302978f7bc6396fa16a9b4f218c89226ee9,t,40806,5522531,,5000063,2018-01-30 13:57:42,110
0x71f3b56d8665a2a9b42175c26b3774cf054e2ae5268e8beb38b389faa2593f9d,t,77383,5599914,,5000063,2018-01-30 13:57:42,111
0x5651cd1a494bd3e689633804a88b3ea5df76bd00df6bc4cf3f75128e63a263b5,t,59418,5659332,,5000063,2018-01-30 13:57:42,112
0x2f517be55f276e5c0dd227878918fe0d78175e7b07eeae35865183618df59dbe,t,84005,5743337,,5000063,2018-01-30 13:57:42,113
0x52a2423b3f46c85103517a57348fe4a7bfb74d75d51dea0537fe34d4a0a3ba19,t,45512,5788849,,5000063,2018-01-30 13:57:42,114
0xb28752e96cddc8bceda05bb72c530fee1c30b01158684411b22e20b915775c3c,t,21000,5809849,,5000063,2018-01-30 13:57:42,115
0x106e8eddadeec8cbdb33e66c3f321818af6e51ae17cdd454231776735ece9e09,t,84005,5893854,,5000063,2018-01-30 13:57:42,116
0x4b611aaa18b2c378de6da3addc6515ff9afebd50feb51aa940990639aeb3ea53,f,250000,6143854,,5000063,2018-01-30 13:57:42,117
0x679ca25d06dc3ac0f5c4a62426f1a6b4de8f0892775febf698f6ff9c497f2c92,t,59034,6202888,,5000063,2018-01-30 13:57:42,118
0x386fbf4fd9b50fc163717e2bb351c83cbac49b0723014b11d0865204ef44d3d5,t,45382,6248270,,5000063,2018-01-30 13:57:42,119
0xd8b12f4aed8d8226b085769eb4d0add1a702d81ebb15a59b621266651e18b95c,t,37292,6285562,,5000063,2018-01-30 13:57:42,120
0x01b47e1ac0c2bccf932f4a7f678ba6d9e91bcfdf10fc2e2f157131737aa68be2,t,92730,6378292,,5000063,2018-01-30 13:57:42,121
0x42927fcee3bfdd812404843cbd90a698f69e274a0c522c30d83a831d9e1678ee,t,21000,6399292,,5000063,2018-01-30 13:57:42,122
0x1c0aa33bf2f1d01bc0f6b42602ec96ea4b5d45c786b5638dcd8742a08192c301,t,78050,6477342,,5000063,2018-01-30 13:57:42,123
0x3c39315fd0103049e8dbbc1b18a07b828e3e19b40af8cefa6ac1cd0279340b7e,t,29493,6506835,,5000063,2018-01-30 13:57:42,124
0xa1f8e3633f008891040da98fd85ec031fe5ddd08ddb554da25ae9beb164faff9,t,23028,6529863,,5000063,2018-01-30 13:57:42,125
0xa8e636ad22c14483b39a5ccb8fbfecb3fbeb1523fc37ec85974c9029602b8ffd,t,107730,6637593,,5000063,2018-01-30 13:57:42,126
0x84c18cbf10f75174d3d3446b422bb8653639d35ff65649830dc8191179385e81,t,59354,6696947,,5000063,2018-01-30 13:57:42,127
0xbe2511b8126ea891d84d6505dd60f3acb7e83f7dbec32bee00cfb92d75681d31,t,108242,6805189,,5000063,2018-01-30 13:57:42,128
0x17ea001b3a0fd24326382e8d1d6b1e412417a9a3b17b07578050b66fbd54659b,t,59162,6864351,,5000063,2018-01-30 13:57:42,129
0x93f081fe2df29f1bfcd938527097a2875300302d97b337de58b26c8bcc60e4ae,t,29493,6893844,,5000063,2018-01-30 13:57:42,130
0x38c0374567c73c1d642c3a3cbe608c86018855e425461e15e743e8ce2744bfd6,t,48473,6942317,,5000063,2018-01-30 13:57:42,131
0xfe6808612e17bfe5dfdb7a56d4b2601850bf165d3c989e7178e035d8d083bbfd,f,250000,7192317,,5000063,2018-01-30 13:57:42,132
0xa58f480b15eb20a59a4a7c877bbb7c9c56d90c4bd76a94a9fd5847921c857d02,t,21000,7213317,,5000063,2018-01-30 13:57:42,133
0x7b6e8cda6923ac5ce5fce12a14422c8b2589a51d8f02d42bcbac5afc52c398a3,t,21000,7234317,,5000063,2018-01-30 13:57:42,134
0xca59b4a61e6a2b35eefc153d40f12f2fa1333facea3eba81a49efe8c045b267c,t,21000,7255317,,5000063,2018-01-30 13:57:42,135
0x53552885b0f3fb2c1cf18e5cb47c94c3731b8dff49035ae952b9d3916167ce02,t,44290,7299607,,5000063,2018-01-30 13:57:42,136
0xf141b02d3427722f1dc1d8aed6fce38be87ae831de450d4c9b0acc8818480eb0,t,21000,7320607,,5000063,2018-01-30 13:57:42,137
0x364cfa7eadb93229598299725ef93ec9253f00f6202c1a3a58c033025bc9dd2d,t,102998,7423605,,5000063,2018-01-30 13:57:42,138
0x33e4fd4b50fe765881b3049e6d448c29329553af23288fa25e422ee7a1aba493,t,44354,7467959,,5000063,2018-01-30 13:57:42,139
0x97e1c0e3774eb6de3f662b5dd58196bcaf68dfe9d0c027c0263965af135e52a5,t,37849,7505808,,5000063,2018-01-30 13:57:42,140
0x10c2498dc677891b8bf93049c0a37d2d135de22ef2492b2fa88b721078542e58,t,29493,7535301,,5000063,2018-01-30 13:57:42,141
0x49e7659e7d81e767dbd7b8535f0c0db35d42dca1a07d6da9f0ef600f9b3f1ca5,t,48151,7583452,,5000063,2018-01-30 13:57:42,142
0xbd1d7ac7fd6754232e4be24ea1858730ee4bd4280d4349881bcb23d03ac095bf,t,50120,7633572,,5000063,2018-01-30 13:57:42,143
0xbd361b1481e6108b51d87f86618381c75d62df4a54c768e743996ac159268ab8,t,100165,7733737,,5000063,2018-01-30 13:57:42,144
0x7777a414bebc0372d9a245136efdf937d91b7a693ca87edec1996117efd25613,t,129893,7863630,,5000063,2018-01-30 13:57:42,145
0x70c464638769cc4c330b9708fb1c17e31b91eef6e9d211d687e3bb14b8da9a43,t,54005,7917635,,5000063,2018-01-30 13:57:42,146
0x3ad62d3ace02ad0c9493f9c9ca13f0622b6b0945fc275140f7e25500e32788d9,t,21000,7938635,,5000063,2018-01-30 13:57:42,147
0x6d70b2a99dbdb96717645602abe6176666e1d073f908ae2742d18278c8a098c8,t,51984,7990619,,5000063,2018-01-30 13:57:42,148
0x1164b577823b9e0b1a9cfc2fdf2939869168fe54c85af5fb1efc6163a6b834be,t,21000,21000,,5000064,2018-01-30 13:57:47,0
0x7fc735a11a920f4e6fb376f1566aefbe3cc6125d90038b183b1f2bfc7db42a88,t,21000,42000,,5000064,2018-01-30 13:57:47,1
0xf9f5d30e7a733118705ca7d5af9822bdc8b8df794d014839b40e8159cb25be34,t,21000,63000,,5000064,2018-01-30 13:57:47,2
0xe22364d15d9a99bb019598d9c39e3fd43b0934cd3221ac5f3a490f3c2d2a45fd,t,21000,84000,,5000064,2018-01-30 13:57:47,3
0x4de03d41395b03c1e2e49d54b408bbef5f40e434d2c2f087f3d8f0b532ca04a7,t,21000,105000,,5000064,2018-01-30 13:57:47,4
0x9d112224bb0422d6f0e67a7a05449ea042eea7b8ee0862b82b058b18ca4b56d7,t,21000,126000,,5000064,2018-01-30 13:57:47,5
0x6eeb730a9c4c11d44b99d70961b64ef096598ca04ca779f375fb1f876fc4bf4b,t,21000,147000,,5000064,2018-01-30 13:57:47,6
0xd04f69b937c25d03a884059a31de5f70404728b9212a313dcec15a81d98b0e64,t,21000,168000,,5000064,2018-01-30 13:57:47,7
0x06cc4517767d16093369f05bcc0a7744fb9ddf92c060d7785e846a8ba17795cb,t,21000,189000,,5000064,2018-01-30 13:57:47,8
0x11e70e08df675138529dafcacdeffefc26319565b15193b05b640473c92a8a67,t,21000,210000,,5000064,2018-01-30 13:57:47,9
0xc2a5459b8d7ffe55f48b7a56e37d500eaf22063d4ccaa908c8b6fd178f0fc49c,t,21000,231000,,5000064,2018-01-30 13:57:47,10
0x13981e0d568eb5bcd49f73484099d0627ea3e189b59bb343bebbf606c119bae6,t,21000,252000,,5000064,2018-01-30 13:57:47,11
0x67cc71a10d4120e9ba11588768297e912bc99fdb41c8d3c3e82ef150802ae7ff,t,21000,273000,,5000064,2018-01-30 13:57:47,12
0xe60003de7474a2c4919c3938cf2bf809115ab3bb139dc84660b63cd8ae046fca,t,21000,294000,,5000064,2018-01-30 13:57:47,13
0x0ace54ce5d81dfe300e29153a48061a6f602bd81dbbca6e2285f2c48fd2f385e,t,21000,315000,,5000064,2018-01-30 13:57:47,14
0xa0767ba44300b8edd66f7fe7a27f679a4b0a836dfc8d8fc95071ba00a6ffeef6,t,21000,336000,,5000064,2018-01-30 13:57:47,15
0x60adf223e4f5b41f3528e3aed9eb23b0595684738629def9df1a93f98cb22f3f,t,39512,375512,,5000064,2018-01-30 13:57:47,16
0x69117e27a15c26e0cd7e1b10c51b4de53475906914ef7e96d6a3e785ba6af9e2,t,21000,396512,,5000064,2018-01-30 13:57:47,17
0x7e9914ba2450b1719a48eb3a731356e23a99046d3e5c3ab2d1c53016bebce0b8,t,21000,417512,,5000064,2018-01-30 13:57:47,18
0x12b3814543b252c5a749427cd3a4376b2849b4cf4ea6d7219a5570feef079bba,t,21000,438512,,5000064,2018-01-30 13:57:47,19
0x433cad97256998ff02fcf81abca2aa64bb897324e720820a539f707910f1ed14,t,21000,459512,,5000064,2018-01-30 13:57:47,20
0x01010a97734bb3e6b30efdd6f372862092430dca512d947cb3a56901082291fd,t,37776,497288,,5000064,2018-01-30 13:57:47,21
0xf9a91f1c82b4953e999df9924e0214c42b3abeb0570017bd160fb87d495d3822,t,21000,518288,,5000064,2018-01-30 13:57:47,22
0x703cf83be99f67fa6b54fc6b762f008007fe68cb57370e420a8b5565041a5118,t,51816,570104,,5000064,2018-01-30 13:57:47,23
0x7fb9e78d989a7ed2c675ad9e4f90d9e4c29efe93a5152e536d5bb00cb9cbe894,t,21000,591104,,5000064,2018-01-30 13:57:47,24
0xef247f5523b36d4dbaebc4a9ddeed88e2950cfadcf0e7b8f4d8763c9c9cd3368,t,21000,612104,,5000064,2018-01-30 13:57:47,25
0x098f303d197a2ff9e571a221f320a9e01eaebbb845277815b71aeadf35f2e33a,t,21000,633104,,5000064,2018-01-30 13:57:47,26
0x7d8af11ac248302452338d990c8fd21613619726885bd99b187bbe59ecc10e5b,t,52170,685274,,5000064,2018-01-30 13:57:47,27
0x823fbe982a36440bcd33a6f4c3a1b1989cc0be39ddb129ef3047e38c82091b44,t,21000,706274,,5000064,2018-01-30 13:57:47,28
0xfd4df6ceec8dcc4556d9c71cb7567ec6f9e926a5cb3173f3136a227c2ab22113,t,21000,727274,,5000064,2018-01-30 13:57:47,29
0xf7128867d0039c4f237722628fd8b122300284d178ffa8c83e8e871928c95ef8,t,21000,748274,,5000064,2018-01-30 13:57:47,30
0x8845f7f19ac5dc38c2551a75cceed670a1fa05e61f29ac1e61a08a714a4f9758,t,21000,769274,,5000064,2018-01-30 13:57:47,31
0x6ef325c5cb953caa7e6e07da26d0fa515612acfa5258124dd4ded33c1988d4cc,t,21000,790274,,5000064,2018-01-30 13:57:47,32
0xc9fe7fc3f96d020072d1fac9b751b32e250d899d44c596d9b479bca7357d9b68,t,21000,811274,,5000064,2018-01-30 13:57:47,33
0xcee9758f69b4b63274c57b239f12229b71038710acd5002ee37873f7504dd389,t,21000,832274,,5000064,2018-01-30 13:57:47,34
0x5ce0f1b4a3ee141d85d35f3e2de3b405fa67fe663022ad8e02f82051ea401315,t,21000,853274,,5000064,2018-01-30 13:57:47,35
0x9fdb35f34c038b6ae706431071e65ee4aebacd4f3138846419b09502a4f06c04,t,21000,874274,,5000064,2018-01-30 13:57:47,36
0xa6a2f95d093b0ac4733d0a48a43a99032d29d27e1d6da330bd963e61afbb95ad,t,21000,895274,,5000064,2018-01-30 13:57:47,37
0xbe25408e4b4eb57ee21e27620865b2250d9346efe2a34ea6714cc1e17b01359e,t,21000,916274,,5000064,2018-01-30 13:57:47,38
0x6524aaa4cae599b368d7c95eb3008d4e26d2261d0e04063daac34d2510237637,t,21000,937274,,5000064,2018-01-30 13:57:47,39
0xa30bf1f0fced53fd1072ca191539993bf35e21d58065347392a61c0321ed757a,t,21000,958274,,5000064,2018-01-30 13:57:47,40
0x609de9f2336f26f78f62563e93a3844a9780f728137d12c24dd8fc3eb360442d,t,104624,1062898,,5000064,2018-01-30 13:57:47,41
0xb1d20354af22826421b910271cde54bca71d472b52382bbabf2635b23d5fcb19,t,21000,1083898,,5000064,2018-01-30 13:57:47,42
0x0135b8c28545e5c9c50b2289f2cedbf70da6f222dbce3e8279822ea9759b8072,t,21000,1104898,,5000064,2018-01-30 13:57:47,43
0x9f6e1e6c3b1c32a44019055aa0ae5c4dc8dc3e6797fd4dadad682944e094948c,t,21000,1125898,,5000064,2018-01-30 13:57:47,44
0x5803396e65e32e2d4c0d7a164c3e5933798f4e5af048d88852923f73d8c8ef66,t,21000,1146898,,5000064,2018-01-30 13:57:47,45
0xe955d70079b3fd1987c58ec107972b9efb609ee1259d6f5577e0c7aa4e38be29,t,23465,1170363,,5000064,2018-01-30 13:57:47,46
0x49d64651c6f91bdcd4b00f09a00be81b78567b721c24f5b2633dea2ea81419d4,t,37356,1207719,,5000064,2018-01-30 13:57:47,47
0x01f57af5af4b536691be079281a5b454a6d686ebadaa514f1416fa0da6bdce70,t,37420,1245139,,5000064,2018-01-30 13:57:47,48
0x4e87d59ab39f74b49d7807138c7aa93413429add8a7d8f84420464ffb234d1ed,t,78862,1324001,,5000064,2018-01-30 13:57:47,49
0x6a0c61504ab246adeb289d80ab250ebfb855ab5309fdd6a6a9737b995416a7c2,t,21000,1345001,,5000064,2018-01-30 13:57:47,50
0x6e83e17e3b739111d3e5fe0a7bfd96da3347214761f75b06275f74fa5bf4036b,t,92853,1437854,,5000064,2018-01-30 13:57:47,51
0x10804a9715a601420cbadded6a5057ada304c256bd04cdb2fd0404b09d370a11,t,21000,1458854,,5000064,2018-01-30 13:57:47,52
0x143b41fa3ae22abed5387ea43c7ccccdcbdc9dc73b0faa83a6f8dd9eb7df4c59,t,21000,1479854,,5000064,2018-01-30 13:57:47,53
0xc1ca6b66a07b1279716729c1343ea1a3333f87e22c203c08986cacbab841b4e5,t,242521,1722375,,5000064,2018-01-30 13:57:47,54
0xa19d33a32ca35760d855e0925976a63b5894a91a19f5f4a1d7b59907369852f1,t,21000,1743375,,5000064,2018-01-30 13:57:47,55
0xa5e36e54f37b8edf60e4e1c42f78b60d08effbeea755e90522ec17ba516101a7,t,52886,1796261,,5000064,2018-01-30 13:57:47,56
0xf1ac368f2ca2c37124466a9bec2e6f55638e49cc3553b539717a4cde1f6d8db8,t,52027,1848288,,5000064,2018-01-30 13:57:47,57
0xc07ed095cd774ec916258ba2ad78f5cf151e1f9d7f27b3b6d9b389a3b17a7870,t,21000,1869288,,5000064,2018-01-30 13:57:47,58
0xca83ba8f5065bc7e6ccde2c055eb2e61815a866a16b3e59640fe3a7819d069f3,t,22267,1891555,,5000064,2018-01-30 13:57:47,59
0x13fca40bbb28a11853adc5174472f156f7ba3551aba3bd409ddc307e639f2988,t,34060,1925615,,5000064,2018-01-30 13:57:47,60
0x665824f5a0b8456e48cfc556afe31928d28bede09b2f8d23ae29497c9d079cc6,t,67677,1993292,,5000064,2018-01-30 13:57:47,61
0x1f1091475468c9c6fa0678139acf0e04c30025086e372d70d7fc90b390ed63b0,t,21000,2014292,,5000064,2018-01-30 13:57:47,62
0xca5cf65f4de65eda87c3d9021d578ff2b845c55f59da63eb08efb2da57aa13fb,t,21000,2035292,,5000064,2018-01-30 13:57:47,63
0x11ec6b85c0f1fb49772cfdf9366064cd4b79d41ddac96148d3841dcb042885df,t,21000,2056292,,5000064,2018-01-30 13:57:47,64
0x89c23ea76cac995f56f135ab2d687a311051406b179fbae8ca76152956da1e86,t,21000,2077292,,5000064,2018-01-30 13:57:47,65
0x496a40fe4710d50edb03fd2e88d1c904cec4271203207079a8b4233c48fd473f,t,21000,2098292,,5000064,2018-01-30 13:57:47,66
0xb4003325ab46ba23e012ce812077a7f05d9d54e27692fd6fda2b09fd4a647660,t,21000,2119292,,5000064,2018-01-30 13:57:47,67
0x9e9a79858c20d8f72bde4bdeb562f504b9c0ebbf1f290bbbcc9d24af8934a6b0,t,21000,2140292,,5000064,2018-01-30 13:57:47,68
0x0838a0b76999ff02fbfee2f83323da5fdc7c825bf1428766a1848b4e27ff7c12,t,21000,2161292,,5000064,2018-01-30 13:57:47,69
0xe64e625975532732b5ae91db34547fa5f4b086a613f872defc3da56002463686,t,4664524,6825816,,5000064,2018-01-30 13:57:47,70
0x8c59eeb74bb93df4d18823bef5bc4065a06a4a3f754e6f863f976df555f4059a,t,77922,6903738,,5000064,2018-01-30 13:57:47,71
0xd875cfc2ca659c362687a558ac2f37ff041dd996c65d143f9df89b119ed02fef,t,45591,6949329,,5000064,2018-01-30 13:57:47,72
0xcb8b9c742e5e6ad706ef4cccc84536da0424c3ab1e4efd1aab211ac5f80afeb4,t,258125,7207454,,5000064,2018-01-30 13:57:47,73
0x7463ce095782ac09efb3103743378f80683e2f71638a4f59b97b34311c730448,t,92794,7300248,,5000064,2018-01-30 13:57:47,74
0x3a2202b664fe8163fe7273884993fedab7183fc453d90de57c3822fa6b79898e,t,21000,7321248,,5000064,2018-01-30 13:57:47,75
0x6fb5718d8de5a569732fc96d69e392bbf74aeb3f21bac76e2be2e4f29b5335b1,t,121690,7442938,,5000064,2018-01-30 13:57:47,76
0xa674788ea404b9dbee5ed8b49b3cf6c21b1069665b57008d3771613326219d64,t,51560,7494498,,5000064,2018-01-30 13:57:47,77
0xba8b9e2e96754a6e6b04fe1088c51965c419e23e9dbcd35d36ef8bc8550df22b,f,250000,7744498,,5000064,2018-01-30 13:57:47,78
0x9f3bc0bcde7956148f42d2c07dd051f66fd1cb3f090ff5f1b1be516c2a7190cc,t,59290,7803788,,5000064,2018-01-30 13:57:47,79
0x68406505ec2eb93b8113331da0bda9144b94d9bb3f765e1c0b11533a64654fd7,t,51921,7855709,,5000064,2018-01-30 13:57:47,80
0x5af7ca1911252aafc1893afafcdf4520d43f479abed4da2c0796e383867d9243,t,66253,7921962,,5000064,2018-01-30 13:57:47,81
0x3f6b16bd588692f36f972b9b525243e216bcf570fbffccd77091f477133385d7,f,52938,7974900,,5000064,2018-01-30 13:57:47,82
0xb5bf99cf000e5353cf3e695b7524fe389262509fe3cfe9dcf8d041c0b4879471,t,36639,36639,,5000065,2018-01-30 13:57:56,0
0x6da10089eeb29d6f1b3c08dd25771e34870c60c986b5d2ccfd0297a57dff71dd,t,36409,73048,,5000065,2018-01-30 13:57:56,1
0x7deaeec8a21356b71cc2bcfd6c50f746a03d07f63b433a31f1587e2e69e0a6c5,t,52784,125832,,5000065,2018-01-30 13:57:56,2
0x43d9ede3f27b9b159df3b5961ef63b85b61cd33bfa274898b6d6810bae29ee14,t,51787,177619,,5000065,2018-01-30 13:57:56,3
0x13e328ed3eb62b321aea50261a0b5d737c880dffc27446ea913a1dd519fdbfbf,t,52912,230531,,5000065,2018-01-30 13:57:56,4
0x3fc06c6e012329deaef6dcff0a1be4bba10b0d96371409a96b099e58683adc8f,t,37904,268435,,5000065,2018-01-30 13:57:56,5
0xa45b746ebbd791e45e412b71527320762cd60bff4d55c025afb48f7617ba3096,t,36826,305261,,5000065,2018-01-30 13:57:56,6
0x4b3ecaefe681994800dfede5483c39b3d2b56696a340358d81f224364360cc52,t,36347,341608,,5000065,2018-01-30 13:57:56,7
0xc2be4a56277a0bdb18b3d17f4748b992e7a0a8f4973dc8b9bb516c61d0b54aa5,t,36826,378434,,5000065,2018-01-30 13:57:56,8
0x9a573e484c455bf9883403da16300dbbbb01f95fb27107da661d6b314cc12370,t,38014,416448,,5000065,2018-01-30 13:57:56,9
0x9d80d270e7ce3fc2822858c512acc34b01fdefbd07e46c7371590a938acfdab8,t,37404,453852,,5000065,2018-01-30 13:57:56,10
0xb2f001c3fb2f8a3eb7ce453b6024dc3baed94864d6f96dc6bb832426ed489b5f,t,37111,490963,,5000065,2018-01-30 13:57:56,11
0x06a201a50d725802d619cb4f6a41da935f585a7088dfd3c4120dc55db70e0a09,t,40971,531934,,5000065,2018-01-30 13:57:56,12
0xb0533ec2955ff7e8f5e1ae7a5f5f6df226e8ec166a33ab1555310198aaf2f6d6,t,36848,568782,,5000065,2018-01-30 13:57:56,13
0x7391e53cafb5a19b532e2a3367be4c365d17c9d9f1a3cce390c98057c634b618,t,91794,660576,,5000065,2018-01-30 13:57:56,14
0x25410b3c43571071ab0a8b01b0da60b66681076fc5fd29bb4f54b12f25205168,t,37939,698515,,5000065,2018-01-30 13:57:56,15
0x9bb671315145202855847a4f0d7f9fe27c8bd13ee278ff7fe4d149d40cea43e1,t,37173,735688,,5000065,2018-01-30 13:57:56,16
0x5322ff76dec3f40877688d1584a211804416c764af9e6cc096e61ce5fe0971ad,t,36857,772545,,5000065,2018-01-30 13:57:56,17
0xfc950834805db3297ab3c001cee4d497d15b6408f7449d8fe9b6eeeeb8aaf42e,t,37222,809767,,5000065,2018-01-30 13:57:56,18
0x7927689276a513f421d1c38f8d4ec58a26852510df02bf87e3e3318f6de0cae5,t,37129,846896,,5000065,2018-01-30 13:57:56,19
0xec90f0e8a64dfadaeed904ad7afe2119171070a218d27434d95227d2f372d3ec,t,91258,938154,,5000065,2018-01-30 13:57:56,20
0x798f6ae891f495228394d9682586d8f9be2f8755ad7577f494b49d7478066dfe,t,37437,975591,,5000065,2018-01-30 13:57:56,21
0xf09892bb69c61aae1db2dad3e4198dd574784bcff7a6198a02b561cef8dcc0af,t,52540,1028131,,5000065,2018-01-30 13:57:56,22
0x7ee4ff8070c8c201318d46feb676c645f3ea32f4ac12705b5de0c32eae92e0b0,t,21000,1049131,,5000065,2018-01-30 13:57:56,23
0x503d2d9324b4550ee042aa874958b681caf83c6823caf83d639e16e1eb99f06b,t,52465,1101596,,5000065,2018-01-30 13:57:56,24
0xbde38fe9662d4ee07fc1d96dd11226b6d7286edf9a82e83a0f6838e1f055a01d,t,39512,1141108,,5000065,2018-01-30 13:57:56,25
0x868d8c29fafdd7bf31799f57f187a434ed212172b223cf99d7927d79196b4b90,t,21000,1162108,,5000065,2018-01-30 13:57:56,26
0x46a8be59b92d550d610d38c6ecdb584d7133192e1fedb7050b1951a0307df45c,t,21000,1183108,,5000065,2018-01-30 13:57:56,27
0x0f0d60b2e71fd60e4c0bd31af34d2c9f7264a516890ff7411d496664d7e59bbd,t,104678,1287786,,5000065,2018-01-30 13:57:56,28
0xd695265e816830af4ff190c279c48712d9182c8e353336b73bcebe499ddf9f5f,t,21000,1308786,,5000065,2018-01-30 13:57:56,29
0xa0322615bf8f148d565a6b11253166402bcd18b48c19057f8581bffa8746f1c7,t,21000,1329786,,5000065,2018-01-30 13:57:56,30
0xe9717507c2eb26f4e3ecf9b0ccbfec5df8b3ca7aab5bbe22cf404833197e2695,t,21000,1350786,,5000065,2018-01-30 13:57:56,31
0x434c7373c58a3dda37f167b1018dae26c63143fdbb7627f17faa0d6c6ae5bec0,t,21000,1371786,,5000065,2018-01-30 13:57:56,32
0x3f62dc70435d15d8d6c6f07e0b123763c3f55a696419134af841183e671e223a,t,21000,1392786,,5000065,2018-01-30 13:57:56,33
0xef8e6bc2ff976a5b63b2867727e8251ed9c10e3c388e9e54397c54c9a8e02495,t,36458,1429244,,5000065,2018-01-30 13:57:56,34
0x5dafe8a46164173320ead668cd9bc84e633b0b7efa92e25f0d39746caab4053b,t,21000,1450244,,5000065,2018-01-30 13:57:56,35
0xc7ef7876f1b63e37ac08dff2e033672928130687440b21dd098cf8dd558ab7f5,t,36452,1486696,,5000065,2018-01-30 13:57:56,36
0x38b0b91af66d352c2af5debf45a6c1ce8eff0c9a1cf1d0554af712cad407b4fe,t,21000,1507696,,5000065,2018-01-30 13:57:56,37
0xab5083822b4ad802e4b2a6233bce5f28b6984f163ec964c294a0bde09e419842,t,21000,1528696,,5000065,2018-01-30 13:57:56,38
0x34105a3cd10d138827dd30127b34b2c1f7e308829d9e2a135a8b3559b42ecb19,t,21000,1549696,,5000065,2018-01-30 13:57:56,39
0xbc80013da5ead351be68774329a6794f5b42a0242a6d749d93ed2efbb1a54122,t,37810,1587506,,5000065,2018-01-30 13:57:56,40
0xdfc36075674f24fe57657cc54b0ff8e6a9cfe0b45826a13059f2f59547baff52,t,29493,1616999,,5000065,2018-01-30 13:57:56,41
0x9f14398e0a896c4fa6a050e3c0f40cbdf784851fdfb3c92d522375e0d84f2712,t,37148,1654147,,5000065,2018-01-30 13:57:56,42
0x3ca28f88bf946f0c669ff4e5f87b3f5883d28fae63e5d3e2949523c3c682052d,t,21000,1675147,,5000065,2018-01-30 13:57:56,43
0x43b23b3c428c41e77bd17ea71fbe04db3b94a1f8726eded6e952765fa4ef355b,t,21000,1696147,,5000065,2018-01-30 13:57:56,44
0x4f0d1482a5f30d1b8b158a9dae1290ba18d7468a96d4cd005e8b92e2ba2507af,t,22027,1718174,,5000065,2018-01-30 13:57:56,45
0x30c19a672eeb4aa37535fd03b37f536f4b072b511e55e49e84fb7bc075b30102,t,21000,1739174,,5000065,2018-01-30 13:57:56,46
0x34c30214122982570d92e1d5aa3bcbda9a593c90d8fde9b02ef52c5cd54e09fe,t,74624,1813798,,5000065,2018-01-30 13:57:56,47
0x63df7862a3c4f942cb2d40c06757a512531929b203a3bc9597cc189b982a11d4,t,21000,1834798,,5000065,2018-01-30 13:57:56,48
0xe7f8fa0c0abc8f79e9a01661ec90614987017987fa32bbdbb986124f32255f8a,t,52465,1887263,,5000065,2018-01-30 13:57:56,49
0xf66d2f84ab5048403676acbbde438f3ba614b803c58fea1d218ed63f51a95df4,t,37380,1924643,,5000065,2018-01-30 13:57:56,50
0xeace127c4fced157376450eb96df26193df2dcb72870a93db5727a7519cd6952,t,21000,1945643,,5000065,2018-01-30 13:57:56,51
0x3702f12d8607ed81c9d7e3bc2bbf0db60317f96a09fb39931cdf998f2c97a21e,t,38318,1983961,,5000065,2018-01-30 13:57:56,52
0x0c8b84f821072356af3434707eb7123da20df992bb217f7414f1210a7ddad7e2,t,21000,2004961,,5000065,2018-01-30 13:57:56,53
0x72bd64da3c53cc6dff0fe591cc23bdbb23561799fc856b5c9b18388c792ca3ed,t,38318,2043279,,5000065,2018-01-30 13:57:56,54
0x82ef829ea43e93c0fecf8eac840f0e61c8febf2c4bf0b8223265ab0577102ef2,t,37420,2080699,,5000065,2018-01-30 13:57:56,55
0xf7414099ffcc2e72350bf1967b59ad146b7dc54cb8f2f7aeccc2ddcc606827c0,t,21470,2102169,,5000065,2018-01-30 13:57:56,56
0xe4a0c41ec756c4630e96101e925de431448cae5d98fa796ef6ec71f70f5eac52,t,140027,2242196,0x0a870d65c91c450632d1B03dbAebC09d64460617,5000065,2018-01-30 13:57:56,57
0xcaa883b3a7063b8473c4237f2e671888c238bb1b72829ab7b1430c71b287a867,t,53803,2295999,,5000065,2018-01-30 13:57:56,58
0x5c9c5e34986583fc24624e9a711eaf079b5201947c802f2dee85c3017791b2c8,t,21000,2316999,,5000065,2018-01-30 13:57:56,59
0xb4880a550e2b4d9fd7732fb77dbe551834513e6a2ae34a84eb224b5a94c42e58,t,74063,2391062,,5000065,2018-01-30 13:57:56,60
0x34b69a103cf8f1827c56df0af896ad0bccfe9714b4ad7556e4c8e7331c61a37b,t,53039,2444101,,5000065,2018-01-30 13:57:56,61
0x26e90fa437d658014dda5a91f73ac800871ebc9ed8c0141fbee6f6a495867574,t,38103,2482204,,5000065,2018-01-30 13:57:56,62
0x698f36d2efbbe0ef26403282d61fae7012cbbfb1afb445f772cc13db9bc9823c,t,21000,2503204,,5000065,2018-01-30 13:57:56,63
0xa702f6e3de2f782b10292b02425e78ae889881dd94eba743490cb6f8420ef480,t,82813,2586017,,5000065,2018-01-30 13:57:56,64
0x0a08b8f03b4d3020637d4200a503d8fce06ca3aabfa3cf7833283ec06fdbbe54,t,67941,2653958,,5000065,2018-01-30 13:57:56,65
0xd03ff50ef3a5fd804ae9da7eaec7d198bacf3ea4cefc1870440e718bd2848bb5,t,157836,2811794,,5000065,2018-01-30 13:57:56,66
0x643539af64cef533fe3b98a18a8b269bd9e7ec81d79d4ebc7718e5a1488bfdc7,t,157708,2969502,,5000065,2018-01-30 13:57:56,67
0xfe25f5850273b72486bd9c42aa19495090caaa99714657a3fd9d2f6884cbc04d,t,157004,3126506,,5000065,2018-01-30 13:57:56,68
0xa2b8c9653a238bc2b0448454b6e4f96b2050a1e6c7b282020801f30b18bbf5ae,t,82941,3209447,,5000065,2018-01-30 13:57:56,69
0x1538a7e620235bdfcd42a7bd524f38a757d6a6620e3f815e55153485f8fd9468,t,142516,3351963,,5000065,2018-01-30 13:57:56,70
0xec88011d25eeb7a691382f999b30dffa1f173f57c10183713adad47383848619,t,142324,3494287,,5000065,2018-01-30 13:57:56,71
0x8c251bfbf521a0941d81e40e23621da7ef02c05d81ae2574a6467b34dc502ce4,t,127772,3622059,,5000065,2018-01-30 13:57:56,72
0x3ce018f4b682ee225fa608774d1f3ea89d9d30ca21996be81e185a22319569fd,t,142836,3764895,,5000065,2018-01-30 13:57:56,73
0xd0fa5e732ce45cc17327f47e44d8436dbce4e09a0486ab7d27fc62788b868915,t,142260,3907155,,5000065,2018-01-30 13:57:56,74
0xbdcf3b68c918abbbb21622476fadd926f6e72250d825ebc2db12ddefbadc82de,t,67685,3974840,,5000065,2018-01-30 13:57:56,75
0xf8758ae6fc6a9afbcd77845a63e7659466907911d49c7aa03f99413777a4a5cb,t,157388,4132228,,5000065,2018-01-30 13:57:56,76
0xfbb843f25767ba003c148bf961f26ae9421ad2909a4c08a95b1ce14a26dd4a8e,t,45310,4177538,,5000065,2018-01-30 13:57:56,77
0x6598f427f82f199e7214d4082031e37b0739a7308bfc0955727771170081e271,t,52886,4230424,,5000065,2018-01-30 13:57:56,78
0x32adc5dc0439058b59de4bd2afd4da2475c63887af496d97229a9cc9770c4066,t,52886,4283310,,5000065,2018-01-30 13:57:56,79
0x02c5bc6d918e9c9df26ba7a8448a6b44ae9ac3fc78cc71259ba50a358a7a56a1,t,52886,4336196,,5000065,2018-01-30 13:57:56,80
0x0c8d0715bf69bc5c8ed4302915f9e3814daff83fb9f6342d088b3aecca072af1,t,52886,4389082,,5000065,2018-01-30 13:57:56,81
0x09486f311b14ff2d276d4bf8818f02eb6b7aa176ecad449026d3c3a80c5e1446,t,52886,4441968,,5000065,2018-01-30 13:57:56,82
0x002c33edefe1217a2d9cdfd7bd4f1fa08857b62fd4180f0ed70e777cb957a462,t,52886,4494854,,5000065,2018-01-30 13:57:56,83
0x95a90eeafecd35251cef01636236e61c07e680bebcbf328e3d22f0d99ce159b7,t,52886,4547740,,5000065,2018-01-30 13:57:56,84
0xdd4e8ee27929f9f8409ed5485f4960a300296e0d69241374296567a7a1198fbf,t,52886,4600626,,5000065,2018-01-30 13:57:56,85
0x1e4624fb3ea818a1a6cb97819ebf33fc37ac5d3f2f1472faf0d0e6fb1606b56b,t,52886,4653512,,5000065,2018-01-30 13:57:56,86
0x98ede568f23db08134a96e8908fc9222aea1f0531d87b068f1fe0f3ee279c093,t,52886,4706398,,5000065,2018-01-30 13:57:56,87
0xdf8c1638d3d607f54b85436900b016d0613e304c6487ad959dea27a298f90e39,t,52886,4759284,,5000065,2018-01-30 13:57:56,88
0x4f630147b4656453b61271844df7c628992dfc457d132505049860fbbac99802,t,52886,4812170,,5000065,2018-01-30 13:57:56,89
0x79f45a1be8adaf1ae8011f7b95f206176a9cb5e7e364fe54a80e139ee62c699d,t,52886,4865056,,5000065,2018-01-30 13:57:56,90
0xb1f4c3904c945991cd73296dc5dbeb8db68ed111ce831e90cb95e94988491cb6,t,52886,4917942,,5000065,2018-01-30 13:57:56,91
0x8503565c0b7c5a436e4177bd7b2bf341f4426e9c4afd97ea85b1ccfbeeff5dd3,t,52886,4970828,,5000065,2018-01-30 13:57:56,92
0xbe61d0bedb230aded388ba2333506376fbc09a671ab64931d667382e52ca76ca,t,52822,5023650,,5000065,2018-01-30 13:57:56,93
0x407e66bf149771a2328b160f138d19b932e69aec36238fc9f879f1f8a3837dea,t,37886,5061536,,5000065,2018-01-30 13:57:56,94
0xbc3c4c318f811d9af20b48576513e7d036c2bc0be0bd7b71e5de891cb108b1a6,t,52886,5114422,,5000065,2018-01-30 13:57:56,95
0x5f8f484587512ef3f186efc5b24bf48c3943d8fb4744d574e6215af52c54bba0,t,52886,5167308,,5000065,2018-01-30 13:57:56,96
0x1f8fc42e37da7fc5d10236586d04db832a8a8b436dcfde5a747d79f05723e5e0,t,52886,5220194,,5000065,2018-01-30 13:57:56,97
0xe50c2ece69c5e2a880edac7718ce36af434b0db2edb3459797827ea0ac637aaf,t,52886,5273080,,5000065,2018-01-30 13:57:56,98
0xaf2ec9e84fd297b8b3c2ac9a8052d18eb1983ea10fc19bad19c381bdfcafb331,t,52886,5325966,,5000065,2018-01-30 13:57:56,99
0x03c666f67b3cd4ee02837f4130d5e0403cf94cbe05155334185f93910545ae00,t,52886,5378852,,5000065,2018-01-30 13:57:56,100
0x97015ef6c1428412a202c0d2d79c07145c991b46842c21508972e05d51137b82,t,52886,5431738,,5000065,2018-01-30 13:57:56,101
0xff588db06a3e12bcb9cd9c9d1b6a84f0f7708178737abc57e2024573e22b9cd9,t,52822,5484560,,5000065,2018-01-30 13:57:56,102
0x62c1e364985461c58d28e92097b7d1c630f509ca4e91ac3182d4089a4b3d2266,t,52886,5537446,,5000065,2018-01-30 13:57:56,103
0xf2276ab4b8812b94b884e731a37a5b0723abdf8e4c6169fbcb61b1eefe0d354e,t,52822,5590268,,5000065,2018-01-30 13:57:56,104
0x5385a7bbdca898fafbc21cd63d31829988e2a22ae91b8002809feaba8ffb3929,t,52886,5643154,,5000065,2018-01-30 13:57:56,105
0x2b26e3d17f4e00d965a6d7e923b4464107be4c81a382aecb8ee71515d2c077ae,t,52886,5696040,,5000065,2018-01-30 13:57:56,106
0x4547924c41109a7f34378a658591663897083d38bbd8a19036ba1358103258a2,t,52886,5748926,,5000065,2018-01-30 13:57:56,107
0x86ae3dcb45944b3759e89765a97811688c24cb0e224895ecb2f34021dc6b110e,t,52886,5801812,,5000065,2018-01-30 13:57:56,108
0x58dee49c8b9e8ce923f28974984a8f4ba40698047a043a879f101dfaad6375ff,t,52822,5854634,,5000065,2018-01-30 13:57:56,109
0xe5a9641a382c7de7c85074f551623d89f55f28b8c9fe129f8a9d9221f220a7a4,t,52886,5907520,,5000065,2018-01-30 13:57:56,110
0xd022422a5dac076e2f17ee6b4f2fa2364856a7f10ab1a75ddc9d0a5539a74323,t,52886,5960406,,5000065,2018-01-30 13:57:56,111
0x7a47f91d6d7e01fdc7280df9e8787ddf55523b0f137ae90b389b469072647ef1,t,52886,6013292,,5000065,2018-01-30 13:57:56,112
0xff974121bf02daf797adbb164a381c6d75280240be4fe96c2e8ec17f1cdec044,t,52886,6066178,,5000065,2018-01-30 13:57:56,113
0xb8c2522ad5ce155aad9bca535cb56cce0385e7e9eef254435431849dc603d3c5,t,52886,6119064,,5000065,2018-01-30 13:57:56,114
0x35f087f59098286797e61509cce784a3f394762b9256f1aa3907c0b9593ed921,t,52886,6171950,,5000065,2018-01-30 13:57:56,115
0xbb4d1c63ba26a86e5f151384b28ee409e9bffb31cbbf6df8c5275838486f546f,t,52886,6224836,,5000065,2018-01-30 13:57:56,116
0x4cb89facdf4eb3cf1554cc512eb60c063c24b27a3e7a1d3c30a3d9713f633a6b,t,52886,6277722,,5000065,2018-01-30 13:57:56,117
0xaff9bc066cfab8eb533a2ca4f34eb0d8352de9d2666c7698e2fc4e68122a9c72,t,52886,6330608,,5000065,2018-01-30 13:57:56,118
0x088ebf4c379ade3f6f7e630d5d66530405ed5bdfcf27a1bfd12c772b6aca1b32,t,52886,6383494,,5000065,2018-01-30 13:57:56,119
0xf45bc81bb8713b569c5d15af0711259feb28e1515e94e2ca1cf7917591b9ed49,t,52886,6436380,,5000065,2018-01-30 13:57:56,120
0x041543c24e7a7eac5d427bdc5bf9ed660e1b55d2b31a98e312d79d1870da2973,t,52886,6489266,,5000065,2018-01-30 13:57:56,121
0xbe4d42dac17c0a3ee6acf412ee0253871cfcfa42ccfd6ecc1a574505395eef29,t,37886,6527152,,5000065,2018-01-30 13:57:56,122
0xa5cc524bece544f49a0d69be91bd3c7bb486f53e68dc09dfea7f7db366c3a079,t,52886,6580038,,5000065,2018-01-30 13:57:56,123
0x33ff9447c862c6d2b608266eaf1076672a3c3cf1d2513dc051c29bedc0fbacf7,t,52886,6632924,,5000065,2018-01-30 13:57:56,124
0x09774ef1e45754cec005b429350229e294b76e97c3b9f4822ca46c989f49b6d5,t,52886,6685810,,5000065,2018-01-30 13:57:56,125
0x734454e05089bda3ef076158406d1daaf6e3494cec4ac04e0aa3c0e87686fc22,t,52822,6738632,,5000065,2018-01-30 13:57:56,126
0x269ef4f5d5dd4ff1b0590fad877ef9dd71419748d2d16ca11947b5f5bc61a4a2,t,52886,6791518,,5000065,2018-01-30 13:57:56,127
0x01e762fcac6c2b93b14a52479e127691061f96d068a49ce5c26d93ee578b8354,t,52886,6844404,,5000065,2018-01-30 13:57:56,128
0xf455a69cb00681dc057bad335335ac3822ee3020783e6d2edc039e3f5e12ea05,t,52886,6897290,,5000065,2018-01-30 13:57:56,129
0x43cef88f7e7b84a0c8fa501fc629156e277cb767a29484339d9c667d48b32e02,t,52886,6950176,,5000065,2018-01-30 13:57:56,130
0x9aeaf775af0081d036de6ec485c386e138e3da57318d2456e5e32b1354d9b978,t,37886,6988062,,5000065,2018-01-30 13:57:56,131
0x5f6a407a86c70d3df5d63360437b4f6524a3e2298ff965305b51c8b10fce0db0,t,52886,7040948,,5000065,2018-01-30 13:57:56,132
0xfeb3081b892d93efca6e062598cedd1b054ec2a0a42fb692ffc21a576e10b2de,t,52886,7093834,,5000065,2018-01-30 13:57:56,133
0x6a4e95284763052da5dea072567a49b9cdcf57820a866c79e2db8365cf44b5a5,t,52886,7146720,,5000065,2018-01-30 13:57:56,134
0xac65a8468f38c9517d89313046f5992e88d7793f2544a5a02a8e5c5cac8e4b8e,t,52886,7199606,,5000065,2018-01-30 13:57:56,135
0xb5620ea41cdaaacef5163e348f0577f2f50255e9f383be5e1f4afb51789dfeb6,t,52886,7252492,,5000065,2018-01-30 13:57:56,136
0xd5909e443f41f9499f28f6d3306b7cd0c831176d383e356457372f1fe45af612,t,52886,7305378,,5000065,2018-01-30 13:57:56,137
0xea94f5d046d2c98bfb987c5e4ab629bfc1a1415d4c541c4101ef3b77e6ae1071,t,52886,7358264,,5000065,2018-01-30 13:57:56,138
0xc5489be4095318a7dcf451a7e8b4fe8b6bad993b9cfdc15b209bd1eeb834c749,t,52886,7411150,,5000065,2018-01-30 13:57:56,139
0x026a5eba1b10f1d325bb16679f0088229b289139f3a3409a58de0c90c8e7de46,t,52886,7464036,,5000065,2018-01-30 13:57:56,140
0xdff3f24bd062ee5b8deb6ab8ce14ee478566635d49197fea22507504d9b5c004,t,52886,7516922,,5000065,2018-01-30 13:57:56,141
0x0ce399ad30e761c1472cceb4cef4f153ffebec1d2a2d371c701c39e5b755116e,t,37886,7554808,,5000065,2018-01-30 13:57:56,142
0x7b38582318007d9db2feadebdfbeaf17403541cbeb596b0d644e0962af5b6251,t,52758,7607566,,5000065,2018-01-30 13:57:56,143
0xbc063a5d8efe07a0e72f96624d5d8fbcd09efa944e856b84e8b4fd8b10430713,t,52886,7660452,,5000065,2018-01-30 13:57:56,144
0xeef0b3944247927ef68dcded7d3ef6d7f1f326a10ead2ee003aa5caa633d35f4,t,52886,7713338,,5000065,2018-01-30 13:57:56,145
0x6782dc7c868ee3860ac124e128b4757d188532817d073d5be47d2515e50f4e32,t,52886,7766224,,5000065,2018-01-30 13:57:56,146
0x8c85f7bbd7c62cd0f838426415ba1b6f7733bfe83ef361b88835cad2094ca558,t,52886,7819110,,5000065,2018-01-30 13:57:56,147
0x180f7dd7c390b9c4a337dda1e952790e2b80868ef31c074f2d788cb0b220e12c,t,52886,7871996,,5000065,2018-01-30 13:57:56,148
0x216879e0d8fde4a2f942cb4795dd3b46b6628483d3b0a1cbe0228b8dd814e67b,t,52886,7924882,,5000065,2018-01-30 13:57:56,149
0x896e643f727a0f24a4908ac58598583677e94721808f29101c0b2fd06ebddb45,t,21000,7945882,,5000065,2018-01-30 13:57:56,150
0x43531a9f807ae8b73740fb66bc55c60c0705554a2f59046ae4cf8d2beba3e25f,t,21000,7966882,,5000065,2018-01-30 13:57:56,151
0xe4cf5e28b5f8006f028dc215fa8009b1a33512240420c79e87a2a96fb1996355,t,21000,7987882,,5000065,2018-01-30 13:57:56,152
0xd10ca839e70bc9833b20da25f94dbbb6e3ec9e0b2ac3de2d7ae9799326dfb8f7,t,55843,55843,,5000066,2018-01-30 13:58:16,0
0xa407b0ae34ed8d76a356bfadf736a265fdb830f310f8ccc1b70a4bb4dfdd0d8d,t,55843,111686,,5000066,2018-01-30 13:58:16,1
0x6acd20a00604b715a09a05f3510e3a42046f0e7864ebab01e19e859c5bee4c5e,t,21000,132686,,5000066,2018-01-30 13:58:16,2
0x92fd3793ad18dc77a1934e541124bbb36eec2f99e0cca671bd68a073b3bafdfa,t,214974,347660,,5000066,2018-01-30 13:58:16,3
0xc80387ee6bb410784cc251ee021654f1ea37c5d5707375809df9fd06fba21b7d,t,104678,452338,,5000066,2018-01-30 13:58:16,4
0xa00d28717209f77294c3b98230b4a5ed84f624666ee563e704aefc35a76faa92,t,91781,544119,,5000066,2018-01-30 13:58:16,5
0x9c48b0355c494fa72e19f65106958e963f4c84104c530545a8754a10c8f17bdc,t,55779,599898,,5000066,2018-01-30 13:58:16,6
0x8a5fd2888455c8abdc8687751fddf84daf02d9fef9ed27e207431b7974cbbd5c,t,21000,620898,,5000066,2018-01-30 13:58:16,7
0xb9b62a0ef03ba014cf65a1a045e10195f4d3dee52c7b01c6cedbe3581cff278e,t,31129,652027,,5000066,2018-01-30 13:58:16,8
0x531b963d3ce2abf37d9646698f91ccd65a1b83d53515a2baf0da70688a69c799,t,21000,673027,,5000066,2018-01-30 13:58:16,9
0x7130a1a68d762070a2d9e83ec450219bc0d285c09e7e914b21861be928ca4089,t,21000,694027,,5000066,2018-01-30 13:58:16,10
0x8958a199042b78b6568b2173adec4d3c0f1153daba06e69604ea236920bda920,t,21000,715027,,5000066,2018-01-30 13:58:16,11
0x4a7e5f792a8878db22123ae26a79daf719af9394f13b51e2639a64de0656d28b,t,21000,736027,,5000066,2018-01-30 13:58:16,12
0x8806a54bff733ea5cdaee8f299c321ec3c3c00b374b62486c5189dd6c116ddbf,t,21000,757027,,5000066,2018-01-30 13:58:16,13
0xf3d0981231e5e46a0b7a07d8a8d4bdac51322eb5539cc4c50d343d8513593840,t,21000,778027,,5000066,2018-01-30 13:58:16,14
0x7c69b49aca35807651de3e8b2483af659c58c3dd002e66752d4f3477fe75a443,t,104678,882705,,5000066,2018-01-30 13:58:16,15
0x03e5643421d855139dafc7e8c6afe4413e2ceee34b49069117cfeda7b6956fad,t,21000,903705,,5000066,2018-01-30 13:58:16,16
0x25119db4c0433b5add3304284efc998819281cb7a341c52af47f33c0796db0c3,t,21000,924705,,5000066,2018-01-30 13:58:16,17
0x5bee29f08f1a1d8075e3834061b8c2eec92685e59df42630b2ed871c612caf3b,t,21000,945705,,5000066,2018-01-30 13:58:16,18
0x5de5b874d51959cf428d0ecdb2eac10b8d7e043f66f542ee0c078c6a5f1eeb81,t,48330,994035,,5000066,2018-01-30 13:58:16,19
0x808bd812460fad429fb7ef80f2bb78c13057c150e69bbab9a0872febfe43c5f3,t,37148,1031183,,5000066,2018-01-30 13:58:16,20
0x344785375248ad0e4e90771bdd5228c53b63569c95efb315c112ef1b303a56ce,t,37186,1068369,,5000066,2018-01-30 13:58:16,21
0xb7b36b22910f1f89aee17b9d3f6937ad1b27a8ce53d9168f017fa13189354f4b,t,36542,1104911,,5000066,2018-01-30 13:58:16,22
0x29f8139dc83b351aeea4f470f68619998cbaa468e82ad06c65f421c91fdd0982,t,37314,1142225,,5000066,2018-01-30 13:58:16,23
0x520953bf3239d8650b9f59754ca3e83bd98b90e396ec9ba781cbfdfaccf86063,t,46105,1188330,,5000066,2018-01-30 13:58:16,24
0x7cfc4f2f9b4bfcf80b558607c1f5cff173f8a317e9ca4146f1e36d9b4ae2e2f2,t,22027,1210357,,5000066,2018-01-30 13:58:16,25
0xd3d42f5f446bb24d81253744a6fb33acbf8d0da33f02478dde2df490d4abb51a,t,21000,1231357,,5000066,2018-01-30 13:58:16,26
0x652801557caf67745ce8038604200914cbb9f9580e1c47c5e5d1863b84344905,t,38318,1269675,,5000066,2018-01-30 13:58:16,27
0x8f9da18ad0a9edd1be10d8454a6876a3f4fa2adb0327601d6b8805ae192f54ac,t,21000,1290675,,5000066,2018-01-30 13:58:16,28
0x074593bfe3ac7475f14a9a18303ad5229106be80fd21db8795dd6ebc520aa6b1,t,53233,1343908,,5000066,2018-01-30 13:58:16,29
0x5ea329739adc102dcab2553fcc1e153470102aae2aeb85d1d66f0ff138bd05f4,t,21000,1364908,,5000066,2018-01-30 13:58:16,30
0x22bbdf6963ebdc8ac033ce545969eeecbb2f6ea54c543e9467a2fa98bd62e2ab,t,21000,1385908,,5000066,2018-01-30 13:58:16,31
0x80613c5ed5435339c738de1378985942f2a03226c1bd84bd72f9385f3fffb0b1,t,21000,1406908,,5000066,2018-01-30 13:58:16,32
0xf901b15a8c40a797bb0a0a2069e883ad4f3dc9eb7ac166fc468638df3d6e187d,t,24899,1431807,,5000066,2018-01-30 13:58:16,33
0x083bf7dfe75c914c32594fb9d5d176d90208ecb0d90832bf6e57ea10cc8d488e,t,22215,1454022,,5000066,2018-01-30 13:58:16,34
0xcb3fa0331aad27f0252d643f191a4ff92fa6e476f5dee63317bf925ae9f92c07,t,21000,1475022,,5000066,2018-01-30 13:58:16,35
0xfc914f9ae8d26f7260d1bcef5ef8c267ae72581b47f1ed5070c9d1a64f79b715,t,26712,1501734,,5000066,2018-01-30 13:58:16,36
0x467172731df9f72cdad566346e577df382291998bb288d5a955db7695476c30e,t,21000,1522734,,5000066,2018-01-30 13:58:16,37
0xcddeb8d09a0486bc1e99987135bb9138e96ca12e92e1e366f8585b429978b6d6,t,24835,1547569,,5000066,2018-01-30 13:58:16,38
0xef163ba31eaca637b4747f5f816517123160f57830bbdcf92acfab15095d5b1e,t,37014,1584583,,5000066,2018-01-30 13:58:16,39
0xac6cc05bc215b4aa10ee02cd2c622c1af45116865da2add666741ab09ad2fa2d,t,21000,1605583,,5000066,2018-01-30 13:58:16,40
0xaa788f200e54007d2b78953b9ffbab08f09b012c87da02e00da9ca27fd3b4d77,t,21000,1626583,,5000066,2018-01-30 13:58:16,41
0x52845a938aaad33b22ced58b87ebfe4eb997b86e0f5e94e6ad2e793fdb77a7ab,t,36757,1663340,,5000066,2018-01-30 13:58:16,42
0x7d116affe684e034c2aa1064559b20fbc41f0b9e3255de73a8a7a8e6dbf76131,t,62759,1726099,,5000066,2018-01-30 13:58:16,43
0x57382407f35a6491daac3963c686d8448161544faa1ad7846562fc2e97ba36d0,t,21000,1747099,,5000066,2018-01-30 13:58:16,44
0x617370fb5c4a7c8190c6c9741fe6311414d6b121de3c321ee697575b00a30394,t,52349,1799448,,5000066,2018-01-30 13:58:16,45
0xa3cd8ae1b3b887f4c3f6a7cc2e23a5a43ad4921e623f9193795e6e09c20984b4,t,21000,1820448,,5000066,2018-01-30 13:58:16,46
0x9d2946752f01005469dd0c84ea9271748f4d8174cefd843d62cb935d95297e70,t,21000,1841448,,5000066,2018-01-30 13:58:16,47
0x1dea08ffb3c0a56f170f0ce5bc66dfd5f8ad0c79c1e5c0cfc781df24743217f9,t,21000,1862448,,5000066,2018-01-30 13:58:16,48
0x8748cad93e129dd6345f190e08d101c1436746a42889c286f402b534dddd2861,t,62096,1924544,,5000066,2018-01-30 13:58:16,49
0xfb89c16c14add13843f3156cfd45b17f564658404b6178a80bd691c0eda64c1f,t,40779,1965323,,5000066,2018-01-30 13:58:16,50
0xca6d40a704f65e575b6a885298e0b9915ab6b7253706669cd2d0c7b11788a93e,t,21000,1986323,,5000066,2018-01-30 13:58:16,51
0xf77aa49711d5f2f42092d63804f77296abed8d9331abf18f252d90f2a38e01ab,t,27395,2013718,,5000066,2018-01-30 13:58:16,52
0xbc431805e280e2b5129d69b434c04017a5ef14b0b8fd66dac1af674357160d26,t,67677,2081395,,5000066,2018-01-30 13:58:16,53
0x2e906c2afe07e1c8ae4f05e6fc4d4745ffa753c926a93966fe3daf961baeec92,t,21000,2102395,,5000066,2018-01-30 13:58:16,54
0x69ab85cbf84bc7f55959df5ffe5031dfc1d381da9586b0636b59d9907da7ca86,t,51891,2154286,,5000066,2018-01-30 13:58:16,55
0x7d955d3d0a66d87b9b27a38a6a662664de88d3706e9281a0925c3eedda696770,t,21000,2175286,,5000066,2018-01-30 13:58:16,56
0xab4adfc34e6a8989580af52e141026e7807e41545ee2c0bb357284c26665d450,t,36792,2212078,,5000066,2018-01-30 13:58:16,57
0xc18275a5bb2c62145d3868c1aadb4a73a7d75afb4654ca01dea8ce52092f524a,t,21000,2233078,,5000066,2018-01-30 13:58:16,58
0x1788ba932de4ec275893f34838178586a7941687421bace3eb88222cf0480de7,t,21000,2254078,,5000066,2018-01-30 13:58:16,59
0x8baa653cbc405c7dc89e3a8505e45c71cc72adc66f8594c3243eca299e815caf,t,21000,2275078,,5000066,2018-01-30 13:58:16,60
0xbfae9d528822b06543b9638310fb7add066f228a639c38e817a5f731fb47aaf2,t,53361,2328439,,5000066,2018-01-30 13:58:16,61
0x2cbad4385774c1729fcafc9ec0b0f6dbbe0263342fbe46d5ce91415e0e56241b,t,51335,2379774,,5000066,2018-01-30 13:58:16,62
0x9077396c3acdb0052414a4323d802805d4fba2bfa04aac60b8c20a6597383ff0,t,21004,2400778,,5000066,2018-01-30 13:58:16,63
0x944dadeea8ccfcb77bf19014f053301434f7e92c210474c54e20a2c4790790a2,t,21000,2421778,,5000066,2018-01-30 13:58:16,64
0x416e5303c0b156a6fc5343cc1876d939aae18830a58780cd6e9aaa0b51c49e09,t,21000,2442778,,5000066,2018-01-30 13:58:16,65
0xf564488ef0762658a5e9995872cb5882f3ee57af33e79b9e0bb4bf641b379b85,t,21000,2463778,,5000066,2018-01-30 13:58:16,66
0x54f727966553525ab07ae1ea5a55d55c0457fba8bf47e44fcb0ac9033fba6d28,t,21000,2484778,,5000066,2018-01-30 13:58:16,67
0xeb4ea05d2e7a30bc1918090d934a85ee79d14becc3a880327addea6a7581dae7,t,21000,2505778,,5000066,2018-01-30 13:58:16,68
0xbd553ef3d0d205253381637bf898158d446eafddda10cc4526868a86ee132e16,t,21000,2526778,,5000066,2018-01-30 13:58:16,69
0x0f8a3eb21946abb0da84d0654be49b32d6599c81231b3141222098350b2940f5,t,21000,2547778,,5000066,2018-01-30 13:58:16,70
0x2177ab02513deb3e42884260836556a19c29cf62b228b63af268ec4ee2877b78,t,21000,2568778,,5000066,2018-01-30 13:58:16,71
0x684c03d7fd9e6444c16bf5b8547e514b0354865ece67ecfcb06fb9d973255721,t,21000,2589778,,5000066,2018-01-30 13:58:16,72
0x48a05752d08928cd564b3e9ea3d2318f76f22960289a95954505abf459a8b559,t,76670,2666448,,5000066,2018-01-30 13:58:16,73
0xf5514c140d93c1b7ff36c9dd8fc2daf7d89d27e89e40990ad54aca3331903e4f,t,21000,2687448,,5000066,2018-01-30 13:58:16,74
0xbca7dd9d4a455194d01e64dc7b6584b97bec3b98abba4e113f43fd8fe712ef4e,t,21000,2708448,,5000066,2018-01-30 13:58:16,75
0x5986a82a71bd2abb09265b0c7adb2d035fa568383b671965c6b3b0fcd00d93cc,t,21000,2729448,,5000066,2018-01-30 13:58:16,76
0x3a7380f3c384b0c34eba96bbdc8b984b760d9bb74698be3593ecbaa095ad34c4,t,21000,2750448,,5000066,2018-01-30 13:58:16,77
0x788aa20329e551150c93af1e4027b044a9301e2191d946061c6904d6008b3516,t,21000,2771448,,5000066,2018-01-30 13:58:16,78
0xef6fb8e835f99c3c936af2f041187aff8585b99e69e3a8933d04ab9ad8e0c56a,t,21000,2792448,,5000066,2018-01-30 13:58:16,79
0x371f48a771a01a22e2e5606febf5397c5026f2079e759e1f100ca1309b23c47b,t,21000,2813448,,5000066,2018-01-30 13:58:16,80
0xb4db8c5b7489ba91246ed33d3a7e818d6f6b4b7c0d222ec7df2dae53e9ad7635,t,21000,2834448,,5000066,2018-01-30 13:58:16,81
0xcc3feca5b500a6830107d4dc20361831de714105cc7d8b299e2914a66193df2d,t,21000,2855448,,5000066,2018-01-30 13:58:16,82
0x9b8ffc98299ac069f4f5655bca8915d70e2ca5609b4280c089abe93f7c8f168c,t,21000,2876448,,5000066,2018-01-30 13:58:16,83
0x963dd1161d09823151d5d8f5ac4b093f5c894b88d472698f5fd4d0b7f7ca97e6,t,21000,2897448,,5000066,2018-01-30 13:58:16,84
0x18f4b6e032d6aad9d403842c4806b1738ef22a7cda8d0c7dac71c9f3c281cdf8,t,21000,2918448,,5000066,2018-01-30 13:58:16,85
0x350543734252d6b3f89a251a8a96a515458e6b7ac34c3be15ac93a3ad0a3851a,t,21000,2939448,,5000066,2018-01-30 13:58:16,86
0xf510b1334001a532f631ad415d746cc27b1ffb07f04fba566950d99099929db8,t,21000,2960448,,5000066,2018-01-30 13:58:16,87
0xc5d0eedc1e3d4e44d2d3d5de57ab4d921f9b977f2626cce79ef7ec6873a38b5a,t,21000,2981448,,5000066,2018-01-30 13:58:16,88
0xc2a4663d5191cfc6414199d93350699831200a2114d21833efd1c3fad67999db,t,21000,3002448,,5000066,2018-01-30 13:58:16,89
0x0c4499cf03c8d712f7cc6b2de520ab872f185d0275759193653edbe852c28e61,t,21000,3023448,,5000066,2018-01-30 13:58:16,90
0x6cbf6178c37c19206f6285a750a6a70909197504dd4acb999eceff9a086e3392,t,21000,3044448,,5000066,2018-01-30 13:58:16,91
0x09a06712c00edc67895519d66f57e22d9fa73e563eab4bbceb660e043131c924,t,21000,3065448,,5000066,2018-01-30 13:58:16,92
0x52a7ab95048118c50fa4d01fe525d0fa7317e494e538098480a815cf20501963,t,21000,3086448,,5000066,2018-01-30 13:58:16,93
0x9abdb03ee59d27f31f22e97deecd374c6fe014d7cbff20f51814198a9bc0c8ef,t,21000,3107448,,5000066,2018-01-30 13:58:16,94
0x01d86004a275113020279859ba7d956274fb1682e79078b216e0e8d388cb11ef,t,21000,3128448,,5000066,2018-01-30 13:58:16,95
0x3e5b6b0b71b04a64c3ae702d252259f3be33607384cbccd796d18f1746f4fa06,t,21000,3149448,,5000066,2018-01-30 13:58:16,96
0xe6bd92dfebc40f4028e790bf596cc0dd75a1239415590793d6e447de17d9fbec,t,21000,3170448,,5000066,2018-01-30 13:58:16,97
0x770884be16d29b8896151b4848a19ea8169912925d309b824525ef32db542bb7,t,21000,3191448,,5000066,2018-01-30 13:58:16,98
0xfbeba67b704cc30d57494da6322552e8026047893fb3b36e1407b97fdaf4d7c4,t,21000,3212448,,5000066,2018-01-30 13:58:16,99
0x0591612abb3386d094792cfd261331d136602de04267bc75d149121be4cb7e62,t,21000,3233448,,5000066,2018-01-30 13:58:16,100
0x6d8099ecafb35c94f1e894c97ce90086e6d2cbfa21bda9c39c2819b5f10db79e,t,21000,3254448,,5000066,2018-01-30 13:58:16,101
0x0288f793b75f4b7374b315dc2ecb14956d1ad80f60ac4704fac6b7bc80d6bba7,t,21000,3275448,,5000066,2018-01-30 13:58:16,102
0xe8a975aa4b4216ad2ce50a4eb7fcf5867c68937f78524e5a7e19fec55a49c72c,t,21000,3296448,,5000066,2018-01-30 13:58:16,103
0x606c83dfc73e0ff56aabb85c029796f7ed34cf8719f48d732bd2109999b664b7,t,21000,3317448,,5000066,2018-01-30 13:58:16,104
0xd8882bd7ba3214caaa2efeda001be095fa65bcceab3387e716ae6ead24f0212f,t,21000,3338448,,5000066,2018-01-30 13:58:16,105
0x7257c859a251a0f3baeec59bba4e45c7fba0257fc0f5bdb1a423c8220b214d79,t,21000,3359448,,5000066,2018-01-30 13:58:16,106
0xd694996b5b2d90677427c817311bdb68713771186731fd246b7bf7e2f4868bfa,t,21000,3380448,,5000066,2018-01-30 13:58:16,107
0xf0e565e183aaed4c0e026447ebf49b6f15697bf5416147030cacf5b3dbac56c4,t,21000,3401448,,5000066,2018-01-30 13:58:16,108
0xdc166efb9ff14355afc80e9db88afe114411f148be838b05f728f5f9c9d67617,t,21000,3422448,,5000066,2018-01-30 13:58:16,109
0x1b044d5eb94b5dce6b122e63406fd3fc61f55d4c10af0dfba1fca4f272466fd7,t,21000,3443448,,5000066,2018-01-30 13:58:16,110
0xc8b520dcb08c6cece35eb774c38bef0209e32fc7ee62be7f01cbc76a2c209f08,t,21000,3464448,,5000066,2018-01-30 13:58:16,111
0x2f9cce0f62d654e948d18dc7a956a32047225913bf55157f671c8fad116def37,t,21000,3485448,,5000066,2018-01-30 13:58:16,112
0x5e28fb48f6e19fb073f4716bad484eaf915496ec1e3e091f62c5a91d4f74c469,t,21000,3506448,,5000066,2018-01-30 13:58:16,113
0x93cf4b3d09b6ada2b459e55a1a658b72a379229904b7813a28735a46f78f4fd4,t,21000,3527448,,5000066,2018-01-30 13:58:16,114
0xa741ec47054bb9d3d595f6b7edbca49cd217a9cab93a6541d30a9404a306d51b,t,21000,3548448,,5000066,2018-01-30 13:58:16,115
0x02c2d6dfa9ebc4692fe46644d77b9ac2f0daf295b7fc6e4783141b2f537a1ea0,t,21000,3569448,,5000066,2018-01-30 13:58:16,116
0xbba668fb21bd8f791fa373e604e96472cd3b66ea7043edb0687ee38dcac871f0,t,21000,3590448,,5000066,2018-01-30 13:58:16,117
0x4ae6cae3bd8b9e6ab2f0e84fb5e25c3da5ba1c53e90d39d780a9619feb1b46bf,t,21000,3611448,,5000066,2018-01-30 13:58:16,118
0x3ef04fb8a5841d74623d174bd923fadf6596573363d322231b11f8ffa5f7f44e,t,21000,3632448,,5000066,2018-01-30 13:58:16,119
0xc5822b687968dcc565bb80d86ea74258cc69de806aac3cf90aef6093ada82055,t,21000,3653448,,5000066,2018-01-30 13:58:16,120
0x075ea33dbea328767e0a92262151a4bd00a4dc8defc59b8427d7efd3bb04a35b,t,21000,3674448,,5000066,2018-01-30 13:58:16,121
0x02795896d767fc4fa1458dedb2c877bb91fed20b62d1a89671a5cd2d1f281c1e,t,21000,3695448,,5000066,2018-01-30 13:58:16,122
0x13d922857b2d45166f42e95a7a5de0cc0cef10eb67281c7dadb48b76ea64dc38,t,21000,3716448,,5000066,2018-01-30 13:58:16,123
0x6aa7680bb7150ec69c0137001d956552e18edbde2cc488b37ba4cc655c3744f0,t,21000,3737448,,5000066,2018-01-30 13:58:16,124
0xc12c86f1dcf883d1c2889305f49e2c66ac354389ab78b0c2553b690028c780d3,t,21000,3758448,,5000066,2018-01-30 13:58:16,125
0xd86f3313e92e1e8a98af0b351c0f4c1e85b0b7c7793048baced24921fcb84ee3,t,21000,3779448,,5000066,2018-01-30 13:58:16,126
0x41542faf231ed60169bea8d500c9d2b0f59f2982beb56f885f0cebdf6febede3,t,21000,3800448,,5000066,2018-01-30 13:58:16,127
0x97f69f0bed506ccf1912d50cd496f191ee8b4c3795ba821a95fdc6dac56e8b27,t,21000,3821448,,5000066,2018-01-30 13:58:16,128
0x9059d558d58686ae9a9603cf256ac455514623d0e235c8efcfd90794be6e3194,t,21000,3842448,,5000066,2018-01-30 13:58:16,129
0xfc983379db6c9353f827a67e484aecbb0c9745b28eee4141613f004892fcbf4f,t,21000,3863448,,5000066,2018-01-30 13:58:16,130
0xaafb123062ba6c8b8265dcfd2cae56229788c8cbe31315e01f7b2e64e494be50,t,21000,3884448,,5000066,2018-01-30 13:58:16,131
0xcb5f4c8617b8f1f69e651f949a02edc5dd12c5e90cc3944f3c3e093cde9007ed,t,21000,3905448,,5000066,2018-01-30 13:58:16,132
0x214128ac8883efce115e1c1b235c2f69d2a2d9246d9106f98ba046306a58d291,t,21000,3926448,,5000066,2018-01-30 13:58:16,133
0x883d5cf2eb2bdb86d6af235256b912f5e74a18e4ef12171a1cbffdd68e2614fe,t,21000,3947448,,5000066,2018-01-30 13:58:16,134
0xcabdb8ce4b381e567ee8f5235af61b2e8f33c6de959c32e258a6bfefdd854da1,t,21000,3968448,,5000066,2018-01-30 13:58:16,135
0xc976191d84430fe573f2d88fa19fc46333d3b7d2bb9dac2b81592b4be546d5a7,t,21000,3989448,,5000066,2018-01-30 13:58:16,136
0x3273ee772419dd12daf3d598a3014f28e6360a3fcac63efb4982396b37dd662e,t,21000,4010448,,5000066,2018-01-30 13:58:16,137
0x8727a0a4f8fffc10b15f76624e8d3ddcac097d1b2683c80f976d52505115974e,t,21000,4031448,,5000066,2018-01-30 13:58:16,138
0x8a5628c08cadfd69f6d52264b96eee8dc48bc8c870a694d1c7a55491628c5b03,t,21000,4052448,,5000066,2018-01-30 13:58:16,139
0xd2218eb53ab07b2ea8db2a2f572bd04c88dc44bea844be3065b105671d9c7b42,t,21000,4073448,,5000066,2018-01-30 13:58:16,140
0x3830feb40a8f01a1ae881579eae96b4391952fd5cba9bf36c3fbf4d1e69dffd2,t,21000,4094448,,5000066,2018-01-30 13:58:16,141
0x94be7e7240acc54c1d7ca653ed7b627d94d5e89179f91384c86fdfb7a02c8a08,t,21000,4115448,,5000066,2018-01-30 13:58:16,142
0xe3ad62d1c74b2efe13d3beb98fb3b4d7c0e0165d138981ed119b2e58e3b22515,t,21000,4136448,,5000066,2018-01-30 13:58:16,143
0x1b9b8e1ce7d95e17e4a12be85bfab6ba29774cb511e4fb70ef9e93cc9072b576,t,21000,4157448,,5000066,2018-01-30 13:58:16,144
0x3956358fd9c298918a42eee1d4ad00b9912a475eff79d58170d90f1be54b5574,t,21000,4178448,,5000066,2018-01-30 13:58:16,145
0x8a0e121014696fff5b0df99ce3514301b00f9b1ae52c3015b6ba79b1985ae9d4,t,21000,4199448,,5000066,2018-01-30 13:58:16,146
0x38ca11cb08ce84cf88d61290b51babdad71285ffd2aa42209c124d528c15fff3,t,21000,4220448,,5000066,2018-01-30 13:58:16,147
0x5bdf936299f7c22aae390e54d6f4103ccc9b250b9b3447e226f2e13250f3bf07,t,21000,4241448,,5000066,2018-01-30 13:58:16,148
0x0a00b6e76e2cf23091b649cd091c52c282ebdae238016c8e164a0b7fc21ad8f2,t,21000,4262448,,5000066,2018-01-30 13:58:16,149
0x63b6880958b6212025ede40e6b7db574344de6306b29f7eca37ae5068ac45a77,t,21000,4283448,,5000066,2018-01-30 13:58:16,150
0x65a7f85451007b20b85c87df4933580d2b95c9931f9dd0a6ed04e3fcc1fd6ac2,t,21000,4304448,,5000066,2018-01-30 13:58:16,151
0x7a18278b91e29a675bb81309f8bb36a09336b5aec008690f33e552cb2d1d615b,t,21000,4325448,,5000066,2018-01-30 13:58:16,152
0x7910e3bc42d4c4098ed1a8cac6bbd03ff2f8fd0e17ef7883da2bf2b706ec1885,t,21000,4346448,,5000066,2018-01-30 13:58:16,153
0x0d2c8729f064bc5ced7c464b3d6dbfcb8b1650ad5f975b9c5bbe8bffe7f87b56,t,21000,4367448,,5000066,2018-01-30 13:58:16,154
0x9fc4865f6c24db5500fe72519f2c19c62cee6796b00bf50ba5ae46d02b3ce2b4,t,21000,4388448,,5000066,2018-01-30 13:58:16,155
0xd926649a58668f2b32a23a8512301d521532ed85f01479660f9cb3e979c27bfb,t,21000,4409448,,5000066,2018-01-30 13:58:16,156
0x022acf371638dbbdef27dd8bc889d6f0c2144b20a129feb27288e49c3d770606,t,21000,4430448,,5000066,2018-01-30 13:58:16,157
0x72c3460e4cc1b1e0cd7359a1460e6c148173cb4f28aed86b314232e8133086da,t,21000,4451448,,5000066,2018-01-30 13:58:16,158
0x680d37cbccf4c4a50a72d1fc73ffe231ad482117019cc0faff6f79f9a0a529be,t,21000,4472448,,5000066,2018-01-30 13:58:16,159
0xe48957f8552e3d7ffa7d5f45ac4626d0c578ccba100c38f8d9efd98bc048c2d4,t,21000,4493448,,5000066,2018-01-30 13:58:16,160
0x62c3917c3bfcb74129cacf4b0ac740c71ff0d8e0034e875123e44c1b5242a8e4,t,21000,4514448,,5000066,2018-01-30 13:58:16,161
0xde3da4580bbc83d2cfae84b881b2e0142b3e693ce59facb6139a9997c69ae270,t,21000,4535448,,5000066,2018-01-30 13:58:16,162
0x11f7fd97373eaab520078532171c18d8b77653cb3ee8a1edda0ebaad27c80a77,t,21000,4556448,,5000066,2018-01-30 13:58:16,163
0xaafcebd9b5005c62425efd3d08f995d6de14ce69369021e7df3db824cb6dcf40,t,21000,4577448,,5000066,2018-01-30 13:58:16,164
0x87c6f63810c107a8fa555605c182d65abb56c3bb489e95d1b13c1821cb0c2161,t,21000,4598448,,5000066,2018-01-30 13:58:16,165
0x8a8c6fcedd1786f89eda242e71d94d787f774b2b58aeb034699e98070a2ff128,t,23028,4621476,,5000066,2018-01-30 13:58:16,166
0x9c8a15d7940766d65920fabdbfa2ddd22b4c04d0b98cf94dbb681511ed2f61fe,t,21000,4642476,,5000066,2018-01-30 13:58:16,167
0x6153c9f7b9d6ac970f48c84414a351d6b111648c0a9a6234387ad45a5b7cfa4c,t,21000,4663476,,5000066,2018-01-30 13:58:16,168
0xbd37328b3fff10ff7b39a8048fa2eff2fd8c2e7b556f6ccb477e5d5258b15b4c,t,21000,4684476,,5000066,2018-01-30 13:58:16,169
0x20f638d30099b03a261b96548d1128aa3bb98af3951a159ef49594f3c57dda20,t,21000,4705476,,5000066,2018-01-30 13:58:16,170
0x4c864f1acf5dd937ce0a1991690c1541938f4a7fcb8fc6b5c6ee10739a22d5e4,t,21000,4726476,,5000066,2018-01-30 13:58:16,171
0xfda3ac91125d2ac8dd6e3857301541b129e6f5943d8443e593418443bd498979,t,21000,4747476,,5000066,2018-01-30 13:58:16,172
0xa0c57df55a0958153c6831387ecc32c89d13c585f8ebc57616a107928120ff69,t,21000,4768476,,5000066,2018-01-30 13:58:16,173
0xc2c973300f6845be11d1a4bfbae236d409c6343a7b381763f36286e68a968046,t,21000,4789476,,5000066,2018-01-30 13:58:16,174
0x045f2174711c3491ea1660fff96fbad6f97822b3413520ac7802f32cb452e9aa,t,21000,4810476,,5000066,2018-01-30 13:58:16,175
0xc151f63df3230332238eef8537e3a2d13740c932b2e16bc2784a5787c5f161f3,t,21000,4831476,,5000066,2018-01-30 13:58:16,176
0x5f8420f2ab87f77b9b7ec817c6dfe38727def643dd09cf31c745b7e23b3b78a2,t,21000,4852476,,5000066,2018-01-30 13:58:16,177
0xa67bf77cf144ee466fd993ae91adcefb77ea4b710931781c40322fc32397453c,t,21000,4873476,,5000066,2018-01-30 13:58:16,178
0xd9a3eed5272f7425400c1ed9fb9b6052c205a79dee572ed7176b6a063ca66f91,t,21000,4894476,,5000066,2018-01-30 13:58:16,179
0xf5e747f4f893d94b7f074f3e6625df216b0596139901814472d70d3d5db5924f,t,21000,4915476,,5000066,2018-01-30 13:58:16,180
0x725e2cf0d34e4d25a51278be9515df0d5539fab28ea754ab96081522abc093ea,t,21000,4936476,,5000066,2018-01-30 13:58:16,181
0x4e6d1ef3ef9f2ff83d9de7cfc228fc4d688933fe3083256dce724aa9c8a18865,t,21000,4957476,,5000066,2018-01-30 13:58:16,182
0xee9ccf5d24de0a1ea6e81e183736bc5c4b14cd6f75a3e00e3952c6ba986c9534,t,21000,4978476,,5000066,2018-01-30 13:58:16,183
0x3f9ad52d9bdef6c9f8bd7ac47fe15d7a65de17311b040b87d652a9adb3e107d6,t,21000,4999476,,5000066,2018-01-30 13:58:16,184
0x37869a4b2fb16edda63a733d84196925ba98356869897d7b46bccb20f1050a19,t,21000,5020476,,5000066,2018-01-30 13:58:16,185
0x19ee5522ab5bbfe9715d52b6bed577b2b073c03b359bb0a149f13aca965c7588,t,21000,5041476,,5000066,2018-01-30 13:58:16,186
0xb4fcd3a7f70b3ffe2759ad2bced2b8a28acd473b2456f74f46cc9a8e14c30ebd,t,21000,5062476,,5000066,2018-01-30 13:58:16,187
0x3bf3665bebbe5da762d98ea3e8d5834be04df983ac25be9cae3e9c7f0a55029c,t,21000,5083476,,5000066,2018-01-30 13:58:16,188
0x5379832156ed34cf60e3813f7485652214f5e3eece9ea505fab33207d0edc305,t,21000,5104476,,5000066,2018-01-30 13:58:16,189
0x6106ccd26eea2886b4bdfb6394ea18a92cbfe40f98a828d2e97ac2e5137ac89a,t,21000,5125476,,5000066,2018-01-30 13:58:16,190
0x76b029ce694b89d4a4ec99722303bd60b209fe05fe20b4b95fd49f738762e947,t,21000,5146476,,5000066,2018-01-30 13:58:16,191
0x69eaaf212249350f98f34c0179592d7e82c4dffd469d0d3d7464a8beb63db3ed,t,21000,5167476,,5000066,2018-01-30 13:58:16,192
0x3c7970d69daee9a80390f57595df1c7c7bb1abd54dbe9ddbe542ce1af203a20b,t,21000,5188476,,5000066,2018-01-30 13:58:16,193
0xa04ded9b4548a800078abf0db851f048caaf984590aef35b787571f5da720632,t,21000,5209476,,5000066,2018-01-30 13:58:16,194
0x5ac2fb2d9209699c4c1f62103e1926297a1c9a76ec0885b2369da07c5b971a3c,t,21000,5230476,,5000066,2018-01-30 13:58:16,195
0xfda7f3a7ef020964da8b16df00b5395410f498b814e4c33fe75e230d3a173512,t,21000,5251476,,5000066,2018-01-30 13:58:16,196
0x7e01d3c8280967df8635169bab208991f82d7b2384ebdf18f23a3e19c0a36bd1,t,21000,5272476,,5000066,2018-01-30 13:58:16,197
0x60779c16c84e7d8d61342a73662be1052a3f9fcd64b528fdd1132022255cafbb,t,21000,5293476,,5000066,2018-01-30 13:58:16,198
0x1fce8022595ddeac555d69ddcfa39a4ac184e4895586cc5275b8b8e9bd2ff91c,t,21000,5314476,,5000066,2018-01-30 13:58:16,199
0x5396eded73fd54553d1890363d58f973652b8855f6083c064ad7da8fc7aa68ee,t,21000,5335476,,5000066,2018-01-30 13:58:16,200
0x6993f4e29f718047cfc9c39866cc4fe82f724c1e6daededdf38df2a4b0460fa5,t,21000,5356476,,5000066,2018-01-30 13:58:16,201
0xc0c8c7426a8afd09414d724d4a2c8d5fee3eed7ed6c0d63e9813566135620296,t,21000,5377476,,5000066,2018-01-30 13:58:16,202
0x3aef77e9d288766d6fe75a235cadafbd278fbf4fad86b757ae2462379859cc3e,t,21000,5398476,,5000066,2018-01-30 13:58:16,203
0x2aa6ea3904820adaf5717c504bb870e14cc57e113e04e99b0f04fca79bff086f,t,21000,5419476,,5000066,2018-01-30 13:58:16,204
0x576da53a7ac3f5640f243d6191ec312b64a4a57b3065eb6b26e64c12eb007d19,t,21000,5440476,,5000066,2018-01-30 13:58:16,205
0xa7016caa93e041c510a3029d2af28e0835948ea7ee07bb40dcb265e2810e8f9f,t,21000,5461476,,5000066,2018-01-30 13:58:16,206
0xde8dcef7bcaa733b036b85df990f73fa2ada301da113173f02f1c5839dcc068f,t,21000,5482476,,5000066,2018-01-30 13:58:16,207
0xdae3dbed76e4078e56288f7fdbe60d4481716452e715e58ee7ed98cabeddd8ce,t,21000,5503476,,5000066,2018-01-30 13:58:16,208
0x7cf6fb02dd3a8aaa9e4f6a8120b49e7d8860af38b5dded99781061768bd0eb60,t,21000,5524476,,5000066,2018-01-30 13:58:16,209
0xff9130bd95bd61ffc433859b101233339d4d7883599534f669e1856395a1833e,t,21000,5545476,,5000066,2018-01-30 13:58:16,210
0xabc69006890993a35f8bbfb4819509d185a34f9d693aa391c8e263d6d904edab,t,52976,5598452,,5000066,2018-01-30 13:58:16,211
0x294bf53798c460f77672df394d5083868f2e9ac47fd127a0b92184635aa4439b,t,21000,5619452,,5000066,2018-01-30 13:58:16,212
0x0b9fb39e77dc54b89b4c6ca5f65066f4811dff41e0f01f06feb0bffb404b8b1c,t,21000,5640452,,5000066,2018-01-30 13:58:16,213
0xee8a789c6d5f0489d5b5f59015c0faf70cbe6d9e272730058cb0c846091b03a0,t,21000,5661452,,5000066,2018-01-30 13:58:16,214
0xd98e989e9615dd4a1bb992113b9e59f524c601488e267f773e67b1f2a8c6481b,t,21000,5682452,,5000066,2018-01-30 13:58:16,215
0x7abae024ee609fa9abb9cdf004a144692cfaa2efc883e7d2931d02c42efaedd7,t,23720,5706172,,5000066,2018-01-30 13:58:16,216
0xf17d6389bc02c947a798b00812ed106b4cf52b824818256ec64250949cb83722,t,39512,5745684,,5000066,2018-01-30 13:58:16,217
0x8420fd657c91eea1a388dd7b344738cedb68e1b7d537b8066520b2ef42fd0b09,t,21000,5766684,,5000066,2018-01-30 13:58:16,218
0xa62a9e427a7cd85d754de82bca24f319c828f79814eb43b9dd57109661a6bd03,t,21000,5787684,,5000066,2018-01-30 13:58:16,219
0xbd1bbdd03ffa38cd28d688fe7d55843a56ca997076034267ea54d73cb09eb393,t,21000,5808684,,5000066,2018-01-30 13:58:16,220
0xc7f7d9e0a0915b6648cbb115a4fcbf22550b6adea238f97bf161f6b558855b1c,t,70404,5879088,,5000066,2018-01-30 13:58:16,221
0x9953bf364464e842f3907cf7037bb24c5e8413b23f291d4f77593a0f9b7d8ad9,t,21000,5900088,,5000066,2018-01-30 13:58:16,222
0x336cf10ddf571816d4ec20f7ff8f9fbb1d99b04455b5de1f0f7f9ec489232b2b,t,21000,5921088,,5000066,2018-01-30 13:58:16,223
0x7d852a1144c305e1d15714341426827724c20a0c45a20e89775cc6115871ef4d,t,21000,5942088,,5000066,2018-01-30 13:58:16,224
0xd820f6412943ec3db688ba1ea8007e5c7abafbb5961c25031e4f08f042bcc433,t,21000,5963088,,5000066,2018-01-30 13:58:16,225
0xe05d4001bb4ed1d3e18b08b2fcf02a9a7f4113b347efbc95b019b1c9e9afdcf0,t,52084,6015172,,5000066,2018-01-30 13:58:16,226
0x06feb55867a3a22726408b380d9a11f40c0c9c28f11596918cdc6e4c4fb62337,t,21000,6036172,,5000066,2018-01-30 13:58:16,227
0x6ec0ae60d26f2e66fc535627d3d7d8902de0b6df6a3c48de5dddf988e4346e8b,t,21000,6057172,,5000066,2018-01-30 13:58:16,228
0x905251bb6e33b314def12dfd02ba6a0d0b7cab5cf353de09fcb931e2e4636924,t,21000,6078172,,5000066,2018-01-30 13:58:16,229
0x9af2d790fb5bf3cb6cbba22f29b25fb6f387c8dfc3000d3251e3d94b8c77304d,t,21000,6099172,,5000066,2018-01-30 13:58:16,230
0x3e25a0d4112958e94f0547eaf1d4f6a198c47c0b7f680225ea61c318a9cd0ff6,t,21000,6120172,,5000066,2018-01-30 13:58:16,231
0x3f64868b0e747ff3f4037fa91f73e78d2d03c3c85a64625af08d2317f4ba7655,t,52522,6172694,,5000066,2018-01-30 13:58:16,232
0x48748d84bb6ec412c371201d0140e164a1763e50b50b53beeef4ee8f02c58a99,t,279531,6452225,0x90dCa98Cc2fe955209597d94D88133a46dFa766D,5000066,2018-01-30 13:58:16,233
0xac628ae3dd4b23672fea0f3180cb26be453ac8b32b156f4d2e9aa45262081f68,t,21000,6473225,,5000066,2018-01-30 13:58:16,234
0xa11bef43a6b28759922e3aec375bb6c2f9a3f919d8264c54c5c097201ae3f238,t,51124,6524349,,5000066,2018-01-30 13:58:16,235
0x4376909acd335f0eed1ef6845229937407d7427121b91252eeb4966bbab9d416,t,38316,6562665,,5000066,2018-01-30 13:58:16,236
0x7bcd32f3fbbff4ca8311e33e024c9a7cf8bf3fbf0f81f8ae551d3b58c5cce1d7,t,21000,6583665,,5000066,2018-01-30 13:58:16,237
0xc20a35a7efe5723196dcc8fc053f743f7c24310c2aa32108450b0e525425d8c3,t,76840,6660505,,5000066,2018-01-30 13:58:16,238
0xbc27515b9aed51692be78057a7a74208c2f70b909d7185942072580c0755f2fe,t,22203,6682708,,5000066,2018-01-30 13:58:16,239
0x5ad99af178ada3a67d6cf899226697196b8b68f5848a6cb8b377199e88120de5,t,105247,6787955,,5000066,2018-01-30 13:58:16,240
0x46d67f6e6da27ca4ef231cf6b84e0975db5ed535353eface0cb54c023149e12d,t,52094,6840049,,5000066,2018-01-30 13:58:16,241
0x0792f13983559f8f9ba6efd90ee5cb47e85264fd4e0eb1294a06dd0702cb73ac,t,48517,6888566,,5000066,2018-01-30 13:58:16,242
0x48cfc4c09df3bd44998a891859f0fc05e94703d453ad05ff67cd53101cabd15c,t,49675,6938241,,5000066,2018-01-30 13:58:16,243
0x780106a9dfadbc0ea4f6cab939f8aae47bd2e83e4dc888f28a1dce39c488f16a,t,55779,6994020,,5000066,2018-01-30 13:58:16,244
0x1caeb7a2f36e1fff660c9e4505e35828cb380c1ad481116d4c35c8edbcc3c4f6,t,23254,7017274,,5000066,2018-01-30 13:58:16,245
0x46d739009d0de385a2085def0e33498f4e2ec752da8db1d0115d5803a9fc75bb,t,22460,7039734,,5000066,2018-01-30 13:58:16,246
0x45d31cf74284d52e2cb40d8d268a7df7f642692ac711eef9771dbd4cab2b9b84,t,45591,7085325,,5000066,2018-01-30 13:58:16,247
0x246ce0e7b10a76d081d422a3f567e8b513dc35ecedac1f56ea14cad607048099,t,21000,7106325,,5000066,2018-01-30 13:58:16,248
0xf438e459b3c764f55b37fdbe4c8d021a88b54a103952a04fc132dac4a1c01bcb,t,69568,7175893,,5000066,2018-01-30 13:58:16,249
0xb293e0005b2263faf2d9a78d7458d1c71c93990920039ddd83a99a010fab1dba,t,51560,7227453,,5000066,2018-01-30 13:58:16,250
0x72f4eefa463363f9e345aa80cad00471aa2819304d336e88b40e05bf42cfd7c7,t,59354,7286807,,5000066,2018-01-30 13:58:16,251
0x4c035994da28c243513f9864f7bff4b19fd6d8401940fd28af96de464eddcaea,t,59162,7345969,,5000066,2018-01-30 13:58:16,252
0x767a81f42afe19ccb74242c1b1860c271bef11e4a77bd3dd1b9565fc1172c1b9,t,26367,7372336,,5000066,2018-01-30 13:58:16,253
0x6c3564341aa8a2b8f3aee6ded15b61b5152bddc4cd5ddee23dab446c298a2e60,t,59162,7431498,,5000066,2018-01-30 13:58:16,254
0x1c60e8822bed505a92ce30958b18d6be253540e7296d587cf24f872f38c61414,t,37098,7468596,,5000066,2018-01-30 13:58:16,255
0x5341f4f8b1ef25e7a7d474ad8afd13369656647d8199b6dd0c80635b3740bf6e,t,59290,7527886,,5000066,2018-01-30 13:58:16,256
0xa8e2824aec3de7b94969769ae061f24efebd99f09e2e56c788e6c220a4151170,t,47919,7575805,,5000066,2018-01-30 13:58:16,257
0x3ef7b4ae560dfc4385c10ca7e62f6466352d9864701e5a78a5a60570f2a35bd0,t,78178,7653983,,5000066,2018-01-30 13:58:16,258
0x517773fc1ea0627ced8e4bad7c31ff29bd0afeb43c82f757453ea39a56ee44ef,t,37249,7691232,,5000066,2018-01-30 13:58:16,259
0x6feb59f3986538ad0a4f3f94eaa2ba7338afc726959424c576ffcc9f6472411a,t,107794,7799026,,5000066,2018-01-30 13:58:16,260
0xe4952c7b38f921c77dc13f755a5a83b4bccdb631fd0fe9a9d264d4182024c855,t,21000,7820026,,5000066,2018-01-30 13:58:16,261
0xd663250234206bbf4d28719f55f35e87d18d9478b3ccd6e02a15fcf2ea3cd28b,t,40806,7860832,,5000066,2018-01-30 13:58:16,262
0x5432cc99230a64c5dbab6d7c0d9e714ecc6af40a40a948c1acf6730cd999ea4d,t,21000,7881832,,5000066,2018-01-30 13:58:16,263
0xc35a01bb8826ac2379606959b15a26a7d7b0e5886b0dd86305ca814651682ea5,t,21000,7902832,,5000066,2018-01-30 13:58:16,264
0xb2205c9dfc35dab19b3ad2d492d42087c025bdb0251d6f69848c3875cf0065af,t,21000,7923832,,5000066,2018-01-30 13:58:16,265
0x937e46ca1ec4306a731f3f52f5ba0d6be2323201c4573be9f3eb5d3d1c2f7359,t,38425,7962257,,5000066,2018-01-30 13:58:16,266
0x5f34f726d04f27ad305cef5bf4c233eb8cc0acb0c38dd1378f82d2ec77558a0e,t,21000,7983257,,5000066,2018-01-30 13:58:16,267
0x8d7f4e60d68586b152905b9a929f9e43fd5fe3641b5e61bbaec54be37f5062cc,t,21000,21000,,5000067,2018-01-30 13:58:29,0
0x054736830160b31288ea8e54106c2caa0a2b012aa0c152e3f58e2142fe0f5ff4,t,21000,42000,,5000067,2018-01-30 13:58:29,1
0x5d1a2a8ef7abf0eef612cd3219ab6c4e3b1a200bd1e0ba524d689a292ac0cb49,t,21000,63000,,5000067,2018-01-30 13:58:29,2
0xa80aaf9603e856eacd055b7ab3a288731509f2b4e416736baf925feb6427fa8b,t,21000,84000,,5000067,2018-01-30 13:58:29,3
0xb143c487c33f7ef3c9812e069fcdf516c2214e6ce4258dbbad98f11a7f0da5a3,t,21000,105000,,5000067,2018-01-30 13:58:29,4
0x0b174a52723fd4869786a7a85fe99b3874675c6cd866cc42d9b8f24ccf21cad1,t,22423,127423,,5000067,2018-01-30 13:58:29,5
0x97b22f64d1511859b9380b22eb805f8d5ec2f6bac5a1cf8486a91260cce9f177,t,21000,148423,,5000067,2018-01-30 13:58:29,6
0x4e8ba08509383c54074b3ad5f43d977c50e8d41acb40a067ac5b863e71ca0852,t,21000,169423,,5000067,2018-01-30 13:58:29,7
0xb21ed4362111f8b981f953299e48508bd16894ec4986504fb0b4af9790c11a6f,t,39512,208935,,5000067,2018-01-30 13:58:29,8
0xc46c6fa73c464f012cbe4c0adcbe9bd73057f49dc9dd96d029bc87aabfcd8349,t,21000,229935,,5000067,2018-01-30 13:58:29,9
0x4f5ed4ff5b5f6d8fe88a9075e7030c1c01c4b5737036f63d3e47aea5c833cd0d,t,21000,250935,,5000067,2018-01-30 13:58:29,10
0x9d80ea3ca614310d2fedf5482752debe85887cdbdf4038b5ce73877fa1691dc7,t,21000,271935,,5000067,2018-01-30 13:58:29,11
0x951581f749e936b8eac789a6906b85340dc3023111512653dfdfdd0a0a51a68f,t,21000,292935,,5000067,2018-01-30 13:58:29,12
0xb0395f76c7b266b95daa69cd58dc973daccc22664f8a4d32d84a3d6d694dd9cb,t,21000,313935,,5000067,2018-01-30 13:58:29,13
0x98b79228ef89191c45113ab97b2ae317a6b03b7a7192c2fd4fb54de0ea7779dc,t,43625,357560,,5000067,2018-01-30 13:58:29,14
0x283319a9b86687707c65305b6488d890ab877537f3b9caf1b39b751064373f94,t,21000,378560,,5000067,2018-01-30 13:58:29,15
0xa1843b9169d862003435b9f7874c5a74a59c416fde056806c9f405590fb5b0b3,t,21000,399560,,5000067,2018-01-30 13:58:29,16
0x65597898f1dd72aa1fd54015038ada6980befd6e295ff1e5a07e4558f9070b85,t,21000,420560,,5000067,2018-01-30 13:58:29,17
0x81090d12a632ec397d82ee5ea6486da860a31ee5925831a05859d25232088821,t,21000,441560,,5000067,2018-01-30 13:58:29,18
0x8993e370f7f283a940e6097f15dd85a5068ea10ad0ec464e7687798851d136f3,t,21000,462560,,5000067,2018-01-30 13:58:29,19
0xdbd9df1f246e739396b03a744af57dfca0156b81c85b6ead250a7fdc8d04b0d8,t,46714,509274,,5000067,2018-01-30 13:58:29,20
0xd86ccae33c41494a17148750a0fd3b9fa28a14ff68a49c7b2b022864c75877b0,t,21000,530274,,5000067,2018-01-30 13:58:29,21
0x03c86befc566a7052a8748e640be740dc2c6dec3a263f2177c80c45fdfdc8b83,t,140972,671246,,5000067,2018-01-30 13:58:29,22
0x9d7acb656b84d919bf0dec7f15ad7d5cbed729b9dfde162f44f23496752b684a,t,57997,729243,,5000067,2018-01-30 13:58:29,23
0x32539d9154b2d9ed509a3c4189d4fac184fc5534f01949afc62faf1de7492969,t,44854,774097,,5000067,2018-01-30 13:58:29,24
0x8160a0fccf7ed0e4a8c4402c155099b7112ba0966438666efc70ee8b71a1dde3,t,21000,795097,,5000067,2018-01-30 13:58:29,25
0x11e2d8d3e9633b3be0f0e103fd1aae8ec05228cd5b2bd190b74137d9266cc813,t,21000,816097,,5000067,2018-01-30 13:58:29,26
0x7cf7d752a7f45d2c99a77f2401b62fde22875a3362010b1e46a36be41f95591d,t,21000,837097,,5000067,2018-01-30 13:58:29,27
0x23f129b60e229ff1778e1fb051fe0699f3b99308e46526bf6185e84a6e747e5c,t,21000,858097,,5000067,2018-01-30 13:58:29,28
0xcb02248ca3aa94e6aa170aee39f0451584c8591807a048ec07849d3001a11643,t,37638,895735,,5000067,2018-01-30 13:58:29,29
0x2dbe3519a380576c2930ee0de13ceb318cba0cc628572ef1af04f52d8094f0c9,t,104678,1000413,,5000067,2018-01-30 13:58:29,30
0x67e78112300ab8bdf594c2c2c600ca41da657cb042973b3ae5bccb870a64cbb6,t,21000,1021413,,5000067,2018-01-30 13:58:29,31
0xc9c73f0f57fe3ae8713d62f361401e9602586f2cbeef17ea786b378fd00499d7,t,21000,1042413,,5000067,2018-01-30 13:58:29,32
0x1142f4446e7443d9359f87e40b278c36337f2791c038b6f0c84fc144536118ee,t,21000,1063413,,5000067,2018-01-30 13:58:29,33
0xde0299b8b8ff788fed518a7fe6b183af3cf7ee89b950b87387c1ff317d52ecbd,t,81253,1144666,,5000067,2018-01-30 13:58:29,34
0xcf30c5d8b1f501d2389511e396d6bbc4c60d9b30a156252eab434a1bd02ae08f,t,21000,1165666,,5000067,2018-01-30 13:58:29,35
0x9128a4908d1e8caebbcb2b008e107c9b0d173178a365e1ff63601f7fcf0e672d,t,21980,1187646,,5000067,2018-01-30 13:58:29,36
0x443a37c456d19bd03c1128ab2c9e190186c96532c3eab0e74ee888c9aab53934,t,21000,1208646,,5000067,2018-01-30 13:58:29,37
0x85695e0ac95e62dd08966d212859bbbe6644eb6d36690abc32efc5b6d6d4aef6,t,21000,1229646,,5000067,2018-01-30 13:58:29,38
0x5e989546a0ecf2837c4aba3182f1c9346c552f85284a99c64c0858e9832b4bad,t,48021,1277667,,5000067,2018-01-30 13:58:29,39
0x5d55b17b762708698be10a30e3ae667b8dc55777847a382fe2885e240a1b70af,t,21000,1298667,,5000067,2018-01-30 13:58:29,40
0x458f91b675991c0a982b4f6902bbd866eec038222efb9c40fb7bf992d820a566,t,21000,1319667,,5000067,2018-01-30 13:58:29,41
0x992ce03bd70a7ba07e270c5db998bae8441b97a526522534bcc66e2f54955210,t,55907,1375574,,5000067,2018-01-30 13:58:29,42
0x8ed66e544702eaa2e47901978eed575f839a0f9cdb51720d39031a923e02b82d,t,53233,1428807,,5000067,2018-01-30 13:58:29,43
0xdb3c0da398318d0503de852577861b1a88920e1e1d3fae444df814fe46d74256,t,21000,1449807,,5000067,2018-01-30 13:58:29,44
0x8fbf0d781d55ffde55da600f7aacc5728f6659956a904b1585ddf6253a235f30,t,21000,1470807,,5000067,2018-01-30 13:58:29,45
0x7f5d98f2262f798ec2fc73b47de8f77cd9045aa6991a808590e8c741e572d8de,t,21000,1491807,,5000067,2018-01-30 13:58:29,46
0x3c03b406fde5835f022c5aba746f065de1c2215942bcc89983e3d9343d2efed7,t,53803,1545610,,5000067,2018-01-30 13:58:29,47
0x3d8d559440adf9752ffcc4b91ef9fb8aebe8a2a228a8d0ce40daf337c882205d,t,36718,1582328,,5000067,2018-01-30 13:58:29,48
0x2f930c96a37d0050822c37324e9c8b3880c3c8e65d682b042e8a0b34f6be63ce,t,21000,1603328,,5000067,2018-01-30 13:58:29,49
0xdc3fcd4112ee7184a3a6d5a05c3d2ca380bd406275704944ee6a0eb08c863cbb,t,31984,1635312,,5000067,2018-01-30 13:58:29,50
0x7694ec9b200f71294636ab616a842df05d560faf20413c73a8ef429b74508112,t,142708,1778020,,5000067,2018-01-30 13:58:29,51
0xe539dd0a7f6e10943d35a8c57c4c746f355f034bdb68c30c683f40db5e6c6e37,t,21000,1799020,,5000067,2018-01-30 13:58:29,52
0x15b62ecc9a63508e134c52e2eef7b4faf4d82492c2654fd6d39db51c452b441c,t,108306,1907326,,5000067,2018-01-30 13:58:29,53
0x251f7a8c6bdc9b8ef5166554099741100e5b9e7c8431b0c7cd2bf12500d5688f,t,52886,1960212,,5000067,2018-01-30 13:58:29,54
0xf0073752d58a965617782288e04d818dfcc0fe10138a6abf8484ddfae888980e,t,27450,1987662,,5000067,2018-01-30 13:58:29,55
0x7d366b126fa656b098951b339b7d4b2e364bfa8c7cdc7f0033b41a2adf88a0ac,t,21000,2008662,,5000067,2018-01-30 13:58:29,56
0x3c6060bbc102fe5e6db37f89df05edb158fe61f389565e65488647f8073bceee,t,21000,2029662,,5000067,2018-01-30 13:58:29,57
0x10db180252f65459fdf4f5294eb2e4e18c4438e2dbc05910014bffe164d1afb1,t,21000,2050662,,5000067,2018-01-30 13:58:29,58
0x814c17e36bb441a71f59989f9ac77e8504603478cda0451769e067420acae41c,t,21000,2071662,,5000067,2018-01-30 13:58:29,59
0x84a4250f9adf04c1d47b0fea9e4bade1f410eed583db7e394382daa9ffd69ec5,t,21000,2092662,,5000067,2018-01-30 13:58:29,60
0x1f5d718db10e00ef3c6b1bde74510594ee4675d62db010369bb1a6839d673cfc,t,21000,2113662,,5000067,2018-01-30 13:58:29,61
0x572f8aea9ae945f28e51fb12330ae4188b6e5919c674c0597a3cd54d2abdf003,t,21000,2134662,,5000067,2018-01-30 13:58:29,62
0x4d222dcfbd20fc6260885e53fc941e4a0d5053071df95f7f24c7a4c6349fbb5c,t,21000,2155662,,5000067,2018-01-30 13:58:29,63
0x15b75757787753b2ac8d236c07dd932e7f74d2f6b3313ab6cac4ab032019dc4e,t,21000,2176662,,5000067,2018-01-30 13:58:29,64
0x58ebbba6c2d2801ecd929f4f37657cb90d0601d73573d485c659376e3461bf5c,t,21000,2197662,,5000067,2018-01-30 13:58:29,65
0xc3f08f78047cd87d0cdc3ca2385597f36d17562ce0a3a30f4cf74a3cfb92a907,t,21000,2218662,,5000067,2018-01-30 13:58:29,66
0x8dc5f1affb7256e966147a49ab547e2d976ec2f8b4b9692eb46fb4517b5bcad7,t,21000,2239662,,5000067,2018-01-30 13:58:29,67
0x55b56e5de9fb5483be56823a6b3e2a3dd2bda5b04ed42123f65dce9dd8662797,t,21000,2260662,,5000067,2018-01-30 13:58:29,68
0x506400814ad46c2f0aa2befca3a658704c27c31bfabd164525e5980299757d45,t,21000,2281662,,5000067,2018-01-30 13:58:29,69
0x78b091a1b9b3e0b41265d4e7fce7e9c6ed016e5533268d577a8baee131f74374,t,21000,2302662,,5000067,2018-01-30 13:58:29,70
0x5927cb25b84c9760bb59fdba7816fc2325dec6b5443a87c7ff03bd40fe14a81f,t,21000,2323662,,5000067,2018-01-30 13:58:29,71
0x48dc3a756fb5908b4f0198d1e9d0e49964b4c2c83dc895e13fa801cfe821ebb3,t,21000,2344662,,5000067,2018-01-30 13:58:29,72
0x4f0c7ed79ba5fc3acdb7fcc8b56f2ecc59c279dd6120a046ae80c76dd2b269e3,t,21000,2365662,,5000067,2018-01-30 13:58:29,73
0xeaac4fe0f6ff5197dd1d804371187ecbd6dffffe5acf9a587638441c82be2a74,t,21000,2386662,,5000067,2018-01-30 13:58:29,74
0x64dc08a5fd84ab50f09ba2047a192ffbdafd3953cbd3bf0ed87c1279a35dd81b,t,21000,2407662,,5000067,2018-01-30 13:58:29,75
0x5ae3b2046176a02a637a8ef40b626c5d5cbec6f7d6ddfc687b055465fd3e5f3a,t,21000,2428662,,5000067,2018-01-30 13:58:29,76
0xcf070f4e7c46177379817f69d945e9e6314a0d6a1295c04ab07aac2827431b71,t,21000,2449662,,5000067,2018-01-30 13:58:29,77
0xb45991c46a969c294ee619e8ce8e72aa60c78ecdbb6645e7513c6efff6581697,t,21000,2470662,,5000067,2018-01-30 13:58:29,78
0x7900c28cc065ceb2ddb2a442fa98e749e78100e71d5540a4c3f13920e921ffb4,t,21000,2491662,,5000067,2018-01-30 13:58:29,79
0x8e39149c41e84aa54d4c34f5b049d9e0bb0e0eb8e9a230947c971f7a273d1ad1,t,21000,2512662,,5000067,2018-01-30 13:58:29,80
0xa922cbd5b09e6a9aefba8506eb036c0a4b6a1fe86a18a3398e87dedeeb1ca753,t,21000,2533662,,5000067,2018-01-30 13:58:29,81
0xc6f53834dd4ae592a626d3052082bf37f9e8ed29ab5c91b49e654d8d92812fef,t,21000,2554662,,5000067,2018-01-30 13:58:29,82
0x53622c4b536fb7ed4feccf1c1d960c6e9ab82086e6ed99a7b8ba31b6b5e4472d,t,21000,2575662,,5000067,2018-01-30 13:58:29,83
0xcb1dcd790855daa8f6f613c7ad3765ab80d1a5e58bd83f77ddd6f928efe81a13,t,21000,2596662,,5000067,2018-01-30 13:58:29,84
0x6d9294a35eaa77d0c3294872974e6c143b8ba7dd19d8c5da792088544e843bfc,t,21000,2617662,,5000067,2018-01-30 13:58:29,85
0xc80a10d1abb293b6b26829e6dcf05f28e02e5cc6895f657ed0e5522e4b8923d2,t,21000,2638662,,5000067,2018-01-30 13:58:29,86
0xd1edd8e0004f40a857a863363c93a8c90e6f37aa8ac9fbc8ccbfac99ebefce34,t,21000,2659662,,5000067,2018-01-30 13:58:29,87
0x6141b040858002f27a70eaf6ff320bdc658c52f26f512e66aaf98d7dde300159,t,21000,2680662,,5000067,2018-01-30 13:58:29,88
0x1170c47c203f822d82ceed3f4f324b6fa9ac5d2e3e3836b7a00d3d48ab3839e8,t,21000,2701662,,5000067,2018-01-30 13:58:29,89
0xacf6ef9abaf487c33818813da3a408cdbe7269c7adf174211c9f65f7132c7e26,t,21000,2722662,,5000067,2018-01-30 13:58:29,90
0x08124750fb76caa3ca149799af376a69d8f7552d9be7673bf984a765eef91411,t,21000,2743662,,5000067,2018-01-30 13:58:29,91
0xbbbb531522a9d4cd118cbd91106cb5b89293ec027023f48be95246b49bb4e36f,t,21000,2764662,,5000067,2018-01-30 13:58:29,92
0xf6afe4ee8fe21e436b167e759dc49b8697ca369229af2bfdfd40d83c8bc0ae9a,t,21000,2785662,,5000067,2018-01-30 13:58:29,93
0x53c2cd72b1ff67a25be9750cac3487927ce8fbc361e1b050adb5c4cf191152e3,t,21000,2806662,,5000067,2018-01-30 13:58:29,94
0xa785b7485501b906bbc49ddf9d21291c5407a1b0f60f7b9bab6b4144c0c836da,t,21000,2827662,,5000067,2018-01-30 13:58:29,95
0x5df401e2df142fbb203b3cf5bc27e4e2d8df82dbf08a457d9b2d7667ed6b7394,t,21000,2848662,,5000067,2018-01-30 13:58:29,96
0xe79dcbfc2e15a8a06181d4d663fa1469357c0bf1b890ff7ceed0cbfc0531970a,t,21000,2869662,,5000067,2018-01-30 13:58:29,97
0xafcb585f50c21793c05948b60ba1ca5c583ccc7e93be63b9525a69403af37584,t,21000,2890662,,5000067,2018-01-30 13:58:29,98
0xf8aa8d8c86e0940627a7809e083bb284ce7f82fd696c7e9559a5294a87f9a9eb,t,21000,2911662,,5000067,2018-01-30 13:58:29,99
0x5e5850f0aefb0bff3fe9f6a1274354b7532cf6aa18f7e2b8c3131044da00384c,t,21000,2932662,,5000067,2018-01-30 13:58:29,100
0xd246ca1fd9694935cfbdcf6b37cef21ef967b6d369608fa98af074d10393609d,t,21000,2953662,,5000067,2018-01-30 13:58:29,101
0xff5dcf4012b1a44f6e1d2f4592d2a715ec45067094e3ca7f70a3ea45b5da612c,t,21000,2974662,,5000067,2018-01-30 13:58:29,102
0x19b50cd08a2488852e07fbc5ee8febf60b1cad8d260457b70c8f75acc7a7a634,t,21000,2995662,,5000067,2018-01-30 13:58:29,103
0xa9e203346bff0f2c6be2349e9db235902aba66de97825965d537351d495e0717,t,21000,3016662,,5000067,2018-01-30 13:58:29,104
0x10e90905b1b86bd7c1288f7aec8e4018eb022e831a2c301e90dc0e0e4b217ded,t,21000,3037662,,5000067,2018-01-30 13:58:29,105
0x7d0227242ec42f1f8125e14a2e504e57b05ed3f4a986bf2681d01846c4f3b5a3,t,51545,3089207,,5000067,2018-01-30 13:58:29,106
0x3f1248daa0e299dbcd476dd65a99fa2c5f80d62dce6ba97f296e34b05076801e,t,21000,3110207,,5000067,2018-01-30 13:58:29,107
0x01c8bf88afbf6c81516de4243941d5c654d55af04fec303f9bd63d27162a9dbf,t,21000,3131207,,5000067,2018-01-30 13:58:29,108
0xc54a6a78cd7638d8507b5edbf91e9104f8387ea07bd6707b38d2ac84db14a1af,t,21000,3152207,,5000067,2018-01-30 13:58:29,109
0xf8a2bb96ea78212c43c59e57ffe28312929bfb3753ed8a5d5b0fe4452563e931,t,21000,3173207,,5000067,2018-01-30 13:58:29,110
0xacd7ee1b2c86f75dd700fb8fe3ca3f2e3e816086cfeee5188d6736931d006874,t,21000,3194207,,5000067,2018-01-30 13:58:29,111
0xa8483c05e7bb252386a0051dc07158448d2ad77f57834e08cf929e0993742d84,t,21000,3215207,,5000067,2018-01-30 13:58:29,112
0xa35e389791ff5533206837c586b876763f16cc5427f0433eda66d97e5ba34b02,t,21000,3236207,,5000067,2018-01-30 13:58:29,113
0x8c6acbaee19d98d4579658d658e5fc75f9b02cbb836cf03c6e1464dc036edb0f,t,21000,3257207,,5000067,2018-01-30 13:58:29,114
0x30fa40e67254b3692d7258b1be49138b61405b762d56cce202f5aaa029b8a3b6,t,21000,3278207,,5000067,2018-01-30 13:58:29,115
0x57ee3816573a7d57358a8b909a4051096781988f736371acb45460158c49a621,t,21000,3299207,,5000067,2018-01-30 13:58:29,116
0xfe5cd7d31c7a983d7574af5d051872069da86444229228373ca1d17719240dfc,t,21000,3320207,,5000067,2018-01-30 13:58:29,117
0x1e43231ffbb4c7dede365ef0bf3e49c308ca1f48e884e339730bd39dbac19970,t,21000,3341207,,5000067,2018-01-30 13:58:29,118
0xfd961e10365ef19e0dc9c0e7c88b0375ef4998dc6ae6f4a86a0141501ba80874,t,36938,3378145,,5000067,2018-01-30 13:58:29,119
0xc4f96386ddc165eaf12d705a97c9698a1c7b76efa45721f6f8373cf4d4f34486,t,21000,3399145,,5000067,2018-01-30 13:58:29,120
0x2bf72d6e806b3d2738767d78ddf1d0eb71b220fbcb8574c95960ca2d1bea1a11,t,21000,3420145,,5000067,2018-01-30 13:58:29,121
0x228156cbc26f6d75d56f81e092be062805e6fd2866c7551fcacf56dee8c72c5f,t,105204,3525349,,5000067,2018-01-30 13:58:29,122
0x525d6ab62208b179878124c7b42bd7504078937f550c41b5bf12fae6866af618,t,21000,3546349,,5000067,2018-01-30 13:58:29,123
0xbe04d2b4819a49166235031c5acba1961c7d122977ed055c517ccbfe9864446d,t,21000,3567349,,5000067,2018-01-30 13:58:29,124
0x3869ef6c2b2db0ac211ba4a6d3bd6dd5ed1ffb000ee529dc862ac7cade7df536,t,52148,3619497,,5000067,2018-01-30 13:58:29,125
0x6f06ac41d9824854cf8c8eac48c8fa300fb7a304391ba8f82c5160d19da6d2cc,t,21000,3640497,,5000067,2018-01-30 13:58:29,126
0x893a02b58568996f101d8d7b751c9d3637539afb4e938389bad074bddcf81473,t,21000,3661497,,5000067,2018-01-30 13:58:29,127
0x4aa3dc5f16974d0350b9cfbbbbbd78a4afc4065c5dd2ed3a282b7155ea1a0678,t,21000,3682497,,5000067,2018-01-30 13:58:29,128
0xb9aed38413397b847083bbba84584e2be996f0327196185ca1627ae4b2bd563f,t,21000,3703497,,5000067,2018-01-30 13:58:29,129
0x583c3e3b085eafbee87e76db136411aedcae468fceb2ab74c4c310414b036a77,t,21000,3724497,,5000067,2018-01-30 13:58:29,130
0xaac7719a7a52b1419237ddf55bc3d405d0b1f184f65a89d088db5dd9108d8859,t,21000,3745497,,5000067,2018-01-30 13:58:29,131
0x276b612678c3773dc23dd759eb47078febdd61ae97005a07a15dd7a8217637c3,t,21000,3766497,,5000067,2018-01-30 13:58:29,132
0xf4f4224cdbac4d4cf89c772bd40454ce260e468fb1cbf245e3178b0da7b1e67d,t,21000,3787497,,5000067,2018-01-30 13:58:29,133
0x66daf9a6fda373c39effbf731fe018e4aca5257edafd4dc32f8593a064f69acb,t,21000,3808497,,5000067,2018-01-30 13:58:29,134
0x3667497cbe4b7882f45340ee423807da6d06106639db570b79868f247d019af0,t,21000,3829497,,5000067,2018-01-30 13:58:29,135
0xe78d7ce7ddda28b2a1922f6d4ac7c5c15e905180b50c06d9b1139cc7d8307a62,t,21000,3850497,,5000067,2018-01-30 13:58:29,136
0x9615cfa5d6f81cfebf1bd87daacc0dde4afcd2d27eacf7767a1d9e6edf21af0e,t,21000,3871497,,5000067,2018-01-30 13:58:29,137
0x7049b05f7ba0a7e052036a238a0e2d856a7e9117ce6eba60e487c6b60a0ba8df,t,21000,3892497,,5000067,2018-01-30 13:58:29,138
0xba3c08ed71b33885249d7b6d0848bd43f194e6a436382a4ad1e03eebd3b6e5e5,t,21000,3913497,,5000067,2018-01-30 13:58:29,139
0xd66f97d6310be4fdc1c7410b983b3eaaba33614adfad524d9687ed0c97b35b3d,t,21000,3934497,,5000067,2018-01-30 13:58:29,140
0x35caeb585136df35be776f79d201d2bb2cc07ce66ccaeb6b077aab4ee6c7d2e3,t,21000,3955497,,5000067,2018-01-30 13:58:29,141
0xba1e83242149022ed8b2e0dd305b2b11f131ed4ab32df205d3835d05327decfa,t,21000,3976497,,5000067,2018-01-30 13:58:29,142
0x270610d6f8012a0f41e711c9627affe61d3f2d21769c9d3367ac426aa13aeafd,t,21000,3997497,,5000067,2018-01-30 13:58:29,143
0x084c179a0ec48015f98f1cf986ce34588fb5c09d8ff1b46141c8939fd9bc54d6,t,21000,4018497,,5000067,2018-01-30 13:58:29,144
0x179383de0b8f8e2bcf60b720a5355783b5563bf6a136471fb33cc8d1e009b025,t,21000,4039497,,5000067,2018-01-30 13:58:29,145
0xab890a009165af9e12c3773e1c024ebf92eac546b2d7dcd037b53fc42b4aa1c9,t,21000,4060497,,5000067,2018-01-30 13:58:29,146
0x81ea2191979630c385e4bf9a33280744701e03e2b16e6127ab2d9c3977faf664,t,21000,4081497,,5000067,2018-01-30 13:58:29,147
0x3057fc1c27f6a3e8da7f4f0d82314da1fdcfa53140431a4324e094dc95953253,t,21000,4102497,,5000067,2018-01-30 13:58:29,148
0x09a0165875c689a28464f5cd54e31fda044a53985726ae711f5ba6a9870d0f37,t,21000,4123497,,5000067,2018-01-30 13:58:29,149
0x07aec2d08ffae46fd4e5338b5a1f65368ac46a3233aa5221c2dcfc5b14089a23,t,52568,4176065,,5000067,2018-01-30 13:58:29,150
0xf5e21948644aaaaddb718b742068dacef4f9d3eb64ed7da7bd025db122b758ee,t,21000,4197065,,5000067,2018-01-30 13:58:29,151
0xa264feb554084b23f9b309a52ceb572a7ff220cf69c8d565e559f7f2161b5bc1,t,21000,4218065,,5000067,2018-01-30 13:58:29,152
0xb3eea31c455bd01435034817bbd8fc4c19a9e0112b2c4d730e3ee868a87aa4db,t,21000,4239065,,5000067,2018-01-30 13:58:29,153
0x1f9fc968bc59f46593af90d8b81d04ab9d12b2c9a6692927005cdc0e2c9c5533,t,21000,4260065,,5000067,2018-01-30 13:58:29,154
0x188be3661426135a5cf9a0a3a86bde3472e189a3bdd2cd46c069357a347e3fc9,t,21000,4281065,,5000067,2018-01-30 13:58:29,155
0x91a3bf2fadb1a3f14ad8fdb63f9445f78123bb5ae51c021cc46cb78b7772cd11,t,21000,4302065,,5000067,2018-01-30 13:58:29,156
0xbc7c7d3c33c0b2675535107f6eb24d8347f1e60d38f00b4fca8763907c9461ff,t,21000,4323065,,5000067,2018-01-30 13:58:29,157
0x2be930a8bf843815644e24b8a728e50cf1aba9c6307c330e756bb151dcb12b9e,t,21000,4344065,,5000067,2018-01-30 13:58:29,158
0x6d229ac75f74a0cfe38dde49f9ce0a58cbcd250667b1cd94e018087feaf555bd,t,21000,4365065,,5000067,2018-01-30 13:58:29,159
0x11700dd5903603f986a4188cc3e94e5cedaf8e311482d41877c5a3b4b8d05675,t,21000,4386065,,5000067,2018-01-30 13:58:29,160
0xf632bdcfeec98a4a5497bb27329f1ad8551d9dd3dca572687c009b3406d908ab,t,21000,4407065,,5000067,2018-01-30 13:58:29,161
0x2b858ab7b23e387ea64c21b6a18b16ef48bc7b7588b3b61181387b0469313f59,t,21000,4428065,,5000067,2018-01-30 13:58:29,162
0x87480c82b5e4daa40eafe9ad645dec77e8e21e02ccc07b5cdf23fd55c615e2a4,t,21000,4449065,,5000067,2018-01-30 13:58:29,163
0x8dfb3c8caa6b5f2aca0127d9d14cce81c7ca83d53ad6c49ee5e1fbc85ddd2563,t,36792,4485857,,5000067,2018-01-30 13:58:29,164
0x7a6e025156d734f1f6a70b806e79fe2f8b8f6be1301aa769588d11077d050d10,t,53297,4539154,,5000067,2018-01-30 13:58:29,165
0x5084d84fdc488e4cc6f38c5186491182d29392e56148917dd9b59f12ed81835f,t,21000,4560154,,5000067,2018-01-30 13:58:29,166
0x483084daa91a9f0f3c247f8d713de7f731c401a1f5d4c84bef67abc3dbccaca0,t,45591,4605745,,5000067,2018-01-30 13:58:29,167
0xc462851b4f2fc2c57c69997682ce201cfd9614dbbf2cf200344a5044e523d861,f,45000,4650745,,5000067,2018-01-30 13:58:29,168
0x3578a1787ea71dccaf8fa20b655cd93dc6362f8efdfc82bef6ec9c2812d040f6,t,37957,4688702,,5000067,2018-01-30 13:58:29,169
0xd0bcd8ad375ca47c93a439d50a5057b1f8dfbcdc2d8d4838e4dcbd443eef9930,t,66316,4755018,,5000067,2018-01-30 13:58:29,170
0x31666357328f86b874f8ae53ce68ac34519a8d2c410e25f35c46840d32a95e3e,t,51560,4806578,,5000067,2018-01-30 13:58:29,171
0x2d03b234ee02caee381686be7c9da8a88805a363d358e83d2b2339100ab8dc59,t,59354,4865932,,5000067,2018-01-30 13:58:29,172
0x4f6c263e30638bdb6454157323ead5d64c93d451abd8ddef6e75e6a7198c77e5,t,59162,4925094,,5000067,2018-01-30 13:58:29,173
0x3235532484fd982bfe78243c3aa09b84b92ebf678ec62d0cf4b4e72be7e4eebc,t,59162,4984256,,5000067,2018-01-30 13:58:29,174
0x1893958df86e3b9c7386a922a622f3401406da75e81bdce0cd774f0c254b8a7d,t,59290,5043546,,5000067,2018-01-30 13:58:29,175
0x941441491f035e0aee26538c2cf97cc3214b7ef683f43b562680c5b37e224094,t,428972,5472518,,5000067,2018-01-30 13:58:29,176
0x3bec862c10fb1d3418729363ebb2d70ec1427e4d6edb2fbb149da6e02dd08526,t,174591,5647109,,5000067,2018-01-30 13:58:29,177
0x1e63742bfa4f4c5a84281755cd83973fc676714611353a808e100e81ce15fb83,t,45182,5692291,,5000067,2018-01-30 13:58:29,178
0x4059bbbf0b5649fce65c1f457aa2e3451b9e0100a86fc6018b80ee70f8851278,t,44493,5736784,,5000067,2018-01-30 13:58:29,179
0x5f91ccfa34dca9c5a7acba8e0cf14858644bb3a7b7a29e08cea6f7006ea6ffde,t,108370,5845154,,5000067,2018-01-30 13:58:29,180
0x6bc713f1086957993b1202d346a9cf9c37eb9c8acb50597574a5cc72903bacac,f,200000,6045154,,5000067,2018-01-30 13:58:29,181
0x2ad988178538ea7c7fab952ef1a80a8ffd95fb7c908dad6ccc4407f12c6f33a6,t,44290,6089444,,5000067,2018-01-30 13:58:29,182
0x68110182158a9a1ddb5518d52901a2acaebb90b130e0ddfd40aa78b804ab2992,f,22540,6111984,,5000067,2018-01-30 13:58:29,183
0x33c184482ddcd44f5dba5596631f793667e76dbf95c69a6760ae8454bcc971dc,t,48562,6160546,,5000067,2018-01-30 13:58:29,184
0xf5acbdc2414be7e4d0465fcb2078d7064f92d1495285bc2c7bbdce821b5815d3,t,44493,6205039,,5000067,2018-01-30 13:58:29,185
0x50392f185cc897cb2c27a3d647689101adbd2c268d4b400556b4ddffc21802a3,t,22987,6228026,,5000067,2018-01-30 13:58:29,186
0x8e6774553485075f3b5f150ff8462a2f761eaa5a58ebb54faef6a59ba6503afd,t,84005,6312031,,5000067,2018-01-30 13:58:29,187
0x26624e7a1d21f81945a6a1ffc4fcae3c549aff90c7674d3868dc5ee3ef3aa4be,t,51733,6363764,,5000067,2018-01-30 13:58:29,188
0x540b0d4537a3716077cd77d0a561efaeab8c846027c7ec61ecb8bfb9c2e046fe,t,21000,6384764,,5000067,2018-01-30 13:58:29,189
0x73ae24013d0b7f27573238a3c7dc3ff91f8401803463ae56d7465cff2dbba564,t,21000,6405764,,5000067,2018-01-30 13:58:29,190
0xb04fcda7b0e30e61d11bd6a245f4041fb1754d97395cbc87376c67aff7f086f1,t,48418,6454182,,5000067,2018-01-30 13:58:29,191
0x09b249a6f92aae03b9633200c173efc0391f9913071b3b0af801534bfed8e89d,t,34144,6488326,,5000067,2018-01-30 13:58:29,192
0xd20829f9586b745b3f844f60af3059d436e3a5e6bb864c67dc82a229c983f75a,t,1301349,7789675,0x6EfeaBbA975C334B7F7704a6d28716f25332cCB6,5000067,2018-01-30 13:58:29,193
0x9d9336067ed56b5edbf763fcf47882445d91403224d789e3c8e9c8eff9081150,t,129960,7919635,,5000067,2018-01-30 13:58:29,194
0x6599ce7ded1298a57f35267e8a1f277eb8c3d8b2f3c8a5d9c1e4ceb539257fdd,t,40806,7960441,,5000067,2018-01-30 13:58:29,195
0xc8dc1f5c044652670a4b6eeefa6e2e34c68bda6fff54880a2590aff13fa59369,t,22746,7983187,,5000067,2018-01-30 13:58:29,196
0x071cdf5ac8896f10ec6c529baf092179cb1ea1a533001b799761c843f68a7f0c,t,43844,43844,,5000068,2018-01-30 13:58:39,0
0x3876572bb3b7b643e9b92a898dc128fd266739aa611e2980e1903a70857f8f25,t,21000,64844,,5000068,2018-01-30 13:58:39,1
0xe54819854e9a3ebf810c082bf0c5624eeaf55c429176beab2f0789a6a729b603,t,21000,85844,,5000068,2018-01-30 13:58:39,2
0x2023251c68117d2a06d838c4fe9b32a8e0bcebd933cfa3751dfee256434794d5,t,21000,106844,,5000068,2018-01-30 13:58:39,3
0xd6c86d03bdb0a4bb4aa529a46ffacc076a0e940bf5526d824c94a202d8e61924,t,21000,127844,,5000068,2018-01-30 13:58:39,4
0xa575aae06031d4d995e916179bb6bc34cfdab088d9b58bb2742bc1c6c1b4015f,t,21000,148844,,5000068,2018-01-30 13:58:39,5
0x4a66edfc827af3d0dfc453e21dab899051ae1a5dbfe5bfb4329f9d8dd49bdac7,t,21000,169844,,5000068,2018-01-30 13:58:39,6
0x0ff2989f958a991fbcebd1cca51701dd319ccdddde2ca1e381e10ae3fab03f0f,f,25200,195044,,5000068,2018-01-30 13:58:39,7
0xa98ee42373893b9a9b888d6b2fedca29053328f8b4066cb728d07e497c2507ec,t,21000,216044,,5000068,2018-01-30 13:58:39,8
0x3b3f03075072bac09a00a44937d7fbe7cc1742edcf79793e93bba279836d9a7b,t,52116,268160,,5000068,2018-01-30 13:58:39,9
0xc0b50a68d71b4aa7bc1f56b4aa97a664a747782b7df915cafdb73da7c58e7b66,t,51498,319658,,5000068,2018-01-30 13:58:39,10
0x5766041db76bc8776df82268ad282cdef1d3b3a7e05ba00652c2e6c95d6510ae,t,21000,340658,,5000068,2018-01-30 13:58:39,11
0xd3fce7bdbbe14f3d58fadbce10e2e5e8ee15fc67a751dfdb562876cf08fd7042,t,140972,481630,,5000068,2018-01-30 13:58:39,12
0x66ec30b75929d4e4c4d61956086443686c260891060862608b4c7da15d1f649a,t,36708,518338,,5000068,2018-01-30 13:58:39,13
0x591feae58d1e0053113ba7e7c5efb6f7d61d7868734792ce712613629535b97a,t,38091,556429,,5000068,2018-01-30 13:58:39,14
0x876cd8ef3f044712b058b1d46a66f1ced2f79f89d2e8494a388805b6a787bf5b,t,37071,593500,,5000068,2018-01-30 13:58:39,15
0x17794de7e4709ab47cb1ac31f6d9dcb90a82d2e4e36d031a2cffe32d4a567cf5,t,21000,614500,,5000068,2018-01-30 13:58:39,16
0x95199837fa07555769abe771948b65e976180950087abb5ef13f114ed559b918,t,21000,635500,,5000068,2018-01-30 13:58:39,17
0xa8b59de16556c1b21bf0cd567f99ea8fb622ef84b9a010af2ab583940efa7c8c,t,21000,656500,,5000068,2018-01-30 13:58:39,18
0xd478f318ca5e187e2276203e06a70831cafc174dff42208e7e2e2d5b28844e4d,t,21000,677500,,5000068,2018-01-30 13:58:39,19
0xbb3cbd51841f634a562d7f1ecc43fcf049e0752f12947267f055177f953ad219,t,21051,698551,,5000068,2018-01-30 13:58:39,20
0x4638ee28f5fb112ce56fb8bebe04f725ba6b0bcb186fb5b467c773ea4fe1eb50,t,23176,721727,,5000068,2018-01-30 13:58:39,21
0x2e3c4d54b600f57937d52772c79d293be8dec7c57e924f6c3672cc7f13d54487,t,52084,773811,,5000068,2018-01-30 13:58:39,22
0xcd275934242dc3e50adc3fc89831f49b6c0f1511590049fad814b99044bf474f,t,21000,794811,,5000068,2018-01-30 13:58:39,23
0x72f45d775ba1f7860fdbafdecc72530c4a0455d4d59b226b17f90f64f749b37c,t,37576,832387,,5000068,2018-01-30 13:58:39,24
0x906724c0535abed9ac305f126b2be25289132b6c3323ddb82da37e5927e865f7,t,37314,869701,,5000068,2018-01-30 13:58:39,25
0x1461c0a5d7a0616338b9e0547319a96fc928f23bd203bbef1abfbcd548b389e7,t,37250,906951,,5000068,2018-01-30 13:58:39,26
0xb90712753552e8cd94daa43f7a790e3cbe98e29cf82c38b978d2d9cf98e7d109,t,22091,929042,,5000068,2018-01-30 13:58:39,27
0x0636dc65505a963b16c899b0830250a33086a90ffade300d08e80265bc03850a,t,53169,982211,,5000068,2018-01-30 13:58:39,28
0x816817d7b57ba00f1cf120d113622068d097cf966409fb38fe7d9b87ed9d4965,t,22912,1005123,,5000068,2018-01-30 13:58:39,29
0x4189f9ce52ce5daddb603a1c277a0f4e72037e01b0189d0eb85a83fe905f7c95,t,45567,1050690,,5000068,2018-01-30 13:58:39,30
0x245cdb0be2ff148359847cdaa5c33c2d2a673f485907571374a0606d148d3954,t,21000,1071690,,5000068,2018-01-30 13:58:39,31
0x8dcba9fb363e89e29c5379859972961b2fe39d7caa7e628ae112c924a371e339,t,21000,1092690,,5000068,2018-01-30 13:58:39,32
0xd1521aac8b71b6bf98ced0ed0b97b18deb25a857b2f7fb0c97511787fe97c3aa,t,52443,1145133,,5000068,2018-01-30 13:58:39,33
0x80393c2d7b260199f75f91f3fa49876c77b79126831a651b9b054b27d6fdb36e,t,21000,1166133,,5000068,2018-01-30 13:58:39,34
0xc553a9c0c514e37b6c4b63b7529e8761b02a62229d0003e16aada568e81c6326,t,222390,1388523,,5000068,2018-01-30 13:58:39,35
0x3b0512e48413a4f63d4df4041d18ae88fa80a5717eab17a2d6309a8e18cd57ce,t,242521,1631044,,5000068,2018-01-30 13:58:39,36
0x3de39916de90034ad0b3d2669d06af24333ff6fc89b3a224d49b6360e9d88740,t,21000,1652044,,5000068,2018-01-30 13:58:39,37
0x45b2440861440e5805889fd16ccc4c46ba7dac3082322986487eae617afb8bcb,t,73999,1726043,,5000068,2018-01-30 13:58:39,38
0x399381fb5be61f51a901d6a5807573b65984216ba08734b1cb485ed0543b2ae5,t,51948,1777991,,5000068,2018-01-30 13:58:39,39
0x23234035e8b1005a09769a1a273e85d65154c6ca2744a87e64b3a2fca28c8284,t,52547,1830538,,5000068,2018-01-30 13:58:39,40
0xc9af7ecaad7f706dece18b29d53942a757dc7ef75b9586394184c2c3a20ba389,t,22588,1853126,,5000068,2018-01-30 13:58:39,41
0x3999df55a7d8e9dc3ef30fd5fff692e64da77136c4bd7de53cf4f02fdb940178,t,55540,1908666,,5000068,2018-01-30 13:58:39,42
0x8566b6796bf0fafe10d15689015844c5582d3e76a8940c88c8023b7b52345cb7,t,93242,2001908,,5000068,2018-01-30 13:58:39,43
0x6b61d31fd40eb0089a61a93ac7d68f6a5eca78abcb4f5db9c5b4ab852ccfea73,t,30449,2032357,,5000068,2018-01-30 13:58:39,44
0xe3f332620f03ec859d222ab3305dfd19d0807854f56073a1a498dd95c5433b78,t,52886,2085243,,5000068,2018-01-30 13:58:39,45
0xc271c7a04730f60224116753ced601cc608df4959b3caaf0e64469fc22889ce3,t,21000,2106243,,5000068,2018-01-30 13:58:39,46
0x79351b102dca3b46de152d7b015a6467cd04edf012788b51f2a8fbaca046f56d,t,21000,2127243,,5000068,2018-01-30 13:58:39,47
0xe4f99fa641986ed3e35061762151acc246cb784747fe1a3e016d6d8fe2334066,t,21000,2148243,,5000068,2018-01-30 13:58:39,48
0xc892d75190adc80d35ea63ad66a149ec88ad3c263d0401cd9f26ce9110193b34,t,21000,2169243,,5000068,2018-01-30 13:58:39,49
0x0159f62a9de605cc352e433216339792cfcd205218ad5f5fdb55b68a13ccee04,t,21000,2190243,,5000068,2018-01-30 13:58:39,50
0xec1e6a048b59fd563586f0e08ac9fa438c17732a2e780e9df9119cec115b2f21,t,21000,2211243,,5000068,2018-01-30 13:58:39,51
0x1bf4d25c5e6d74b0d81691f91bc5d28bd888c9a62b44dc63f88e829b424bfbee,t,21000,2232243,,5000068,2018-01-30 13:58:39,52
0xa1fc011c234722b4f8510ba1bcf6c27e9fed99c33a706bc52f6c2997d0986c43,t,21000,2253243,,5000068,2018-01-30 13:58:39,53
0xd5ec87ea95adaef9ea584c6704ed3e835e67876a0af66ed757cbfe60cac407cc,t,21000,2274243,,5000068,2018-01-30 13:58:39,54
0x3e6152872dedf4bd92d49227d7da230e56dfb41b425ddece123e14886adab4c8,t,21000,2295243,,5000068,2018-01-30 13:58:39,55
0x9537805b04c793e2fb6f9d88fab35b6464f1123d87eb7c948470b62fe3e4cfa1,t,21000,2316243,,5000068,2018-01-30 13:58:39,56
0x3c1454f8d35c0f6ee35eedf5a3b98434784fb2a86c52deccbd47d42f35567fb7,t,21000,2337243,,5000068,2018-01-30 13:58:39,57
0x81c6837a445f85be4ede84227d4520772a787ae0d53b661d32867fd764d6bc69,t,21000,2358243,,5000068,2018-01-30 13:58:39,58
0x21e76452040f01c03a199b6977cb1f751302b5ca56eb508260e623b01839e658,t,21000,2379243,,5000068,2018-01-30 13:58:39,59
0xa4ab55aa35e6eb03267e6ac72f8910bd1cfd15f275b27b9ff884078c0cccdf61,t,21000,2400243,,5000068,2018-01-30 13:58:39,60
0x62a72fbc0c71d337f4d8885e104038381a41c604c3d82f57c2fa84c0313bfa55,t,21000,2421243,,5000068,2018-01-30 13:58:39,61
0x66c80a1b51ac4592a016b7496c4f40ee186c35c4a4173bffec8a7289af7065dc,t,21000,2442243,,5000068,2018-01-30 13:58:39,62
0x19088dcf4260e750649e276286c899dfc14037560284ac014d622f60b4d99d2f,t,21000,2463243,,5000068,2018-01-30 13:58:39,63
0x3f8770ce278d2fb35f865b952b6b3ff01ba29c42bdfbb28e7da1da1822a5c588,t,21000,2484243,,5000068,2018-01-30 13:58:39,64
0x26464cabd35e0eecd935ec7a0a2313c3102a48cad906c9cc3699a446de37858a,t,21000,2505243,,5000068,2018-01-30 13:58:39,65
0x590c09ffacf88061df96118db979ab22c954ea8af5644b004172fddcf10df2db,t,21000,2526243,,5000068,2018-01-30 13:58:39,66
0x04b56bb2406810f8927e5ba5605d9216f72efb521b3104a3ae5c3681566cf06b,t,21000,2547243,,5000068,2018-01-30 13:58:39,67
0x3c09f205015c77096ea86a09ea0349fe71620c87bf7dd78a5bbadbea5404bfb0,t,21000,2568243,,5000068,2018-01-30 13:58:39,68
0xbbcc6b233f9453e312bedb54af5ec7a9419601e2ff98328f35013f87eff7ac8c,t,21000,2589243,,5000068,2018-01-30 13:58:39,69
0x564b2b17854ce06eaf4cc4763c7cd821042ee31c7d8e5281c0092df2b1daf65c,t,21000,2610243,,5000068,2018-01-30 13:58:39,70
0x0cd0e09c7957974e1bfc6a0109c80d6bb6d5536a024e59bd9c658d5040ed44ce,t,21000,2631243,,5000068,2018-01-30 13:58:39,71
0x1dcdf4fc7db19aca5a4b4defc699a33890f3db7496a29d03e7a3a6a1484666c2,t,21000,2652243,,5000068,2018-01-30 13:58:39,72
0xdd40f4bb7382a6e38536a8738e9e589f1706dd162ae54c9a9c836816160a0aa4,t,21000,2673243,,5000068,2018-01-30 13:58:39,73
0x0ca934f1d7e8b84fa3f05d53fd85e0262f3ff93e21aac1b6d42fc0b1a7902465,t,21000,2694243,,5000068,2018-01-30 13:58:39,74
0xb53643acbe37519745505b9d364d684481049e2a3fe22b1fd497ac94c3a0a6cb,t,21000,2715243,,5000068,2018-01-30 13:58:39,75
0x88767a6f510e89f95714000059b653fd35525d7fa7e6a53db5f32beca703692e,t,21000,2736243,,5000068,2018-01-30 13:58:39,76
0x8541a39977358f56abf55ab4d547d44917ab9cf3eef4229c707cc6f184e02f9c,t,21000,2757243,,5000068,2018-01-30 13:58:39,77
0x567f1414a75faad32761ef1d6e7cf380df2cef7c0a17741c4f1491ca2e68dbb7,t,21000,2778243,,5000068,2018-01-30 13:58:39,78
0xf3679238fe4e95384874639269d8caa7249c3893adcbfefac8e9eaee36d6a6dc,t,21000,2799243,,5000068,2018-01-30 13:58:39,79
0xb9856bf1b29746b00b53d35ac626352b45c6f44f13495e4565a56a4dbb4527cb,t,21000,2820243,,5000068,2018-01-30 13:58:39,80
0x2ae6a4f4155dd892511ae4a3e8a5ef22b2f376a31b07fed76c0286bce4f830b2,t,21000,2841243,,5000068,2018-01-30 13:58:39,81
0xec1a62c4c5e32ddf152db92e93db1972f25d76d4bfd4bbb5d7bdbe342b37aa65,t,21000,2862243,,5000068,2018-01-30 13:58:39,82
0xc069f271a3cf941ce20a9c01d27d7b7d6835776d4c9f083a9598e292d59e4a9e,t,21000,2883243,,5000068,2018-01-30 13:58:39,83
0x7cb70ce20ece6abcf2e987a374d754da82020c09c00c2163da361f99544d649a,t,21000,2904243,,5000068,2018-01-30 13:58:39,84
0xf409a2f7e7aa20a3f23cb793e61e1286525fc7a92972e38121a866f94264fcf9,t,21000,2925243,,5000068,2018-01-30 13:58:39,85
0x5bcc4b68552f3be5d80dceaa4dbe8405036cdb843309f679d57c6f96cad9ac93,t,21000,2946243,,5000068,2018-01-30 13:58:39,86
0xbf560ccd52e6999e3fddc68f3fbee63957b8d85bbf305dd3762b6f5f35ab84df,t,21000,2967243,,5000068,2018-01-30 13:58:39,87
0x4ad16eea8a1fb3ca64097d34ebeed74371418320894078bf134fabc878db0f00,t,21000,2988243,,5000068,2018-01-30 13:58:39,88
0x5841aa4465b6e833194a164e5cc9ec3aec96de2c49f372d7e1daa258398a9902,t,21000,3009243,,5000068,2018-01-30 13:58:39,89
0x003c34c042ccfb38c5e7686d26344a7d62b382bcca51035caee1bb3986d0a758,t,21000,3030243,,5000068,2018-01-30 13:58:39,90
0x9574f054294be5294fac61a78a4bfc8810cdd6d4ecd62cc45d0561b39322e9b5,t,21000,3051243,,5000068,2018-01-30 13:58:39,91
0xfe72563bf4885aebfc0352e3e31f9202e137d479a9bed1b4ab7f043d0484a365,t,21000,3072243,,5000068,2018-01-30 13:58:39,92
0xa01746c03d9460a1441e6affe44edf768edfc8fe1db2bc362e52403b8660c463,t,21000,3093243,,5000068,2018-01-30 13:58:39,93
0xd2517054a3803afca2472ef3b12ee175baaa85825203b5b4c5e05f5093a397e3,t,21000,3114243,,5000068,2018-01-30 13:58:39,94
0xa415f6d500d3b59b6e03741476291727db526dfd082c4e09021b8a8d341d498b,t,21000,3135243,,5000068,2018-01-30 13:58:39,95
0xd87e402484a8437cd7800dfd4f349b340361c5d519214c40cad97d96e6897fcd,t,21000,3156243,,5000068,2018-01-30 13:58:39,96
0x44edeb5c77194085fd13aa837b724de38c621a6ab2dea32779978ad1f0e35bef,t,21000,3177243,,5000068,2018-01-30 13:58:39,97
0x569cf390082933dfe7b4c1ca8900e1f690c343163eebe964e514fe0e509e7a3d,t,21000,3198243,,5000068,2018-01-30 13:58:39,98
0xd341379f918c422dd4499f11ca48f2a58f4577c330cba470642cceed0eba616d,t,21000,3219243,,5000068,2018-01-30 13:58:39,99
0x22f12ef694ab83b80b1bc9b818703f82a44a3c64be2fb4dc92858abeab81513f,t,21000,3240243,,5000068,2018-01-30 13:58:39,100
0x82dcab892a8604aa089faa8575a60a73006167bd798fff3ebdca3d87cc4b05fa,t,21000,3261243,,5000068,2018-01-30 13:58:39,101
0x53a77cd46ca1f3f435ddeac2fc444761a4f94ce8a143c3e2d291bb360f0c7984,t,21000,3282243,,5000068,2018-01-30 13:58:39,102
0xf00be00d36cd0153f3a9d62c444e3e23c89f920700c7d62d2ee4c8604e966fb0,t,21000,3303243,,5000068,2018-01-30 13:58:39,103
0x9e8a3ee25b0aa4e4b65f72fa2225cd46c94d6157c50607cb2df1ad109d7bd077,t,21000,3324243,,5000068,2018-01-30 13:58:39,104
0x7015b4ecef6953ccbae22483f7886958b6e7de1a3d7aaf3fb70afeda5fb2fe1a,t,21000,3345243,,5000068,2018-01-30 13:58:39,105
0xf331a58f9756c75ae7c29410e76069a221910630cc27d103e27e9c242d4c5520,t,21000,3366243,,5000068,2018-01-30 13:58:39,106
0x9549ed9dbad57cb6f72d7b86824d653fdad9cc0a63b1e28e286f79bd110617ff,t,21000,3387243,,5000068,2018-01-30 13:58:39,107
0x27ebc345255168900cdb6e45ee3585720fa12484b8873ea9478d2cd3e7a09c34,t,21000,3408243,,5000068,2018-01-30 13:58:39,108
0xa6486e0fffaece369641530ad9b6574e02ee061635e5086baf45a2a145fab080,t,21000,3429243,,5000068,2018-01-30 13:58:39,109
0x358c2880813db76566f26a15e8e38ebbb867abdb6195590c0a9af4bfbec1190c,t,21000,3450243,,5000068,2018-01-30 13:58:39,110
0x01120a6da56d22a3aeaf5a970357eaaeac77e8fa38053de8fdffd9584eede5fe,t,21000,3471243,,5000068,2018-01-30 13:58:39,111
0xec1128e8e3036a7e277ef1d96246cb31716b74c7d6c1a7b24348092569e24536,t,21000,3492243,,5000068,2018-01-30 13:58:39,112
0x5698fd919fd5e04d63001b600fbbb371f235bc485c972950973a6b368184bdee,t,21000,3513243,,5000068,2018-01-30 13:58:39,113
0xef746e31f6dab33d1d545ba6a66c6990700c38dd0f6a1afca90c18f7e46ba493,t,21000,3534243,,5000068,2018-01-30 13:58:39,114
0xd72068b3215538186f76cbb10ee7b9ad9cee8beb067174a47272eb9ef7a193e0,t,59638,3593881,,5000068,2018-01-30 13:58:39,115
0x12d18721b43cde44ee43e3fb04b088876421d965c3555e01d7cae57bdad8baba,t,21000,3614881,,5000068,2018-01-30 13:58:39,116
0x3b30cada0b80a109dfadfb27c36baf67f300d987236d7bfb092697e51dc4cdac,t,21000,3635881,,5000068,2018-01-30 13:58:39,117
0x05e6575d13d316e23a75b70bbec56462e5bb34e6aade6320fca1b3900119fa2e,t,67669,3703550,,5000068,2018-01-30 13:58:39,118
0x627c0c04079bff63b956b5f4bb2a0072b43df066555fe6d03e72ecab33088d7d,t,21000,3724550,,5000068,2018-01-30 13:58:39,119
0x15d8ea944f8f5ea4f70ece24a4caaf02b22655b043b12dd4013b59d032a92e29,t,21000,3745550,,5000068,2018-01-30 13:58:39,120
0x2bda33b9b9f47931a60854d3f97eb8314e1c2d1dc4068877a573820572b00f2a,t,21000,3766550,,5000068,2018-01-30 13:58:39,121
0xe3f0a79fe31b7fa7dc9d3a8f922a51f3b121a247b1fdeb4faa101ad639fe6e89,t,21000,3787550,,5000068,2018-01-30 13:58:39,122
0x60807504aa58f73f388b952c5782f6938337abd57392ad09fb59abe41b9e6a13,t,21000,3808550,,5000068,2018-01-30 13:58:39,123
0xb7a20117a16bb749a4785c51566d8ff89fbd432e8ff3a202ceed46dc3c5d72aa,t,21000,3829550,,5000068,2018-01-30 13:58:39,124
0x9bf57fa812a07e260aab0f90768d24002228031181664775162635ece3306d3e,t,21000,3850550,,5000068,2018-01-30 13:58:39,125
0xfe0944bf9d071269885bd88d7ff7651422027ce5d74d18335732f0a359362561,t,21000,3871550,,5000068,2018-01-30 13:58:39,126
0x854deda0a10fd4ccedb15f1cb0161628cbdfe78e3d85da6127b5a9b400d51690,t,21000,3892550,,5000068,2018-01-30 13:58:39,127
0x5c49e49b36812866de94276eaf123c47879e52895259ee9c7a9604657c36d54a,t,21000,3913550,,5000068,2018-01-30 13:58:39,128
0x15256bd9be228fe0ef74c1e0d9b3b45ddd2afb017edaa965bb95baec75865234,t,21000,3934550,,5000068,2018-01-30 13:58:39,129
0x63b85d7033416e5b975546fb3d55f398d8bb5d25269dbc5255585dde644c0166,t,21000,3955550,,5000068,2018-01-30 13:58:39,130
0x0cb9daad0617b658a47c7c9c07156fbc935328ac53254d801c94477e2c9d9807,t,21000,3976550,,5000068,2018-01-30 13:58:39,131
0x1d36af46f21641ff5c09f0b0ef803c4cfd24eaa70d939f57433c09359fd959c9,t,21000,3997550,,5000068,2018-01-30 13:58:39,132
0x0bbe30aea70b9c05bfc3506459c3213d9470101e0702edea794b6b5201c6103a,t,21000,4018550,,5000068,2018-01-30 13:58:39,133
0x407d6b457741f996026d9663ad767b9c53b988d134fad49276f748b40160db09,t,29883,4048433,,5000068,2018-01-30 13:58:39,134
0xb9c9dc7e77148e23c59573dd9f81bb13022df84bf32dc15ff44732e3e4d0ef06,t,21000,4069433,,5000068,2018-01-30 13:58:39,135
0xc2142f34918446368343a43fab988b195cde5888941b1e6c4b47154dc180c4fe,t,21000,4090433,,5000068,2018-01-30 13:58:39,136
0xfd5fc29691cb154bc3e9eebf787c399870e397d8d038e0daf037a2345b6668d8,t,21000,4111433,,5000068,2018-01-30 13:58:39,137
0xfe3134fe83247262cdae1860c36b2e5d148ec5e9eab3b492e239297260f23afc,t,36347,4147780,,5000068,2018-01-30 13:58:39,138
0x7cccb3f30a1489b5c9e9ff97b3c4b471d5cdbe58ae5d97f2739204bb2504766a,t,21000,4168780,,5000068,2018-01-30 13:58:39,139
0x7530eac726b97a627bb7256a79cbb676431f463e28e52be4a4870b173fec20a9,t,21000,4189780,,5000068,2018-01-30 13:58:39,140
0xe249c291f1a39b9d2869ffd1e0f55b9dbe422ace318082a7db6f0b827e1f890b,t,21000,4210780,,5000068,2018-01-30 13:58:39,141
0xe6ab153c48772396305b3b2e6b11b5652662c1eac65650ebc0c94553fb77e4ee,t,21000,4231780,,5000068,2018-01-30 13:58:39,142
0x72155b63ee2c270537690d14350b3fae4313344dfba3474a4367e977835cc42d,t,21000,4252780,,5000068,2018-01-30 13:58:39,143
0xb6af20c4189801fcaa38fc06576226cc344d5af33ed717f01e084b570eef7987,t,21000,4273780,,5000068,2018-01-30 13:58:39,144
0x5adcca06ce315f74aa0d24c8b41d6a24ed8aefcd17680cee6597bde0e65da421,t,21000,4294780,,5000068,2018-01-30 13:58:39,145
0x6bd2c653205a93a6c80c3675dd0a3099c676e3f73da598e4a9d4331aef48000d,t,36542,4331322,,5000068,2018-01-30 13:58:39,146
0xd6ee18e377370e046deca28b1c4b56869995b049965a951f16c44cfa937437e1,t,21000,4352322,,5000068,2018-01-30 13:58:39,147
0xa92b7fba35fd0d0e5d9e519682b57bb79fd7baed138b5580726f016cd647b5ca,t,93242,4445564,,5000068,2018-01-30 13:58:39,148
0x6b8dede50d19f440b5eb8fb1ef8aec4d2f005e5b4aa4a1e07f75549debe71693,t,45591,4491155,,5000068,2018-01-30 13:58:39,149
0x5b907adabba3fd94a4cc34d54f7f1c4da92595b904346107259818cb40443fb7,t,66252,4557407,,5000068,2018-01-30 13:58:39,150
0x3b8c2bd9f19337a691e9cb0972963406fd4cb4dde17c7bfcd1594febf28a19ec,t,51560,4608967,,5000068,2018-01-30 13:58:39,151
0xed0d6be7c97e28dd75edb1f094d05332179c41444085e04dcd095295c7e4071a,t,59354,4668321,,5000068,2018-01-30 13:58:39,152
0xe4ff1c973017b298692248536ecdfbb6b2a84d409b5f8d274be4ae1c6c9bf6c7,t,44493,4712814,,5000068,2018-01-30 13:58:39,153
0x945116d586f7d5fc69ff3624f8fc4fea50e2aeeb9929cfedd671ef98b9e2bac9,t,58919,4771733,,5000068,2018-01-30 13:58:39,154
0x0676289738d144e5d7b1317f78656f2fd69f73cd0f495785c5223832d16ac3af,t,23252,4794985,,5000068,2018-01-30 13:58:39,155
0x40945db91e01dc6415a82aaf5fbdcf26172d3f78e7ad64b5b318406c298c96d2,t,21000,4815985,,5000068,2018-01-30 13:58:39,156
0xf1e0842c97fc6332c5238ffdee3999e1919401dd46be7c29afcb048b2da4c408,t,59418,4875403,,5000068,2018-01-30 13:58:39,157
0x8a07c730e3549bc108e4b43f7ebe7198ba2a770873191510d599f8d2604a3f4c,t,37686,4913089,,5000068,2018-01-30 13:58:39,158
0x90af959635790ce6989850c1ce7ad3018253d6c866ea76c37ac7890e6bf60ab8,t,43876,4956965,,5000068,2018-01-30 13:58:39,159
0x8ae49882221e6ca356057d223a3c2820214c618fd9270e52ca1326f1508ae413,t,37627,4994592,,5000068,2018-01-30 13:58:39,160
0x4d21f4bc71a22fbf395815822092f811062933f8e681ac5ecac57a5a3d783b37,t,36973,5031565,,5000068,2018-01-30 13:58:39,161
0xe37367e1e139fa3ae7836dd6502c20c6ccaff65c77a8f1eef0b65a788e841225,t,64725,5096290,,5000068,2018-01-30 13:58:39,162
0x774f0ee211ea969137df0cab2eee253ac80c357ebb69ee1a0f4bcf73971f8d94,t,53615,5149905,,5000068,2018-01-30 13:58:39,163
0x23a075aed402ec4a5a292ddbe9f598f9059a3911c4749fe1208990a4674baf26,t,22627,5172532,,5000068,2018-01-30 13:58:39,164
0xa8ccc8d304e012e9cc75582bab8889757d5f33890fb94fc0f3aaa3c3222e9864,t,36984,5209516,,5000068,2018-01-30 13:58:39,165
0x21f8953ff4cf16c30042cf59d4df61b234bce42262efebc3665c2755858e852a,t,31223,5240739,,5000068,2018-01-30 13:58:39,166
0x8c62235680ea5ebf56eac88ad9c5f8137b75c8a2559bb977abe164700292850e,t,36984,5277723,,5000068,2018-01-30 13:58:39,167
0xc18f9a11c973769d59c41d2d008f96eaf32b22c34a6d0d4b166a5a9a57428b44,t,29493,5307216,,5000068,2018-01-30 13:58:39,168
0x7c45779a169b7a3b9dfc16ae983b79c603c60cdd55f635e5ec17cb4337b7201d,t,40806,5348022,,5000068,2018-01-30 13:58:39,169
0xf3255b530a9269646267392441aa29beebf697a3eb330feb6aa7e1b5428f5f27,t,36762,5384784,,5000068,2018-01-30 13:58:39,170
0x89860d0d5a3afe9dceb1744f3a897d01e5f280503d6d43fd7285dd9504aec192,t,52810,5437594,,5000068,2018-01-30 13:58:39,171
0xa10331a5c41a5e202360948b17fb394fb24d9d0389dc6322700b647a0ad8fd24,t,35648,5473242,,5000068,2018-01-30 13:58:39,172
0xccd783c2ecc1065c1e2ff1cb564983faf8d7656e8f67d727bff37cce3dbe1864,t,130201,5603443,,5000068,2018-01-30 13:58:39,173
0x180aef1d6d7e61f59366334c6db47a56cf3513d3f0ce1443bb65abf209c82150,t,133647,5737090,,5000068,2018-01-30 13:58:39,174
0x88506025daa34ac728d46d2dde3c926c570f4137080bb9a00844a95947f64552,t,69376,5806466,,5000068,2018-01-30 13:58:39,175
0xe3620fdc31176bcc5fce295c539f7f0198dba35e318574f4b9beb6a110ec7ad4,t,137307,5943773,,5000068,2018-01-30 13:58:39,176
0x89066edeccd65eb55d0090624b929d517c8b2158db22b4482a3d6f8040c522da,t,22938,5966711,,5000068,2018-01-30 13:58:39,177
0x6b9312494c508343ec6abcae82d3e5a5c319d9d560b0cd863a7342885c244a77,t,22964,5989675,,5000068,2018-01-30 13:58:39,178
0x8e84d4c83224720f2a1dd4fb3df702ab2445798c92b218f6380fbf05617c35c6,t,109050,6098725,,5000068,2018-01-30 13:58:39,179
0x94536d7551cf74ad09e511e8a908fe94d7215a1cc66b20389a2836e293c4e329,f,22540,6121265,,5000068,2018-01-30 13:58:39,180
0xa80e6327f836b44f96570664886552ec0692b60a33e49d9d5bbdcb64ec6a855b,t,47982,6169247,,5000068,2018-01-30 13:58:39,181
0x21238ab06e721c4446c0df17d9881bc92d729fa1638f399e7ee313a49f24776a,t,21000,6190247,,5000068,2018-01-30 13:58:39,182
0x97b3bb82c532d86a83085c67fa2429f957782af1dd41240b3b2458ee1569bbbe,t,90729,6280976,,5000068,2018-01-30 13:58:39,183
0x97a3d3a5a1379a44ac432eb229797f615da5ad41cc8ba1e53b3c76a54d167ea4,t,90117,6371093,,5000068,2018-01-30 13:58:39,184
0xa91bf2ca1becfc524e31c6e74682cc9a07bc4c7b98c22aa98cc603d1990b62f7,t,102998,6474091,,5000068,2018-01-30 13:58:39,185
0x867fd50ce3e0498083933034e03a37a849ab6944004fe3bda767cb8e84abce9d,t,78242,6552333,,5000068,2018-01-30 13:58:39,186
0x8a2dbed6560fd7d9f4ea50e8e912b556a0c26f4c5f8f4572c1bf0943794d02f0,t,134540,6686873,,5000068,2018-01-30 13:58:39,187
0x90d21a98450ada90d37b19f39d886b9b66f37f113d7656fd1814289cd3a1646c,t,52408,6739281,,5000068,2018-01-30 13:58:39,188
0x7434d8825ca2f8af79b9afc0b7d1101b46b78191cdc359d4b981ed0ec76eeefc,t,443188,7182469,,5000068,2018-01-30 13:58:39,189
0xefc2caa741d2ebfa99f620a1a133d18d7ad17bf050d0b734b3abd6642dfb0add,t,48734,7231203,,5000068,2018-01-30 13:58:39,190
0x5594b3e1895fd44e5f1868a42a744fa4fbad5422f1a58b3d546a9e696cc18398,f,21000,7252203,,5000068,2018-01-30 13:58:39,191
0x30084d9140e53baf1fc3de37dcdc3dc769b0deb15b32ef15357bb4f4eac6f68c,t,48108,7300311,,5000068,2018-01-30 13:58:39,192
0x4f0e9d6052343dfd49f9f81129ee74e6a5087daaefac19487921891cdc0be3ef,t,43960,7344271,,5000068,2018-01-30 13:58:39,193
0xf1e5d2cccff1c7996a9dad284c34c6bba774a6be5d559b1d363eceb889be5aed,t,21000,7365271,,5000068,2018-01-30 13:58:39,194
0xd0a983a6e9f80ca7349297220222ec984adfe20abff0e18ec05ea2cbbf2017df,t,21000,7386271,,5000068,2018-01-30 13:58:39,195
0xd70083524617118d9193adb59821b539033fc8443b9cdc6b507993fa77029f48,t,64725,7450996,,5000068,2018-01-30 13:58:39,196
0x6d35710c6659c991c96b346a24240640bd158a654033eb25e6c0a763d2f9f085,t,21000,7471996,,5000068,2018-01-30 13:58:39,197
0xbf315b1416923318e30def46ed88f7952b207370ca447e5d4e3f5d822ba00841,t,51708,7523704,,5000068,2018-01-30 13:58:39,198
0x0aa241d0394f8b0d3078d581abe419190be0c08742060bdc7695306fb25197b5,t,47904,7571608,,5000068,2018-01-30 13:58:39,199
0x11875baf9a5dbaa1f31bcce3ccfbfde962b01e887cb690765c0834a59ab33c46,t,93178,7664786,,5000068,2018-01-30 13:58:39,200
0x3b55d7e4ae9c7911ea1983283683dcaa3a6543ed395ec9b5fb62ee7145a82cec,t,52068,7716854,,5000068,2018-01-30 13:58:39,201
0x2605c65dd50d46ab034ed1bc6b752d692d886ff131000c87466092f1d1ad2c12,t,21000,7737854,,5000068,2018-01-30 13:58:39,202
0x2fb55e37719ea43e404e84b6e627f843ce9272030f01a65fdc4306f92e8f226a,t,37913,7775767,,5000068,2018-01-30 13:58:39,203
0x6cc70304b8e668afda59bc15d61522580d78f0f31d0a2deb54bdeb755469a9bf,t,21000,7796767,,5000068,2018-01-30 13:58:39,204
0x8d3a204c39d8f2dcf96af93e70e1146a4e5206ba21622257cb93331c7e6d69f0,t,21000,7817767,,5000068,2018-01-30 13:58:39,205
0x97960184ed4c9d166c28332c4ac83e2cd14b64883c55f59a477842b943ea36d1,t,21000,7838767,,5000068,2018-01-30 13:58:39,206
0x1bf6a15da9e3b6b60f7f746435882a589190318878d0f764c558d4011676f3f0,t,21000,7859767,,5000068,2018-01-30 13:58:39,207
0xfbe975b0f2d89784c5cf8451ee092e4747525b667d8879d29fc0cd3e235e86e2,t,21000,7880767,,5000068,2018-01-30 13:58:39,208
0xeff52a516fffd8d32c041ab6d5bf579414b6ab11f2aae57cd72eeff56ded95c6,t,38297,7919064,,5000068,2018-01-30 13:58:39,209
0x1fc60d18ad220d31f84e6d8aae559f9572399fc9b76ca8d6450005bc285641a0,t,22011,7941075,,5000068,2018-01-30 13:58:39,210
0x98bba5b491df85434410fc3f97ace1986cb17809a1922bf502a835bb11882da0,t,21000,7962075,,5000068,2018-01-30 13:58:39,211
0xb318cea0e8dec15dfe68a50b5690eb53fd0dd79bd64cddd88c30a02585fd8ce4,t,21000,7983075,,5000068,2018-01-30 13:58:39,212
0x83ed71e369dcc1d6b81379386d8d8245df7ae1e0e6a30f358d83b4a94c4a849e,t,21000,21000,,5000069,2018-01-30 13:58:56,0
0x770ae47c117f1a7d7c112ee697149093f231f1379421dcb70ff320ca55686837,t,21000,42000,,5000069,2018-01-30 13:58:56,1
0xcc5d52f48fe0abe4afcefecdc473c21ad705cd421f57cf6e512089d426f025cd,t,21000,63000,,5000069,2018-01-30 13:58:56,2
0x0de6e724bd56f9867377827dc2e4f4bd69ea809c0e02f5fec39d3491d4e4ba37,t,21000,84000,,5000069,2018-01-30 13:58:56,3
0xca1ef4a8152b2c86f034dbcfaa92996f42093fbcd9bb13a38834d816d96ebb43,t,21000,105000,,5000069,2018-01-30 13:58:56,4
0xf05065f467cfe0947bd15c9d35cf399a5c416dde7c994460aec52754a02c20fc,t,21000,126000,,5000069,2018-01-30 13:58:56,5
0xaa32dd31aeb88345d6e7e648d58934ae3937bc937e3ca5ca258682e0876a3647,t,21000,147000,,5000069,2018-01-30 13:58:56,6
0x50daaeda5b588704e21d5fd882a0a45f5fca7dbdb41bc844d77c67c4fbed6ec8,t,52249,199249,,5000069,2018-01-30 13:58:56,7
0x0dc1e4b39a10273990803153a14c03f278a466f031e1fddb0b2c275e1003b3cf,t,21000,220249,,5000069,2018-01-30 13:58:56,8
0xcec504a10d3cf5900ed63e7a6d2102be0bd8eb9ed9729e06bcf5236083adc74c,t,21000,241249,,5000069,2018-01-30 13:58:56,9
0x6b86f7df1544b66300719297093fc9c13e210ee195f4673d9c2330ed25496376,t,52200,293449,,5000069,2018-01-30 13:58:56,10
0x0a10b9d863593fcdce53c0d5d0f1501eafef1f0066052e395c58fb96fb233693,t,90558,384007,,5000069,2018-01-30 13:58:56,11
0x3ea3cae8ceddf4ba89953224dff4efd8f6597287c6aa15e0ce99325989424372,t,91781,475788,,5000069,2018-01-30 13:58:56,12
0x7dfde6eb45cd138d2544292201d001ffbf02aa7aadb41f27f8f13d9b71bb3e0e,t,21000,496788,,5000069,2018-01-30 13:58:56,13
0x1d5509203cc23ef9daab0f21e4c22ac105130230feb431f59033bab03f0ee985,t,21000,517788,,5000069,2018-01-30 13:58:56,14
0xc12ed090495006a728af651907f61d72154dc728646d4854a41a651b7887843b,t,21000,538788,,5000069,2018-01-30 13:58:56,15
0x421d36564d486e79e9a19d5f3191712ebfb33d609ff83f85eebf0896536b50fa,t,52094,590882,,5000069,2018-01-30 13:58:56,16
0x4b41a9a4615aabe16cf199c29e1cf409d082b9c32821d4ff9fce944caf661f64,t,37945,628827,,5000069,2018-01-30 13:58:56,17
0xfba65699f8cd315942af8a4a77134482e3bc34b25daa2ddd6ab8a8d0e8788e9c,t,21000,649827,,5000069,2018-01-30 13:58:56,18
0x612e1dd2d334a2befeed174484d0e58feac96f4b1df4fe1ccf1ca43689e549e2,t,21051,670878,,5000069,2018-01-30 13:58:56,19
0x2c750514bb777bbb82973c78b06c9fed186de81f3fba05f991027fc4a0b322fe,t,21000,691878,,5000069,2018-01-30 13:58:56,20
0xac5ffc539cbb60991773a1e46af7023f84c965634b4186d5903b94456bd532a5,t,21000,712878,,5000069,2018-01-30 13:58:56,21
0x0f52b81138a0c563cf7d0baf79249c0cee85ee88a0ab668b89e812114306082f,t,40907,753785,,5000069,2018-01-30 13:58:56,22
0x307120c84ffb039e7e219a4fcd531aea7baac76c726e47c5e5f1e38826f9c5a2,t,21000,774785,,5000069,2018-01-30 13:58:56,23
0x62b59127998678e939506ec0058752b5c207e474d8675e4ad9694eec37fc7f77,t,21000,795785,,5000069,2018-01-30 13:58:56,24
0x8ad32a6d9d37912c5c3f5ca69545eccd083a9e53eda4467ef6ca2c3e42c8788c,t,21000,816785,,5000069,2018-01-30 13:58:56,25
0x51ef59d7a7d342213b787f2ea94129801f643ac4724b9326b957086ab1345d3a,t,43724,860509,,5000069,2018-01-30 13:58:56,26
0x076697f5429ce718e0a02e0b53889ac9d5306c175992fb9b5c2854afb048992e,t,21000,881509,,5000069,2018-01-30 13:58:56,27
0x9d82733e31473099e24b1145af871ec54a4410acb14d5ee53c135df3e8ceaaec,t,37594,919103,,5000069,2018-01-30 13:58:56,28
0x4bb55767e9ec66b9f36210baa4605547570fb754ec9a822ac3bea6da0f51a605,t,23176,942279,,5000069,2018-01-30 13:58:56,29
0x8a6726d79208af08aeece9ac19cfc5dc6690aed621369c2f5c605afe1810afa8,t,108114,1050393,,5000069,2018-01-30 13:58:56,30
0x7db773d2021937cf7a7806220aef13000528f72f84b647c4018405e6e5091cca,f,30000,1080393,,5000069,2018-01-30 13:58:56,31
0x7596e8397a26d0be796523e6200cb7c45065d15707d45f4a6ca4239b9d19b87d,t,21000,1101393,,5000069,2018-01-30 13:58:56,32
0x277c18ca9d3e458f436c09f42882ee807edd25a39f29cef44744aec708f48c60,t,21000,1122393,,5000069,2018-01-30 13:58:56,33
0x0f04944555e59d5b75d7806476a926514e7f8c5e3be2d1a0b4026af9225b4c3c,t,21000,1143393,,5000069,2018-01-30 13:58:56,34
0x7f5b8047ac8dcbbba121921a5dbcf2e6f9dd26ba0225bee1e2cedce9fa551464,t,21000,1164393,,5000069,2018-01-30 13:58:56,35
0x8b011db149b9adb56e51aae7484fe670f9f3013d655d44612c55ac932da858b6,t,21000,1185393,,5000069,2018-01-30 13:58:56,36
0xafd681bc4e65aa2fccc287053e54aff5fe3dbea5d2466c256631d82468009c38,t,52404,1237797,,5000069,2018-01-30 13:58:56,37
0x3ca7a6547e38bffd51ecd16241ba6a7f2a65d58808adb7a7c01fa9fb0a8711e1,t,21000,1258797,,5000069,2018-01-30 13:58:56,38
0x685bc5c4e7a5df547453602ae24ac2ce06ff008f7c686dcd3ccc0c42b6443072,t,21000,1279797,,5000069,2018-01-30 13:58:56,39
0xf4d4a72bd1b9eab2008f45e0d0ac69896d7475ba227dd80a8763ec5aafb99e9b,t,52257,1332054,,5000069,2018-01-30 13:58:56,40
0xf331cc798d1a23de799fceb47b51f75b5fc115c63f956479ddbce7c6c5241c00,t,22193,1354247,,5000069,2018-01-30 13:58:56,41
0x8a595211bc37d683e6c4b133ba5bcf8d3554a86fbdf1e06b5c4554262ff93418,t,37948,1392195,,5000069,2018-01-30 13:58:56,42
0x8501aa90afef4b1a7a139f6450893adc5a0c6c4cb0c419ae5f04e8046b56e407,t,38111,1430306,,5000069,2018-01-30 13:58:56,43
0x3cd01367af61c5f176cfbf89772fb2b10f1996e36dd2f4e95f8b44afe7f28817,t,22155,1452461,,5000069,2018-01-30 13:58:56,44
0x6159cbd364b01a67128a922f07d44cc1db17a9b7465eb0d558f1f0effd1cfb24,t,37643,1490104,,5000069,2018-01-30 13:58:56,45
0x569a6560a783a0dad52c8fd8bee41c42007f96825c9d5a44a9fc68b4a202540a,t,37555,1527659,,5000069,2018-01-30 13:58:56,46
0x92bc6f6703c6a3a75504127bdd765e2d657f335b59d921d17ccad5eef6a384b6,t,22292,1549951,,5000069,2018-01-30 13:58:56,47
0x44c231131f4dee9c5a7d3bfec0bd7dbf8cf6dfd1340ca8bc04df06abc58f0da9,t,22356,1572307,,5000069,2018-01-30 13:58:56,48
0x3a15a9b4c1ea5c74fb776217abe7d83b2e83b74fe8980c36cc730352ea0a22ed,t,37314,1609621,,5000069,2018-01-30 13:58:56,49
0x63005f29104443f5a58fc640ef4139c4e2a32266c7d3fadc7b36cb4bafe1d3cf,t,22155,1631776,,5000069,2018-01-30 13:58:56,50
0x3efaac0ae4165beb1290e40c9a6a8a120a56505799102d15930b40965c9ccc0e,t,22155,1653931,,5000069,2018-01-30 13:58:56,51
0x224fc495ee79747eb5c3e2a624cf372b96a4bb7230405d1076a2fbf191fb20ee,t,21000,1674931,,5000069,2018-01-30 13:58:56,52
0x8ef2081af24b59f9dec9a9483ba07511df3a3a6e64cca0e9bb696d888595e659,t,37847,1712778,,5000069,2018-01-30 13:58:56,53
0x0ce4139b52ec090621cd4a0f853c80fc416c166ded8af3c108dbb440c5842695,t,108178,1820956,,5000069,2018-01-30 13:58:56,54
0xe41c69a6263af8f15554fa1add0d74e023f1e82c691c5198172e572836714a90,t,92794,1913750,,5000069,2018-01-30 13:58:56,55
0x473ff2e52610db8202ff5de5c9b00cad59ec096f4dcb7ea06677564eeadd8b23,t,52115,1965865,,5000069,2018-01-30 13:58:56,56
0xbc796d8a3f865a773dd9c10d979fe5822513e2b63e0354c997e221e79949366b,t,21000,1986865,,5000069,2018-01-30 13:58:56,57
0xfd3a22aee89358839e3bea052416cfe335bc02aafb189444821297f5a3949aac,t,21000,2007865,,5000069,2018-01-30 13:58:56,58
0x69e8f9280e77ea0186ea55ba274eca864f1813f946f3cfebcd148e8263d015f8,t,21000,2028865,,5000069,2018-01-30 13:58:56,59
0xbeb58c973c1e6ee3c7c4b7c0abcfbaeb08d058d3e9cdb98b4cb05ab5ec184488,t,21000,2049865,,5000069,2018-01-30 13:58:56,60
0x84272ed8acf74d590661ea075be51bbd5e8597b6ac7eb49ea88c3cc97000af60,t,142516,2192381,,5000069,2018-01-30 13:58:56,61
0xdc6ce56f48f63263d4f28392c8a84fb9791121331d9c6c92b3b135cc5a878f73,t,37027,2229408,,5000069,2018-01-30 13:58:56,62
0xa83e1bb3743b79618f7b0c45c1392b5d7766b514800a4450c41c47258b04dd69,t,36989,2266397,,5000069,2018-01-30 13:58:56,63
0x7a46dc181c1d24b4337894c35f41ce57792410842ba7fe2094e78f6371efd0ae,t,30449,2296846,,5000069,2018-01-30 13:58:56,64
0x7833df01c6bbf4c43e81d47587bba943948091c18037940d3036942312ab35a8,t,52886,2349732,,5000069,2018-01-30 13:58:56,65
0x4f126ca9c4d865d76e5111499fb568c904d3243166aaa71a3a0201308736d98f,t,21000,2370732,,5000069,2018-01-30 13:58:56,66
0xa3365784c1c8317b03ec8d5e8366fa7ff6826cbe21da6c0d3b4880e3c89af6a0,t,21000,2391732,,5000069,2018-01-30 13:58:56,67
0x54dbe7eed318b0f34c89c0b7ed9a07cb4dee3e3cbb229a70359c551b98b3ac6a,t,21000,2412732,,5000069,2018-01-30 13:58:56,68
0x11c2dc2bd1d509b67a2143cf20fb34d27e22e2e57f17449ff6acee4c0e73c278,t,21000,2433732,,5000069,2018-01-30 13:58:56,69
0xe4ede6a914945067c31d2800aefdc985e050707a40b875f4c11437301bc5e428,t,21000,2454732,,5000069,2018-01-30 13:58:56,70
0x91bc3730bfd2ae4815ca3c5ed702dfcb8ec8622091435f0ef35ea3802ec0f34c,t,21000,2475732,,5000069,2018-01-30 13:58:56,71
0xc2eee41727b7e8027169c6df1ca9052efd6010010871bc8e3e81fcf8fe1cfdd9,t,21000,2496732,,5000069,2018-01-30 13:58:56,72
0xe2314eddfc05bf257a2abc9ccdf765dbd4bf5dae68fdad437dd41a805c44f407,t,21000,2517732,,5000069,2018-01-30 13:58:56,73
0x0fbc02521645052d996d9ec549afce0bbd484c1dafc16298e263c4584dabd801,t,21000,2538732,,5000069,2018-01-30 13:58:56,74
0x0a12c7020cc3881a8c37ac412e7fb1efaf06ffa92911cdea75134797d05d06df,t,21000,2559732,,5000069,2018-01-30 13:58:56,75
0x1961630721e0e54a467a525d6918f992648a03d20b7d83f63fcfadf15032ceb3,t,21000,2580732,,5000069,2018-01-30 13:58:56,76
0x03053f86390d26a4b0044316cf18256cc69e10e9a223c578df698a804bb7845f,t,21000,2601732,,5000069,2018-01-30 13:58:56,77
0x17b166dcb79f00aa1be6f1cde60c1d3388f9b809c7da5652272b7dc972538ab6,t,67597,2669329,,5000069,2018-01-30 13:58:56,78
0xe232162fc0c12243ee29dd0f50a98e35761fe7820c6963d6865dd9497c41c039,t,21000,2690329,,5000069,2018-01-30 13:58:56,79
0xe63b4e2d2411aeb0090179bee6f0c8711296a56c0281365be09f54b91e3b129b,t,21000,2711329,,5000069,2018-01-30 13:58:56,80
0x04f4b33a8350632a3a65353be651e0375983aa23e87ad6ef3ff4f4b546a02469,t,21000,2732329,,5000069,2018-01-30 13:58:56,81
0xdfc8b05a96c78b8967326ec03a39ba81d45975fd21575a1893b7f819e450498e,t,21000,2753329,,5000069,2018-01-30 13:58:56,82
0xe8759bd76d647aab5a1ba6cf24074543f49d8d85c9acb7f5fecf0071d39d6814,t,21000,2774329,,5000069,2018-01-30 13:58:56,83
0x18cbba32efc6bb7bb7575470eb55732e53e912520f2f110a77f3b4d812937d98,t,21000,2795329,,5000069,2018-01-30 13:58:56,84
0x4599b15a065e6783991532e0e7fe8b08ff649aef50d0d4f7e16ea1956709ab7a,t,21000,2816329,,5000069,2018-01-30 13:58:56,85
0x679615c3ad72e6e109c7f2c866dfdc01abee139e5f62ba9fefb89f21c587ba04,t,21000,2837329,,5000069,2018-01-30 13:58:56,86
0x4781f18a06204338bb64602e76106d62724e38f479c26f96d083c366b6ea0e21,t,21000,2858329,,5000069,2018-01-30 13:58:56,87
0x266d18339cdc533bf075ec0f0a6497decefcf73a6d04a4292d6c467d4f38e38d,t,21000,2879329,,5000069,2018-01-30 13:58:56,88
0x3dfde925fae077ac0cb4a1d61c44d5b4bafbe5b006864651993e91e935783eed,t,21000,2900329,,5000069,2018-01-30 13:58:56,89
0x5a989e71af8eb3f890f1241be452ccf20dd045bf31449fee5c270be28cce4eb6,t,21000,2921329,,5000069,2018-01-30 13:58:56,90
0x76b079e2292bfa8b991df5f5ae38b985a7032ea9ac0c42910c68197fd2e4f10b,t,21000,2942329,,5000069,2018-01-30 13:58:56,91
0x7438fd24f7351ee722d95471e85fddaacc07e3a8c8fd1297e064e6bcedd1095a,t,21000,2963329,,5000069,2018-01-30 13:58:56,92
0x132622e58b5d40332238f5a635772a966da5272a6e89b890ba330900f9c882fd,t,21000,2984329,,5000069,2018-01-30 13:58:56,93
0x87fef148de3f992c9cf75489bfac2a2399d132965c8e57fc0be1db2f8c717ed8,t,21000,3005329,,5000069,2018-01-30 13:58:56,94
0xfb47d7186a0cb2567c23f4774edb42f2c7f0d3ad59570980aa64cc29e24a9d5a,t,21000,3026329,,5000069,2018-01-30 13:58:56,95
0x6ad0abbc317083bc5cf85b5760b0d864fda5d56f88925079fa7d8a8eed18e233,t,21000,3047329,,5000069,2018-01-30 13:58:56,96
0x773d3c776adacd076313f81273f272b3fd4cc5e4d7b9676476b47d5429136a61,t,21000,3068329,,5000069,2018-01-30 13:58:56,97
0x92ced76aec911994b0223d3f62b43e64c1a12d3c1f472eb70d9a3eab90144aed,t,21000,3089329,,5000069,2018-01-30 13:58:56,98
0x09508c3eb73cd05fde7b4bdedc9edf285762222b2ffd20923b61a70b994be2f5,t,21000,3110329,,5000069,2018-01-30 13:58:56,99
0xf6143ae4d5d1a785e6ae42fb16e6d64dae6d022c7afb49f6bfbd403a480f571e,t,21000,3131329,,5000069,2018-01-30 13:58:56,100
0xa2664a9bae4695170eb1c9d45283b75c1fbb5351f77c94224d7a9f894681f099,t,21000,3152329,,5000069,2018-01-30 13:58:56,101
0x08b4d22b4258e1aaae9e054b94a289a9e6e59d631a8324b5096a74594ca6e4f1,t,21000,3173329,,5000069,2018-01-30 13:58:56,102
0x2515b69309a19266b7846362b4692a90c888923c1776b39f0ff09875e9ee8a71,t,21000,3194329,,5000069,2018-01-30 13:58:56,103
0x48e2b8d886a9e1c5748455ed42762c23cfc565c2cf00f6c115f97f6b7f5f65d0,t,21000,3215329,,5000069,2018-01-30 13:58:56,104
0x0bc9e917038cbd861b4728bb69c03f75236e7a641ce194c234107a2eec35f862,t,21000,3236329,,5000069,2018-01-30 13:58:56,105
0x4a709b27d7c7fee2863c4a5a77027d544aecd5301f37dbb30ab5664c565e704a,t,21000,3257329,,5000069,2018-01-30 13:58:56,106
0x201f6b43a455bafb39df1cf292198803d8bc8f803460660a66e75b5cd5e7c2d6,t,21000,3278329,,5000069,2018-01-30 13:58:56,107
0x57b1bb6ac33e7437eb1347b5caa39b13b68bab6adcff0b24265d44924458904d,t,21000,3299329,,5000069,2018-01-30 13:58:56,108
0x94fbf17394d75852777b1cbc3707fc186d165a7a349cb8417b68a2699ad7f67b,t,21000,3320329,,5000069,2018-01-30 13:58:56,109
0xf23ddf2333970ddf861abd04ab59e5082db4e4262f65be0525ea20e08e140fe2,t,21000,3341329,,5000069,2018-01-30 13:58:56,110
0xeb6aaaacbfe9c8435ee06c11cdd5cac20b62f2c046def3320de28fa4e8168f23,t,21000,3362329,,5000069,2018-01-30 13:58:56,111
0x578b555b38787d058a6a7179e8dd84069706a3a07a0099d7686808d6214c48c9,t,21000,3383329,,5000069,2018-01-30 13:58:56,112
0xee84f797aff19f646b557f46b3f9fb0c690aa545690e40da3767c549156a48ed,t,21000,3404329,,5000069,2018-01-30 13:58:56,113
0x358a7b2380da1477f90fc123f71681d381cf4e85e5379f0b741289de827ef497,t,21000,3425329,,5000069,2018-01-30 13:58:56,114
0xe926fa6d7ef38555799efb5d254ae608019d53fe20b6cc44cce3c318dc3ff245,t,21000,3446329,,5000069,2018-01-30 13:58:56,115
0x3526474fff6c4de750e290cd7c7ceab45b0edaba9cb9372b3fbcacc6ebee2e47,t,21000,3467329,,5000069,2018-01-30 13:58:56,116
0x1ea4828ab65a97d9a6ba28d8d461769cd9217c6feac8ee9449e69ca2e5b313a7,t,21000,3488329,,5000069,2018-01-30 13:58:56,117
0xfef9bc41bb0f176110c24f95790149eae83e0e4aa6eb042b1cb84b338b66ae37,t,21000,3509329,,5000069,2018-01-30 13:58:56,118
0xa0cf62f33e40d222c6bf94a3d253a4d87a5b32a67cdaf07ca138a1c4c24dedc0,t,21000,3530329,,5000069,2018-01-30 13:58:56,119
0x4c2c37b086b2fbf4294e58d7b15b30b51bca00f5d634b1d7d87bc12fcb6175d1,t,21000,3551329,,5000069,2018-01-30 13:58:56,120
0x135605fe201e5fc2bd8c08d3265258eef567fdc27a2d3840abe1f31b603d68ba,t,21000,3572329,,5000069,2018-01-30 13:58:56,121
0x88334cff13230e7b178274ffefecea99237d5f2639030352deeecc4f3c9e13ae,t,21000,3593329,,5000069,2018-01-30 13:58:56,122
0x677a442ea6bc24df0b5b8977a5b2ea1b431e23af6d12655fc1ddba7f50034a85,t,21000,3614329,,5000069,2018-01-30 13:58:56,123
0x4c2f673298db2451a69a757ae3c25421ab15b3d742d61f73f34f94bdd211a2f9,t,21000,3635329,,5000069,2018-01-30 13:58:56,124
0x4457eaaf18593cadf853036be68566652ed57454e93146e9a7bd7656e4c1cfc3,t,21000,3656329,,5000069,2018-01-30 13:58:56,125
0x3efc5f586257cb763d89abc81b2419959eb10dcc667e286f7f46a17b35133f09,t,21000,3677329,,5000069,2018-01-30 13:58:56,126
0xf6de73f745606399628dcb7f41ca7a412c87795a2d5ed34569b93a0138105b3f,t,21000,3698329,,5000069,2018-01-30 13:58:56,127
0x6c0e7045ef319a1a84077f8bf3ad5eaf465ee6b25570e3d2ef65113c8d147885,t,21000,3719329,,5000069,2018-01-30 13:58:56,128
0xfbeb07a964ce11351ddf844c0006b12ffb01a06a6894464f1e54204c4066d19d,t,21000,3740329,,5000069,2018-01-30 13:58:56,129
0xa78005ca8adb08339cc4456e8275a8bf0723309400c1d4a1698f84bb73bcf9ab,t,21000,3761329,,5000069,2018-01-30 13:58:56,130
0xb10f96e4fce6e0b9fc1671fb2a0dcf6b161851b180c681ea53faa5b149d112e0,t,21000,3782329,,5000069,2018-01-30 13:58:56,131
0x2fb3cde49e7afab1a25dc37a7fb8c6b1aff84a2701a4c1e69a6b333c821f8ef0,t,36792,3819121,,5000069,2018-01-30 13:58:56,132
0x9f112aea0d530cf1427229fffe85d2f6be4a98c30711ab763bfe0aac61cef540,t,21000,3840121,,5000069,2018-01-30 13:58:56,133
0xd7970359d142007dd4f834cd72a12b6386485eed60201b904717cda82e6cfbac,t,21000,3861121,,5000069,2018-01-30 13:58:56,134
0xfb731f55a0a68c29796180b42c893930138cf72c7e60c20a1f935621a802bd5e,t,21000,3882121,,5000069,2018-01-30 13:58:56,135
0xfea212e70bb36156df33531e8b79ba3666a19ec7bc48359480a691cf6e4bd962,t,21000,3903121,,5000069,2018-01-30 13:58:56,136
0x8d0cf28e2c058bbdf0e08afb88ff8836e80b4ed873d24d89e189229e2cecc4ec,t,21000,3924121,,5000069,2018-01-30 13:58:56,137
0x76be0b47c0d05448940219059086c15e076c62a90622ddc648c7c913b6747d7f,t,21000,3945121,,5000069,2018-01-30 13:58:56,138
0x1eca4d3cfa74e377a490038de09bb8aca3b746c73178a5be8900cd547f457d6f,t,21000,3966121,,5000069,2018-01-30 13:58:56,139
0x9922e9838624ec60869b76196dbf25ac6f9a44dc89390596d07f1bae41492aed,t,21000,3987121,,5000069,2018-01-30 13:58:56,140
0xdb79f9770f5b706afe391c81bb354d7ee470723f8ef4b420fabd4e3403897c3d,t,21000,4008121,,5000069,2018-01-30 13:58:56,141
0x9ef1b68a7d78e9ba9002acfb6d4e79a1d276f7aac0e75accf21a60365078cc54,t,21000,4029121,,5000069,2018-01-30 13:58:56,142
0x58f570a6ed78488004a5b5fdb1b765934a85f5e1c4bb4da3530aa51dff0e6878,t,21000,4050121,,5000069,2018-01-30 13:58:56,143
0xe21b1227b8be559bdd0dd9430e9c3b9261f702d1f9f001953f70c22c36a7cd1f,t,21000,4071121,,5000069,2018-01-30 13:58:56,144
0x694b2809a14fe0355e4c0bc843853504251439acde0e8be8343d8d761b29e692,t,21000,4092121,,5000069,2018-01-30 13:58:56,145
0xce44e41dc402ca0d979bea3ad51072074cee3a6fa9f7e9a414c7f020f83d657e,t,52413,4144534,,5000069,2018-01-30 13:58:56,146
0xd795e54fdd7fb554e751f566d326ba937e4a849ed9152463b0b426068cdbcb24,t,21000,4165534,,5000069,2018-01-30 13:58:56,147
0xb574ec6a43f20d36ab890cc3e3b0ebfc1aef991dd21124a9fddcf3feb2673c20,t,21000,4186534,,5000069,2018-01-30 13:58:56,148
0x642c1f6e72ca5811c126133a2d4e7d758c37fd705b198b7623049f048f4fbb75,t,21000,4207534,,5000069,2018-01-30 13:58:56,149
0xb4c41fbff6b59e65e9c96d95161c8fbfbccf40ce8455067158294ba32a83b123,t,21000,4228534,,5000069,2018-01-30 13:58:56,150
0x8e476bfe45fdf5232ba9c17f16240a0f1e0fd516642b49d9def3fc4281a0de56,t,21000,4249534,,5000069,2018-01-30 13:58:56,151
0x852da5d230b6d50f6777523ea7c6dd151238407b2314085da652fbe5a96b869e,t,21000,4270534,,5000069,2018-01-30 13:58:56,152
0x61734cf616b3c3c870a3bbe3eaa265504f454d51daf84938355cfd816a4a5550,t,21000,4291534,,5000069,2018-01-30 13:58:56,153
0xd3f98ec3639876b9a3c33b1a71ffd746eaff8e812632371db929609e6adbc7aa,t,21000,4312534,,5000069,2018-01-30 13:58:56,154
0xac32a508be305d88e6c23199d84bb889c7ab767f2e38fd24f0a77fd8fe99d9e1,t,21000,4333534,,5000069,2018-01-30 13:58:56,155
0x889e5e9d80429a52bde3bb4b9333bcad463e8aa312059cdd43de9375c67e67c6,t,21000,4354534,,5000069,2018-01-30 13:58:56,156
0x0ef4c39c7b3f2a599380424e49ca8ddaa2ade0e43a9a1cba66a1d7a1ad9fedcd,t,21000,4375534,,5000069,2018-01-30 13:58:56,157
0x6c8de1b1a2f5ddc95f6094a4928b7986ac7938420e4d31bdd10679fbf2f54279,t,21000,4396534,,5000069,2018-01-30 13:58:56,158
0xd7be03e579f07f65dc04b70a4181463b14d475ea22b723f298b5e689180d0f68,t,21000,4417534,,5000069,2018-01-30 13:58:56,159
0x369a7c1b5949e8a0d0f3552065cbe7b5e7fbb747c41b6c6b8284f44be8e03f7a,t,21000,4438534,,5000069,2018-01-30 13:58:56,160
0xb30f0a409853d9a6cd4c542507c9dca67dbb619c965885a685e7696afc456377,t,21000,4459534,,5000069,2018-01-30 13:58:56,161
0x12b0b1ecc8d980860b78ce7b2b95c6e2866d9676b3be9aa613ff5ab2116b40d6,t,21000,4480534,,5000069,2018-01-30 13:58:56,162
0xa318ddfe591d9bc5f7fc39c997ab4b51eedbb339e564816910c7a30bc7ead5b5,t,21000,4501534,,5000069,2018-01-30 13:58:56,163
0x5dc2035df0b9e97868a8fde6c2f6a38f6e112b755f53c2d7093b2ea0010a70e7,t,21000,4522534,,5000069,2018-01-30 13:58:56,164
0xb274413e44f3ceb442a635205ad5de9d5973afe81539d3294915906703faa4db,t,21000,4543534,,5000069,2018-01-30 13:58:56,165
0x7a49aef09719f5bc0c294f7338268470b1da2dc7087afe2e0b9ed7556b11f172,t,21000,4564534,,5000069,2018-01-30 13:58:56,166
0xd367b6a50bc4bd167b812ec9ba3b0efd1502b43bd0666782e2e40b7de15180a0,t,21000,4585534,,5000069,2018-01-30 13:58:56,167
0xfb2c206ace35896ffc210a9cc33b0d1004244fc802bbc8e35a11ecaea8c3b083,t,21000,4606534,,5000069,2018-01-30 13:58:56,168
0xe1a9da8ba058c7da14da6e39732484c52cb57d2f0a398eb7b877d23462eeb66e,t,21000,4627534,,5000069,2018-01-30 13:58:56,169
0xbe8736076dcafb9592c9444a0d89f422192cee07ac72aaf639cecd16ee35f107,t,21000,4648534,,5000069,2018-01-30 13:58:56,170
0x80b431c7fdfde8efef34b87ff47d70798a8a5ea4f897e9dd8ce65fc705aa09b7,t,21000,4669534,,5000069,2018-01-30 13:58:56,171
0x16371b84394323c497a72abe737bbc016b129931846a08a51df3c44966278157,t,21000,4690534,,5000069,2018-01-30 13:58:56,172
0x947527d6af102314d48be37960654a408ddb6c5bc1f68ec2860ab264f629ffab,t,21000,4711534,,5000069,2018-01-30 13:58:56,173
0x1ec8d13c6be6465165eb54b105a0f63851b10a4abaaf656b347eaf7d0d2f3558,t,21000,4732534,,5000069,2018-01-30 13:58:56,174
0xf0a501aafee466fe55b6a2ed19452f3c26c7dd4d28e5ed1fc8782818cc31f4a9,t,21000,4753534,,5000069,2018-01-30 13:58:56,175
0x544bc25d6e2044c821b3690a6b806eae8f028b53fbb8c55ac11647ceb088f34d,t,21000,4774534,,5000069,2018-01-30 13:58:56,176
0x6fae8e7e3d462186dbe893decba6ddbdc492b976941c3af837b9436b987bfca1,t,21000,4795534,,5000069,2018-01-30 13:58:56,177
0xd0f7d95686722654c2a1bb2fa038df8f824ab1b4ccf57a88ce83720291a6fbe7,t,21000,4816534,,5000069,2018-01-30 13:58:56,178
0x7e79262de60a47111a23e6efc514c7c992acb4152e6287cc5981a6d361b59195,t,21000,4837534,,5000069,2018-01-30 13:58:56,179
0xf3c0d778a47939452aed78864ce918ae19cddbe762aaef73fb96926c3723ffc4,t,21000,4858534,,5000069,2018-01-30 13:58:56,180
0x2f9c251c7dbe7bd1933aeb9ea46f56f0cf06ed234834b89c1133da69cee7002e,t,21000,4879534,,5000069,2018-01-30 13:58:56,181
0x77afc00b3e94409d35ff3b6ea1bd427056e5f38e91c40699324ddfb0a227c2b4,t,21000,4900534,,5000069,2018-01-30 13:58:56,182
0x50def47312ed676fd7e4519249809113d4091ce198f762990b95a2902db2ae4d,t,37106,4937640,,5000069,2018-01-30 13:58:56,183
0xd1f4d365abad6a963dbed74255d2deacc37fa10795e993367bf0f79a248c84c8,t,51542,4989182,,5000069,2018-01-30 13:58:56,184
0x391ce9cabc13bfd766a39b7b92b502621cd3931f43a5d2b49d8849f229ad5acd,t,21000,5010182,,5000069,2018-01-30 13:58:56,185
0x75faedb9f1d5da0790642327a5c73549fb2450c17be8e3ee05517a559cd84bf0,t,21051,5031233,,5000069,2018-01-30 13:58:56,186
0x8f5335891af05f4527ced7f9dc0119590d7719f7f089138a8b48052096d04ac0,t,21000,5052233,,5000069,2018-01-30 13:58:56,187
0x273b261896e9c35a2fd6e1d60c9c407b0cf933178f15272f7e572fc6e9a5e2d4,t,21000,5073233,,5000069,2018-01-30 13:58:56,188
0xe4b2a11309e8b34bb64cec0fc5a82b93d38da875e7a7a1c0fdad9877eccb5c5f,t,21000,5094233,,5000069,2018-01-30 13:58:56,189
0x63e06448960e4b47e70910702a8efa9cc51af73e8404ed4fa4fe75e7de22136e,t,21000,5115233,,5000069,2018-01-30 13:58:56,190
0x81fc140c4029034dec6e701254d6b10757ce8b72c60d0b610c4e817e220de2b9,t,21000,5136233,,5000069,2018-01-30 13:58:56,191
0xde030dfdf8b254b2679f849371a21f072f218703f970d6460e0ebdc8220585cc,t,21000,5157233,,5000069,2018-01-30 13:58:56,192
0x2cf4a2774e5f2ba350748bd3194c50687040f9230bbd35e0658efa1054d0f905,t,21000,5178233,,5000069,2018-01-30 13:58:56,193
0x33280b0262caad171103bfc79c97da78ec35c5127f5347e2d994ba22d4431398,t,21000,5199233,,5000069,2018-01-30 13:58:56,194
0xe038ebcc3435dd4a37e1cc096c4979f3ace06f6957250348d2eee62371f8aa47,t,36904,5236137,,5000069,2018-01-30 13:58:56,195
0x4a598fbde37eadffcad10734109970a9b0619f3ea4250e3db7b18d22a6ef5395,t,52148,5288285,,5000069,2018-01-30 13:58:56,196
0x5fbad8da77892e5ad405efb4c915cb3b6fb6cb12a31c7e5910e194602b2938c5,t,21000,5309285,,5000069,2018-01-30 13:58:56,197
0xb92b658f73354d15f7ea9ebca737cd2d1d35886802e0e709769739c8fec0c239,t,75247,5384532,,5000069,2018-01-30 13:58:56,198
0x1c6ddc57cd1a02823bd436d08cfdb1645733c9bfc9575ee3b733d4c09fd721de,t,66253,5450785,,5000069,2018-01-30 13:58:56,199
0xe633f53141018ca2761021c84dbd38f702ec880036baae9bc8ceaba53919e7d2,t,21000,5471785,,5000069,2018-01-30 13:58:56,200
0xfb3c639b2f5ce68a95cbc1d8102a518b3960fdef04bdbb9d2efbeea404eb698e,t,21000,5492785,,5000069,2018-01-30 13:58:56,201
0x0dff2783abe454beb128141f98c586a82d47efa791921b0ba9137524ad5d2873,t,45591,5538376,,5000069,2018-01-30 13:58:56,202
0x3cc9b74b7cd4e19cb0f9a3b9a81ed0b5f3a2520ec7dd4676e4f5107d0885a48b,t,36973,5575349,,5000069,2018-01-30 13:58:56,203
0x5a271975df94a6f96af24943a7baf17c85902e903bf7feda158afa1f9ff81f91,t,69504,5644853,,5000069,2018-01-30 13:58:56,204
0x77280ef34d26fa3a5c85e2905f19bf4675c3ac369e8ad041aecdbb358a138937,t,21000,5665853,,5000069,2018-01-30 13:58:56,205
0x074bc96d930f11853b31d03e32d856505a3eca5798a2a9d05e4064418cac663f,t,21000,5686853,,5000069,2018-01-30 13:58:56,206
0x233de6752dfb969b83f783f86bdd58723c61e23c27b9e5792ee90b6e4ce7854f,t,52052,5738905,,5000069,2018-01-30 13:58:56,207
0x1a8c7ca3e61b3533a0841d32236b63e139f0fb720f7726492224a72b39feb631,t,66316,5805221,,5000069,2018-01-30 13:58:56,208
0x0760bc6e5cc1f50b47674d3dd40dacbeeb328f566f8ce32d5122bd75fcdd514b,t,51560,5856781,,5000069,2018-01-30 13:58:56,209
0x59c9e742ac5ad9d9b504a64b1a37fccba1effc8aa2be4ef04b03de281a148dca,t,59290,5916071,,5000069,2018-01-30 13:58:56,210
0x840355ab83643ac8a56fc05ed47fc4ae5f6248d1ee6ee6c0f7de012d15ad47b4,t,107986,6024057,,5000069,2018-01-30 13:58:56,211
0x072e54cd51a74c736a9751c74a65869c6eda0cf66962c9346589cd98a684f082,t,21000,6045057,,5000069,2018-01-30 13:58:56,212
0x68f470dae95c42d29ccabb50b1620dfc8494d874ece1953111156cf83a10683c,t,69005,6114062,,5000069,2018-01-30 13:58:56,213
0xd309362ab7838e6b296f9b24cb71e98a5a8702077d26d64a5d0be45a9dbf4fc4,t,174591,6288653,,5000069,2018-01-30 13:58:56,214
0xdbc27584fb50e3f033826885ecbbfb37d268bd537e11d03b9938892bfdd13816,t,21000,6309653,,5000069,2018-01-30 13:58:56,215
0xbe023284b0a6d4d7c581b48dedca8d345ad8f259fe2e3f9295b006932b6b4a77,t,37182,6346835,,5000069,2018-01-30 13:58:56,216
0x07bbe9a37bb3b39eb6a05ef272aa24d4903d94c77ce5a1156990edb77a8bf718,t,59354,6406189,,5000069,2018-01-30 13:58:56,217
0x123db3c1cceb14d7a28b5f332922f96cba4fbecdcf4b8849ea4cd9d42d38f33d,t,51921,6458110,,5000069,2018-01-30 13:58:56,218
0x03c3bb90ba161ddc30a10dbcee48d9d229671993f178207acf853a3951355853,t,39285,6497395,,5000069,2018-01-30 13:58:56,219
0x63d862effab8dc8077a393fc817d16805aa72f49ffd36962218402e771da2dbd,t,35904,6533299,,5000069,2018-01-30 13:58:56,220
0x00447e48f011d56ccd68adf9bac894c07695eed338a2dc0d4b8d8c318dec626f,t,21762,6555061,,5000069,2018-01-30 13:58:56,221
0xc929d33bb4fcc7bb811ab4e474588b706661c9a5c173ae0a2769b92a512160d3,t,140276,6695337,,5000069,2018-01-30 13:58:56,222
0x563fe5b93db16b4ce8ce209404b766ac2c1bdafba9843d43bd5581b4c2d8ba6b,t,90117,6785454,,5000069,2018-01-30 13:58:56,223
0x66e0e4e1d39e0a82baac5fb07fee768dd84e968c613296995fee0ae6dd65767b,t,21000,6806454,,5000069,2018-01-30 13:58:56,224
0x41894c4585d206b684ba27af4e160f2f700647f06c451167eddb2c583142e2f8,t,90729,6897183,,5000069,2018-01-30 13:58:56,225
0xebcaec2bf3f7c672ff3140b165fd1a6eefd7f0cc4aaf567c4b279693b09354d3,t,48734,6945917,,5000069,2018-01-30 13:58:56,226
0xfae3ebd6345c6992be3ab84974fe86b51538436722db52b199694acea52f9013,t,113736,7059653,,5000069,2018-01-30 13:58:56,227
0x729a4e2154973e24203b26d2bec608984a54924e4595d886a3d2a681f21b5ac8,t,93242,7152895,,5000069,2018-01-30 13:58:56,228
0xd87c624bfed9b0f947e431a9470e8569ccf7333792c41432517351daa3dc3ff4,t,71219,7224114,,5000069,2018-01-30 13:58:56,229
0x9c266787eb5821e7629059fa70ce086ce2409988628cd13c5f0befa5ae7740e0,t,55779,7279893,,5000069,2018-01-30 13:58:56,230
0x3989d44ae2d27cf7dae19abe42aefe5a6842866541ca9f892136f6cbe00de7c4,f,22540,7302433,,5000069,2018-01-30 13:58:56,231
0x92a3317164e61892dba58ae5efb91e1b46818eb494745569c87757a4b74fb4d1,t,33705,7336138,,5000069,2018-01-30 13:58:56,232
0x00695518236c6daa14d36c26a7036b4d66ddeb45b793c552ede07c0a2c4d6452,t,45971,7382109,,5000069,2018-01-30 13:58:56,233
0x8ad3846a4d77f155ce2388b10a0ddfaeb7a87a9cee155eccc8d719baafa6b2e9,t,28960,7411069,,5000069,2018-01-30 13:58:56,234
0xce4bec268dc86c52b94afce0a4498a65b5c6470d111fcd60dd1b9ea9eabe6e99,t,48390,7459459,,5000069,2018-01-30 13:58:56,235
0x07d2520d4eb1005cdc5ebe5d4d5cbe176adbbbb757f7cb9b6fb4caa6307fa0a2,t,21000,7480459,,5000069,2018-01-30 13:58:56,236
0xea1501cebe1d0961e0dc6b89bc02e9de0c8a14c446efc7e3adc807e69650765d,t,70366,7550825,,5000069,2018-01-30 13:58:56,237
0xbee0d6a7267569bb86a940bcd931ec1525b8202d9ceb5c4081fe8abae781740a,t,21000,7571825,,5000069,2018-01-30 13:58:56,238
0x6f65f55a0161431b129e4b37c992ab62d865f7fa4f015d46788012b79441629d,f,30000,7601825,,5000069,2018-01-30 13:58:56,239
0x79c9dce67d1b6bdf0a4b9a38bc0300c10a3a92a0e80b61dd394dbb154aa78109,t,52187,7654012,,5000069,2018-01-30 13:58:56,240
0x3aac86255cd179f8595fa96b099dadd6ff9b832d22968aa3da335ef9390c480f,t,96450,7750462,,5000069,2018-01-30 13:58:56,241
0x7e3f72ddb517ec32e0917ae0fe3ce8587559c81714c38b9d0fb043880620ff41,t,21000,7771462,,5000069,2018-01-30 13:58:56,242
0xca2681209e9abcae77490f4a65b1d9a32f7dd3870404369f92c5a37cdea12046,t,21000,7792462,,5000069,2018-01-30 13:58:56,243
0xd8d0c4ecdc5f07f507a1a50d49f3cbc2a251fd4251b6c6b020e78ac0a26872e5,t,21000,7813462,,5000069,2018-01-30 13:58:56,244
0x5d1900ca47092b485faa8e1a504b04d908d3381bc9fbdf49549f418aad9273ec,t,21000,7834462,,5000069,2018-01-30 13:58:56,245
0x6f8cdae0808384dc78ed4ac59105ad700542881b8045d04e850a8eb67e68f1ad,t,21000,7855462,,5000069,2018-01-30 13:58:56,246
0x233c0d09e203bc922cacfe16a8086ebe6914f9bd7e4bd8b99256f171a7e0fe8c,t,21000,7876462,,5000069,2018-01-30 13:58:56,247
0xeea198d4fe99da367435f428c8420ff80604c306930a7375cea92a3e826e1b18,t,21039,7897501,,5000069,2018-01-30 13:58:56,248
0x4b35efa30fa87878bb40cf2dc286953c4ca58c89e8b73d423745eecdf15af166,t,21000,7918501,,5000069,2018-01-30 13:58:56,249
0xe3410c807e16b999d93d022de3c87c8796bd1176c83ddf10935ecde4147964eb,t,21000,7939501,,5000069,2018-01-30 13:58:56,250
0x25ed3d6d8ea230a436a30127fabdca290649b7a0a6542e7762b4b9a47b0b3720,t,21000,7960501,,5000069,2018-01-30 13:58:56,251
0x49e6791d392104ccd5e28cf8789277c4190f62f09960508057d31456d67d9eaa,t,21000,7981501,,5000069,2018-01-30 13:58:56,252
0x7b16a781e6a6a5ad29e73500980044bf00090430ccef8e609d1bce0af14df3f1,t,21000,21000,,5000070,2018-01-30 13:59:01,0
0xe855329053469f480844f528d2293f0df16974fe40149237360db5b0d698ed67,t,21000,42000,,5000070,2018-01-30 13:59:01,1
0x95c63017d3c0b0661a1fe5878b1a7c2820806797a659c4d07a5768eff87da2bd,t,38188,80188,,5000070,2018-01-30 13:59:01,2
0x6d0cb60681fc3ed40d3a38e2aa6d7409993b144c69bc7a30bf7348221d83e243,t,54835,135023,,5000070,2018-01-30 13:59:01,3
0xa5b3dbae8a442ceae71fae3c2548b87e99e2b55cc86d3ac626a7bfef25709003,t,21000,156023,,5000070,2018-01-30 13:59:01,4
0xf81698df0fb2ce62f0d74168eb799babe8b859d6a6b9473fdf0df369870f749c,t,21000,177023,,5000070,2018-01-30 13:59:01,5
0x21ca1d5de7819157fc344c4031bc93693a3f8dcef4e5ae8191edeb252dc74602,t,21000,198023,,5000070,2018-01-30 13:59:01,6
0x0bace6eeb104261779efa48609d52aef7e756e9417470bcdcfbbc8405734295e,t,21000,219023,,5000070,2018-01-30 13:59:01,7
0x5f18419a3c36bf7841e2375a8daef3ce23d187bfc4f7b4ed049bc6e68cf13382,t,21000,240023,,5000070,2018-01-30 13:59:01,8
0x4786f158fd684627519f5c81c7cf5cfdfaf739ecb38cbe048714c57032344c0d,t,21000,261023,,5000070,2018-01-30 13:59:01,9
0x371bde8df9ce9c74008042e945420d0b69362eb79623b59b7af0f26e8decb539,t,21000,282023,,5000070,2018-01-30 13:59:01,10
0xa554ce747bc9a05ee3ef95b0a6932f5fd959f39b51b763e0ed532d92fab9a94a,t,37514,319537,,5000070,2018-01-30 13:59:01,11
0x43c1f461909a8ffc40e578b2c180b32185e3dd6056417f3e54f31331eb6d1651,t,21000,340537,,5000070,2018-01-30 13:59:01,12
0x5af4901549e7cdd5ec4cb3ba0e236b0d21b3cd494a04457e75464165349f1eab,t,21000,361537,,5000070,2018-01-30 13:59:01,13
0x4b6080e7ce7080a3577177fb0ac69ba08f8395e13a1c9f4077123352d3efa5f4,t,21000,382537,,5000070,2018-01-30 13:59:01,14
0x0401d6efd20a224c919ffc640978342ebe178472da518ca42c78adf5120190d2,t,21000,403537,,5000070,2018-01-30 13:59:01,15
0x96591d1ee4bb945ca08cff9285aa6a163e32ff6ac875c56d52cb7b5fb347985b,t,21000,424537,,5000070,2018-01-30 13:59:01,16
0x512bc783c04b2c0da8b06b7691041eb059de2066aa9cc9d09d07951713ed6b3a,t,21000,445537,,5000070,2018-01-30 13:59:01,17
0xc0f94d36de2569131ba7d14b247f60aa8278eb8acf8740b0c1a052b9a4817dd3,t,21000,466537,,5000070,2018-01-30 13:59:01,18
0x5b546060fddf5ba500fe8abe25eb8c01f09931a099f4b02e0d08dfd6f6861c48,t,103638,570175,,5000070,2018-01-30 13:59:01,19
0x26cd2fef1d0109bbea02e90d0cf272bfb16cc12f43c5bfbf5209d60a37daa4f9,t,36458,606633,,5000070,2018-01-30 13:59:01,20
0x808c62ce509703488dc23b1ec48821f04c978d6ff62043381a582493a2dcea86,t,21000,627633,,5000070,2018-01-30 13:59:01,21
0x6ff1900bba1d5555989d6f1afaef5e8f055d89ee78467c05f5b87d0f27d96b30,t,21000,648633,,5000070,2018-01-30 13:59:01,22
0x144b068996b74f8810a9e797384c0d8630ccaac3a54ab20ce67df9f915683c63,t,21000,669633,,5000070,2018-01-30 13:59:01,23
0xc14bcd3bd4c74495eba12824c7f2cca6159602ef9ad43f3e45d6229faf86bb65,t,21000,690633,,5000070,2018-01-30 13:59:01,24
0x445d5d3cd6716123f4efdbada9721c24d818bfcc354c5d439d3eb53f0801d6d6,t,21000,711633,,5000070,2018-01-30 13:59:01,25
0x79d21fdf80dceee767de77dd5c910f19b0fc1f4712a84fbbebb36014c63a3903,t,21000,732633,,5000070,2018-01-30 13:59:01,26
0xdf36b95b43ed119343baeb9afb65a8e9a865ea87837a24f12ca67b01477e4198,t,54835,787468,,5000070,2018-01-30 13:59:01,27
0x7cad1884e066b888a1f0b96b0daca4e150c7b626a428a728fb880d01d119d4b9,t,21000,808468,,5000070,2018-01-30 13:59:01,28
0xda0a157d56830e5776c8d26bc87a688b512c50b8d68794e807da3bca553ac095,t,21000,829468,,5000070,2018-01-30 13:59:01,29
0x5edba6f8270bba053b8c488345b417affb77d0d9b792d28fa9876134c1539823,t,38254,867722,,5000070,2018-01-30 13:59:01,30
0x7305e41b1f7ee5e4a4c56bb4af1fd2b8e0bd45a1e12f566947e92d40cd74602b,t,37449,905171,,5000070,2018-01-30 13:59:01,31
0xe60bb82d61795aeae983854dfa439eacbd0d6a241256ff9f8b42022bf7a158af,t,21000,926171,,5000070,2018-01-30 13:59:01,32
0xe4ff7f00736300207b49cda130816fec354db7137035e8c52057847c0e3eec0e,t,21000,947171,,5000070,2018-01-30 13:59:01,33
0x6e50e3109bc2d59b0a2e856586ac47d60b1ab88aa1cbabfe5ef6cbc0aaf5050a,t,21000,968171,,5000070,2018-01-30 13:59:01,34
0x608c04c22db2037bb9ab4f37ef93681f61755c8a8a80b6b13c43ae23ada1cda2,t,21000,989171,,5000070,2018-01-30 13:59:01,35
0x98fec8ba580cf871fbd992665f4b16f8fe0ed9ab638969332fbbbb7ea55b0abe,t,21000,1010171,,5000070,2018-01-30 13:59:01,36
0x867110893bed212a57428c573005cf03af19b4ef8dc6006526ca3e0f9fb2586a,t,62759,1072930,,5000070,2018-01-30 13:59:01,37
0xf76f894ebd8bd494acbeab3cd8b86b90150b6e512bdffe6c822900c86cc94187,t,134870,1207800,,5000070,2018-01-30 13:59:01,38
0xde3f95d5ad07808e7e82f3f2683aab0636875c87e12f3ee5d0d2cd64ff2191e0,t,127516,1335316,,5000070,2018-01-30 13:59:01,39
0xc2380612a43309b8bb837be2f2f263ead3b8ee5af945e400df07241e0b25ec45,t,127580,1462896,,5000070,2018-01-30 13:59:01,40
0xfc5c77a908067f287d15e09575bc7dab21c3d2ca6817df5bdb1bb1321f95ddf2,t,142836,1605732,,5000070,2018-01-30 13:59:01,41
0xf0d86bddf2786c16a5ac8ca1a96c2ae4b8af841376c5000a40be7bc7bbe16206,t,142964,1748696,,5000070,2018-01-30 13:59:01,42
0x8334534673ef0de84d9d92a41390f8ed58826f154e0f6e4eedf333a02b43b4d2,t,139033,1887729,,5000070,2018-01-30 13:59:01,43
0x96436712d7b68534ddbf3244873a32e807d9d3b8ea96befbfc5e4dcb73e84eeb,t,67813,1955542,,5000070,2018-01-30 13:59:01,44
0xc8508599d0eb2d84fa4434fc11f050dc782f9348af69f13a13d3d2f383b16345,t,76804,2032346,,5000070,2018-01-30 13:59:01,45
0x1e6a214b8886d539b328645c2d90a33b6c07e3c616e0d6e9f12a234f78c56d34,t,172580,2204926,,5000070,2018-01-30 13:59:01,46
0xe719b30ae799ebed4c0db7ab83cbc7cfeeca5ca06a6ecebf56ca60c7361e4b6c,t,127452,2332378,,5000070,2018-01-30 13:59:01,47
0xea8e41a60afa6b0a74142a7f36173d62182b1c74d957f25c78e94dde33236057,t,142388,2474766,,5000070,2018-01-30 13:59:01,48
0x1fd6323a363ab940a418ab2f5425bbb57e37b0909d40eb6cc2b980b6659684cc,t,157772,2632538,,5000070,2018-01-30 13:59:01,49
0x9ec7515a950547d3d07032ed237f67ad80d7e1168f859f2da86e417ed648cf64,t,127772,2760310,,5000070,2018-01-30 13:59:01,50
0x9c09ca0c9d24973deb6f8f16bad589bffabba414308e86bed4e6cd37d59aa814,t,157708,2918018,,5000070,2018-01-30 13:59:01,51
0x191843057b811d746adb7fb5ad871c59c17129314fda67ddb73211ed1d9d7d11,t,157516,3075534,,5000070,2018-01-30 13:59:01,52
0x68404f804cad27300a5ce5de92ab253ba50b9151f897e10144c1b941631752bf,t,157516,3233050,,5000070,2018-01-30 13:59:01,53
0xf20fe620ed4150249f20366aec1696abadb089fa9aa1bd6a46712f111f94e0ef,t,127580,3360630,,5000070,2018-01-30 13:59:01,54
0xb5606d3a6a842654cb16fc84595b05981430cfde1511467937c4f82b1982e5d3,t,222326,3582956,,5000070,2018-01-30 13:59:01,55
0xd3e12c48df76d55691492314ee7bb382a12eb61ed2dc8d37cff8247fce890b79,t,67877,3650833,,5000070,2018-01-30 13:59:01,56
0x76df292386e85338f13ba41efed465ca8c2c3a6e692e2765c6d7141469cfbb71,f,21000,3671833,,5000070,2018-01-30 13:59:01,57
0x1250b3336fdf3599e6ad040daf783238744039fae7e7347107ddcbab23ea012d,t,21000,3692833,,5000070,2018-01-30 13:59:01,58
0x72d21c9309308e87506c73191db52fa2e2da2b1c0e1cd4fd0fc88806cf6d69dc,t,21000,3713833,,5000070,2018-01-30 13:59:01,59
0x7f9ad788418bd7e4af7c0e61a3f06842427e0358a9478b31efe2f9e7a8526b90,t,52048,3765881,,5000070,2018-01-30 13:59:01,60
0x7efd72df2d9af2f96f14350bee650a2be3b30d448fe21b87eb9aace72bd30cc4,t,21000,3786881,,5000070,2018-01-30 13:59:01,61
0x69ced764af370e8fd7ce569007b1f8d077c95523851add541185d64119a4382e,t,21000,3807881,,5000070,2018-01-30 13:59:01,62
0xa4b007f40dd44cf234a881894a2bc79a70c5e0bddd2baaf32b2eb1dbd66b0333,t,21000,3828881,,5000070,2018-01-30 13:59:01,63
0x7f811c3788cb53fa9a5d841e89b2e0219d7a220e98f859659c61dbfa96511020,t,21000,3849881,,5000070,2018-01-30 13:59:01,64
0x19f1831798e073b43c223d6247dc83985d91cf77c8c2cb8fbf97f51c6e42a108,t,21000,3870881,,5000070,2018-01-30 13:59:01,65
0x88b3410abdfe89e1efc2018408df01239ede4681e8ba291cd3191252016ee149,t,21000,3891881,,5000070,2018-01-30 13:59:01,66
0xb8c947005dec0e2ec05fe53f0cabee33c969bdecddeef273ad539a8f316ae615,t,21000,3912881,,5000070,2018-01-30 13:59:01,67
0xa8a1be0b4d1779ced10bed18fc518e15780f2daabad5c39aacf07fa62d9e697b,t,21000,3933881,,5000070,2018-01-30 13:59:01,68
0x7420bf73b3945c3fc0cd111f81d867a23c17fbc321c5713d069c79e5c749ec7e,t,21000,3954881,,5000070,2018-01-30 13:59:01,69
0xfc6aa8a3b38bcadfdb9dc604c8878601d8b9a061e753829fbb39e547b556cb3f,t,21000,3975881,,5000070,2018-01-30 13:59:01,70
0x0502a9fdbae17f2a7c5d309405c3f053cbcd9f034ce01234ae61c4c56817699e,t,21000,3996881,,5000070,2018-01-30 13:59:01,71
0x9891924974ed446a16bc42619e8523c49f5722c8142def2d45b01e107a59de7a,t,21000,4017881,,5000070,2018-01-30 13:59:01,72
0xf5196558473fafdfa1fe676e9ef5291148dbc349e245c9e46375277c010f2237,t,21000,4038881,,5000070,2018-01-30 13:59:01,73
0x931abcece4f9489a829d3d078e6ed39937323b8557ae62d6cc8ce70789d1c2a2,t,21000,4059881,,5000070,2018-01-30 13:59:01,74
0x27d8df7abd2adb567d1ca3245545c32c64c4057d8de71712004d64f32ad1da64,t,21000,4080881,,5000070,2018-01-30 13:59:01,75
0x06b989c9a35e3c47749e811735a967e1c75a6a6a637bdd00d3a3ea0afe11f309,t,21000,4101881,,5000070,2018-01-30 13:59:01,76
0x401c73206024e0fdd5552642bf8a981728d48318ff136eb25796f3314f6fc1ae,t,21000,4122881,,5000070,2018-01-30 13:59:01,77
0xe87ae3ab1e3b62b16fb35ab67e2922c07d272c92eb23ba4586eecf4ee71223b7,t,21000,4143881,,5000070,2018-01-30 13:59:01,78
0x4236c9a0becf31adf8eb3a1a431340d1b42471347924dca5ce91ac2073e79a0f,t,21000,4164881,,5000070,2018-01-30 13:59:01,79
0xfccd5958d93fd8a80532e449894ecc2855d672a435027a76557d67b4121d3ab0,t,21000,4185881,,5000070,2018-01-30 13:59:01,80
0x3cf0a483a8c326be5e810a3424c5735dad8e882d57851f5315cb9bc2ba85cdf8,t,21000,4206881,,5000070,2018-01-30 13:59:01,81
0x923f3307101e95a8807be6d9f078d57e289c7a9bb5f8caae5183e9d95cf3dbad,t,21000,4227881,,5000070,2018-01-30 13:59:01,82
0xaa42be9ae66e5d84ed2ba65613278b1b2e43ac2134f2b0c2cd3f03451816f1c9,t,76670,4304551,,5000070,2018-01-30 13:59:01,83
0x476888fdd4a3bac0443a9e928360778d1da1a9a914337a94aa7995d7c4b3262d,t,52886,4357437,,5000070,2018-01-30 13:59:01,84
0x4348a38cd3007d719bd07868bef51ace5ffae6bc2008f4b5f7a44945cb57ed22,t,52822,4410259,,5000070,2018-01-30 13:59:01,85
0x5a72dfb8f5581e7fdc69f7df0fb7bbecd47da2a3b169265c1ce00d77abfaa891,t,52886,4463145,,5000070,2018-01-30 13:59:01,86
0xe1fd90bd52da500b99cb0a47c06efcb079c17d754cc2e92f03745b8979f7f950,t,52886,4516031,,5000070,2018-01-30 13:59:01,87
0x18d28504b2cf08d0d5caee2293d9dc29ce7a5ca3bd165a77a7cfbbc565e0d857,t,52886,4568917,,5000070,2018-01-30 13:59:01,88
0x18f6a8c0ecf8025a6aba6683466fd4e8682af7cd2ef452c9dfd470f78a1ff959,t,52886,4621803,,5000070,2018-01-30 13:59:01,89
0x320582f6eddcb81096795317ae9e3c5ed36fd931ad8713526e78c600602c419e,t,52886,4674689,,5000070,2018-01-30 13:59:01,90
0x2dfca22db3db5632f308136c61fdf25bb51bd8eb522cd57db3a9749e5b0b0b34,t,52886,4727575,,5000070,2018-01-30 13:59:01,91
0x9b58eb0817c89ae822d2eefb5e593dc8fb4acb43040cc9f1fcda8c4a3efd66f2,t,52886,4780461,,5000070,2018-01-30 13:59:01,92
0x4b1ea226dd5b50492f7cd7bb4eb344bc33c0fd25cc39f5427ae92daaa9b8ec48,t,52822,4833283,,5000070,2018-01-30 13:59:01,93
0xfa69c94f6f25e4edb700e28e6a967b94569bf82de97cd6cb6180b8a53d98c141,t,52886,4886169,,5000070,2018-01-30 13:59:01,94
0x8218c82447a29d6a91caf04cc645a8f4147454a419f1c4f1a8694fecaa44d208,t,52886,4939055,,5000070,2018-01-30 13:59:01,95
0x6042f71b2849c046ead8a224fa30a35fdfb49a96d82e6b5fd7e71f29a5705ed5,t,52886,4991941,,5000070,2018-01-30 13:59:01,96
0xafe78e5f77d6852dbdb6c74dd9815a940b8989e726eaac5924bff48f4ff4e0a4,t,52886,5044827,,5000070,2018-01-30 13:59:01,97
0x26ac6e5cc4df0794cd64571eea7d40e4eee30e04b745561cf88bab0eee572896,t,52886,5097713,,5000070,2018-01-30 13:59:01,98
0x43d63712bf5686548d4eb0f93f87e082e473920b033cf1a7d271265af339427b,t,52886,5150599,,5000070,2018-01-30 13:59:01,99
0xb0874146be39defe61dcc9d520775e187effbd8e7df03fa5bee9e5acf9d5eb8f,t,52822,5203421,,5000070,2018-01-30 13:59:01,100
0x9d10ae329ed70011577e60b44b001431f5fd7effcd2af447ad6f7ac575341eb5,t,52822,5256243,,5000070,2018-01-30 13:59:01,101
0x5a641cad89d4c0dd0876c7515b24f049cd21db46f6aa0ca8c5ea7850598b9e32,t,52886,5309129,,5000070,2018-01-30 13:59:01,102
0x085ec7a86ac0445b026589210773ef148004187576151664461dc124a8bb8b75,t,52886,5362015,,5000070,2018-01-30 13:59:01,103
0x87a39ed83e1072e486578f612d120d3f21c2b9b67c3ad3a29ee5677693772e64,t,52886,5414901,,5000070,2018-01-30 13:59:01,104
0x0e609a116e7112450ac2cc24262661caaae648f94092b246d46e4b6c13bee340,t,52886,5467787,,5000070,2018-01-30 13:59:01,105
0x040b00bbfbec7efc3c3fcaf58d044bccc01e7bf0e065a730e17f3a69c4003343,t,52886,5520673,,5000070,2018-01-30 13:59:01,106
0x78ba540a65c81f2cc9871c4124c28a2de86d77c5862db16803d842dcff1d1cfc,t,52886,5573559,,5000070,2018-01-30 13:59:01,107
0xe16a2199c69db5281d37d98588004d6e5a236a48c1d0f36176b8174f536caf27,t,52886,5626445,,5000070,2018-01-30 13:59:01,108
0x629f8fbb01e26b7c3335f5ed38324af68b1b055778f205e4bc8fdbb107f4f8ff,t,52822,5679267,,5000070,2018-01-30 13:59:01,109
0xb468a46125a973e0624b9360e79f3335030a0c825dd5f7e3153f6898cd3d3e1c,t,52886,5732153,,5000070,2018-01-30 13:59:01,110
0x00f43bd35425321a02a90bfcb4a88911d7fd4dd4502643d484b4071c8c19ae24,t,52886,5785039,,5000070,2018-01-30 13:59:01,111
0xd42372d6f9499f25b0ef3735948c643ccc622842bd9303f629277c69ad434975,t,52822,5837861,,5000070,2018-01-30 13:59:01,112
0x514c062f11ec077b6e3205f2d607237245fa346fcf8a9b9b783a88885c9e1885,t,52886,5890747,,5000070,2018-01-30 13:59:01,113
0x63c042bec6ef6752eaf726f00dd0a730bc27650f98ffdf11e75cdbc2c3556c4e,t,52886,5943633,,5000070,2018-01-30 13:59:01,114
0x9d70737a6bd92c1bd394ce7a489a1421c7e3f2365a43f212d38e77c9eb28ebaa,t,52886,5996519,,5000070,2018-01-30 13:59:01,115
0x909941861accd385798a64114cf86e99dc758b4c02138db469f2c92307a43a04,t,52886,6049405,,5000070,2018-01-30 13:59:01,116
0x662399ad5c51dce9fa9e45af7625fc67b7a5fcc17d70d9f3a2e5966cc2526764,t,52886,6102291,,5000070,2018-01-30 13:59:01,117
0x4591adfdc27aa4d1b8e857f03166d40d883c03934a974f70046e7b850c097f59,t,52886,6155177,,5000070,2018-01-30 13:59:01,118
0xc56abd5a134626a2e4f5374faafbc9baea939c87efd616bb657eb7841ac32bfe,t,52886,6208063,,5000070,2018-01-30 13:59:01,119
0x2a68c63d496e0142dc648bc79b5f727cb379108f89723ab63056bd5573c59a7d,t,52822,6260885,,5000070,2018-01-30 13:59:01,120
0xe563d794cad7aeac44920d9ad83389c5f888649225321270a515e5608e2b3423,t,52822,6313707,,5000070,2018-01-30 13:59:01,121
0x94ad5354f34193b1376c127859c7977ed24cc9951cecb25f7131d2a54bd3fade,t,52886,6366593,,5000070,2018-01-30 13:59:01,122
0x521baa25c6186c6fa94848263d1428934bd0d0c7eca5d20d873d5a7346d1481b,t,52886,6419479,,5000070,2018-01-30 13:59:01,123
0xfecf2182093d00ac2915c0bbff9fe71250537ce8c8b20ee68a9dc836130a702e,t,52886,6472365,,5000070,2018-01-30 13:59:01,124
0xad91f8b386bbd990a66fe58d6c7200b7df6f0fc16cb07bf232e4e0348c679dd1,t,37886,6510251,,5000070,2018-01-30 13:59:01,125
0xcb2ca69e31df63f6fa2a35850cd36b702330fe2c6149e8eb1e984ab2700b151f,t,52886,6563137,,5000070,2018-01-30 13:59:01,126
0xdc77c645305f04164a4dba1fb5794b82785eb0080de8befd6fc4ea546c458d15,t,52886,6616023,,5000070,2018-01-30 13:59:01,127
0xde991a22da54c7e9244fcae7b037c675fe4a1424ffc7ab72fa4abfe09977e5c1,t,52886,6668909,,5000070,2018-01-30 13:59:01,128
0x8590c14246b6d89af5b18e98cd31ff77e6d5d26dd04997262a9264b502ab6f75,t,52886,6721795,,5000070,2018-01-30 13:59:01,129
0x00cddb6e413fdf17b2dd35b6248b230d4eed380ae348a1ece467539716903bdd,t,52886,6774681,,5000070,2018-01-30 13:59:01,130
0x9c7ecccbc78e569944f9969c802658e4aa6d546657b1933f8c61f24f8145e686,t,52822,6827503,,5000070,2018-01-30 13:59:01,131
0x50ab29f2ec3768bcb54076a09f454f8f909a7d8f9c9ee7f31109adc4e013e1e5,t,52886,6880389,,5000070,2018-01-30 13:59:01,132
0x29cfcca00ecbe0bd02537d425473f274c94d364e37dc9c4b00104d01afa696b5,t,52886,6933275,,5000070,2018-01-30 13:59:01,133
0xbce38961491747ccc3bcb05d2d953054da3f688773cf895cc70790d5dea63d26,t,52886,6986161,,5000070,2018-01-30 13:59:01,134
0xa4ffbf125adcc26803df0585783d51f6f194fc63cee8bd8f7e8022a9f951f1f9,t,52886,7039047,,5000070,2018-01-30 13:59:01,135
0x77b433f46c9aa9a450951cebfe92359bcecf418297e6afe3a681e3f68ee36c8c,t,52886,7091933,,5000070,2018-01-30 13:59:01,136
0x99aba42402627083e63509447b124a4708f35b2d3c442f292d61d875f0d1a8a5,t,52886,7144819,,5000070,2018-01-30 13:59:01,137
0xc60af9f9431bb6307566676c66ae66dbd6f093bffe8a728cad905a9c7e85f1f2,t,52886,7197705,,5000070,2018-01-30 13:59:01,138
0x5febadc94687a36320dd5c83bb756cce4da9c26f5a5128d59ac8bc387aa19e64,t,52886,7250591,,5000070,2018-01-30 13:59:01,139
0x9df9bdcbf937d85b0efc8a9e260c4e360d28f52af7879d3b2e47a91d06bf2438,t,52886,7303477,,5000070,2018-01-30 13:59:01,140
0xf2e0a97d61e5d07bf52eb8fe5fa90755e95b41d2329de693eaddaad48d20440e,t,37886,7341363,,5000070,2018-01-30 13:59:01,141
0xab4abb6c12599df7597cfcb9f650f5d0d94787a752a049d4cf2e378ebc1d974a,t,52886,7394249,,5000070,2018-01-30 13:59:01,142
0xa78bc4cedec4860ec323fe4864c05415d6a588f350e3b1dcb2413ff3682fa115,t,52886,7447135,,5000070,2018-01-30 13:59:01,143
0xa0bd5b38646d8e875aea404f38b82ec3a39093c933c5d7d3f70e6e102b2143da,t,52886,7500021,,5000070,2018-01-30 13:59:01,144
0x0aeca80afb18372e7aeda31c61159372054038c8f271e86f111fba57e81cd655,t,52886,7552907,,5000070,2018-01-30 13:59:01,145
0x3dcd516253b5d90a4c53a25c08bf9a6939ae27b08de5b42e2896e89af5cd12bf,t,52886,7605793,,5000070,2018-01-30 13:59:01,146
0x1d7bd0c24c01469045c8426cc256f59a006f2ae1646f75d58737299046415b49,t,37886,7643679,,5000070,2018-01-30 13:59:01,147
0x7973933cfda0f05a2f301369f020aab43dfb9644d64eb008ffc6b55c69a1a577,t,52886,7696565,,5000070,2018-01-30 13:59:01,148
0xeeee659d0e5f7c33b0bb8011f847920a925c05d274b1658c8d6dbbd4fc74357e,t,52886,7749451,,5000070,2018-01-30 13:59:01,149
0x6312df4a4cc6e25889c6fddbf84bd8896a482894bb0be64a71377064806eb45b,t,52886,7802337,,5000070,2018-01-30 13:59:01,150
0x6ce6b31350472754ffd0ab8cf8db0c537b2575f411ac63ee4c7d46d4dfe4dc37,t,52886,7855223,,5000070,2018-01-30 13:59:01,151
0x50f62c89eee4d6ee9900a15138836400a81852fba26cfad875c2ee9d02f17796,t,52822,7908045,,5000070,2018-01-30 13:59:01,152
0x162748136bd177c89b2bb54fb1c4d40d406dbee7cf7990a57d7626ecafbe902f,t,21000,7929045,,5000070,2018-01-30 13:59:01,153
0xce02e515c2228cc13b0d4ddc450544540dbc4c0f33fb1366b6301d327e92489a,t,21000,7950045,,5000070,2018-01-30 13:59:01,154
0x51b54e73c9692deb439d70c9a2c055f02a53815ce71af5df5f63647d7f86f561,t,21000,7971045,,5000070,2018-01-30 13:59:01,155
0xbe92fdeab9dfefdbcd42f54d2aa3085e190ca38f78f17fac386e470558673025,t,21000,7992045,,5000070,2018-01-30 13:59:01,156
0xfaf48ad212ae790eb76fb1f7808a78ca82d46cf9a7a5b7965b6ebccd8d1edaff,t,51470,51470,,5000071,2018-01-30 13:59:18,0
0xcd23749450612bee865c461f45c6a5e3070701ac30853327d6a64d7df5e9aff5,t,33341,84811,,5000071,2018-01-30 13:59:18,1
0x08448a0b6778332408fcfd4ddbd1e8f8c5c193756f7439421f02b527f6b088af,t,21000,105811,,5000071,2018-01-30 13:59:18,2
0x4a1261631ed5edf32a337f4165dc1b464da1e8ed9913efb8c46a59b1bc007640,t,52522,158333,,5000071,2018-01-30 13:59:18,3
0x48f9f92b2035eca664506a7b58ba541e24e3a0f67d0e8866527ea70d5dcea59e,t,21000,179333,,5000071,2018-01-30 13:59:18,4
0xa1ab8d9e55edf12039ce4b3bc0ec8c2ef72004b9c442fe729b2753e62a2cb094,t,21000,200333,,5000071,2018-01-30 13:59:18,5
0x2de9e288ad1acf64befa0f090c6055f2469e0f0a0ef720868929f3c6ce4f5453,t,22193,222526,,5000071,2018-01-30 13:59:18,6
0x8b7db50334f714ff72be2e2b3a051532566be68ed58f5f839ea0fab020b3707b,t,21000,243526,,5000071,2018-01-30 13:59:18,7
0x0a273f71881ed2c741a224de3c6eb94c7f17b6130d1d03561c9b659791396eb1,t,117637,361163,,5000071,2018-01-30 13:59:18,8
0x758b2672751d64c99c0d75fa03db6a207988da5f2f4a4eb5dc1ffd42c19f693c,f,300000,661163,,5000071,2018-01-30 13:59:18,9
0x1eaa4ea0f089e3dd49ebe4961f385f15f383d543650dda6afc5704a153955335,t,40843,702006,,5000071,2018-01-30 13:59:18,10
0x06ee05205ae7e178df56368f1b3bedf7f62dac8169279e3390e035da028b16c6,t,21000,723006,,5000071,2018-01-30 13:59:18,11
0x2b6c05da21f4ac04ca6f6d00d646e798038da9220fca661c232dbf5227439787,t,44854,767860,,5000071,2018-01-30 13:59:18,12
0xee3ab72489ad8705211f66b03e5989189564079b29589141c059c240ffd6877c,t,89678,857538,,5000071,2018-01-30 13:59:18,13
0x1b379011f2e378e86e071760836116c95dfaec252d6be753100b524d95b774f8,t,22746,880284,,5000071,2018-01-30 13:59:18,14
0xb40f8076a9c263047e7830139f67bfe00086719946e9713c9dacf33a44405504,t,21000,901284,,5000071,2018-01-30 13:59:18,15
0x21f9dbea0f03b20bd8809cd03b40200755a5527bfa5c42545d1ae9ca1f77f827,t,44493,945777,,5000071,2018-01-30 13:59:18,16
0x5f016eb0f129611ae947f032a90eaa720da9cf8bcd6a98b769b67c4bedff34fc,t,21000,966777,,5000071,2018-01-30 13:59:18,17
0x787534a62df5c26132c9985cfa427bf39fda949074c3d464834099bf981a14ef,t,21000,987777,,5000071,2018-01-30 13:59:18,18
0xc45dde36bebb01b8adb15f1e54556a997f57d7ad4a383338800ce8919232a1f1,t,21000,1008777,,5000071,2018-01-30 13:59:18,19
0xa2be3d7269a609a62d9bd378685adcc1e93f957b0715481a7ff31b29ec042456,t,21000,1029777,,5000071,2018-01-30 13:59:18,20
0x429062206e3fd91807651c4bf7ac8b0aee6d09793f52eab8402280f10e71554e,t,21000,1050777,,5000071,2018-01-30 13:59:18,21
0x443ac109df30330d0b3f397fb9ae6803f34b2be22616743f275a519745eeab3d,t,21000,1071777,,5000071,2018-01-30 13:59:18,22
0xa1e7dac9a044675644b82b829a25a46620174651ec80ee4981ce259aa5a75e0e,t,36708,1108485,,5000071,2018-01-30 13:59:18,23
0x8c9683ee179f5bc0986019f98fc83ec127dec4e5c710a19baf9b67e35d330d3a,t,21000,1129485,,5000071,2018-01-30 13:59:18,24
0x19d086011d6606fa6730949245fa42075584f6a4e1c51bcd6d8f4ec620ad97f6,t,98791,1228276,,5000071,2018-01-30 13:59:18,25
0xc64ad2f467483db19f54a1f60fa44d49e1903c6b4203792a5f8624242e7ef577,t,214974,1443250,,5000071,2018-01-30 13:59:18,26
0xfacf46eec26f2647cc9210dfc809d22f666d538a626b7c2283701ba0a8b6e078,t,21000,1464250,,5000071,2018-01-30 13:59:18,27
0x107360f9f27f66d834a8396b5bc7174b91bbe454e2d4c6f4cbdc0d01c4c2f948,t,59354,1523604,,5000071,2018-01-30 13:59:18,28
0xfcd2e8bad273b0df8c48e7af6c34b07f167e022b304e3286d11ad5bdfb0cc258,t,21000,1544604,,5000071,2018-01-30 13:59:18,29
0x2712fa64742d577685ab3f52f56d18b590501b22ae3fcef42a6d16c518f41eb7,t,37267,1581871,,5000071,2018-01-30 13:59:18,30
0xd5570e2eb3ead3b7c422d42eec9fc010d390f8ff266d7307a2d799932d00ca60,t,21000,1602871,,5000071,2018-01-30 13:59:18,31
0xbc0bbe764ca4d4ac02eaf5ccdc744f70fe2d2e653641dcf89bd90bf925cb2ea8,t,36947,1639818,,5000071,2018-01-30 13:59:18,32
0x63cfd50ed2f07eae75c7d1b1649f0e5522c49c88ae98ada517986e74c7baaf93,t,21000,1660818,,5000071,2018-01-30 13:59:18,33
0xbd1363bc4798c5b7af2411a33cc95536aadf3098139a4aeeef86c288d2b8280f,t,21000,1681818,,5000071,2018-01-30 13:59:18,34
0x63c7fd87c1f18a64344d7cb6d31426fefc9cda588ee91adefbba434e7838679f,t,51949,1733767,,5000071,2018-01-30 13:59:18,35
0x9780ea4ddb3607afe7fe691077c2f9d524c5737694c95ccf0cc327a46546e9ac,t,78306,1812073,,5000071,2018-01-30 13:59:18,36
0x6640dd91f73b52a5b031fc7ed79a1f12ae24b324885ae9cfacfa5bc7021cdbcd,t,37084,1849157,,5000071,2018-01-30 13:59:18,37
0x78b87e7021bcb0fae8b112bb770b12bfd5aa25f9442b72ad529268b66232a2d3,t,46018,1895175,,5000071,2018-01-30 13:59:18,38
0x625d9afa78172de7a3a2da5a4f61409350cecad3e2b49ab2a417f5d1c55e64f1,t,37366,1932541,,5000071,2018-01-30 13:59:18,39
0x2b415ebceca9958635bfa6c96503aaa9a44f687f6b43fbdf3f3af5788ada2011,t,37950,1970491,,5000071,2018-01-30 13:59:18,40
0xae9fc592c2221f91a98f81c127b8e8fc996cb99dc9f6df2f13e770ae538f7312,t,29493,1999984,,5000071,2018-01-30 13:59:18,41
0x9da5a15c357c0fe054a85b374b9429293e876596b60c3c0d43e81f9731e66462,t,21000,2020984,,5000071,2018-01-30 13:59:18,42
0x9c46fac9eea88c7d355487ed08f493e597027fc98be855d93c1b36ecfeeddaf0,t,22170,2043154,,5000071,2018-01-30 13:59:18,43
0x8cddbc0d06ef0aafc448ad4f2f873cb1629fa139c8a88aa2dd3450b8492e3b1e,t,21000,2064154,,5000071,2018-01-30 13:59:18,44
0x8debf0be999e8b3fee0c9fcb94289de9678528df2f2a6cb91f04c3fb1c929678,t,38318,2102472,,5000071,2018-01-30 13:59:18,45
0x90b1337d793b83fdddaa87f15053c932312c32f861c83faa4ce806a3264d40e5,t,52356,2154828,,5000071,2018-01-30 13:59:18,46
0x875474c0075dea912c67a0677a9b88be96aeffa8efc7470966f48fb3a829c88e,t,21000,2175828,,5000071,2018-01-30 13:59:18,47
0x849888a1a4e62c7049f733608a085bb6a3533bd43d67de99b78474d429066cd6,t,51820,2227648,,5000071,2018-01-30 13:59:18,48
0x050fb34a1a9d0c3b278aeb21c93c853e278468e3c86f2f10d5d976af9f8b3916,t,21000,2248648,,5000071,2018-01-30 13:59:18,49
0xbd716f46beb3eb2d5ea6ebe0ea7c9d927ed6ebd9c7aeebbd277be6f08c7b2fc7,t,21000,2269648,,5000071,2018-01-30 13:59:18,50
0x7d4ef8d3e4c659be540998f5a0026a1e45ad15027ba138bc37c0a6ed7c46d154,t,21000,2290648,,5000071,2018-01-30 13:59:18,51
0x338731c9b29e55d618eb72b4e7c974838db02d9c7a49fd96360c30ba2d8d1c40,t,37199,2327847,,5000071,2018-01-30 13:59:18,52
0xdcf2b4ee87d958421deb14d9d978f240f904c7b4d8de24879a2104a3bceeff8c,t,21000,2348847,,5000071,2018-01-30 13:59:18,53
0x6b446eeae34e077c2dccb5d2af56839ba910e6453e56ab00819c3a592472f434,t,21000,2369847,,5000071,2018-01-30 13:59:18,54
0x424fd8c4d67e3089802306e53ff7c8dbbe02099c1d6ac481ab9a66899c4cc036,t,37193,2407040,,5000071,2018-01-30 13:59:18,55
0xe6b0f39cbb0f2d821af330bc96be84e10973fbfac8769749ffd42c4ad5b3d736,t,22155,2429195,,5000071,2018-01-30 13:59:18,56
0xc0772f8a25347cd733d53d3c3bba49cf6e6b6b522dffd71a251d71e771dcf42b,t,22155,2451350,,5000071,2018-01-30 13:59:18,57
0x3aa26586acc62a0696fed4fbcbdff4841a55186b7b6494ec7a752e6bbc8b76bf,t,22155,2473505,,5000071,2018-01-30 13:59:18,58
0x3aeb20a838a7df8e811e407bebbebede422ffd4c0a4dd10eb7f7a582d09f5ba0,t,22420,2495925,,5000071,2018-01-30 13:59:18,59
0x0a4f64ce3cf8552a9071172a32dc3808fd475f95e18bbf654d682d86acf5a407,t,22420,2518345,,5000071,2018-01-30 13:59:18,60
0x0acffd9c7226f2a77e527e823e9a95fd00efe6c8e5edcd93fe32cd1870fbc6df,t,37918,2556263,,5000071,2018-01-30 13:59:18,61
0x4a845bdba8580c8cd62c72c0187aa70d8c3f1d0fbb7a7cc4a9a19efa224a96cf,t,22420,2578683,,5000071,2018-01-30 13:59:18,62
0xce6d49de9204bf4cf20392acfd6aa6fe700fcb959de6cf7ea8cbdbabcf1437da,t,37982,2616665,,5000071,2018-01-30 13:59:18,63
0x03754f5c1ac326a491c96e4f289eaca95e9b29a0cdd6262a11c0f05a302a23e7,t,22356,2639021,,5000071,2018-01-30 13:59:18,64
0xb85cd60db1815b9ba75fd9ea3b986c693419552ae61923257a7c6959415b3db7,t,52027,2691048,,5000071,2018-01-30 13:59:18,65
0x0d61811372c29801a8b4204487557385891d2663adde3d6c3d2bb1360ef0906e,t,21000,2712048,,5000071,2018-01-30 13:59:18,66
0xcd3a1eff510b57c199102b5c505e0efff6c090e3cd030fa842655715a9f52365,t,53233,2765281,,5000071,2018-01-30 13:59:18,67
0xc2874e3282717a7ddb40a60aa5000734d97cb5f3fef6f2716dae4bff5817e6ee,t,53233,2818514,,5000071,2018-01-30 13:59:18,68
0x9622043fb42e0a7c7536645393d507881663c56da0a61c757e345e4cdf0c81c1,t,21000,2839514,,5000071,2018-01-30 13:59:18,69
0xf0fea8a49643e8b8320e7b7e164806e74800c5fedc78bf9b1bb747a1e9ec8d6b,t,52524,2892038,,5000071,2018-01-30 13:59:18,70
0xcff8e0ce371fec986700bb9468a11ef99d279e44f83f0f880c3706e01b5e9ee5,t,21000,2913038,,5000071,2018-01-30 13:59:18,71
0xb7641d2bf175ef1177ba63af3e57746ae4ffb248f6fa24e3079aa433d106c19e,t,21000,2934038,,5000071,2018-01-30 13:59:18,72
0x63292eaa76df00fb7a226867f21fb976f5ce469b05d6277e8c850dd114670b92,t,21000,2955038,,5000071,2018-01-30 13:59:18,73
0xffbca02a5bf353a37eeb71e3b85eaed79561647cca0eb2a0ff178e5ca1dbddd1,t,21000,2976038,,5000071,2018-01-30 13:59:18,74
0xa48c61f2f2cabef58cc0ca49742bb6efa15967b2c5e22ad41fac9f9d78051039,t,59921,3035959,,5000071,2018-01-30 13:59:18,75
0x1351e2ddcd42f44abb22f30288f2cc103226585f6c6da76c07bb2c3d95db695d,t,142644,3178603,,5000071,2018-01-30 13:59:18,76
0x60df4bb18c3a7db8eb711d83e6d7237cd0c92c29a7083a4ca070dd66a23eefe3,t,127708,3306311,,5000071,2018-01-30 13:59:18,77
0xbe1c1bbd86ea6f05a5beb4f1950666a1ae65ac49bf744c8c539ca2d5a4543ee2,t,31984,3338295,,5000071,2018-01-30 13:59:18,78
0x0d682f404395127c73f241433335168e4d82eface7f3cb5a73ccfb3a2be5ee85,t,31984,3370279,,5000071,2018-01-30 13:59:18,79
0xa58289c28aa048b8ac3ab5c43ebab371258f032af016cd4cecd2b5356e655513,t,31984,3402263,,5000071,2018-01-30 13:59:18,80
0xd53cefdf5fc23e5c1bab45b76a1f6986afda3780e39ec47bd74e921c14eea3af,t,37158,3439421,,5000071,2018-01-30 13:59:18,81
0x4d5aa77519d6aa7618bda7cce06f52a04a46d19e65dbe6b146b67cad22bd6b6f,t,21000,3460421,,5000071,2018-01-30 13:59:18,82
0xe5afc2cda0c05545c7c0f12fa7737dea5d980270ec74da6a00817b73bcd09ca2,t,21000,3481421,,5000071,2018-01-30 13:59:18,83
0x0a050f19e3eca70d12a9038b8e5b20bf1ecebbd2e44f95cf91d40f05f94212bb,t,44418,3525839,,5000071,2018-01-30 13:59:18,84
0x26663f419553cbf27b350493d6cbd349c2aca159050aa956c05cc3ea870eb1b4,t,21000,3546839,,5000071,2018-01-30 13:59:18,85
0x97221783462a5babb0a37fa255c5eecb961bf94ce43f3fac46967e5e2253c655,t,22173,3569012,,5000071,2018-01-30 13:59:18,86
0x51b40ac2aedf03a6a1d725a338fef3fe409d2960009d31c93365a18d7ac14d09,t,21000,3590012,,5000071,2018-01-30 13:59:18,87
0x113232edcc1abe466f47af896977bf64837a462fb137629e2f8123b7fb102b9e,t,21000,3611012,,5000071,2018-01-30 13:59:18,88
0xbb6d37b488a5cb9e4d6f7e1d908ec33cc0b85f2d25a2b4e0afb23b74248a1016,t,21000,3632012,,5000071,2018-01-30 13:59:18,89
0x16fa43b2d47a4a3c2f14ae76c7e3faab5082505109aae04dd0e1c330b99f5403,t,21000,3653012,,5000071,2018-01-30 13:59:18,90
0x9337612c2c7a1e710a3fdc32749a617b6cd646b1efb4184993c30105ab6edec3,t,21000,3674012,,5000071,2018-01-30 13:59:18,91
0x9966eb10472e56539e126111c6370e9bf22c73989cfbac2baeca21c5394b4e27,t,21000,3695012,,5000071,2018-01-30 13:59:18,92
0x17286387e79a50ee9f9f93b48c0542b6c030121c7a61e9e4e78c6fc38d11945f,t,22678,3717690,,5000071,2018-01-30 13:59:18,93
0x5db470beb2154ce0a241e5caaa83af9ebe694ab0ce96d9e8a737facaf7155c9c,t,21000,3738690,,5000071,2018-01-30 13:59:18,94
0x5ed2f41d8c5add5f18cbac99f3be01733ef7de95af6e99ddcd541be3cadd478e,t,37139,3775829,,5000071,2018-01-30 13:59:18,95
0x36f45ece8ed298c0ab990080001c8010da0ffb1d03f2f0d68852ac0ed1f8b15d,t,21000,3796829,,5000071,2018-01-30 13:59:18,96
0x1cbfcd9ce9ecec27690e9cceee1aeb9b9c298cd8b27ed4d47aa6642afff664fa,t,22237,3819066,,5000071,2018-01-30 13:59:18,97
0x79706a7b0d1597042df1a3a928c760fb5c1827ec0c7211d26fefdcd2f2b77f07,t,21000,3840066,,5000071,2018-01-30 13:59:18,98
0x6ca5c6af9a4251a93c0b8d52229c7161df12bd7938e27101a51d3562ba8a0133,t,21000,3861066,,5000071,2018-01-30 13:59:18,99
0x1277eb770e98255ba8efaf15efcf6843e8dcb5a7ef74ad2f6b3caee0fda4bd37,t,67669,3928735,,5000071,2018-01-30 13:59:18,100
0x46ad68d73ec1e369fbabafb54683771753e9add4a6a847b3db2bb4e38d34fb28,t,67677,3996412,,5000071,2018-01-30 13:59:18,101
0x4996b4bf347481c6810abbe92d5257f33d4c67d80e4b240a8140daf6bece4e5d,t,21000,4017412,,5000071,2018-01-30 13:59:18,102
0xbb09fd57716674a93cb84e6b0afd175ced05230eb78bad262d8263914612be8f,t,21000,4038412,,5000071,2018-01-30 13:59:18,103
0x51681dcfed04c03e5b74b5246749048a7d25f502be2f08213fa9b324a000fcb7,t,36706,4075118,,5000071,2018-01-30 13:59:18,104
0x71c1512c1f2b0df1ccac756c4011d1f5091443ffa068ceebc4817d4bb11c7fbc,t,39210,4114328,,5000071,2018-01-30 13:59:18,105
0x77721db780f02cb4a3033a39bb098e8ae96c9b7cadf0011a8dd6054512dfd576,t,21000,4135328,,5000071,2018-01-30 13:59:18,106
0xb47ffa654f6f3b5e639ef2996366101a87692648f41a44374e627b6a0f754747,t,21000,4156328,,5000071,2018-01-30 13:59:18,107
0xc4ad69087b0a4041ea43775fb2a76f658f261c47b3e0b279c9430dec5a0c70e6,t,21000,4177328,,5000071,2018-01-30 13:59:18,108
0x4f513d97bb2178ec411eb9b92788483e3138d338399949c79aa09a14f9684102,t,21000,4198328,,5000071,2018-01-30 13:59:18,109
0x383473f9519037f3483eb6f75b434831c56c5c26a2df75f085ac5efa7d5e79b4,t,21000,4219328,,5000071,2018-01-30 13:59:18,110
0x04fe352a54f8fb81caa9b8ae5e45798fc2b664b4247e54965d133d651727b7ce,t,21000,4240328,,5000071,2018-01-30 13:59:18,111
0x1d16c54b3adb2076ef43c9cd6442ec6c0804f72058d2fbf9921aaaad678c17ce,t,21000,4261328,,5000071,2018-01-30 13:59:18,112
0xe0c74810fd4e0bece70b3f5cd105991f4cd25b16df5a1ea473414c0c70fb7931,t,21000,4282328,,5000071,2018-01-30 13:59:18,113
0xe02cd406e1baa4e96920f134f8e702c9a0b5ed0b1a422265f8bb409d45a9b872,t,22170,4304498,,5000071,2018-01-30 13:59:18,114
0x3b8d0eebd43e3108f4be6da0e7ed151fb630ce11fc91915def783657dacbfb80,t,21000,4325498,,5000071,2018-01-30 13:59:18,115
0xef4a44a2cc9898b02b91295735e25e490821defb86cac3557bb7a4108ced4225,t,21000,4346498,,5000071,2018-01-30 13:59:18,116
0x3a6ab7e542c8693f45d5fadf09d2b6b593d42a81705a0d1bc2f36439d0955545,t,22237,4368735,,5000071,2018-01-30 13:59:18,117
0x7b7464ae206431763d2caf83ecae2e2f05ddc29bfc14b87f1b316ce696c00916,t,25843,4394578,,5000071,2018-01-30 13:59:18,118
0x40d44f953ac51ebaaff281549ea393ecac537585edb708970bbaf57ab8128cd4,t,26035,4420613,,5000071,2018-01-30 13:59:18,119
0x1ef6bb155080e70ffa3fc5ec0aa7ba8d1ffd6354ce6551d2258996558b484102,t,21000,4441613,,5000071,2018-01-30 13:59:18,120
0xe63d8fdf55ad0ada2ae573696e8a1ae9aecf72ec6638268d76f5a74e04424ff2,t,36938,4478551,,5000071,2018-01-30 13:59:18,121
0x9757a8b763f6599fbb4ad870da05b2181b05212455f026161f03fa134c26cdb0,t,21000,4499551,,5000071,2018-01-30 13:59:18,122
0xba7e31cc7a127f2d7f86e796e71764673af48798c7b6916946345921c5d82d08,t,52316,4551867,,5000071,2018-01-30 13:59:18,123
0xd50d6fc091b02a01a0ef9b317de6e75b62cdea74b85423f4587a19d267cf7d66,t,55327,4607194,,5000071,2018-01-30 13:59:18,124
0x1435137d30af479a449c66b8433b6733f8b0f357485477d48a7fb1c4fc139635,t,21000,4628194,,5000071,2018-01-30 13:59:18,125
0x182091fd652ecf23c1d5bcaf0046cc59f150051a2144e30a9f19110796770b0a,t,21000,4649194,,5000071,2018-01-30 13:59:18,126
0x7c9d82ba9c1c62362bfbcab1da821a77b7c4ef88d842c811c4349f736f2fe9be,t,40733,4689927,,5000071,2018-01-30 13:59:18,127
0xf1fda35fe4911dfbcbe95036780ac32a2ae0e66ed467a86fdde439f5ed68022a,t,21000,4710927,,5000071,2018-01-30 13:59:18,128
0xf2e375bf3dbc609d77dfe254298df01e8fedc31456cac4f89311f0182db0216c,t,21000,4731927,,5000071,2018-01-30 13:59:18,129
0xde2de695bab18d58d2543e660f7c56056c0422e153a8de40aefb8e07f6a9956d,t,21000,4752927,,5000071,2018-01-30 13:59:18,130
0xcdd30751676d4e2e8a282d67daf093c6cc5224fedae3503ecb3b3b75998b9437,t,30327,4783254,,5000071,2018-01-30 13:59:18,131
0x752c281d1ce356dcc3df4dab1bd3bb859f48e1b20b22f9d0568e7e41d34aa708,t,21000,4804254,,5000071,2018-01-30 13:59:18,132
0x5f8cc41b11c361c4687c45c2ccabd79f419d58641ecce8322bf32522ed38bbd1,t,21000,4825254,,5000071,2018-01-30 13:59:18,133
0x88fee1d3fa0dd3197fb33d526debc14747a9e0c15bf3d643a59d8e0255e93058,t,22234,4847488,,5000071,2018-01-30 13:59:18,134
0x609fc0709a43a29c81eac92bfa60dce3f72fd3d6056328d3ba425ec7243018e7,t,21000,4868488,,5000071,2018-01-30 13:59:18,135
0xe9e92f885a64d8c5921b11a8682480f595cf46ea6757b7f9291d8093b9b3e37d,t,22106,4890594,,5000071,2018-01-30 13:59:18,136
0xbfc328af0a8c23d160683702f61783df9875d91e81c93bf8c28cb2c92ddde60d,t,21000,4911594,,5000071,2018-01-30 13:59:18,137
0xb8603fc6c09532ecc9712bd9bd7c6b17ebe27f2a463c633b2cbc0c4fc2629435,t,21000,4932594,,5000071,2018-01-30 13:59:18,138
0x9bdb125e65122cef9e4b17623a4ac752a372a47b888860064ff417f93717e5a7,t,73999,5006593,,5000071,2018-01-30 13:59:18,139
0xb129ca6befbc68c08101e6634761d7c0c673424bf0eb3ce762803409cb1bb4cb,t,22109,5028702,,5000071,2018-01-30 13:59:18,140
0xd2877c8da34461a28afdd646a2f3e1da1698494e43faaa3a9732d7d742d5999d,t,21000,5049702,,5000071,2018-01-30 13:59:18,141
0x66c0869e5eb6ebcefedeebbac8abd697d2d84b4e295e376dd312a851c09d85ea,t,53818,5103520,,5000071,2018-01-30 13:59:18,142
0xa0815637d0317a4ad46aa3adb42f0dab22d646299e7cf678e6ab7cb6adc91265,t,21000,5124520,,5000071,2018-01-30 13:59:18,143
0x9bea6db452b1fdfaf525998cf22244f6bf227f85c978c914f09e3d11ff5b8719,t,21000,5145520,,5000071,2018-01-30 13:59:18,144
0x982347ae349fcdf02ffd3b598557a821bc8c1e9657fc219cf1172b54f14aa01c,t,21000,5166520,,5000071,2018-01-30 13:59:18,145
0x7380aa8c793fb3f1e6336bfdbfe5dea3d011bdee361515fca75a8305fbe2dc3e,t,22153,5188673,,5000071,2018-01-30 13:59:18,146
0xa77a1c974e0907f95ea83b8920e6d03dfcfe18b5f1242f47291b927094f3b836,t,25843,5214516,,5000071,2018-01-30 13:59:18,147
0x8cd6611e5dfd2583d25fed5575774cb62da6940fd729c4d99dcb0205e125c7dd,t,21000,5235516,,5000071,2018-01-30 13:59:18,148
0xd06a548c6a2d94abe093df2ea56bd2a637368df59106a291134871ef6e84a656,t,21000,5256516,,5000071,2018-01-30 13:59:18,149
0xa90dd6b876aa54a5ee53fe479fdfd2fb6e6ec16adc34a4481822f04232675e28,t,22173,5278689,,5000071,2018-01-30 13:59:18,150
0x70ac4a80adba9319d56aff9491287b81bdf03adfd61079b7d1e0a0ea411d190a,t,22217,5300906,,5000071,2018-01-30 13:59:18,151
0x02990120569fd53b02664ddfe457fb705dce25f90501123aaa63e567f3a0a598,t,21000,5321906,,5000071,2018-01-30 13:59:18,152
0x23477cf4cd2e3ad06bd97bed5234081dd73b812342b62c7361ab15790dfae45a,t,22237,5344143,,5000071,2018-01-30 13:59:18,153
0xb77edc69a6a32020829d0a6bbc0a1555a8107d4bdd25d9c3db893bbb764ce3b3,t,21000,5365143,,5000071,2018-01-30 13:59:18,154
0x89fdc9b3e1a99bd11655a6c3a08739e8eb4699d1c815192cc1a0c2fca2881003,t,21051,5386194,,5000071,2018-01-30 13:59:18,155
0x8eb9e775cb2d71c4dcf24767cae616cff372e5888dd92e6789032300b6b8cbbc,t,21000,5407194,,5000071,2018-01-30 13:59:18,156
0x61d3acafba10a03cdb4f974cc6632989bbc7edb2c79a17bb67afc54073885a5c,t,21000,5428194,,5000071,2018-01-30 13:59:18,157
0xf61923e1869f5bab38149a0e94b2b55c8ef77b52efa0d78495bab093a2bef143,t,21000,5449194,,5000071,2018-01-30 13:59:18,158
0x5521fd9b3de06a05288cb8c1119595d04911145f2243203c6188363052e0b6f4,t,21000,5470194,,5000071,2018-01-30 13:59:18,159
0xc6fa5b539a79a0c2bfc490b953c16a38c2dbdbc471741bd03c4a1a92627ea092,t,21000,5491194,,5000071,2018-01-30 13:59:18,160
0x7c2f091fff6a34cdd7e3bc6a8b8c4ccd75cb8ae34a8785ec407b9b62bd80f4d3,t,21000,5512194,,5000071,2018-01-30 13:59:18,161
0x96cb44904295713700f47758d0676247f6aedffea16b5c2c6693b99c41ee5710,t,21470,5533664,,5000071,2018-01-30 13:59:18,162
0x52c91a0c1538ab7808d176ad86ca1cc16f1a3c9c2a909cc555c1dbcdf76dc8e4,t,21000,5554664,,5000071,2018-01-30 13:59:18,163
0xec5c28c59a1933caba1ed3fd81cdc17bf62f3a9c2808a32cce27b998ffab8d8f,t,25907,5580571,,5000071,2018-01-30 13:59:18,164
0x7a234db68703bfcd7934c9842c6b2cfa9448f63c1ab869952bbba15218257fe5,t,30011,5610582,,5000071,2018-01-30 13:59:18,165
0x85ee67741f63e267c6bc183ef03cd93eff6b496d1b4309e1b97a8b6041c17538,t,30011,5640593,,5000071,2018-01-30 13:59:18,166
0x93ac7f3e1bda2653b34617f5f841debcdfdde8f9c771decfa714dd66573a5f01,t,26603,5667196,,5000071,2018-01-30 13:59:18,167
0x513e415777c9b67272fe47f2d88a8f4c42644bd4c8a9b42a9e5d8e2755858a26,t,26262,5693458,,5000071,2018-01-30 13:59:18,168
0x7f7c7870138e76c28e4f2291c64c0ba6b4d1cd0710ad662625240194e0399b5a,t,98441,5791899,,5000071,2018-01-30 13:59:18,169
0xcb688d67f57200b9bd7d6814be54ae8e0e24fa44a1cca8185ab639d7366dcf02,t,253854,6045753,0x37b6e6E64074a68A988d52d379a8d3d0A564B616,5000071,2018-01-30 13:59:18,170
0x5de54f4fd70a0540b8319c43133bb83dc5a2cf985bb61b552b2b45c595b2b553,t,253854,6299607,0x0f48A51C78fdFC258af73075f0BfeE21429F2e73,5000071,2018-01-30 13:59:18,171
0x611f48331f2835834147700162644b230aa839ad667a635c90cb362606617e25,t,253854,6553461,0x24c052182C0c56B1FC5E7F2F53F6576914b351DB,5000071,2018-01-30 13:59:18,172
0xac42ff10250037fe2b8a90bf9e9e335b1b26fb68f6f0b98347e077fe68ac11b6,t,253854,6807315,0xc7077792197687D48a930Fed2c11D7b0e3bC458E,5000071,2018-01-30 13:59:18,173
0x4d6fbeeb14bb997be2b09e7e2ae47822d2d431ebbe095e95eecc49cbd1c97d5a,t,253854,7061169,0xfa0D6E6Fdc8313C960fbf463b09DCa9aC34aFD3b,5000071,2018-01-30 13:59:18,174
0x5fd46dda994944a9e190a83d06204184ce5fb15830fdfd82a3a5a5d955d23ef5,t,22173,7083342,,5000071,2018-01-30 13:59:18,175
0xe6491dac086a2d07449c8e93ebba18c51fc99b04dc7b3937d4da0c2bce37443b,t,21000,7104342,,5000071,2018-01-30 13:59:18,176
0x1430d8afccd372d6d539171b35aa708419c1b432ecb994e3fa05faab9cf1fd9a,t,22173,7126515,,5000071,2018-01-30 13:59:18,177
0x304ef5da691b20f79c3b83ea9f5e8847c85c88f0f8feb5b256fb0c8bc9e0147d,t,21004,7147519,,5000071,2018-01-30 13:59:18,178
0x5067bc81c99cba8a4e91f54c04e2c41ca346c49cb4558d729396fec30a164a01,t,21000,7168519,,5000071,2018-01-30 13:59:18,179
0x01d166f5396ad83bacc609d121cf0a24dcabfc3e7886ba3b842d9fef861580cf,t,52886,7221405,,5000071,2018-01-30 13:59:18,180
0x849ec93e88ae1edd8f04518c820a142bab4def190db8f01c773c0c04f79b4bf1,t,52886,7274291,,5000071,2018-01-30 13:59:18,181
0x21d75725bef9fbce09b4c814ba5ba341866535e9344b49c92a073b393dd545c1,t,52886,7327177,,5000071,2018-01-30 13:59:18,182
0xf8f6fb58ecaeaa82c00fd566c253d53479e2717d19e5d26d0c73351b66123160,t,52886,7380063,,5000071,2018-01-30 13:59:18,183
0x0c8f172c43f653c54d68c208fd4c5c487b7933db492db0e9e682e668bb7137ce,t,52822,7432885,,5000071,2018-01-30 13:59:18,184
0xf33ed34cd4f36b88e6f7c6a5dbd2d99a4215ce2059988cb29a76716c1ef983bd,t,52886,7485771,,5000071,2018-01-30 13:59:18,185
0x6a30f52515864e6ff3e46f4d9b9faffb0acaf500607b8852092e8472cf0e3995,t,52886,7538657,,5000071,2018-01-30 13:59:18,186
0xec5aebae789a5b1d51b6d0b7db993ef6ea89108cb75187cbf41c1896ff504040,t,52886,7591543,,5000071,2018-01-30 13:59:18,187
0x1c134170beb32afd7fdeae181b94cbe1909a18a18b248402a80d80a2ca11ee89,t,52886,7644429,,5000071,2018-01-30 13:59:18,188
0x171c77ea1ca9b2a51a5e1b5c9b6174d689dbbfbc70889bef2d4735302bdc7df9,t,52886,7697315,,5000071,2018-01-30 13:59:18,189
0x2e4716522797c058d875e72062eaa016b8bfdce2e084c3b5931b6de1b0056d5c,t,52886,7750201,,5000071,2018-01-30 13:59:18,190
0xbbfbd782e9eddfeaa838e5f5a70ce1c09bb3194a228eef6503064a3f30b7b22f,t,52886,7803087,,5000071,2018-01-30 13:59:18,191
0x632b8f9c47f94d2d1b862ee467b74da588be7a2d36a509066a6ca95dd4b1d09e,t,52886,7855973,,5000071,2018-01-30 13:59:18,192
0x46b85c312260c3318c710353369a8350c44141d2e390e6a38ea11d926f89a6b1,t,52886,7908859,,5000071,2018-01-30 13:59:18,193
0x0814511d35c95019d9c89dcfee3afe7ca16fe1102c3e49cebd21f1115f0e32ee,t,52886,7961745,,5000071,2018-01-30 13:59:18,194
0xa5348bfd009ffed9ed1a89f80aff0bf7bab89ef0f89b15731ccc91de5d3cf8a9,t,21000,7982745,,5000071,2018-01-30 13:59:18,195
0x5430a9e899ed4701db219cb54698a368d1ae57019f4fff9dc1e3cc511373dcd7,t,37219,37219,,5000072,2018-01-30 13:59:24,0
0xe6e3f3024e0682bf7948467fee662c49f7f5612b1686e2ca9beb600707c8f94e,t,21000,58219,,5000072,2018-01-30 13:59:24,1
0xfc0e65659c88a604c8c730ba87eae5c0aa11cf8ccfde945f074485017089d57b,t,37190,95409,,5000072,2018-01-30 13:59:24,2
0xf0264c938e0bf39281b41e4550ac11d8e8398700f059eae2e69ba365134c702e,t,34470,129879,,5000072,2018-01-30 13:59:24,3
0x5c581958009c5344de017cbfa7b0a063bcca6fbca767c1f1991687210fcda7c7,t,34470,164349,,5000072,2018-01-30 13:59:24,4
0xcdc4d0d8d3133b0837fcd06b7ecb82ef1f646fd02c825db0551574a07c8a6e41,t,31257,195606,,5000072,2018-01-30 13:59:24,5
0xa776192617bf2e645f307d1378fe9bdec6353ef018bc4336a2775e8b05ada612,t,39512,235118,,5000072,2018-01-30 13:59:24,6
0xb39412f09b955b176a81fb63ba2209029a8fe5671f361d4a022682f132bdd84a,t,21000,256118,,5000072,2018-01-30 13:59:24,7
0x2a8099c893e01af6bf886e86d0e0c408273831a70872cad2f4babc21bce68491,t,21000,277118,,5000072,2018-01-30 13:59:24,8
0xeb5f4abcf4a32d7d5a9a6a48b172afa41c9df022266a2a08651e525c63ba2088,t,39512,316630,,5000072,2018-01-30 13:59:24,9
0xe4501b083c8129b50a9dcceecf10ceec8103a4d7f9ff2a1e13c90e7276342765,t,39512,356142,,5000072,2018-01-30 13:59:24,10
0x5430d8c538c6ac7f28dd511ade138483362b8254c1a6cea74bd0f9a809366fa7,t,39512,395654,,5000072,2018-01-30 13:59:24,11
0xf849380ee4fe9c5d63b534441aad838f1daa78a9c530a345e6bb686564c32104,t,21000,416654,,5000072,2018-01-30 13:59:24,12
0xec71deb3f85dadda2f94113655e624453d7a1b233cd3dec46bfa28f58cc3f952,t,21000,437654,,5000072,2018-01-30 13:59:24,13
0x8b1ee4f0f684300cc71b8a0df301fb02326a6c3be7fd567c8d426fb85fcaa580,t,21000,458654,,5000072,2018-01-30 13:59:24,14
0x0886dcfa8c0469fcee4e779e25d6e07d7e1bc9f47f2f36bd943e1faa1bae982a,t,21000,479654,,5000072,2018-01-30 13:59:24,15
0x08a34259ffba5e408f8ec5bb684470ed8cd6029d3082e8722ef8eaf6190323e4,t,21000,500654,,5000072,2018-01-30 13:59:24,16
0xa18a00a08c448cdbb09330adb9af7e0805f85a3d634140a702e73b7ad7720660,t,21000,521654,,5000072,2018-01-30 13:59:24,17
0xa669299718139f555c14c55b5bcc6f7f6449470f2a029cadd4e813881ac9001e,t,21000,542654,,5000072,2018-01-30 13:59:24,18
0x520fd050b4994705f5a5836c52450f1563fd18ac8e40eb5a22877f0d4ab23d9b,t,53233,595887,,5000072,2018-01-30 13:59:24,19
0xca0afbb5bc13b3662872713e15a2010ebfa705370463eb63ee6d7b2f25f71fc5,t,22356,618243,,5000072,2018-01-30 13:59:24,20
0xba66abefd67a6ff03ac9808b484c29af713834cf607ecd41f10661f741389613,t,22420,640663,,5000072,2018-01-30 13:59:24,21
0x91abf8d299be250f8d102aaee361df9dc9b2ac1bb639325ac03340f243fb6684,t,21000,661663,,5000072,2018-01-30 13:59:24,22
0xf249b93e7eefe50bf01441d2c38f9013e9b50bde4c4e9de9ef6b6d0c464da281,t,21000,682663,,5000072,2018-01-30 13:59:24,23
0x2cf8510e9ed04cc96f45fb3ab81c05eaa91f5b7628feb061c2d6badfb0093694,t,52173,734836,,5000072,2018-01-30 13:59:24,24
0xf971ffa2f7dc782554b074c1d729a64a1b073f5f6454a49295d44f8fe751434b,t,40907,775743,,5000072,2018-01-30 13:59:24,25
0x0b9a51e6509561be9eb63437e3dbc4708fac6f9fb9acc26bb5b170ec67c10c39,t,21000,796743,,5000072,2018-01-30 13:59:24,26
0xe16933d069452103ae828a83810ec86d6311a7525b68f1e086d0e8012051da93,t,21000,817743,,5000072,2018-01-30 13:59:24,27
0xa8f4113e8424ed03d989cc9992853a4a76474654fa3a0d0ffa05a290bae85205,t,21000,838743,,5000072,2018-01-30 13:59:24,28
0x2481be47877e24e103aa72793faef52ff0d84077387c07a90a26c4f6e959b528,t,21000,859743,,5000072,2018-01-30 13:59:24,29
0x18d8bb8df010891211d5becf5abc40348471e601db40753ccf3fe60b831be3d1,t,21000,880743,,5000072,2018-01-30 13:59:24,30
0xf36cb9c90f0f0f8d58709b2c54226fdaa8a6dd652559eec931c7829321221110,t,21000,901743,,5000072,2018-01-30 13:59:24,31
0x7dc6665fc1dac1a05382afbbca628731e7fbad698720dab6581a16bad1c8fca6,t,21000,922743,,5000072,2018-01-30 13:59:24,32
0x75002033f5fb507ad3bc0f55681a8a620675b9389f9bd05a15a6706c0529f290,t,21000,943743,,5000072,2018-01-30 13:59:24,33
0x8a22ce41ddd3d0bbea073b72cc827bad1f927c4eac7759f7cb745c15edfcb900,t,21000,964743,,5000072,2018-01-30 13:59:24,34
0xaee36a475bb0503b1142de78faa664172ddb463281981678ba097233146f16cb,t,253854,1218597,0x1DDd54BE2cB6f846F92A2D7742bbb89633BfBb73,5000072,2018-01-30 13:59:24,35
0x6585c7e410e1bd36e48b10a044f83060eb10d8b165cce42ddeb30181a32fcba0,t,21000,1239597,,5000072,2018-01-30 13:59:24,36
0x171648ba43c4780a0fa207942a9ffe0ed09468cc363d81644a8dac6f69731590,t,21000,1260597,,5000072,2018-01-30 13:59:24,37
0x43c2971f03760d8d5b2545c6d72f02b8c5fbeb758c5e5453b729ce1a21d8155f,t,21000,1281597,,5000072,2018-01-30 13:59:24,38
0x6bceb085471975dc17752c70f1f17c29ede619f151783730e95308f241e7a6bd,t,21000,1302597,,5000072,2018-01-30 13:59:24,39
0xe2b8c364fa126415d86e661ccb8633face2ade8b10a89cfc4d729ad8891a2bf2,t,21000,1323597,,5000072,2018-01-30 13:59:24,40
0x46c037d688268b9fdfcc63a01a59b32d06242e08b582d7aa77fbd5aed65b8a07,t,21000,1344597,,5000072,2018-01-30 13:59:24,41
0x19164225ae6bc4817fb6c9dd1b400c05c318dd4557e7d480d472dc099c5533d6,t,21000,1365597,,5000072,2018-01-30 13:59:24,42
0xf6d52bbadcf3662b4717a96a48352898d234aa546dd1f6e892fc1a70bcd8ce79,t,21000,1386597,,5000072,2018-01-30 13:59:24,43
0xd362d25666fcfcbd82d92166e16258f72e04a8968af46caac710a13e6594b5f7,t,21000,1407597,,5000072,2018-01-30 13:59:24,44
0x9f83ae8837f024227f942a91233e5dec09d5f3c26b8be0f2417d70bd861e4454,t,21000,1428597,,5000072,2018-01-30 13:59:24,45
0xd7f29d75f4e50afcece5298e187021b59841e6272f4aa1a903bb92a619c54382,t,21000,1449597,,5000072,2018-01-30 13:59:24,46
0x1ed297bc1b386ed723156e520ce2c7cf596ac799a76515035b58f9da4c4a6ee5,t,21000,1470597,,5000072,2018-01-30 13:59:24,47
0x6dca055f115b8b52add53247ca7d8fa8283762428f13f84793d72b7fbddfacb1,t,22106,1492703,,5000072,2018-01-30 13:59:24,48
0xbfbaf41de49f7877dbcd9fdf0365545f0f3d0837b6b91934b4e4701bc4600d7b,t,22237,1514940,,5000072,2018-01-30 13:59:24,49
0xba2d6303121968349c171fbbb859d91e357a6e3b2d90d335d6ec87baa93ef312,t,21000,1535940,,5000072,2018-01-30 13:59:24,50
0x55b7922ef3d48dd4366b4d1f89bea0f7d236206853448727b2fd5052a06a2816,t,25907,1561847,,5000072,2018-01-30 13:59:24,51
0xd3cdfd1e5db9ef3784c9ecbb5e06c8a65762465e5545640fbe86e487953c6787,t,22237,1584084,,5000072,2018-01-30 13:59:24,52
0x916534ff4ff439759c988885799b50d6fe001c06514cab044ad935ce28106224,t,22237,1606321,,5000072,2018-01-30 13:59:24,53
0xafc0feb86a5201bd6e41d67867eafac46142b7ecba2d49e993ebaa3f9075611f,t,21000,1627321,,5000072,2018-01-30 13:59:24,54
0x726c4698b573e7427c49549f8bcb6b091943dbbc7ddfbbc289fc38a103e53e5e,t,21945,1649266,,5000072,2018-01-30 13:59:24,55
0x1f68d055e07dd23e0d10802e11ef3a3f74fe9ade22612933c92dff4c5e019f2e,t,30327,1679593,,5000072,2018-01-30 13:59:24,56
0xde0cdecf82d5814c04d220e31193380ef8575f69cfd5560065d4c523b7e01de5,t,22173,1701766,,5000072,2018-01-30 13:59:24,57
0x137c8a4d0ec22cc3fb571c4926c112676044ff29cb71cb28e328b83b071d0713,t,21000,1722766,,5000072,2018-01-30 13:59:24,58
0x2e4a27798e2fe4a614ca70da03debe6e1c628bfa163adab331e5845d6a4ad895,t,21000,1743766,,5000072,2018-01-30 13:59:24,59
0x812f41f7592ae258932a4f3753f2c8215cf590ef084f0024f939dcd3bd80692b,t,36856,1780622,,5000072,2018-01-30 13:59:24,60
0xa071ce87373da510705a96a86752d11148dbaf5cb9d05164fa5c853cbc1d3081,t,30327,1810949,,5000072,2018-01-30 13:59:24,61
0xdad649e6401d5cf428b2e3971c7836dc5f0a3629fee8576c9f6a887df2027dd9,t,22510,1833459,,5000072,2018-01-30 13:59:24,62
0x6226639b2508d4834f299b99160e6a0a828a3377f8c8876e76494d4bc4337535,t,21000,1854459,,5000072,2018-01-30 13:59:24,63
0xafedb20e95f5fc0dd15775816433df42bc645e4ab9a3dec1ccf967b0ddae5777,t,22109,1876568,,5000072,2018-01-30 13:59:24,64
0xf9c6d94666a5f399d36e2f03d7a68b4fc3b77408bfa6090ea43a4723a4646c27,t,21000,1897568,,5000072,2018-01-30 13:59:24,65
0x2d8150582f589b455016582e3d529ca00af8e68c13e0ac514a251f0e02d1a8d5,t,21000,1918568,,5000072,2018-01-30 13:59:24,66
0x69f93d59d908d0981dd9263b9b7ab6a8f56259f3f1153868126ebf7ec98d8be7,t,21000,1939568,,5000072,2018-01-30 13:59:24,67
0x0b365d9c224adb09fed87d2b7b3c2945b872b13a9a2befc9ebc373059be77e34,t,22643,1962211,,5000072,2018-01-30 13:59:24,68
0x5f917047aa64fe6bc6dfb678d2533bbacd0b47a95daa79fe93399bd926352111,t,37158,1999369,,5000072,2018-01-30 13:59:24,69
0xbb9e0dbdf15e46df5fe820872fe6f86ee1d6650fccba72944f1fab338c1ba092,t,92685,2092054,,5000072,2018-01-30 13:59:24,70
0x3bb5dfef567e91f57ca252c1cbf3da11a8347d3e1c6b8c080f5a2aa97f5c2ca2,t,21000,2113054,,5000072,2018-01-30 13:59:24,71
0x1b57c7837726d5908b21ba6fb3ce052ede53f20eaeddd72c89edc8f315ff71f0,t,21000,2134054,,5000072,2018-01-30 13:59:24,72
0x8d8fcca427698e72faa0d1af51242aa18918baf6ccd422dd32aeeb9c92f6fe77,t,21000,2155054,,5000072,2018-01-30 13:59:24,73
0x50960917e6dbd50f28d371885c183cef75b7cdc467d5d86282d019322c39ff0a,t,21000,2176054,,5000072,2018-01-30 13:59:24,74
0xfddf8a21cec67e5ad1cc7796bafaab5f2357758a87c3427254866d357ed006d5,t,52886,2228940,,5000072,2018-01-30 13:59:24,75
0xb0ce753656da6a6fb920b2263661628c2238e246b1335d299c6abd51844a0cad,t,21000,2249940,,5000072,2018-01-30 13:59:24,76
0xfa8b509b851794c9ea8a39d6577eab2e28d6608c18c2aeacc0c1f8c3a3b3ef73,t,21000,2270940,,5000072,2018-01-30 13:59:24,77
0x5b6b42299950e20ec14692344c7055e0a051fe0d1d1f88924b9af525747fa076,t,21000,2291940,,5000072,2018-01-30 13:59:24,78
0x9b8a9f3b608e0307175be23689cb967a383b500659690fcbcdb651a580e14d9e,t,21000,2312940,,5000072,2018-01-30 13:59:24,79
0x687e41f0a9ac1e4568a420ce0051148fc393dbeddef5acb57d83eadfc5b9349a,t,682013,2994953,0xDdb0115378d92E35118C8076cF0A8aFa13568260,5000072,2018-01-30 13:59:24,80
0x35688e27b463270ab5368a60f0a0ce9b340fa05e2297a9b249db17b9627f0f52,t,21000,3015953,,5000072,2018-01-30 13:59:24,81
0xbb652c8f6de67b3ffdaed862a60b01373d9cc13e7a33775f8ea8f186a08dcca5,t,21000,3036953,,5000072,2018-01-30 13:59:24,82
0x5f8f0339b0b7a049193e1d156b2b934a2d972dd8c06dacf846657a319f7808f5,t,21000,3057953,,5000072,2018-01-30 13:59:24,83
0xdb7b41daa64eb0b7b6979d1d114a921e8108293dc128c90a35d4df32b7f3f42f,t,21000,3078953,,5000072,2018-01-30 13:59:24,84
0x62e7fd8d30c7a88eb5f4d3801390cef594467dcc41badf01f942f875812fead0,t,164716,3243669,,5000072,2018-01-30 13:59:24,85
0xf2252c573828a47f7d261b68ee61f2a762861ba51e646acdd3bd2d9cbdfcc1af,t,4664268,7907937,,5000072,2018-01-30 13:59:24,86
0x0d1abc6a5b1d65a8d38aba265925d0d55d55d828d3306ae666ea340c422935c0,t,21000,7928937,,5000072,2018-01-30 13:59:24,87
0xbfef5a9799aa24a7f539dcd2ec354aa2cd18be84ee9a639be2f9323f26e990ef,t,21004,7949941,,5000072,2018-01-30 13:59:24,88
0xafecbed5ef6d15a319b09080719b6d2498d24735053e50ca446ec9e27a52beed,t,21000,7970941,,5000072,2018-01-30 13:59:24,89
0xbc2a1f73d3d93ab5b65fd46fb666610b2f8d0ce5283f74c1e67762e7009d223b,t,21000,7991941,,5000072,2018-01-30 13:59:24,90
0x93485c7f5ef51953dfdf4f1511a3438f9b51e83668f4b819c8cf688b7d821d66,t,21000,21000,,5000073,2018-01-30 13:59:47,0
0xe08e3c1cda3f6c1ca58079c515940dca966f59be0a03a9e8580c35b025b0d72f,t,21000,42000,,5000073,2018-01-30 13:59:47,1
0xf1a58e9a3e32bdc1cdb15308f3a2b09f5a264bf31435e208e95a0ddc8ab8008c,t,21000,63000,,5000073,2018-01-30 13:59:47,2
0xc1e762d7c052338af3cbe68e165b1ec6e3da3634eb346bfc684d20cd103b6f74,t,21000,84000,,5000073,2018-01-30 13:59:47,3
0xd3150108029f6f3664340489785017050a3ff997615287b339191593475d2cef,t,21000,105000,,5000073,2018-01-30 13:59:47,4
0x3860f0df63b2f4b6f5766868013ded3f36214a991a11297c7ab875833f397def,t,21000,126000,,5000073,2018-01-30 13:59:47,5
0x727a3d3369977bd88cf5d5c7833897bf095816f3470aa3c52b44eaeb3b60f149,t,21000,147000,,5000073,2018-01-30 13:59:47,6
0x5f908212a611647dec09922c179b6c5df2905124f5de8d226d05f9357384bac3,t,21000,168000,,5000073,2018-01-30 13:59:47,7
0x31da442760d0da3c063a2e61cd80141d1a018cc3f1428eb58f5e10d09a02657f,t,21000,189000,,5000073,2018-01-30 13:59:47,8
0x3cea633c4931bfaacfd8884a41627a1e193a13e52240887919a3d034e84d026e,t,21000,210000,,5000073,2018-01-30 13:59:47,9
0xcfe4fd3175fe0349773f2c9e61d21e2b71e6fce0ac2ae4b88a638bb69e2a40c2,t,21000,231000,,5000073,2018-01-30 13:59:47,10
0xcf6979a69d8506ccc0aec0b53714594f328d42b48378befd8d377578096c1fd9,t,21000,252000,,5000073,2018-01-30 13:59:47,11
0x09d6eaf60812cd832e88ed73f286ee0b9ae6f854097f12e1ad4b393948c6a57c,t,21000,273000,,5000073,2018-01-30 13:59:47,12
0x630498a38bfd1ced3cb7518b19c729326b4867c88aec8795f0af4d020a2efe1c,t,21051,294051,,5000073,2018-01-30 13:59:47,13
0x29b0bf6625eded2e48ad84e588df6850e0019319f5c7993119741380db6ac4b7,t,21000,315051,,5000073,2018-01-30 13:59:47,14
0x870c4c3dd013956df17d04602314a28ab21ec0f00f20a9013cb0116e7013c88f,t,21000,336051,,5000073,2018-01-30 13:59:47,15
0xa0fe6b54df5f550346f24027d07364f4bc09183a26f8851d4a397e7b26c36bd9,t,21000,357051,,5000073,2018-01-30 13:59:47,16
0x72e22a4c917de7e07a085c539173f65df1e6f706072129ce45a99c4bbf242085,t,21000,378051,,5000073,2018-01-30 13:59:47,17
0x750839124576d7844a454d540a80f5d9ef416a7b4fcd4cb39d54a4f3131619ed,t,21051,399102,,5000073,2018-01-30 13:59:47,18
0x4302240b1da40ad2058c6ec44e7e6c2db688d134a30a8bc23fb65e7d65f6b77d,t,21000,420102,,5000073,2018-01-30 13:59:47,19
0xe3dd27fe606b6b362eba95519a45e8a35a70f0bf9be7627df631fd72d9d88a14,t,39512,459614,,5000073,2018-01-30 13:59:47,20
0x7dc4683fc4df7aa9a72436d3def27227feafcde8bf2a30a923f81c23f2d6effb,t,21000,480614,,5000073,2018-01-30 13:59:47,21
0x1e7b65765fad2b158bfe08c61ae28da47a87d0264f3c02497c2cd170e0125b02,t,21000,501614,,5000073,2018-01-30 13:59:47,22
0xe3ebbd25c45e87a3a95a7bc9fdfa2577c6b62c12d942d08cac5818f5c2a51726,t,21000,522614,,5000073,2018-01-30 13:59:47,23
0xc4163df49dfb548cede0f90013d7d2b7c69f788408eea2f18cbda564637ccba9,t,21000,543614,,5000073,2018-01-30 13:59:47,24
0xd2d868671e64c25f9f170b07ff3729f1b03b23639fb8e56dda0c20f295ab72f8,t,21000,564614,,5000073,2018-01-30 13:59:47,25
0xbc4393113fbd240f07737277765987e4ce5e6e1874b41f469c5701469c38e8ca,t,21000,585614,,5000073,2018-01-30 13:59:47,26
0xe1f793a3a9f8842ae9a1f0ca10eaf55dfd24da8136b3e079a4daf26ab61c7751,t,21000,606614,,5000073,2018-01-30 13:59:47,27
0x6b1c88a24acaf80c3a74fb4929b8a45d98120f5534553054b0f56e20ee634219,t,21000,627614,,5000073,2018-01-30 13:59:47,28
0xa02e51beb9bd528e2d501b45a87b50b980df1d53b1dfbc018b6f4bcf04bea80f,t,21000,648614,,5000073,2018-01-30 13:59:47,29
0xfe87f808331584ac460bd064a1d9074065ac5556a60eb260ea279043649b0b25,t,21000,669614,,5000073,2018-01-30 13:59:47,30
0xf78987b684767a3d21816a90e206be2ec2049dfd6a0bdbd616c78ba6c77fcb3a,t,21000,690614,,5000073,2018-01-30 13:59:47,31
0x1f772597a96716dd2ccbd42408e7cd5c4845f7bc09a96aa702c1cb1bd4d5df52,t,21000,711614,,5000073,2018-01-30 13:59:47,32
0xacbac61bd8d47ff6056b277fcad65a2fa2b81eb040619f93314879177603be29,t,21051,732665,,5000073,2018-01-30 13:59:47,33
0x869f0e22c51e121617fefb6bda0da40f328b3887a094a89732d422cad55814ca,t,21000,753665,,5000073,2018-01-30 13:59:47,34
0xead34fa9301570813b8b7efe07b19310b338959c62cec4bb42916771bf59396d,t,21000,774665,,5000073,2018-01-30 13:59:47,35
0x10d68ea97c7680de9e396ddc1dbc6b8736bec5d7c00dff365680eb997ea5d23c,t,21000,795665,,5000073,2018-01-30 13:59:47,36
0xd297c8245881d6896976dcc4ea6e5f8d85f058bab13fecb121ac7b1c87f96ec2,t,21000,816665,,5000073,2018-01-30 13:59:47,37
0xf51660a85e7c0bfe243f78119d311a55cd896008018072791d5d69582fa43769,t,21051,837716,,5000073,2018-01-30 13:59:47,38
0x4804187b627d0dfd659e1156798903a3a138b61d1b09bdf2b26377086c59acd7,t,21000,858716,,5000073,2018-01-30 13:59:47,39
0xac3c5ffeb8f1b2ad7cfebddf0968c29c140ea9b6f17f4c71725364aeb8868a12,t,21000,879716,,5000073,2018-01-30 13:59:47,40
0xd6b587bb0faf9073022b4a8235bd3b08a8e7f0e9209a017798ed5815d71b3be9,t,21000,900716,,5000073,2018-01-30 13:59:47,41
0xc7221ada0678430ae29f597f0e3e4c87c9914939eb6fa326d3455870bc8de9a8,t,143081,1043797,,5000073,2018-01-30 13:59:47,42
0xb2d38bb6aff160785ddd169f43c05eb1e279867fbf950e203f3990ab6930d431,t,21000,1064797,,5000073,2018-01-30 13:59:47,43
0x0f4d2dc467bbe213af6b0e6e78b0affd889722ba7e43ee3ace8ef61c09bf3175,t,52155,1116952,,5000073,2018-01-30 13:59:47,44
0xc14f8c2e29c791b7b0075a2e8b36fbfe67c8f047dd131f58fe2949c7620d814f,t,21000,1137952,,5000073,2018-01-30 13:59:47,45
0xfc40030f5e4f26ef6fa84cfb576503c79a81ceb757f92fe0e64ddae0a1b7e524,t,51698,1189650,,5000073,2018-01-30 13:59:47,46
0x69f445be1ed5795f0bb7244a42d0792658f0d6dab1121d475917b74177f13af6,t,21000,1210650,,5000073,2018-01-30 13:59:47,47
0x91625c0e60769a6d99bd82162144cb179d7182dec40c717bdc99986eea3ce032,t,53526,1264176,,5000073,2018-01-30 13:59:47,48
0xb29b6575ae24a9c3f2deca0c04021f94f0cc4025cbc2d36ef8aac1b68ecb859c,t,34470,1298646,,5000073,2018-01-30 13:59:47,49
0x05c4174214dfb71f2e8a05ec04f4999ee58f0b6dc03470ca76c43685b0823f15,t,34470,1333116,,5000073,2018-01-30 13:59:47,50
0x61fe6e324d46fe0dc2ec5c2e2ea0c4b074800acf91514ddcbcb02a3a8439db0b,t,34470,1367586,,5000073,2018-01-30 13:59:47,51
0x39aa99e78cbc09f66c1f97b4daf6bc3bd86fbcf4eb2aac148ac1428315a3abf4,t,34470,1402056,,5000073,2018-01-30 13:59:47,52
0x3ec9c0df2539e798da2263393669d27839324a0187fa3964044e01f53852f30c,t,34470,1436526,,5000073,2018-01-30 13:59:47,53
0xa05d778f93f3f4f1dff50aab3c4d9674e22403a3b851b16e0e825bbee01fe3f4,t,52186,1488712,,5000073,2018-01-30 13:59:47,54
0x4bd21a7c717e68568f18a0a6a292ea647f84373cf22ebe3879340e933fa1f8ca,f,24248,1512960,,5000073,2018-01-30 13:59:47,55
0x97cfbb641ece3a74cccc70a5a22776f13daaa1ba395535eecb70495af34a9f71,t,21000,1533960,,5000073,2018-01-30 13:59:47,56
0xacfdf0ff1912c7e5f7f1c29205efcc23ad4dcb7f4018d5051dc6aab96017e2fe,t,21000,1554960,,5000073,2018-01-30 13:59:47,57
0x93b113447645b21506dd6cbe53f8f5987b78dd147af6a07471515dc9dc44c64c,t,40843,1595803,,5000073,2018-01-30 13:59:47,58
0x027b8f6988f98c8931fca3226aeb48f2f243f294f3d11b36623b979d77c2e99b,t,21000,1616803,,5000073,2018-01-30 13:59:47,59
0xcc56a869771b18eff8e9e820b50d73c89db038eae8f511b2be26f69d85e3c4c3,f,40000,1656803,,5000073,2018-01-30 13:59:47,60
0x05300c20a9043b28c6de79a14a029a900ad9880dadc205063115f7940ae7827e,t,21000,1677803,,5000073,2018-01-30 13:59:47,61
0xb982f9e04a5ffbb05d040155d4764443c12feaef6141e1a71a9ffb345abeda49,t,21000,1698803,,5000073,2018-01-30 13:59:47,62
0xcf3545cae3e627838ff0dc77e589c782c2d2db3916cb1e9a464ffd0d10cea996,t,21000,1719803,,5000073,2018-01-30 13:59:47,63
0x9dd519a28986de791825675f26b625f964e43bda349a9fab8ea2b1611405064d,t,21000,1740803,,5000073,2018-01-30 13:59:47,64
0xd4bec67e6ce8f08a14c20945650bb2ac8114a77b4c2f5fce2bd3bdf9bceaf9c1,t,63482,1804285,,5000073,2018-01-30 13:59:47,65
0x194418569c0fc33f56aa0542540a6f4c0b35b590791084f32fe4b5f16dbc25ac,t,37052,1841337,,5000073,2018-01-30 13:59:47,66
0x16a8f72872a26f88b1f48f06b3657c0a8acdb47025951604150b27f47fee079d,t,38615,1879952,,5000073,2018-01-30 13:59:47,67
0x5de16cd3d6f7ab44360872a3fdc9f1a26964dee346d0bceeee94b9a3183699ea,t,21000,1900952,,5000073,2018-01-30 13:59:47,68
0x9f17f2f9f3ea7979c7cfdcaa591a5357b8f41d35f4baf11dbf74945ab2902c91,t,21000,1921952,,5000073,2018-01-30 13:59:47,69
0x5381950fb467d32a685b9f57fc6a433b1041678ca6c5bd8a0991d7d12c07c0e1,t,21000,1942952,,5000073,2018-01-30 13:59:47,70
0xe6599f3efa1357e2375f8b8a08f48c5dbfa35a35382dfba7276edd83ca7373d2,t,21000,1963952,,5000073,2018-01-30 13:59:47,71
0x3e8d80b7a3c0b1232b795a9bf860308ed7f9ab573ea333ae8ca6ef0187cc3740,t,21000,1984952,,5000073,2018-01-30 13:59:47,72
0x36669126a91c32fb7332294742c680f72f5c79c268995bc2bb88ed619a8a0882,t,21000,2005952,,5000073,2018-01-30 13:59:47,73
0x20b0f3cc5c3eb28c0c7dbb1f8770218c896c159ebfa5f12e0a965a60265c6e6d,t,78370,2084322,,5000073,2018-01-30 13:59:47,74
0x95bb40eac5321381607e4af22ab65ec76af6f19763d1c92de24997c798be0549,t,21000,2105322,,5000073,2018-01-30 13:59:47,75
0x3f09a471880bf15d300d18cf89c060009db2916b2b3146724451b6717943769a,t,51522,2156844,,5000073,2018-01-30 13:59:47,76
0x6a9cf95e5867b04a62824ec5989de1e5cab1e8fe32752bb5123f2263ab239916,t,21000,2177844,,5000073,2018-01-30 13:59:47,77
0xa9daeb8633cc20d5a3bfe0cb0471c605e7c21b8beb28a4cf522a94b5bae86db4,t,64725,2242569,,5000073,2018-01-30 13:59:47,78
0xb39bf952ee64b6759b8008059bf2648b0c539a904c18eeb36ca474bab5535768,t,45598,2288167,,5000073,2018-01-30 13:59:47,79
0x388971a2394f834049205461b03f451f38b59861bbb76a121a8d9b5b526dd677,t,38221,2326388,,5000073,2018-01-30 13:59:47,80
0x55bf7f80a2988707028cac01aa684672dc57980f8eb027c5399e700062431651,t,48021,2374409,,5000073,2018-01-30 13:59:47,81
0x6189b442d525f43fcc8952489f3098b67ef7e5fbcb0c00170cd4d6313cf38a2d,t,51762,2426171,,5000073,2018-01-30 13:59:47,82
0x855d3c9af0de4470198127e784d81ac339c819924ca7cab805ee572300d0cd34,t,37084,2463255,,5000073,2018-01-30 13:59:47,83
0xe7bb1d6be862c336500dcb19fc029accc835531c31bb877c35bc65845360ff69,t,91781,2555036,,5000073,2018-01-30 13:59:47,84
0x028ed2b87b8fbeb6b7c9d753ad52e57d9dfc2b2bd6be7f43932e79ba2749728e,t,21000,2576036,,5000073,2018-01-30 13:59:47,85
0xe4a7eefd1e7097be50da6af661b02e80aced5c93ff6cef6ce034899803e713c5,t,52356,2628392,,5000073,2018-01-30 13:59:47,86
0x25860c5907a9b40bc4ffca2212ead3973c0722d50fe39bc21e9cf81fc1fe60e8,t,63122,2691514,,5000073,2018-01-30 13:59:47,87
0x1f9b48e6757d35ce5595438e41a3f8f7ae96984fd5daa9be0b1f5cc3d38d7791,t,21000,2712514,,5000073,2018-01-30 13:59:47,88
0x30b88170468a99fe2ea4e2d0f03a9474c2e4646dd195a2b0d52d650a76ae8ec2,t,21000,2733514,,5000073,2018-01-30 13:59:47,89
0x53d8bbc0d4dd4dbb1dacde17290891d19072c1f7bca02e119696c0a4e0a90654,t,38754,2772268,,5000073,2018-01-30 13:59:47,90
0xb0018db9e966d85cefee80b95cfee489eb3f5997c9d8bc536a84a139712026ff,t,22356,2794624,,5000073,2018-01-30 13:59:47,91
0x613c8fd2a28d7ea879f70c487250ee8d5acafe9e7de51cf529e276557646466a,t,38754,2833378,,5000073,2018-01-30 13:59:47,92
0xc30940c8e9b39e376a71eb14ec68cbbc12061f459b78cce9769088486531bd04,t,38754,2872132,,5000073,2018-01-30 13:59:47,93
0x329666cfda8788f30636b1a4af5a7246ddbb49571fdac65006039f948096aae6,t,38818,2910950,,5000073,2018-01-30 13:59:47,94
0xbc7ef6d3db9bba3628ce00a6cfe851b1dae591a403d4eea4386d82f54eeaecc8,f,110000,3020950,,5000073,2018-01-30 13:59:47,95
0x4d8484c417c469dc2f6d201851ea3e5082a0ca7c52f387933b2944f7e67f270b,t,78178,3099128,,5000073,2018-01-30 13:59:47,96
0x1ee4bf39733cd8ba749953c7b60c762fa18e86157cad30e76477334397bdc8bb,t,38002,3137130,,5000073,2018-01-30 13:59:47,97
0xbb2556f75794d3428b604ec60dc87c49273e7e58c50cae74cf8497a40da3c8d3,t,21000,3158130,,5000073,2018-01-30 13:59:47,98
0x70c1142d34b41842ede3ddd0eeebaf8f6eef5402c06ba18155a9c4616e1b4710,t,21000,3179130,,5000073,2018-01-30 13:59:47,99
0xef6600ed4714b6b05b29c9ba461452e8a930bd2b995d630eb35fef458cac050b,t,21000,3200130,,5000073,2018-01-30 13:59:47,100
0xc4fafdb09524fe12f0ba27d78f9708c8f90348d78b26195b18da53a612d1bc43,t,21000,3221130,,5000073,2018-01-30 13:59:47,101
0xc361b57c522767d1105b24011a022e9ecaa4aa7752c32aa512eded8dfcd82ad2,t,21000,3242130,,5000073,2018-01-30 13:59:47,102
0x9719cab429bedbd9ea5d6533f71f035c46b967cad64f0d23bfd9dc4d4ded5c33,t,21000,3263130,,5000073,2018-01-30 13:59:47,103
0x5e61a739077e2b432f210ee1898652196206579d84b999830ff17dd157b55c94,t,242521,3505651,,5000073,2018-01-30 13:59:47,104
0xc2de54ac15e13b2f562cc8713dfcc65bd28132984f8753ba5d1b1c2b8c0bb9d4,t,37106,3542757,,5000073,2018-01-30 13:59:47,105
0xcd5f50078f5f7d0bd0624197e3f84d4f0c9757a36331ffc801de6f657d75906c,t,92730,3635487,,5000073,2018-01-30 13:59:47,106
0xe030353421217c3873e7308ecd68f6f88aef5580da75fe8d20fd20bbcb0deaf0,t,21000,3656487,,5000073,2018-01-30 13:59:47,107
0x53655aa950a32cb3a2dcca1b1206658df18f51ab02f9b2fbe8f0aa9c8c414955,t,55843,3712330,,5000073,2018-01-30 13:59:47,108
0xa16d98cfe946a93c056bce5175ae87339d02d9dbad3010b8493a54c9acbbe1c9,t,36955,3749285,,5000073,2018-01-30 13:59:47,109
0x3b625c8e54644b107b2c13a24c87ce027e60d84ca5ea86a24bf92210af64d83d,t,21000,3770285,,5000073,2018-01-30 13:59:47,110
0x67736caa3824e46b208e5f6d877a20a0e10d9fa8d939fa678ea2353c9f052405,t,37766,3808051,,5000073,2018-01-30 13:59:47,111
0x1614f08981071c838bf1a88b9efc931dee047e5dff147f36fd98616e78a53c91,t,21000,3829051,,5000073,2018-01-30 13:59:47,112
0xf5ebb3d6fadf9fc1ab60f5ebf7dec137125ef87c6356f1129a5ceebb18c01771,t,36765,3865816,,5000073,2018-01-30 13:59:47,113
0x5093bdedebbb278904c1d391e9bb68b7ec3654bc0f2e6a58792118c49ebe6055,t,21000,3886816,,5000073,2018-01-30 13:59:47,114
0xe1378743396927897bc57fe57eed9a0b62ba1ada902d2f3d3238aefb1381f8ae,t,52886,3939702,,5000073,2018-01-30 13:59:47,115
0xe6a24f5be2b6dc43ee9d69b17d164089287810bd4c8c23b6c5de3fc1711f4c17,t,253854,4193556,0x79F7a2c50bE07B2724eD7AAaa4F816E8f348d0c8,5000073,2018-01-30 13:59:47,116
0x93625a681ba15785ebefbb1ebab059b73cf3bbbb73af31548a7fa17655199785,t,21000,4214556,,5000073,2018-01-30 13:59:47,117
0x17ec96f5f77516865cbe35378c293915df5379053f2313b1ab610c622ac59d39,t,30327,4244883,,5000073,2018-01-30 13:59:47,118
0xebcaf1e66f5a37fa4bd4e242891ec0d16e7c422a70e8fbc8159a7b0d032ca76d,t,21000,4265883,,5000073,2018-01-30 13:59:47,119
0xda66552b44e857d22ce9a76129c980b460e2999b34ea85633f4768e57d22bec8,t,92549,4358432,,5000073,2018-01-30 13:59:47,120
0xc500152f89a75a2689526ab01e24cb9f77d162c1535b825e89d247e81d99583b,t,36792,4395224,,5000073,2018-01-30 13:59:47,121
0x18a50192c8dc81550d6b37e9d5f2148a2a4602de04ba97c2c9f5d59c1a5b2af1,t,21000,4416224,,5000073,2018-01-30 13:59:47,122
0x24650eb8bf18ca88b0e45cd925495d5689bbc685b5aaf3cd421bcb110dc0ee89,t,21000,4437224,,5000073,2018-01-30 13:59:47,123
0xd4aec053262eeee9c680da200a07d752b6dbde5f77d690591a95becce72ee8f0,t,38133,4475357,,5000073,2018-01-30 13:59:47,124
0xb7879ec37a9efd6760158da416f5ebd6fc1e99c9084b70cbfba4b3b2fee88957,t,37900,4513257,,5000073,2018-01-30 13:59:47,125
0xdb593e8ef2e53a6ce3bd55a8f456d193427bd304443ffcf70eda6801b7699768,t,21000,4534257,,5000073,2018-01-30 13:59:47,126
0x10723c6414b2b704752d37b4c8b248462db8d16f5b7482f130eb29fb33eaf4d1,t,53551,4587808,,5000073,2018-01-30 13:59:47,127
0x84647768374c94395036f5a08a64cb75cd4488b7112275f196217d19bb276f33,t,21000,4608808,,5000073,2018-01-30 13:59:47,128
0xa2222e2dcdbe7b16f7dd2a67821b1da9d8005e8763b2e0cb331ded093545ec65,t,21000,4629808,,5000073,2018-01-30 13:59:47,129
0xac92d969729ac034586778ab78fa08451019daf4b374269226940e8c6d211698,t,21000,4650808,,5000073,2018-01-30 13:59:47,130
0x9377c8ab85eaa0f88dfa80c082316a30559f28605d384583c0ca93222c8c23a0,t,21000,4671808,,5000073,2018-01-30 13:59:47,131
0x28debc2254d3db4d9e870a07640400377b0024c583eff90df925d1b6f069e6e2,t,21000,4692808,,5000073,2018-01-30 13:59:47,132
0x2bd52391306df8adf9cc26bcaa2cfe82e940ab76dd72574e67a3bbfcab158947,t,93498,4786306,,5000073,2018-01-30 13:59:47,133
0xb979237985d61a49e8628b3d11dab0d12e7655026342d6e4288f1a4c3ae74e82,t,21000,4807306,,5000073,2018-01-30 13:59:47,134
0x8a43fa1672841f5eecba08056e5f95a59578ee8e540a375b5cfbd13d6ae51894,t,52810,4860116,,5000073,2018-01-30 13:59:47,135
0xf547394d5087dccf3e7dd91201170b4b7edc03a4399eeb3bef3b0392f56f2294,t,21000,4881116,,5000073,2018-01-30 13:59:47,136
0x1c61e022019cdca2246531e389874fe258e6f73c0cb71f5224faed4d3b3e4545,t,36848,4917964,,5000073,2018-01-30 13:59:47,137
0x07baf0292d25daaff343e9929f083a37a29016c4d27a02f232c5210713e446c9,t,21000,4938964,,5000073,2018-01-30 13:59:47,138
0x667a1f9de0f73ef6d5d7ca8f43cb43f436914c24cdbc02574685acf3a5977b8f,t,21000,4959964,,5000073,2018-01-30 13:59:47,139
0x6a0620a135caaac08e3996a62997c9f9a07685b31fb172a28ae3252059989f42,t,21000,4980964,,5000073,2018-01-30 13:59:47,140
0xca74bd1f2acc9c3a65c963d37b94835defd8f5eeeb5090aa47db2c3d1dc94e60,t,36770,5017734,,5000073,2018-01-30 13:59:47,141
0xa7b9146745f2b803365adf474c26ee890a090d9931ec969b61bebee0936e55d5,t,40005,5057739,,5000073,2018-01-30 13:59:47,142
0x4c73fffb86088e023d1eb3885314c7df58c2de09664b01cdae740c883c40d902,t,21000,5078739,,5000073,2018-01-30 13:59:47,143
0x3c967e9ad9ccb3850367c395506c323e083376ed99d4d3d75644d87c08df0ccc,t,21000,5099739,,5000073,2018-01-30 13:59:47,144
0xe175cad54bb316df63429f72bbdf2e561955c543a33dc53a7666978c5e65832e,t,21000,5120739,,5000073,2018-01-30 13:59:47,145
0xcbe74e168b3da92d8b0b7f0bb86bcfd481e39833aa980fc9b1151533bae2ca55,t,21000,5141739,,5000073,2018-01-30 13:59:47,146
0x6e649e5b5d04a8b30212e2ffab443a2155ae12249b0f88fa729225accad2fe27,t,52094,5193833,,5000073,2018-01-30 13:59:47,147
0xf7c3421cc8b335e1daa1cf78c3adca04656632d166bf0ab0ae91952f33ea60ce,t,21000,5214833,,5000073,2018-01-30 13:59:47,148
0x4d31611a89eba28233b08f63d5913e0280628ead7437bc78fa8c52196f6b6f30,t,21000,5235833,,5000073,2018-01-30 13:59:47,149
0x6273fa39637ba998a3807a7d5fd7330016d3bd3b1d3d12ee1f04399ee46136cc,t,21000,5256833,,5000073,2018-01-30 13:59:47,150
0x4a0a0aa1cb522ce1c6f1f023140edb06f4427d66744dd68f40a1e08ab62c28e2,t,21000,5277833,,5000073,2018-01-30 13:59:47,151
0xdcf1c08ce68b41cbc5287b7ad0eecb73e6d104662ee59daac1106e4439ff2d2b,t,37132,5314965,,5000073,2018-01-30 13:59:47,152
0x736d94aa1363b8a15fd1b7921a26e38d5fac3e3ad87338df9fd9acea85186a58,t,141215,5456180,,5000073,2018-01-30 13:59:47,153
0xba491e347d940b2ab0f41a1798a32e5098f06b6968d2b2da69edafdde2a2759b,t,41872,5498052,,5000073,2018-01-30 13:59:47,154
0x88493c8df679b95bfa9bbaf24d198a03f94a2217d6465630014109629d914930,t,29493,5527545,,5000073,2018-01-30 13:59:47,155
0xb7b32158277be68adb3dfb443d9a5af28692955d2679018178a80d7c9c4824cd,t,55907,5583452,,5000073,2018-01-30 13:59:47,156
0x7ffcb1c587f24d2374db7504eae9832eb7a6b83c493744c8b9acbd14d7c54aa5,t,21000,5604452,,5000073,2018-01-30 13:59:47,157
0x5d4f8785a77e2c526d089c3c5c1d5f7c80911599cc596db4f26c96bd965336fa,t,75247,5679699,,5000073,2018-01-30 13:59:47,158
0x953c2afdadc5a4ad18cec53c13712b24a92eb746363cd5f8d335d50da6046697,t,53254,5732953,,5000073,2018-01-30 13:59:47,159
0xe6440be81ac1a8280d43e553408744c7f056ddb4aca320bcabde13fee7a39850,t,21000,5753953,,5000073,2018-01-30 13:59:47,160
0xdc4e1edef3b4a0b4140ad867be575a353d067a4a747ab6232f038616dc069e30,t,29493,5783446,,5000073,2018-01-30 13:59:47,161
0x7b673db2fd12d4637ceab11d1bbb67c3b25850de13867d95d261a2107c9cf803,t,36685,5820131,,5000073,2018-01-30 13:59:47,162
0x7ab497f7376168b4599ca164677ae861b0ddcb8e1589a6ad3fcf42c11349e7a2,t,46035,5866166,,5000073,2018-01-30 13:59:47,163
0x2c547fd204028a6c47a6ac3fe3271f2b60324a93d5af129f7cc6489a58f546d5,t,43715,5909881,,5000073,2018-01-30 13:59:47,164
0x8d7ba7ab7669077beafb67d3399f965e344e56c748998d5f40ab3125970554a5,t,33521,5943402,,5000073,2018-01-30 13:59:47,165
0x82e77795e5ccd7003f2bda31c32dd2ffe116792ed6c9947c218d399867e3d0b0,t,53543,5996945,,5000073,2018-01-30 13:59:47,166
0xa2458f1d21d35b7497f31cace021a968ca6f8a9689521976921b7dc64fcbd742,t,22158,6019103,,5000073,2018-01-30 13:59:47,167
0xc446beb737cbb42ab6fc276a09f01dfa5f5d9cb7333607684a5ea3b259d79ac7,t,77730,6096833,,5000073,2018-01-30 13:59:47,168
0xb750a2d519e4fcad88e8f9986f8d7498747400ab806af62bf5dcb4c6f0417cb5,t,45591,6142424,,5000073,2018-01-30 13:59:47,169
0x77ce053d605a289c001ac3b3e40c10e1c78ccf37c314c1e8b8f8ea1e488c90da,t,44354,6186778,,5000073,2018-01-30 13:59:47,170
0x3e6f35c5bb10f76daa6f44e944ecf82513cfaed7373e7cb82ed6b3cded710535,t,130338,6317116,,5000073,2018-01-30 13:59:47,171
0x78a87d609f0ff4aba101acfe834ca24f6b76dd799f0de147edcccc9be70ced0a,t,28066,6345182,,5000073,2018-01-30 13:59:47,172
0x6f066085c8afe227b4afd7ffc498b4faf9fc73c94c660b90fcc3aba394b6a0ad,t,92858,6438040,,5000073,2018-01-30 13:59:47,173
0x59c4b950215a0f0bc962063e03333ccab3be7e3d6b8f74a0edb5ec007b0508d3,t,52052,6490092,,5000073,2018-01-30 13:59:47,174
0x8ea5f2efa53d52db4c28ea82ba872984f17a5f701cd90a2d7819696ccd24a70b,t,45508,6535600,,5000073,2018-01-30 13:59:47,175
0x2c6d3ee0d47735c6a18d3f03735ba988d1bd0ceb97532983b944e8d32a073dc7,t,51560,6587160,,5000073,2018-01-30 13:59:47,176
0x576c46ba9628ce5e9a32ad0ac62976d6b3bb75a52409c086d2d819d298633ab6,t,59290,6646450,,5000073,2018-01-30 13:59:47,177
0x604f7ad8eaa00da82b91924aaeb83f08e9eddaface7e08ed11cdf19ea1b11a88,t,92858,6739308,,5000073,2018-01-30 13:59:47,178
0x9950c704530d82a7bdd84e704d4f47084353a577a8ba8070f32f4cdcc83e59d5,t,21000,6760308,,5000073,2018-01-30 13:59:47,179
0x173ecf52fa48a7bc61314c3ad4b0a44763c742f218f74449ab717657ba30e481,t,107794,6868102,,5000073,2018-01-30 13:59:47,180
0x161c3e1ce95e4b751fe7752acc8b3575a37d61a8767f0fa66720d2f2faed1448,f,21000,6889102,,5000073,2018-01-30 13:59:47,181
0x5660b216bd8a03c82cb586e5d30893c3c18cf76fd4f65c6e1cc7151ca520a945,t,84005,6973107,,5000073,2018-01-30 13:59:47,182
0x619cb643c0acd3a573520d683dcc270eccf328debd32140fdfe8bd8ba66a658c,t,77922,7051029,,5000073,2018-01-30 13:59:47,183
0xf5aa3a96e48a9365ad7645682c0dc08b7971d80a70bb4c73ffb0086fb6f4f445,t,21000,7072029,,5000073,2018-01-30 13:59:47,184
0xb82185b2aa618b31d3b7c64fbd86fce34548b44a5845d8bb42c2175ed14f450d,t,93050,7165079,,5000073,2018-01-30 13:59:47,185
0x7990392bfcf7146ee9e5e3c3ab162548b9744ad21a2e369c5d74dbf6e3f743e7,t,21000,7186079,,5000073,2018-01-30 13:59:47,186
0xc2332703e6f794692ed9c068ce266046df512299187acb0b635daefb0b5ad211,t,68831,7254910,,5000073,2018-01-30 13:59:47,187
0xdf59d68b6864bb194a45641f44665037ed679218eb6e116516fe2c52bee347e0,t,174591,7429501,,5000073,2018-01-30 13:59:47,188
0xc4bb0b5dad3cfce51083e7f10caed70b3221797473e31cdd6788a42bc6fdd979,t,48403,7477904,,5000073,2018-01-30 13:59:47,189
0xf79791c432bfc08b391921b52de234e9f462e2937f2ea83cea9f393040859b51,t,37900,7515804,,5000073,2018-01-30 13:59:47,190
0xe005d41da2d1805f4f31768b88168c87645ad6d4fb6775b8303e7916ccab876c,t,21000,7536804,,5000073,2018-01-30 13:59:47,191
0xa43c0aeecee9b786cac13bf01f858b123e70f61bf3a74dce6023850736931e43,t,21000,7557804,,5000073,2018-01-30 13:59:47,192
0xbec939360836db3e94dc07fb4401a2ee514c5a65dff970c7e6c42ef3d25316da,t,21000,7578804,,5000073,2018-01-30 13:59:47,193
0x0367062ff9609466f2306f7c9f2d18f88163c94500d5a3fc1da8f4854ceef34e,t,28002,7606806,,5000073,2018-01-30 13:59:47,194
0x3b2b3570a646062186c6ef6e89f7d191f3675a13ea2898b8d40a5f368f300c14,t,108114,7714920,,5000073,2018-01-30 13:59:47,195
0xaa7f7de791a82379f05361b752424c040d8e598a5b8842a1cc51292b6091f936,t,40867,7755787,,5000073,2018-01-30 13:59:47,196
0x2a70ac4d049e1a460d105c1aef4797566bc3cdb6676a927979315a40a3063a06,t,21000,7776787,,5000073,2018-01-30 13:59:47,197
0x64ee48e327a3a91f913e781e3720ba176b8aaa16b223edf52a1a68838d0323c1,t,36921,7813708,,5000073,2018-01-30 13:59:47,198
0x4376b5e3760510770929fa8f9524d89b62a240162e9f95a8dc8f0ad1cae04a72,t,21000,7834708,,5000073,2018-01-30 13:59:47,199
0x242867f9f18890853318f29d62f1722fc0b1057f3b842726fb0dc0d2d63c36eb,f,21000,7855708,,5000073,2018-01-30 13:59:47,200
0xa866f9446471fcf9ee7ce1b4605a58b8fe3008996c2d24e4535910b8d3dbbf01,t,21000,7876708,,5000073,2018-01-30 13:59:47,201
0xb026513a8ecb156aa202152143eab2d010c44e5898c1342074eea195bac2f33b,t,35904,7912612,,5000073,2018-01-30 13:59:47,202
0x59daa6eb3188b75484087444741e73b792a9d623eb259ec43af7882da2879e16,t,21000,7933612,,5000073,2018-01-30 13:59:47,203
0x690496da579574a055f94714744b6421f8830cd3adf2ffc5a02f95955e095b9a,t,21000,7954612,,5000073,2018-01-30 13:59:47,204
0xedfcedf04253949e3dee91b4401ff6205ffb314b7131c202291294c59d35b1d1,t,21000,7975612,,5000073,2018-01-30 13:59:47,205
0x9c444f3e9d2c8d886c766dc63bf7eaadb2b427e7ac8a5539243cc3574321e098,t,21000,21000,,5000074,2018-01-30 14:00:11,0
0xf27fa493cdb3766a1684a42da341a2abe83595da488c1e0bbcb92c4fa284a6d5,t,21000,42000,,5000074,2018-01-30 14:00:11,1
0xa9064b545d3acf5a5a86477e22dab65ce7e8491d25cf777837e144af0d7bd958,t,21000,63000,,5000074,2018-01-30 14:00:11,2
0x14468739b0cace7a8958c821867b6ca9919869bc0b02d4138f2df54606389414,t,21000,84000,,5000074,2018-01-30 14:00:11,3
0x57e066067d952f95f5a2e7cb74478168fba3e57d581d36aa0adb44ca65874fc5,t,21000,105000,,5000074,2018-01-30 14:00:11,4
0x14582451ca52f98b1e4c6dbba703011eb8c49115a35f0f8f63234d7bb9c04755,t,21000,126000,,5000074,2018-01-30 14:00:11,5
0xee155256f8a77a4908d889ece7cf87529533eac693d7d349177ad23557528e53,t,21000,147000,,5000074,2018-01-30 14:00:11,6
0xa928a54dc682d27c4f2453bfe06c81335b16a901de31562e5ee124a79ac10c36,t,21000,168000,,5000074,2018-01-30 14:00:11,7
0xacc55305c57960b1d365953705fd276c4bafcaa3f926312ec63b128575465f28,t,143081,311081,,5000074,2018-01-30 14:00:11,8
0xc42d6cb0b12cf524307736c9f3287f42765f2ad5f1dc5774219b96ff9435d2aa,t,143081,454162,,5000074,2018-01-30 14:00:11,9
0x653c790735d96a9e35cd4fea276693b92b889f3db1c9a62611c6bc208d06a2d0,t,21000,475162,,5000074,2018-01-30 14:00:11,10
0x7e0ec85096fa64a28dd42b364b5f8fe01a36ceca2b72eb1bcedb66121861f438,t,21000,496162,,5000074,2018-01-30 14:00:11,11
0x18575dc0634c074e967ffc5cdee40388f8145f454dc511003117974d0ce2fd81,t,21000,517162,,5000074,2018-01-30 14:00:11,12
0xf79eae289f4a11a73a92625666b2ca6d95f5607ecdf2d9aee4353bce62d23dde,t,21000,538162,,5000074,2018-01-30 14:00:11,13
0x68cf3ecd8ced6ec42abe49d1421ad2296dc9610fe0606e4898d529c1e2029e9b,t,21000,559162,,5000074,2018-01-30 14:00:11,14
0x0ec67f5d4a7ca11662501b54daf8f3c4a61c3fc9e4f925251ade9ed2405c8b58,t,21000,580162,,5000074,2018-01-30 14:00:11,15
0x494a7ecf662572fd00ca3e852c2350f235a17b43c5c211aeacbda4b5fed7ee69,t,59034,639196,,5000074,2018-01-30 14:00:11,16
0xfc8e11fdb77aa7828327b3482dcec32634035b0b3fc0c3864904822a5d858563,t,21000,660196,,5000074,2018-01-30 14:00:11,17
0x49eaad8ecb2115731e58da7df8c481dbeaed9617bcad316b3508b305f2024459,t,21000,681196,,5000074,2018-01-30 14:00:11,18
0x8dde5cbdddec03cf35e18f50e8f9a41ae4ec3960e2d37def8befa0fa3de1fcec,t,21000,702196,,5000074,2018-01-30 14:00:11,19
0xb9930e06b6950c8a8711d790336f2d27a10a622d649116b5af16ef9eaa06c1b3,t,21000,723196,,5000074,2018-01-30 14:00:11,20
0xe73adb328138289534c3f8bed274a4e51fac0f2da07adef259a87d67508ede3a,t,59127,782323,,5000074,2018-01-30 14:00:11,21
0x3f4795ee2e5df79c0cc5402bd90c027c1c69a4d1a8d649d2af4ccfd358ab7df9,t,21000,803323,,5000074,2018-01-30 14:00:11,22
0xc4488d4b9ce272cdaf2e1a801f2ecb4839c961095de915d5e68a54047515d211,t,21000,824323,,5000074,2018-01-30 14:00:11,23
0x58481193b905e0d29c1a0d1872698cb33fdd15bff1ff2de7581546c7f5011096,t,55907,880230,,5000074,2018-01-30 14:00:11,24
0x0aa06ee0926e5545cd886e322a4f33e2baa7be32b11a005799c7fec7a5a4b778,t,21000,901230,,5000074,2018-01-30 14:00:11,25
0x0c94c7aca78f7d49a894f71a2e0b470f81200c9bf9c6b2c9c25f1d1fa7abdfed,t,21000,922230,,5000074,2018-01-30 14:00:11,26
0xb9dfeec22bc1b38c6ac86303ef377a3966b66fd4c51a9225542c15e4cccf1238,t,21000,943230,,5000074,2018-01-30 14:00:11,27
0xd8906f2f7c0634c0d6fcfe25415e4c595dac511880d624e545a7e4c435d5963c,t,21000,964230,,5000074,2018-01-30 14:00:11,28
0xef23a6b814ba46fcd28c6ac5a2c3f10475d2753c3421bd48dc43203c946c9b88,t,51915,1016145,,5000074,2018-01-30 14:00:11,29
0x0031e4dd59ce2d1544c6670f364b81af3f26bd114929c16209063843538076eb,t,21000,1037145,,5000074,2018-01-30 14:00:11,30
0xfe2fc2a2de69b165b2c07776d2f8190fd8c78bbc955a45b3f8c595ebb8afc370,t,21000,1058145,,5000074,2018-01-30 14:00:11,31
0xac060bc741941830632ef95d07bb3327b82738b659bd4772e30bc82cfeff9114,t,21000,1079145,,5000074,2018-01-30 14:00:11,32
0x3ce879713ccf350b193dedda70ddae4ca9f426b2424aa0fedae9376c60a9250f,t,52158,1131303,,5000074,2018-01-30 14:00:11,33
0x9e3728a5a9da4647ccd0b74ee7c428f853a0a533c83cc2c7e728877f8f8ed9dd,t,36522,1167825,,5000074,2018-01-30 14:00:11,34
0x8410413d060c6152c656118c797c94914a2587ffdd6d8e609b6826380d3e7584,t,21000,1188825,,5000074,2018-01-30 14:00:11,35
0x70b51c90bdcd6fc906a09f091907c90c83918c564fce15db77aa9d755aebcab3,t,21000,1209825,,5000074,2018-01-30 14:00:11,36
0xd7102ec6f2c373052dee0bfa04eaf557977c6f71705c32cde90bc5ffbb961fc3,t,21000,1230825,,5000074,2018-01-30 14:00:11,37
0xa9ec30752261d72eeeafec678ba80d48dc946f8844391a1384fae3749a618a40,t,21000,1251825,,5000074,2018-01-30 14:00:11,38
0x0dfd31266f3f6c5cdbb13965ee07d837d038f3dbbb820d1901b36f3b760224a7,t,21000,1272825,,5000074,2018-01-30 14:00:11,39
0xe559fcf19f177b8f177a29b21158d4dffd3adf42e19c029fc57d26ad5eabe4b4,t,52962,1325787,,5000074,2018-01-30 14:00:11,40
0x8afcb479c5a5887743e91fe80294a5f1194e04ed3f8d97676ff400ba68de1775,t,21000,1346787,,5000074,2018-01-30 14:00:11,41
0x980cab75a8e9f756e810b2091b2330d23387200ee81452c5dfe949dc8ed7f3be,t,21000,1367787,,5000074,2018-01-30 14:00:11,42
0x0ebaab1d6527e3f67cb9216f82298c4264c987c31642d03852dc1a7d7e10f3ea,t,21000,1388787,,5000074,2018-01-30 14:00:11,43
0xb1c7dc7a60ae7670c2bd75ec4bb235ee2a8ec9e31a7bcd028d78718652c43fa3,t,21000,1409787,,5000074,2018-01-30 14:00:11,44
0xebce5305f083f5e153772928aed526aaf22d34f0e5deb76cb1e61ce23462145a,t,21000,1430787,,5000074,2018-01-30 14:00:11,45
0x830e005a2cb59073bbb544231d1c8f58c81824e61f35d717e0c6c5894025dc84,t,40907,1471694,,5000074,2018-01-30 14:00:11,46
0x3e8910c9ffe877e0bfff652ca8702db93abb4911c41384dc6b916bb4ed705c6c,t,55907,1527601,,5000074,2018-01-30 14:00:11,47
0x14e7cb203ddaf1973b2d6e5fa97c9d66682dad901637838c507532865a74bb25,t,21000,1548601,,5000074,2018-01-30 14:00:11,48
0x1cab92f02094a51f29a8956e434f94de3074b31718f2b076d7119908d8d8208c,t,21000,1569601,,5000074,2018-01-30 14:00:11,49
0xf43ba4edbaed5221c36222a22a9b0172488e7a6d68f1f9eee9b8a6680270428b,t,21000,1590601,,5000074,2018-01-30 14:00:11,50
0x99acd61a716c87c3ed95c9cee33f6930c36f4cc3aa3be41be37ade6e1c41c317,t,21000,1611601,,5000074,2018-01-30 14:00:11,51
0xb600ad4823c7a72417d25cb70d06600820014451da725240c37dd2a108fa4695,t,21000,1632601,,5000074,2018-01-30 14:00:11,52
0xdfbc7187edb282693e49c4fccf9af1c0e7bb81776becde0bceefb0964df1b70e,t,21000,1653601,,5000074,2018-01-30 14:00:11,53
0xdcc9e2a64d0102c454c24db7b607ea877062e685cb6c7378a3877e6504bf4a98,t,21051,1674652,,5000074,2018-01-30 14:00:11,54
0x7b4ac3ec895fb41aa5fe4ec06d336f37d247230acb35e345d4367c8a6afec08d,t,21000,1695652,,5000074,2018-01-30 14:00:11,55
0xcb759a443b9d2577ed0cde2a4c3ff72e29c471da84939c5081f641fc95bc5c5f,t,21000,1716652,,5000074,2018-01-30 14:00:11,56
0x461df06b30ff269262d17a5f15f8880872a1e80c856fbf3375b62ef28137ad01,t,21000,1737652,,5000074,2018-01-30 14:00:11,57
0xc4320d335fb89e327c63d8c664e12e00a60fb30710406bc9e0a52c4f0de5c159,t,21000,1758652,,5000074,2018-01-30 14:00:11,58
0x012e1a6e79dcdca7d3c0c6c1f1bda8909188f7948bc083226933011dd4e5e3a8,t,21000,1779652,,5000074,2018-01-30 14:00:11,59
0x0c93ff509364d0d0c4b22e28b6bf5c5260e7e6798624f09f00bd675b30a663fb,t,50057,1829709,,5000074,2018-01-30 14:00:11,60
0x57374a90b60c025e9b00f86a9da973e006f5a479060bc5f8b0adb62340744809,t,49993,1879702,,5000074,2018-01-30 14:00:11,61
0x8e5fe37fd3c30c4278e2ca2112b114f3332a126dac34aff5a01f8ad5b13d6b7e,t,49993,1929695,,5000074,2018-01-30 14:00:11,62
0xc8d397ba652e2964e75e34d5a3b873a6186b72df5c682798abf5082b35b29fd8,t,50057,1979752,,5000074,2018-01-30 14:00:11,63
0x96778c4fd0745c3734e826ba057a594e46254378d5bbdc44844defc79487c799,t,49993,2029745,,5000074,2018-01-30 14:00:11,64
0xf9a487e912ea4a9e0c2b8f378c054951ace620880351ce90938b31c85e67db5d,t,50057,2079802,,5000074,2018-01-30 14:00:11,65
0xbeaa802e309c8a12ea99c4cff1f4ea741f752e831696accdd56d981d58f387b1,t,50057,2129859,,5000074,2018-01-30 14:00:11,66
0xc87e8a92cd244c5a72ca2a50f72ccaf143efbcef1f16c215f35ff7d143e327a1,t,50057,2179916,,5000074,2018-01-30 14:00:11,67
0x047156271db31ebe39f5737fd56240589d717e5e7491e10580cbdca56ae65ed7,t,49993,2229909,,5000074,2018-01-30 14:00:11,68
0x685edce258c272ca3a85e7192f31dfa948daf135a336f7b099a3758b811253e7,t,50057,2279966,,5000074,2018-01-30 14:00:11,69
0x0721be984accb4ff783e6bacf74c8d7de830c41e4e6ca59c3d2d04b3c5a57c77,t,50057,2330023,,5000074,2018-01-30 14:00:11,70
0x437b78d1c278a7b618a5c57e4c660922297af69d7e0cea94e2698fdcec2b4352,t,50057,2380080,,5000074,2018-01-30 14:00:11,71
0x7e8c25981f43736f9efc5be4daa3427c04c3def164353376014f42a0ef356156,t,50057,2430137,,5000074,2018-01-30 14:00:11,72
0xf3ef28a56c99cd7213c7ca72294cae16f0ee0f7c7607b53f72b47fd4aff47432,t,52678,2482815,,5000074,2018-01-30 14:00:11,73
0xaf834936dd8583c2730d64b113593a26b20d46fd6c45acb0e0a3bec64924b374,t,21985,2504800,,5000074,2018-01-30 14:00:11,74
0xe0d13c50a890b283e0683a6902f2626028eef645d8a745a486dbf2606779b720,t,21000,2525800,,5000074,2018-01-30 14:00:11,75
0x0a9222dfa8754495ae9cb73ddcf0f434ad5f146bd800199b3ecd0f18eb3359d4,t,21000,2546800,,5000074,2018-01-30 14:00:11,76
0x128f6963b075de9c5b682fb32e5cf4c758067e606fc8cdc5ca6ecbcc2791cae8,t,21000,2567800,,5000074,2018-01-30 14:00:11,77
0x8d31ad8eb04c48911a78191fe0b1bd87eb23e2da1a6d12c9ed6d5073a17380d0,t,39771,2607571,,5000074,2018-01-30 14:00:11,78
0x3fda9cec3748699091bc88d2ffdef9981e78f19f30ad6b5c0ea76684c2669e47,t,89678,2697249,,5000074,2018-01-30 14:00:11,79
0x2ae5d2537ae18e9b70ca26c5a3c644ff403ae1d546e1d7d1880057200265cdec,t,21000,2718249,,5000074,2018-01-30 14:00:11,80
0xa963ee783fc4708dd765f08e303ea2c402686503bd6daaebd9bfbef4d7279c38,t,21000,2739249,,5000074,2018-01-30 14:00:11,81
0x3cb08dc06ba5f4fef479bb7c9bb93349a6cd3902536a0e781e139e629e5ec5a1,t,37148,2776397,,5000074,2018-01-30 14:00:11,82
0xa8c7650e2583bbda0bd16bf08e9e34e2a17c10822003d2b9282467701d71d8f7,t,31257,2807654,,5000074,2018-01-30 14:00:11,83
0xdee7f153250704a4dd033df8001d2efa93b1f5a8d178017919df837aea7950e1,t,21000,2828654,,5000074,2018-01-30 14:00:11,84
0xe7e6ff0a87185ab75147633f2352c04249fc4eabc3d60e28b191659401bfa81c,t,21000,2849654,,5000074,2018-01-30 14:00:11,85
0xf93b86cd01c43825daab7f390b301fd918b8bb11850b43bf55492e7bc474641f,t,21000,2870654,,5000074,2018-01-30 14:00:11,86
0xec9bb5ced02ec09906e2f57e727bf3dd776b750fa6dffa685ef42412084b50f3,t,21000,2891654,,5000074,2018-01-30 14:00:11,87
0x1cbaf4d0aeeff0a1de8fed2e40eec0330de7196b2698f93e182645d6c60725b1,t,21000,2912654,,5000074,2018-01-30 14:00:11,88
0x3ff07d4660aba938597290d283b5f95982374f7d89b132697c790739dbcb8164,t,21000,2933654,,5000074,2018-01-30 14:00:11,89
0x2ddfb3531bbf2e52014a3cb8fbe6fb784781a11fb8d8e38bcc9587f92a61c520,t,21000,2954654,,5000074,2018-01-30 14:00:11,90
0x5bc60741a0ab0189574497a51de4935dfcc0c970c8f2d9e5acedb60db3708d16,t,21000,2975654,,5000074,2018-01-30 14:00:11,91
0x0a501d95c27cf42da09fe72ab2a2f29774a7a26ba23d531983b8fd921ea7af0a,t,21000,2996654,,5000074,2018-01-30 14:00:11,92
0x0170217ec022df8b893c6d5c0eb5545db3bd9199b09a78e02b2e894d39eaea74,t,21000,3017654,,5000074,2018-01-30 14:00:11,93
0xd93e667acff3b7fbc470dcfe3da4d08450caec1c2bda139dbe14fd3b74186736,t,51728,3069382,,5000074,2018-01-30 14:00:11,94
0x6e0da177a9f9bcf00d4ed350dcfd72e287c1369ec57a5d441393cf4f024059e4,t,37053,3106435,,5000074,2018-01-30 14:00:11,95
0x15c179ea812759c36b82fc31c0c3a3a630814e14a16055a7e01dcd6709cb87e6,t,21000,3127435,,5000074,2018-01-30 14:00:11,96
0xc6c2c51c313c3a453260c2c1dabf8c00e90c46968623db0dd9c17e3e596c520e,t,23679,3151114,,5000074,2018-01-30 14:00:11,97
0x8a699af775d6cd17d1b22c701db418fea71b1480982d5a022443cb2751614e12,t,51342,3202456,,5000074,2018-01-30 14:00:11,98
0x03581872451687823e0a2690461473e15d897adff363df69c58c52ccea7cba8c,t,72694,3275150,,5000074,2018-01-30 14:00:11,99
0x21626cc1521d016862bd24a96419a74ff29c05d4c1e32d04eadf755e3eac7992,t,52848,3327998,,5000074,2018-01-30 14:00:11,100
0x84db15a89e70aac3ed5d7fef18be02866266cc70f455b97c247e4b38ed0bc911,t,29493,3357491,,5000074,2018-01-30 14:00:11,101
0x99a47b47ca16498068cf3e3f813e8c6e8b6c13340ddda71b414e318bd0497767,t,21000,3378491,,5000074,2018-01-30 14:00:11,102
0x8dceb4ded4669178ae6c10b86d234f923eaa50082c03c585de780eb140cc1d70,t,34725,3413216,,5000074,2018-01-30 14:00:11,103
0x0975ff7af02a223e2e3fb15d29a044f7d026f743d0efbda586058d9e94764ee5,t,21000,3434216,,5000074,2018-01-30 14:00:11,104
0x6f2ada5fe45bf832dbcd94d4ca2c4bfa3a7281dc8201a1fa2bf1a812a73e83d0,t,21000,3455216,,5000074,2018-01-30 14:00:11,105
0x166af9ed55b8a978d4a108bebb127dedd04b2b707150da40dc22e6e655f17264,t,21000,3476216,,5000074,2018-01-30 14:00:11,106
0x1e04f3160366799562102b33e9e2fdf008d88ab73394ef421fd1ca4fd6fe19bf,t,21000,3497216,,5000074,2018-01-30 14:00:11,107
0x8f3d30171f81fe9a414750d91af149c68a547061289f48a3250ff25e14452485,t,21000,3518216,,5000074,2018-01-30 14:00:11,108
0x79d8f6a9255f938e15802bc0c511962844ac3d46c19eaff40bf949ee33acb2e9,t,21000,3539216,,5000074,2018-01-30 14:00:11,109
0xb1e2f4647f628d0c7f239da2312dc558b2f8b0db1d7faa1e2e133bbaee6336fa,t,21000,3560216,,5000074,2018-01-30 14:00:11,110
0x3ac4b9440689f16595c157c063a69ee43f48dd727f42a636326390ca39eccf08,t,21000,3581216,,5000074,2018-01-30 14:00:11,111
0x3466f7f74989c419da3356f2ffb6fdf76875b4b7342c5f110cb10d2e8787f19f,t,21000,3602216,,5000074,2018-01-30 14:00:11,112
0x9f9d00a43a4665a921c98205bd737fd69e8d54d637eda9d0476a5f1df3c0b474,t,21000,3623216,,5000074,2018-01-30 14:00:11,113
0x1ab5fd40d362d2c29c5d1725cadb882527e817c9f6d0e2c1bd0bd9cc53b43318,t,37327,3660543,,5000074,2018-01-30 14:00:11,114
0x278f44bb04ec04414f16fb37104ca080154fd9f63d523f3a2618f99dec32b308,t,53103,3713646,,5000074,2018-01-30 14:00:11,115
0xde6cb5f7eb478c171412d394510eeac4c78cefcab689c1a2672bc9c8a0991424,t,21000,3734646,,5000074,2018-01-30 14:00:11,116
0x25e75463f25a359876556f9763d41236ad4dd9716493584e4dbb832e55081bdb,t,21000,3755646,,5000074,2018-01-30 14:00:11,117
0xbca1dbbdfa81c7e5f0b9270e8e26ddc4e648b1c74d9fa54bbb0a46e2a8f6abd4,t,21000,3776646,,5000074,2018-01-30 14:00:11,118
0xddfc56e056c96c51802d882cb1296ebb73ed40572f6e9132ada649ed4450505e,t,39026,3815672,,5000074,2018-01-30 14:00:11,119
0x7cfbc55dfeeb1e67b16d4907ac800a102e3fa604bdc43644d943e1fef5017c63,t,32893,3848565,,5000074,2018-01-30 14:00:11,120
0x6d7455ac8bf8935233da2aa8cf09f6c4d2eebe45e1c127594e5675f37d45d3aa,t,49725,3898290,,5000074,2018-01-30 14:00:11,121
0xa466adc59671b6cd3da5bd04fb59c12d464d9c840fefadd6a3ee534138b668d0,t,21000,3919290,,5000074,2018-01-30 14:00:11,122
0x5a94b9e4e5ec1b1ebb84d0ca8ed503c95c74cd82ccd064f6f32443e25e051b63,t,21000,3940290,,5000074,2018-01-30 14:00:11,123
0x099d7f0ddf8199a21d47a14893df08d3227f6ff3aca74f2fd15d4c8d90cfad9f,t,92356,4032646,,5000074,2018-01-30 14:00:11,124
0x14c814940093f8920730a734c73371b751e5297248487e42acdaf0cf22de043c,t,37148,4069794,,5000074,2018-01-30 14:00:11,125
0xe10cbbfc263faa19e94a4f59d320902dbce7ccc5e756a786fdcc7bbf850e9d6a,t,52148,4121942,,5000074,2018-01-30 14:00:11,126
0xf1fc77f7edd110a3170630fb48592d8a7b5beed3168f467440770a2e1cc322ea,t,21000,4142942,,5000074,2018-01-30 14:00:11,127
0x6f4e44cc685b895f87b2a128fb4b052900a100b500e23d268dc98cbbd6df29e9,t,40907,4183849,,5000074,2018-01-30 14:00:11,128
0x12b8f284f441002c0ad214084f74997a7e305f0ba442131acd3ce37d2f7bd944,t,55907,4239756,,5000074,2018-01-30 14:00:11,129
0x62579e051418e8b73111a4408d7b92e77ce8158b9fe137cc5e52c505e30deec4,t,22091,4261847,,5000074,2018-01-30 14:00:11,130
0x2befedc8cc95cee89e0db8206dc25e52dcf66abd224de17aaa2dc6e0a71eb783,t,45738,4307585,,5000074,2018-01-30 14:00:11,131
0x5b62487784bb25f51fd776791d8fc6505eea4d973c26f571d4c1d22314f3b806,t,37654,4345239,,5000074,2018-01-30 14:00:11,132
0x9f3b967c9f2eb5f465ba1671304bc42466d9a32e329cbce12c25cc80a053d06b,t,37616,4382855,,5000074,2018-01-30 14:00:11,133
0xdb3c48cc9fe085d6f7d02b958cdcb0147720d9e3b767bfec64cd193b2a57af8d,t,21000,4403855,,5000074,2018-01-30 14:00:11,134
0xf60d0c2f847a27debba0ece26a9f648f855ad40bbb1e06f1972577c58b877e55,t,21000,4424855,,5000074,2018-01-30 14:00:11,135
0xf462013a6dd92397d90249347d7080e1d45a8d70674b48ddf0819104d56fd208,t,52313,4477168,,5000074,2018-01-30 14:00:11,136
0x3c5e47750780e9b0d5b571fc24478a57fb8b546153b2f91faf18f85a38f0a656,t,21000,4498168,,5000074,2018-01-30 14:00:11,137
0x08b20018eeca88017ccfe62c1699830be4766b2e309856e556098bd3b9223e2a,t,21000,4519168,,5000074,2018-01-30 14:00:11,138
0xacba8e8ba27e4d15f0f6a6a2c455c86322193ac0ccafbedba7f4abebe2482389,t,21000,4540168,,5000074,2018-01-30 14:00:11,139
0xe94c12f7f5c02f54661f9927636cc7ce48b9044a4d762955ed5ee09d1ac61a94,t,53318,4593486,,5000074,2018-01-30 14:00:11,140
0x91f10ba2f2bcfdef3a2b4090a97a93c532ea70c497a9350066dcf4a238299f36,t,21000,4614486,,5000074,2018-01-30 14:00:11,141
0x67e284600fc54252103c7b35a6035648010428b2e6f8b321a32026343765b297,t,21000,4635486,,5000074,2018-01-30 14:00:11,142
0x4a2abab3e39f8a6b0c66d691aff3e1dced731c2b6c9cfabe9b143d937d6688d5,t,21000,4656486,,5000074,2018-01-30 14:00:11,143
0x84a60163fba85779812676a119c70dae05fe859e93c2946d654ac08a4fd5085f,t,21000,4677486,,5000074,2018-01-30 14:00:11,144
0xbba0fec7892c80a4d991968d9d52a6dc78a88d8147b5b3baca04dd233144405a,t,21000,4698486,,5000074,2018-01-30 14:00:11,145
0x7ab1d657083246593b055e3ae7df6cc3365794bf7b141248fd61a5ea48daeacc,t,21000,4719486,,5000074,2018-01-30 14:00:11,146
0x0cfbc43968c56ee1536fe50c8cba26aa60433d0d2e092ce6652b1188d8e4f2d4,t,21000,4740486,,5000074,2018-01-30 14:00:11,147
0x12f0dc45d26fa79e050d55823e61cdcb18c73616e81640680b40cc35f386c293,t,21000,4761486,,5000074,2018-01-30 14:00:11,148
0x644fe474011f83fb9615ec9f07a3b70e6901dcc8dc5c95af5a76603587d7896c,t,21000,4782486,,5000074,2018-01-30 14:00:11,149
0x4cd591a018e7cc024032122552f358c12863077c96a0e529dcfa5a3293ea46b8,t,21000,4803486,,5000074,2018-01-30 14:00:11,150
0x7f586ea16743a88459c3a402e7b55315ef4ef29f3f482e0d362ab71e5bc90414,t,21000,4824486,,5000074,2018-01-30 14:00:11,151
0xcc9879dd7796f2478d8209014394d62a6425793c9a88abebf4e019782ae8e5e1,f,110000,4934486,,5000074,2018-01-30 14:00:11,152
0xd3f52d836d097134c76327734f35034dd5a3bda25f11b87272234b87f00d4e94,f,110000,5044486,,5000074,2018-01-30 14:00:11,153
0x5deeab6e7c4c587ddbdb7435a4ecd7fe9b1d67846699972c21f7e815ed14dcba,t,21000,5065486,,5000074,2018-01-30 14:00:11,154
0xb6dda69006d528f667135a2af0f45fd029d9c2be465664f0b904ed485e7296f0,f,24783,5090269,,5000074,2018-01-30 14:00:11,155
0x95680e37e9b8095e941f2a6c351ccf91a16e6a51ecfe9139ad80556b9914caab,t,37320,5127589,,5000074,2018-01-30 14:00:11,156
0xf2ab1f15ec4bb2edcd869f65ed722a9178f0d42ca5a8c94b0ffb3610d040e414,t,36590,5164179,,5000074,2018-01-30 14:00:11,157
0x87ee8e7a5303a442e90ddede34a0fbaa78bea14dc2e46765d6cbec5ba3c4c210,t,21000,5185179,,5000074,2018-01-30 14:00:11,158
0x43a257d974d7f69b7390cfe5715877df781085207948e99ae3cc600a92fc149f,t,21000,5206179,,5000074,2018-01-30 14:00:11,159
0x6084b89543122b337aae38dda30a30a2b901aefd70634fc9792f30dbc66e3e2e,t,68687,5274866,,5000074,2018-01-30 14:00:11,160
0x0b502c209e97034579466cba282a8b2fe6b3e6f262c53f110d71b4c71b8343c9,t,32766,5307632,,5000074,2018-01-30 14:00:11,161
0x2f8331e23b5719952f73261eaf375e3e79c8e28db3689d5027673984057a489a,t,32721,5340353,,5000074,2018-01-30 14:00:11,162
0x23bb1713664da6e3b02c0ad1bd86a053785383bc514779c2d3c777fd80d0735f,t,21000,5361353,,5000074,2018-01-30 14:00:11,163
0x3f9ecce3d02952e25bd485eb80f46f6d4c0719657f04aa1fc32ae07ecdf78100,t,127452,5488805,,5000074,2018-01-30 14:00:11,164
0x4bcd9e2a85e9638800c506271ac5686101079e01bcc4b86a594870b9f783b72b,t,67941,5556746,,5000074,2018-01-30 14:00:11,165
0x46d72b9b410de715f3548c96d05376b2e9d7ef1e23da3a9906e570b562575653,t,157772,5714518,,5000074,2018-01-30 14:00:11,166
0x1fe35f85e6ace98a6493d9769d6743e8ac43e5563ad6cb87a30e30645ffca74d,t,142772,5857290,,5000074,2018-01-30 14:00:11,167
0x24fdd03782ce4b0309c3fc308d8675887557bf5779028dd5c1e0432d8935f8ee,t,127644,5984934,,5000074,2018-01-30 14:00:11,168
0xca2b240c79a32111e0d66a3d9c73d8a8dc8d5f4d1671aa577739c97ec1dd0e8f,t,142836,6127770,,5000074,2018-01-30 14:00:11,169
0x893949d34eb5457b6cb4c6240ae7b092c525d1c5a36ac195f4b4b43a87064624,t,21000,6148770,,5000074,2018-01-30 14:00:11,170
0x85c14a52bf186d9a43889ffff25e615c5fff5308618eab5263e7a23c1173e897,t,21000,6169770,,5000074,2018-01-30 14:00:11,171
0x8c1d414e95cf70ad2c833be113c393dae308c463a8414f9f991453cd37cdcd4b,t,40907,6210677,,5000074,2018-01-30 14:00:11,172
0xb49c84ccff180ed4af29da20e6b0dcb5bb84f2f75b68e41440e45ae7b58cf605,t,38418,6249095,,5000074,2018-01-30 14:00:11,173
0x9103218a60619c8f319761480228597c7932ed6cebcf3a84e24579e376094884,t,44418,6293513,,5000074,2018-01-30 14:00:11,174
0xb317537ab802c11b6147b4019650b7f0195f3626cd213bf27be3ff8e37618493,f,51784,6345297,,5000074,2018-01-30 14:00:11,175
0x7d286ec0b31bda3dbedb4664a3951138f50443cfc0602a31a3d4c87e320df1cc,t,52886,6398183,,5000074,2018-01-30 14:00:11,176
0xd9f847ce50e6a37cc5068cc25657cf72cfe19026fefa5a8285310f0c68d1e839,t,52886,6451069,,5000074,2018-01-30 14:00:11,177
0x9fb5730529ee77d2872e09794a981af44bae5a4494503ef1d707ffb23c4f882a,t,52886,6503955,,5000074,2018-01-30 14:00:11,178
0x81729bb6be08f1c1d10514810182e80cb0408fe28057e760a7d4cfa99c677cd1,t,52886,6556841,,5000074,2018-01-30 14:00:11,179
0xf85cbd783af409a28254a1aadd7d8fc250284f40b1e28585a16d35f7b546cc5f,t,52886,6609727,,5000074,2018-01-30 14:00:11,180
0xa7c2a0d7d639976fbfae331bde0900cffaf07f4d308c1268ab2ea75ded887513,t,52886,6662613,,5000074,2018-01-30 14:00:11,181
0xf0cdcc8940370ffaef7aa06d3525912bec682f8d971fd759855ed7868b3bc950,t,52886,6715499,,5000074,2018-01-30 14:00:11,182
0x247dcf485df010ba70bda94e8350528fdaa4cad3899ed9311f5a693bb0a5e3e3,t,52886,6768385,,5000074,2018-01-30 14:00:11,183
0x13af81e7a7a7019d1526f56e5f15b3ec5d3920d954bbff633968942efd65ca45,t,52886,6821271,,5000074,2018-01-30 14:00:11,184
0x34e630dece8c4dbf0d3e67292f0714c3833e682da666c8c41785889b77460905,t,52886,6874157,,5000074,2018-01-30 14:00:11,185
0x409c38a04630a14b8115bdd9fd82a6230456b999ab13a06a1c488f844205032d,t,52886,6927043,,5000074,2018-01-30 14:00:11,186
0x3f0fa65c2690ab452eac792076568e66eec8cb41412a2dc6b9bf0967307a76f3,t,52886,6979929,,5000074,2018-01-30 14:00:11,187
0x0f900720f96699da258669f8776d1717b959e59c4320845860ba29fce2593a3e,t,52886,7032815,,5000074,2018-01-30 14:00:11,188
0x09202767d6d53241ba9fac1a762bf470eb82b8e855787671ae6a5e8669ce118a,t,52886,7085701,,5000074,2018-01-30 14:00:11,189
0x07db502ed48c61d30f817dfd9a0ffc017c3ac0459e61872b766cb4063cbca97e,t,52886,7138587,,5000074,2018-01-30 14:00:11,190
0x68364352c3f257551ab7a64192075943c20b8df78d05bb412d9dbb2dd591e3e5,t,52886,7191473,,5000074,2018-01-30 14:00:11,191
0x28062c42bc1523fbd4bfa02c24134725dc051f79089bdb38841f502da3867bb3,t,52886,7244359,,5000074,2018-01-30 14:00:11,192
0x6bd747d5ae0c10dc75a26279cddb5c12e42ef42257071c1df04d968d1767c398,t,52886,7297245,,5000074,2018-01-30 14:00:11,193
0x09c83d63bf2e773ac7fe820bcc7c1ff25eb01dc8517cce07246d2b77a0de62cd,t,52886,7350131,,5000074,2018-01-30 14:00:11,194
0xdb3f41684500315ae7a16573b2b3becfb2664364a16cb2f03118797d329fa1d4,t,52886,7403017,,5000074,2018-01-30 14:00:11,195
0xdd2c8cd8d167a4d78d8bc3c8f38fe6284a2c0076edf6ac7116cb609da8dc7430,t,52886,7455903,,5000074,2018-01-30 14:00:11,196
0x85e96fbc6382bce9d73a1dabd45583d839e5e44da5f35b83b103c1c3a38f4d97,t,52886,7508789,,5000074,2018-01-30 14:00:11,197
0x77ef0f04d239494c25d377cfec3101c145dc295c1e392390dc72e204584da65f,t,52886,7561675,,5000074,2018-01-30 14:00:11,198
0x65386406edb9bca1210d7f8811c2446d3716f3baf5a478a1b2741d48dcb16a4b,t,52886,7614561,,5000074,2018-01-30 14:00:11,199
0xde9db9d1ea943c0fecbe8b9a6d45a09e341d989a2b5afb24304565bad010cab7,t,52886,7667447,,5000074,2018-01-30 14:00:11,200
0x287cc0de596cab96a84db47686e2e57d1f4230f1f5f067d594a6e819b7eb4c20,t,52886,7720333,,5000074,2018-01-30 14:00:11,201
0x3f30239ffaeef2cac86f2c625cb094ff7906dd4b67e619effc37d9b848823468,t,52886,7773219,,5000074,2018-01-30 14:00:11,202
0xe3fd5ae62ceccccf680dd27c466b10793a4eeb5c8eae5fd5c749bdbcfa5e0706,t,52758,7825977,,5000074,2018-01-30 14:00:11,203
0xa292f450064958fc7099e2b2625655f68810001c2f48448980be170b97eccee3,t,52886,7878863,,5000074,2018-01-30 14:00:11,204
0xc655c5e3d358479d569114ad6e09f5fd0ad6b68e32e7dcbe618575a58984afbd,t,52886,7931749,,5000074,2018-01-30 14:00:11,205
0x99ca57657bd1aa5290e6778d7022f74458b53dabb69342ef989445239470263c,t,21000,7952749,,5000074,2018-01-30 14:00:11,206
0xd16080b1d646b04a1556bc3dc869d22d4049f4a81f4f6fee65989ad367f1304a,t,21000,7973749,,5000074,2018-01-30 14:00:11,207
0x67f2fc9a3960ad5aa350dfb8a62b337cb714fce26431d03bf0c48255ad178b22,t,21000,7994749,,5000074,2018-01-30 14:00:11,208
0xb28a511fedc874b357e1baf5638ebacc5695bd49c0102d0fcabccc3b115b123b,t,21000,21000,,5000075,2018-01-30 14:00:28,0
0x740d3a4a55a26f26ea00dd7c2478108edb5471177422aa829c7f5cbfad386f18,t,21000,42000,,5000075,2018-01-30 14:00:28,1
0x791b48f12fcf55ac2c5f0c3642e4d4adc2293482bb56c708f0fff32ec4bd2835,t,21000,63000,,5000075,2018-01-30 14:00:28,2
0xd7768cbb336724efafe3447d51be4eb13523ce5f9c928918326c3a980aa8caa0,t,21000,84000,,5000075,2018-01-30 14:00:28,3
0xde84b12b6ef73672a1351be5a51c77448d64fd31997b26b3b264b359c73d8a1c,t,21000,105000,,5000075,2018-01-30 14:00:28,4
0x35464a1b57f2920dc0347bd6caffb1e7282b890416e5a379e95a71d11929f8e6,t,21000,126000,,5000075,2018-01-30 14:00:28,5
0xbb6c695f9bdf5f7e8415c9d39af741567c009b3a10eb085c3bf31c4b15042a8c,t,21000,147000,,5000075,2018-01-30 14:00:28,6
0x4ebe1320affb39ebd103708c8eed9a4d54d2a86e1b81b075d41e5ec2ac0e7fd7,t,21000,168000,,5000075,2018-01-30 14:00:28,7
0xeea98bef51829d25479311bc3353ec4a75a9987100c6eafa69e5642c6d86f63d,t,21000,189000,,5000075,2018-01-30 14:00:28,8
0x1dd7bbb6da6dd72e658c340a387c6fbedda66c7db679d7c3608ba2139999287a,t,103563,292563,,5000075,2018-01-30 14:00:28,9
0x3815fed6860452af29a7b5c1d44cc3581b0d772ef0739a471e01e77118ec18f0,t,82879,375442,,5000075,2018-01-30 14:00:28,10
0xb6e2e79009916f693be7f10c0e5adb0e7e00a66eece8898e11417d1b6a25a00d,t,82879,458321,,5000075,2018-01-30 14:00:28,11
0x1aebdf64b6a3a09c07a507cb67d0ee7e67e5cb57bf7f76db657c5fab6dcd3624,t,143081,601402,,5000075,2018-01-30 14:00:28,12
0x4982ccfaa5cef62fe2bcc9e42ec4cbb46e37cf9a9f8b9a3e39b02538b8fa358a,t,21000,622402,,5000075,2018-01-30 14:00:28,13
0xf608d46aecce8c826853f6ab538c909631b8185857294822e9eb7250c55058e0,t,21000,643402,,5000075,2018-01-30 14:00:28,14
0xb303a5dc48de06854f780306f336c90db05b33e10775496758efdb9d891d1f0d,t,21000,664402,,5000075,2018-01-30 14:00:28,15
0xfbe851fe65c09e8390edc33c7b508bdcc4d21445da350b7650dceb08b2154d34,t,21000,685402,,5000075,2018-01-30 14:00:28,16
0x47c86c5c3095ae234efb4103d3a378f6ef9b85902d41db7d9783d837967ab1db,t,21000,706402,,5000075,2018-01-30 14:00:28,17
0x13638f329b8a2c9530eace13ad0a4dc9a78cbb04590168f1c22d9865d7aa5bbc,t,21000,727402,,5000075,2018-01-30 14:00:28,18
0x5b0f7385789344027228ca52aa5db1a49a60cc167a9e03a72db6755166534996,t,21000,748402,,5000075,2018-01-30 14:00:28,19
0x08cb07414d4576b4e15d93df2e54dab948358601a3a61cada3b3b3ff3d2b11e7,t,21000,769402,,5000075,2018-01-30 14:00:28,20
0x986c5abee98d86cd654e9ecac1dd0379b547b61dfb6c70e97e84d36165143847,t,21000,790402,,5000075,2018-01-30 14:00:28,21
0xbadc6ee1090c95242338cc6b4387b7e800d2b7f089759f322dffdc79237d7300,t,25843,816245,,5000075,2018-01-30 14:00:28,22
0xe145f257494da3f8e97b9eb0262ef496ee227fc224071fd5852802ab17e6840a,f,66666,882911,,5000075,2018-01-30 14:00:28,23
0xc68c4a53db49e024bf20e1e7534bf1957ae66dd457cdbb29219f9f42430ef769,f,66666,949577,,5000075,2018-01-30 14:00:28,24
0x550c5521b727fd8240ba6e63f0617bade0a61d49d7e167db7d61d13c83ee672e,t,39720,989297,,5000075,2018-01-30 14:00:28,25
0x72295a17140105245871317a31a295ad5fcaf0c4dcd9be480b00a1c0339a5034,t,21000,1010297,,5000075,2018-01-30 14:00:28,26
0x160e59bdb57d4928e035decb9e6b2dd62b83a73a1b170d6e6cb2f28454ef409e,t,21000,1031297,,5000075,2018-01-30 14:00:28,27
0x082f2cbf5dcbb1bb2ef3b617a7d01825337b790615c9fd367cc694ccf4058d63,t,21000,1052297,,5000075,2018-01-30 14:00:28,28
0x45afbe9d7d5d384f0c1666bb40027909e4f9a564db5ab5c9114091fa02f9de87,t,21000,1073297,,5000075,2018-01-30 14:00:28,29
0x9a9987a51965a112619efacd62eddee5ca2c126d6284abb4ae8d52a5f51276b5,t,21000,1094297,,5000075,2018-01-30 14:00:28,30
0xf6c93a8f8dfeda4558b4b6b662638944ca8860c1e2a8ced5ce8d0391c41d8b6f,t,21000,1115297,,5000075,2018-01-30 14:00:28,31
0x791a18694ec01a3534d45005f1b793b9204480248ced1b25770330e215381472,t,21000,1136297,,5000075,2018-01-30 14:00:28,32
0x4f2123f6609a5fc5da1d5bf85ecda6cbad0dd91f83ab2f669bc582e61373e9a3,t,21000,1157297,,5000075,2018-01-30 14:00:28,33
0xcf6829fe72e8ca9f40596c7b8401cc8c98e45f14624d6a9157bd54ba278cbe20,t,37193,1194490,,5000075,2018-01-30 14:00:28,34
0x1c0c30194241932b9c37de82a4eb988390dc037d85f3e68ac4be66c614ccf5df,t,21000,1215490,,5000075,2018-01-30 14:00:28,35
0xd7c3f6c55719ff1014aebb4d88b68c34b4921fdffa0630addba5babf095b8b5c,t,21000,1236490,,5000075,2018-01-30 14:00:28,36
0xe9620f9a2fa97ce04add76e31270484c7a490f5e60631cc98350322e8eeddf23,t,21000,1257490,,5000075,2018-01-30 14:00:28,37
0x92d47b961b2f955670394c63a5d80652096a934d766b4ac0666331ed85c33070,t,21000,1278490,,5000075,2018-01-30 14:00:28,38
0x3eecf920c36b7afc59fafbdff4a615d5fbc17d9cf249beac524c4ff7ae23ed17,t,21000,1299490,,5000075,2018-01-30 14:00:28,39
0xaaa024bbeab217dafa4b67382816c251268b55488d78ce60e08b529cec4297e8,t,21000,1320490,,5000075,2018-01-30 14:00:28,40
0xc92f6c93df5fee95b5b07247a334d20c5eaad65035626091d722a5f1b50a7abb,t,21000,1341490,,5000075,2018-01-30 14:00:28,41
0x78e4d1622962a69b62077d53d7445b3607e3b557ac43cb9109c1f0b81aee3314,t,51883,1393373,,5000075,2018-01-30 14:00:28,42
0x4f415d502ff4c6e11c7e84786f78e2e4d5dbc0f9e966d02cf3fa2e7abc1e9fed,t,21000,1414373,,5000075,2018-01-30 14:00:28,43
0xa0c25e47781254bcd08bdb096ae97bbdf0071b26112fb080f2e9405438525857,t,21000,1435373,,5000075,2018-01-30 14:00:28,44
0x92e9b0bc3347fb0217b74b3be24fc2e0c3c3c772841becc0e4af4c4d5115f533,t,21000,1456373,,5000075,2018-01-30 14:00:28,45
0x1cb0faf9994f271b00a3398cb32262d5c2f1b0584196fa60a76fedc3ebfc7c8c,t,21000,1477373,,5000075,2018-01-30 14:00:28,46
0x6be9fd07068fb0d2db8907af79177eba4d5903309d0a3097bacb8514583c6e4d,t,21000,1498373,,5000075,2018-01-30 14:00:28,47
0x9ae390a77b7d47cd66486117bc4a83584ff1be130b2a0716124daa5785c8dfcc,t,21000,1519373,,5000075,2018-01-30 14:00:28,48
0xed8ab25aba7dc4d5e327e94b3ce170a6bb3c109c2729e77353cd2f0029ad7ca5,t,21000,1540373,,5000075,2018-01-30 14:00:28,49
0xbe381da6100df021b179e46ccb4c24b01e351ef39cb75f3bfdf9d9ec6efe8831,t,21000,1561373,,5000075,2018-01-30 14:00:28,50
0x7c2a80bc1cebcfd2c554ee183b940f18bff18c764557f78abb28f1c69feab365,t,168580,1729953,,5000075,2018-01-30 14:00:28,51
0x6bf644aa801ae92b3bbf1a48c981b7b1583b085676fdce7036c5330b9a80fd8b,t,33665,1763618,,5000075,2018-01-30 14:00:28,52
0xca9b1ca9fc02ee62b50851f0e28e797c189b00b3c97a0c77a3145b4e2bb6bbd9,t,23338,1786956,,5000075,2018-01-30 14:00:28,53
0x73c2e3733f607681592abc47ac872cdd06402a792b984229045ad31dc07b7a3b,t,21000,1807956,,5000075,2018-01-30 14:00:28,54
0x3906dc52b6f1ccca985cfedc61ea868c832a27a9ffdfdf703afa668b741f9b0d,t,36886,1844842,,5000075,2018-01-30 14:00:28,55
0x82535381a7250b3c3eb973d4badc641055f8f4d6c3fbb12601d6f2cd96f7c840,f,22229,1867071,,5000075,2018-01-30 14:00:28,56
0x6d7de4e4fce71dcd4cb09f15d559551f478f9f559e228677765c611faf5c1d25,t,21000,1888071,,5000075,2018-01-30 14:00:28,57
0xc9b0794cc1757fb700f66d04bb3176743d9d4a2fb26987ce96566a2cea01d82d,t,53615,1941686,,5000075,2018-01-30 14:00:28,58
0x8160d9a5265235c9f13d8b755803042fd93ed1ec1122c9aede8c9ee33630a8df,t,48240,1989926,,5000075,2018-01-30 14:00:28,59
0x5faf9f334a14f8a7e9dd996aaf45037515336bf1fb08d6f79d4a0a537fc09df3,t,21000,2010926,,5000075,2018-01-30 14:00:28,60
0xca86859f100ce256e40ea573b05b6070455aa320a17fad4410776242ae501782,t,46031,2056957,,5000075,2018-01-30 14:00:28,61
0x82a680a3bbda3ab4766511b27cfd4724bfc08e17161d01162198eeb6bd3f3198,t,74624,2131581,,5000075,2018-01-30 14:00:28,62
0xd6849790777888860df0d15c8e57306480cae3f646f83ec65054f53a1ff21cf7,t,22510,2154091,,5000075,2018-01-30 14:00:28,63
0xc0b00cb97bdb6ba9b5261d71da70522d55bbc33a9fe05347d5347b81a6aa9e3e,t,21000,2175091,,5000075,2018-01-30 14:00:28,64
0x351edacb65b852de06df7e03b6b8d211421ea1012e7159e21fdf9d38509dafc9,t,36188,2211279,,5000075,2018-01-30 14:00:28,65
0x8f2f17ae514284c7e036ca932c270e4117f60a212fc1ce2c9e8f92a8159b28b3,t,21000,2232279,,5000075,2018-01-30 14:00:28,66
0x4d8146bd179437254a647a63cb642e64ab4021edf9ff3c9ef44843111a9cba93,t,21000,2253279,,5000075,2018-01-30 14:00:28,67
0x27335a8a53e46b4f00c6a79919031f67f49de2b24ccfea487698baa783265dcc,t,21000,2274279,,5000075,2018-01-30 14:00:28,68
0x1e1e923c108298bfaa99fed1baa38e9f751c3dd0b386608848559f840f63b557,t,21000,2295279,,5000075,2018-01-30 14:00:28,69
0x944d89523ec20c30f1322791e3aa4498f7e1894c2f68a139c5d7d151ca69be1b,t,21000,2316279,,5000075,2018-01-30 14:00:28,70
0x881b1222fce6e759e8dbbe0cc1fe19bc13f4a2d45a21886e5a9576465e737b9f,t,21000,2337279,,5000075,2018-01-30 14:00:28,71
0xb82083da5e38beb34239af14f0a15d9a795cfb1be996625099944822e9ca667a,t,108306,2445585,,5000075,2018-01-30 14:00:28,72
0x0ac758214f92d1c88172b5c09dba9eefe637e331726793278ecd7fef8d2922bb,t,21000,2466585,,5000075,2018-01-30 14:00:28,73
0x0bd6a878642a5ac4694baa14abac4afeed8385ec6957c146c77548c3480c8854,t,52555,2519140,,5000075,2018-01-30 14:00:28,74
0x4c6c544ecbc816cc011c2adc0c8b35a78ff0ac25774ce30681dd8b6d003a830f,t,51947,2571087,,5000075,2018-01-30 14:00:28,75
0xe65fc45196f31f1adf7d608e21ef751d57bbb99d7f3934cf66006b01907f7c6d,t,21000,2592087,,5000075,2018-01-30 14:00:28,76
0x9270109e16473b40c4decd04729c103ce66eec4e1d0d38d1047fa26953535ddd,t,51893,2643980,,5000075,2018-01-30 14:00:28,77
0xfe2af22427bee27caa03a4bd8ad3b8d84e0afd84565e8261226ea7794fb6cef1,t,21000,2664980,,5000075,2018-01-30 14:00:28,78
0x340151104b147d06c642fe6e0eea08a81e5afd89022b98cd65f15eeb71085786,t,45738,2710718,,5000075,2018-01-30 14:00:28,79
0x98d247aea2fe12b057653ebcdfda2753f0d2c76073465935a5089dcda7ffe1f1,t,21000,2731718,,5000075,2018-01-30 14:00:28,80
0xe4afbc23379bc652f61581758f44c81b543879602e7454a4e3fbc4d33197ca1e,t,21000,2752718,,5000075,2018-01-30 14:00:28,81
0x2bc17170778c0ad2dd2d170fc06dab163e3d2f1c417da80a761e460ec6049179,t,21000,2773718,,5000075,2018-01-30 14:00:28,82
0xc558b526ae2f8844a65667688bbb88474509e6e151b9a11110e5c6e0eed72087,t,21000,2794718,,5000075,2018-01-30 14:00:28,83
0x7ac76754e4cec7e27b30f394ef3aed85c2fdfff8dc4b1fa403b1e32d299f5564,t,21000,2815718,,5000075,2018-01-30 14:00:28,84
0x8dd1b49de24a89cdf39e9b763d489aa57632cf5421ee0d0b42ca9fdb2d586b09,t,21000,2836718,,5000075,2018-01-30 14:00:28,85
0xf250b103085075388d7a4d33dc20a3fc6ef61144ffa149672200f010dbd3b390,t,55843,2892561,,5000075,2018-01-30 14:00:28,86
0xc2d15732f20d590c3771075cc9a27dc7776c9df762ace352b7e8c7d21a01f9c6,t,52524,2945085,,5000075,2018-01-30 14:00:28,87
0x6a985bdb1e7312f3b918461cae49a5b2663633eef587bb941eaeee0e0d8a59f3,f,110000,3055085,,5000075,2018-01-30 14:00:28,88
0x7c046d5758fcdf8d9774ee2e00a5d596a7a155672bf8f2b30fa8018b415aca05,f,110000,3165085,,5000075,2018-01-30 14:00:28,89
0x320b515abd850ee87a39e36d834960c57281baa13b4fc4db1c25857176889981,t,86688,3251773,,5000075,2018-01-30 14:00:28,90
0xc45b9619f35a73e63cc9b89155baafe8a5d56c1aac347ea0c8e7f89c5c3bc0e7,t,53233,3305006,,5000075,2018-01-30 14:00:28,91
0x14187507decc3e09cc5a1f13bcec1980c8d4575483d177fb6f55957fa5572343,t,140027,3445033,0xADd8f94a3820f04C8E18fEfE34A8E1C1699080C4,5000075,2018-01-30 14:00:28,92
0x21952fb63693e9e168eff310a1dd5c62518582db4f275465cc9a0c20f54262f6,t,21000,3466033,,5000075,2018-01-30 14:00:28,93
0x6fec50375fe13d0332633d074cfc047c800130005daea88c20b821163afaec24,t,31984,3498017,,5000075,2018-01-30 14:00:28,94
0x6f266e91240c0c963ad1fee8d0ebbd7fa1257124fea84a1d7935ab7139b57ed4,t,98809,3596826,,5000075,2018-01-30 14:00:28,95
0x571056ec7290b18b98be533b5e54f620e4c670fb7f1db1e69be827ff995afc42,t,36820,3633646,,5000075,2018-01-30 14:00:28,96
0xe5c03fab49f4eec1556b686cf579695aa183ceee2c3182e3f186db537a636832,t,30981,3664627,,5000075,2018-01-30 14:00:28,97
0xa725f9f4ae036d1221239def4204a6b69cf0ee1ac95955833374f2e5b509c9f5,t,30981,3695608,,5000075,2018-01-30 14:00:28,98
0x6de145185f7e9ce9f82637403a3bcde43fa710b894bf02318cd38bc230893822,t,30981,3726589,,5000075,2018-01-30 14:00:28,99
0x6509fe8d70cee99ddfd9b3d4247973acacadb16142a50d77f06f4348b4f123a5,t,30981,3757570,,5000075,2018-01-30 14:00:28,100
0xd5e5cd5690549be593259c392597ffe4c8c750829eccbe223a27ba21b9ded533,t,21000,3778570,,5000075,2018-01-30 14:00:28,101
0x1edab101ebf1a656c3022cb1e7ef8d30a16b13b5d61768a75ae227af72741159,t,64725,3843295,,5000075,2018-01-30 14:00:28,102
0xa3ce7b1962fb4631803a1da87380f99c79b91142c6d778cae32d728f7db004bf,t,93242,3936537,,5000075,2018-01-30 14:00:28,103
0xd442503a625afad01021b98b1157165f9e4aabe05982cbbbe419b87b15b4b9fd,t,21000,3957537,,5000075,2018-01-30 14:00:28,104
0xf9d66ebd7d27eb459e9b009c06a05aa1826ed521a1483a06862ea37156bcd9bc,t,21000,3978537,,5000075,2018-01-30 14:00:28,105
0x21366a02d02f6116dffaf263e89010f35f00119246276989ced77b6755a418b7,t,21000,3999537,,5000075,2018-01-30 14:00:28,106
0xe173ba1404d334aaa1851f75ec3ef41345ec0516734e4ea9448fb3ffecba48db,t,21000,4020537,,5000075,2018-01-30 14:00:28,107
0x3778528c7f18b46716cf707cd27fab8a8480e97a1380f4eb6feb16f3ea42f80a,t,21000,4041537,,5000075,2018-01-30 14:00:28,108
0x9f45b88217766477572245e249c30556108ff615cfbf0c64c181eabdfb39d15c,t,21000,4062537,,5000075,2018-01-30 14:00:28,109
0xc31622dd1a151e94ab882189bf56f9fb04249a04c5e96fbb1fc30099e7d496b6,t,21000,4083537,,5000075,2018-01-30 14:00:28,110
0x7ac014ffa74de3464985d052751047692233f9e21fd28ca19fff5ca98acec348,t,21000,4104537,,5000075,2018-01-30 14:00:28,111
0x0ac9fa930da79b4a052c26666dfd5d40e0847634fd89091d5d51f74dfa1fd82c,t,21000,4125537,,5000075,2018-01-30 14:00:28,112
0x65ac0b27af13a59d3cb334ae7cbb7f6d3054ab4b154d9558f2c552ebff8d0d4a,t,21000,4146537,,5000075,2018-01-30 14:00:28,113
0xeddbfc2a090719415b63f8891592ab84b5a0ca77557db40ea88d42c574704f73,t,21000,4167537,,5000075,2018-01-30 14:00:28,114
0x9f991bf0bedcd9a118d287a6017e361def11c2ddde92e5934c651b0a363c5233,t,21000,4188537,,5000075,2018-01-30 14:00:28,115
0x16b9c4ee98ee8e69742e069424b453a7d92ffbbea817fa7319a25c09f8fc3dfb,t,21000,4209537,,5000075,2018-01-30 14:00:28,116
0xc45ff31a9d1adee97e17aa81e1bb9721723e5cc27cebbafa856fa2ad97ab3bf4,t,21000,4230537,,5000075,2018-01-30 14:00:28,117
0x66d04119f251a1a6d9a876c25c1ddc38f2528c3dd6d174c7b04877f4119b4939,t,21000,4251537,,5000075,2018-01-30 14:00:28,118
0x48c39987e195f81101b41d3b42a67f702fa009d4b7d1482a2b93675c5ab466a6,t,253854,4505391,0x9718786b4b7D780C1a8867Edb9e751bEBc6Eb928,5000075,2018-01-30 14:00:28,119
0x55e8203fe591c4a4b3b0eb606cb5aa46a16eb20ebb3369f4aa49667397a38ded,t,253854,4759245,0xa4680d3C8c188f25CDEd9c6b269Ef9682ACcb222,5000075,2018-01-30 14:00:28,120
0x4e693f876ead48bb783851d31972fc113dd47f88b8751ff8287aa38983e810e7,t,253854,5013099,0xE4Cd7ED50A42304057455403a91BD463c182B50e,5000075,2018-01-30 14:00:28,121
0x6d76a35cba94cc7bb1341cfc0136ac0f9d66971251cefdca426c9da96093e6ec,t,27329,5040428,,5000075,2018-01-30 14:00:28,122
0x40b8ff5dd16267d59d3e2f8a1fc07a7f074f5e46f1c90720e16c94ca465593a2,t,27329,5067757,,5000075,2018-01-30 14:00:28,123
0xabae942205b2aa7322f2857a0c43bf9cf9dfacdc83aecf54c859f2ffeaf7f425,t,27450,5095207,,5000075,2018-01-30 14:00:28,124
0x0d3244b0ef5d8ee409adc8a6058ef93e03f3f5e061bc38e920f74fcafc23d6b0,t,27450,5122657,,5000075,2018-01-30 14:00:28,125
0x968c3765ca00f187b1e9f0f677eea3afb1df1fbeec2d157f9108a2f653a2d930,t,26563,5149220,,5000075,2018-01-30 14:00:28,126
0x595ed04ecdc5ee2e2ffd6a9ddcceb549538042e6bbf46cd05b7a9f70718590af,t,27360,5176580,,5000075,2018-01-30 14:00:28,127
0x9ebda386c3b55472e0a80d7b8ef98a64a4c9bffa25c3954f76a382fde088934c,t,30449,5207029,,5000075,2018-01-30 14:00:28,128
0x75d83dd3d3d523c9bf2c5fee4cba081f4ebd9222102ce3b55fba486ab51908d2,t,30449,5237478,,5000075,2018-01-30 14:00:28,129
0xf1f59df39674e7352a0556dfd9f4f04242c45795d6036fac1ae81c2b51b174ca,t,30449,5267927,,5000075,2018-01-30 14:00:28,130
0xd0d03b7027fc055143accb7a8c111efe5b78edf7f38c3440e02145e4666fe4df,t,30449,5298376,,5000075,2018-01-30 14:00:28,131
0x2e3a24f5d5e4726161b8738c7d5b074a32563744113b2b61e8428798ebd3c73e,t,30449,5328825,,5000075,2018-01-30 14:00:28,132
0x34358d57c63b99c380fe421e5ea8f85d02105242ab0521a6282877ef1083fd0d,t,30449,5359274,,5000075,2018-01-30 14:00:28,133
0xbe60f49d5ad8cd91090060fec94c7ed4f91963cddbda36cf57b1a75971db0fe7,t,30449,5389723,,5000075,2018-01-30 14:00:28,134
0xefcd019808763499c207a5b330a803d32cf75de6f293f5342189a24cc5f800d4,t,30011,5419734,,5000075,2018-01-30 14:00:28,135
0x586ae5f09a96fa2cdf2159b3d561857b4275c931690c37877d54657d23e692b6,t,30011,5449745,,5000075,2018-01-30 14:00:28,136
0xa3533520c3d5e61f91935f4d8dea922c09d5359e44181914ebe2e23e4076a28b,t,30011,5479756,,5000075,2018-01-30 14:00:28,137
0x5079de6097e78801913867c9c7a96a3bc23fda4d302431cd2e0a83801c6e6fec,t,27584,5507340,,5000075,2018-01-30 14:00:28,138
0x57ee3ebbfa47801a182e5ca1687c9bea2f226670a65b9f7a49f15c54eee4e862,t,26573,5533913,,5000075,2018-01-30 14:00:28,139
0xb78639e58c7b13ee47a0f9ea1fd005df4f5816068694d3547530d42a4ec11494,t,26603,5560516,,5000075,2018-01-30 14:00:28,140
0x79ff19e667b989f89eb7c31ca8008485a0d53596735631cf0923f68c16928f47,t,21000,5581516,,5000075,2018-01-30 14:00:28,141
0x66d84a422c3eadf3a5e77c592a5bc2c5c86832323ff40d7370bb207b607f5b9e,t,21000,5602516,,5000075,2018-01-30 14:00:28,142
0x761cdde3ffee5856564c5edf6841a04ddd6874a4de8d78049092cbca4a018f42,t,21000,5623516,,5000075,2018-01-30 14:00:28,143
0x146fb3a443c6a51ec6a99baacc82aff614e87c8de0a223c90d031e066bdbc98f,t,21000,5644516,,5000075,2018-01-30 14:00:28,144
0x6a68d834300b9cc40f6d53f0dbd614c0ba309f4f2ef10c7b7b346e5da9fbdd4a,t,21000,5665516,,5000075,2018-01-30 14:00:28,145
0xc30f2edddb349ccb463813bf0a4540a940d0e96d6d9ac9b4670f22233d8363e1,t,21000,5686516,,5000075,2018-01-30 14:00:28,146
0xe67d59d5f945f2bf12ad69879342de32879221d85f1d71499bc1bc101dbcaa1d,t,21000,5707516,,5000075,2018-01-30 14:00:28,147
0x0d7eb2cd7f359221619c867fa13b60b1ce229e9c3a3ea1fb1fe8485b83355ba3,t,21000,5728516,,5000075,2018-01-30 14:00:28,148
0xa1485c5f35880f5a281675b259dcdd79856421683155d1aa3516cb5f778dc9df,t,21000,5749516,,5000075,2018-01-30 14:00:28,149
0xf47537916488d49714f536607793e4d3432c6275970b429736fbe65a06117dd1,t,21000,5770516,,5000075,2018-01-30 14:00:28,150
0xeecbc041aae0e5a095ff5cc2590b2540d3ed6ce621f0b78546353547d33410f4,t,21000,5791516,,5000075,2018-01-30 14:00:28,151
0x7fdef6dffbad862bacd224be01a6a4b70dfb26eb0679cb5628c5b173a1866b1a,t,21000,5812516,,5000075,2018-01-30 14:00:28,152
0x4ec73c9f057aa09893b6d36d0b2339acfcee090352c856ee13eee887d51df9f3,t,21000,5833516,,5000075,2018-01-30 14:00:28,153
0x039a2d223cbe49a09c6b6b2110fb3209f6d0dd695ca602a4596c113a940f25aa,t,21000,5854516,,5000075,2018-01-30 14:00:28,154
0x57c740be8be03630cefc08988c501750b3fad3297cfffc1e4ad992ea46d7d9cc,t,21000,5875516,,5000075,2018-01-30 14:00:28,155
0xa98f6bd2e11c64cbbc75f3b8a7b8e6701d10cac88b3531c19dea94674014c52c,t,21000,5896516,,5000075,2018-01-30 14:00:28,156
0x64ac91edc7323dfd6f109c665832a7d1699edfdb0a7594595f9563bb723ed5bd,t,21000,5917516,,5000075,2018-01-30 14:00:28,157
0x506e128b17503ffa981a5657aa3a86777453d15297d4d295fa46f94e5e24e071,t,21000,5938516,,5000075,2018-01-30 14:00:28,158
0x249bf2674a7eca824d6566b498bcc76cd3c52e05bb41f7a6fd26191fd71d5b2f,t,21000,5959516,,5000075,2018-01-30 14:00:28,159
0xeeb4803ca3500affd84ca954049d033ef3029d2ceffcd859bcb747966ae5f316,t,53162,6012678,,5000075,2018-01-30 14:00:28,160
0x7dd01edeb65f3cd239cbe6eb119a35432a45e68dad05ecc4629fd2652a43b10b,t,76670,6089348,,5000075,2018-01-30 14:00:28,161
0xf46ebfc790bbf79840a9c0efc55d836e8b34a51d293bac5da121b98245fe9e3e,t,21000,6110348,,5000075,2018-01-30 14:00:28,162
0xfa7221d4a62bdc8e579aaccd3cc460373f81f7a392861b5b70ceada54f853164,t,21000,6131348,,5000075,2018-01-30 14:00:28,163
0xe5757b0c78d24a9944a7ce5f25c7e9e7eaf0e6c2742c4a58d0a5b344458a5d16,t,21000,6152348,,5000075,2018-01-30 14:00:28,164
0x191d1ba63c8baf8d11f62b369bf1261af5fc0caf84c885ee97c2a4abdfb86b40,t,21000,6173348,,5000075,2018-01-30 14:00:28,165
0x92da097f438343a83c5a3fa42d4c73ca373cab9f10b2f693d27b4810136c1ade,t,21000,6194348,,5000075,2018-01-30 14:00:28,166
0xce3063b647196e43182df11493fed884cd42930c86da1db654b39398648da05e,t,21000,6215348,,5000075,2018-01-30 14:00:28,167
0x0078280dd764f9888c1defe5edcbb9c816882dba9a39b8420e5e6f7a753874f3,t,21000,6236348,,5000075,2018-01-30 14:00:28,168
0xb7bcf0f78fe46b54d20ff6fbf8e17c77b56771982ca9b5600127121385314bda,t,21000,6257348,,5000075,2018-01-30 14:00:28,169
0x8d3dc14748897e52da1f7132224473e57a9af8bafac0ccdaa854c6794a4233c1,t,21000,6278348,,5000075,2018-01-30 14:00:28,170
0x67c454cf27aaa2684a19abcae5ec48b58f1cd068ca9ee063d3b236126ac2f208,t,21000,6299348,,5000075,2018-01-30 14:00:28,171
0x63c98ffccc0f1e24f1cb52f6e435c6f588df9a4a9c1cd33fad39ccea4354b4c7,t,21000,6320348,,5000075,2018-01-30 14:00:28,172
0x0d2d0a8e098dcdc28340c00d971fe6c3d50f547ec6e37f33406cc9519d071aba,t,21000,6341348,,5000075,2018-01-30 14:00:28,173
0x00cfa84a2ba421748894e8714781293bcd5489781c8eb8f9e7e25d58dff47c3d,t,21000,6362348,,5000075,2018-01-30 14:00:28,174
0x80d4428241d463ea049a423a74fc66a018098a8e3616cd9c94423d56f786afca,t,21000,6383348,,5000075,2018-01-30 14:00:28,175
0xecac39ca1981d6b9c01630b5fd4debe2f1dfb305e9bb20671f8ac71646331084,t,21000,6404348,,5000075,2018-01-30 14:00:28,176
0x9f1a127178c6fe2693cdce7c041c2b442de44e5eb5148dd15cb53697c2c6cbe9,t,21000,6425348,,5000075,2018-01-30 14:00:28,177
0x6b34f292342520109f233d3282be0ec982e0e0632e7c46312ce86020e05b8881,t,51542,6476890,,5000075,2018-01-30 14:00:28,178
0xe373d7d3b5358b9024d921367932639c44d34e99809e0fe0036efd0ebb029b2e,t,21000,6497890,,5000075,2018-01-30 14:00:28,179
0x320ee048e2502a2733e9f15a6f6f4d44d9bf1b47562e40a3b2d8c4e99e26b72c,t,21000,6518890,,5000075,2018-01-30 14:00:28,180
0x72a44ddd225be2ed1581d853b1f7ee4ae3252c845008ce0a3c69b75061a84c9b,t,21000,6539890,,5000075,2018-01-30 14:00:28,181
0x090b379e7990ef318377caf29b8fc76fffc1f3a03abdea184babb09ef1723222,t,21000,6560890,,5000075,2018-01-30 14:00:28,182
0x944859ca3df6220cde4d4fc61dd936e76885975d9d7f7d0d699fcc3e3940e7b0,t,21000,6581890,,5000075,2018-01-30 14:00:28,183
0xbf1a5a924e6891b57aa0435d89a2c47b21b1bdc63c03dcd2923467846b9ed93c,t,21000,6602890,,5000075,2018-01-30 14:00:28,184
0x94663661b6c1746d0293ff77f5a0bb9f2a84cc5fb19782f72900c3249ddc09e2,t,21000,6623890,,5000075,2018-01-30 14:00:28,185
0xe7ea66df11f861c480d6ebca0257dcee61a5dd9296719090478f3dd3ec0f419d,t,21000,6644890,,5000075,2018-01-30 14:00:28,186
0x9db09bbd408c66eec96188ae1d050d7709616b121b66f757849e496529ae99b7,t,21000,6665890,,5000075,2018-01-30 14:00:28,187
0x93ff52d82956e81a7eeb391843c10a16302b8dfa0170244b7232d69138ed72b2,t,21000,6686890,,5000075,2018-01-30 14:00:28,188
0x3166daa0bcae2e3a213b3a179c23621a9b0302015ddc1160b82d2831c0ba0ce3,t,21000,6707890,,5000075,2018-01-30 14:00:28,189
0xc3af12e971ef5886029ec1a4970484c702103251406df9aa97609d5f7580fd86,t,21000,6728890,,5000075,2018-01-30 14:00:28,190
0xaeaad2cca7917d1b67ddc97f7fc8907931501c35f60dee0f723938487c4ac139,t,21000,6749890,,5000075,2018-01-30 14:00:28,191
0x8cdee6abbed0c4ea105916ebeec16505de0a2201ffe5fbf3e99a2acd1e9d9245,t,21000,6770890,,5000075,2018-01-30 14:00:28,192
0xa6548947d9a24c9e8e3e80730c83efa8c606932a16bfed097c154cfb943a6cae,t,21000,6791890,,5000075,2018-01-30 14:00:28,193
0xc71378da5f347e3ab6545853e37fd827b85436c379e08664725d6be517c13a0f,t,21000,6812890,,5000075,2018-01-30 14:00:28,194
0x9f76104b257943a6dab96f99153dbf8cb1db52a40981e2e43794aa8db98582e2,t,21000,6833890,,5000075,2018-01-30 14:00:28,195
0xe87f52ff8c4b39074e8dcfaaca6d12c9ac17252729fab9fbc6df7762f3a68377,t,21000,6854890,,5000075,2018-01-30 14:00:28,196
0x6f1ae845957c4aad8b1d2bc340e82679ccdd0a087af35c26a50bb0fcd00f29cc,t,21000,6875890,,5000075,2018-01-30 14:00:28,197
0x7fe120d287c7c139967a58cc14908d817683d088b3d25682269f77ec09d64238,t,21000,6896890,,5000075,2018-01-30 14:00:28,198
0xdffc30b621014f322ce40b7586598e458911e0cffd2797cf05153a30895593b4,t,21000,6917890,,5000075,2018-01-30 14:00:28,199
0xc85bd2686bb2770773e06e87e61d55cfa56be71fbc3a7e160485c18e3e10cd08,t,21000,6938890,,5000075,2018-01-30 14:00:28,200
0xfc888405e196fdc2872404f0912430d3f5dcad68acb66be0497ef6dab803e496,t,21000,6959890,,5000075,2018-01-30 14:00:28,201
0x708f3af3beb14a1064fdc70f37f729365765c65434c454126814c103bdc488b9,t,21000,6980890,,5000075,2018-01-30 14:00:28,202
0x0f9a7f117bde7037c68deb54d8cf1e0a43c054656d369b9578f05a8dd702d0ad,t,21000,7001890,,5000075,2018-01-30 14:00:28,203
0xfdcbd060e3f3824b037e39f4a290e3472624b3e9e2c8535493fbe326eb5a1100,t,21000,7022890,,5000075,2018-01-30 14:00:28,204
0x9a26713e575443cc593b2eb21d3812d714dd58825d72829783eeaba7c241b8ba,t,52091,7074981,,5000075,2018-01-30 14:00:28,205
0xeb03ff9dc4bfa523b07e6f67fe8960d22a53422eeed2eaf2efa99835e82b55f5,t,21000,7095981,,5000075,2018-01-30 14:00:28,206
0xa87af9e1ac805df4bbd2f2644647ea87321ed8f73164f8125c108ddb0867f146,t,22373,7118354,,5000075,2018-01-30 14:00:28,207
0xf1c3d2292d89df801c1233f832a0a3cdde58249f6a0f564e95de90622c2c1089,t,21000,7139354,,5000075,2018-01-30 14:00:28,208
0x5b47117a3c958a69c4316b34f49428cbf0484b29e207b6f32bfabc384d79b932,t,21000,7160354,,5000075,2018-01-30 14:00:28,209
0x39bd8a02829b0d3dfc3cc97e461ad20b35ce101069978ceaca45c0bef3b711e0,t,21000,7181354,,5000075,2018-01-30 14:00:28,210
0xcab089b082d7e3e1e8f54e56ce6a2207a72aa3e873c11aee66f96b7e1d2596f1,t,21000,7202354,,5000075,2018-01-30 14:00:28,211
0x7598ac02f62a968ce664735e91eb376d77b8a4d50180dc836f385aeed843f22b,t,21000,7223354,,5000075,2018-01-30 14:00:28,212
0x431e42c6c11eec82c4040e9651ddb36d1fb4b75e6c2f794d23d1dce694dcb178,t,21000,7244354,,5000075,2018-01-30 14:00:28,213
0x3bd15cdefe76585198f0c0a6eda810e83a83a3cbd9064490af2f7309347b9cb7,t,21000,7265354,,5000075,2018-01-30 14:00:28,214
0xa57803f12b405f7561edfd494aa46aecc0ead32acecf411a50c31f228d3f72b1,t,21000,7286354,,5000075,2018-01-30 14:00:28,215
0x420890039eee28b0f3aa62983dca78787ff78836968048dc7a593df1149e8782,t,21000,7307354,,5000075,2018-01-30 14:00:28,216
0xd9db3aa071c3b70f656c174992553b743dddd7dc48c75c322aa5805ce0d2fa2d,t,53047,7360401,,5000075,2018-01-30 14:00:28,217
0x102847570243d065fe771236b0b6d910e295249bf4adb7c50380de80744b21c6,t,21000,7381401,,5000075,2018-01-30 14:00:28,218
0x3e5203f05b6e1020d29cbafb2f30dbca7527a88197be6806d4888d419bf0186c,t,37950,7419351,,5000075,2018-01-30 14:00:28,219
0xf396b2268ac34f98c940a74d558082384b1a5378287589444822240d11ff1eec,t,21000,7440351,,5000075,2018-01-30 14:00:28,220
0xb8d128c2527a40d96ddc0f06c5f0425575251faf8cfce1664a856ba2debfba7c,t,21000,7461351,,5000075,2018-01-30 14:00:28,221
0xb60c0cfb420df6d59e80e6f47132feaac4d9729c8e251305ad6d7b29559c7afe,t,21000,7482351,,5000075,2018-01-30 14:00:28,222
0xc6767c96a236319047317530611be63aa803bf547c48a8a0b25b7d0b412792ae,t,21000,7503351,,5000075,2018-01-30 14:00:28,223
0x0eeedbf4810f04db19475f0cd9d011cf76e5210b0df5ec6ea150f2acb834d1f5,t,21000,7524351,,5000075,2018-01-30 14:00:28,224
0x43629e520b97bc46f1fa05d5505715bfb2e087ea9765ff9afb4b2ab5ec977e23,t,21000,7545351,,5000075,2018-01-30 14:00:28,225
0x0d78af19a3846a019ff7d0862c69ec33f0f30842f48ac2799ac5463d42119b5f,t,21000,7566351,,5000075,2018-01-30 14:00:28,226
0x8501580c7cdc71ba9ffc8d6258c5e76428234f93e6b7c2e6fc6c0ada778fb5b8,t,21000,7587351,,5000075,2018-01-30 14:00:28,227
0xb094c3d7931b93ef3c2d5756a4268e2626b9b892843d8415a76cae8bcefc0906,t,21000,7608351,,5000075,2018-01-30 14:00:28,228
0x2377afd901bf0c8080c37dc3532af169f180b14ccfcbb2b7705a2ab51db64f09,t,21000,7629351,,5000075,2018-01-30 14:00:28,229
0x36b650e6423d1cdbd952ea4591d859d45a8e4d80a353b5092e87ad543b86e7f6,t,37950,7667301,,5000075,2018-01-30 14:00:28,230
0xf59cef9cbaf9070d46d1c39be73b5771ec0681f31ec585cdf3498db6d8aa1348,t,21000,7688301,,5000075,2018-01-30 14:00:28,231
0x41cfb7696b10221e91bbdc51b2bad7757f8d199d050921cea1ff4d9750978834,t,21000,7709301,,5000075,2018-01-30 14:00:28,232
0x93cfcfa638d069781cc6312a1e51c0ef00f65e728303fe9f73b14f9ca8cd6e38,t,21000,7730301,,5000075,2018-01-30 14:00:28,233
0xbb6a47b7e29c5aa4bc1065b5d7d933235970f889778fcdf29573289a5410b632,t,21000,7751301,,5000075,2018-01-30 14:00:28,234
0x16c2c06d6d13528068ab901cb9f8eceab16041cbc9251966e87a186ca53ed302,t,21000,7772301,,5000075,2018-01-30 14:00:28,235
0x0ff5d99fdb0535083297116f1db11dbeb24494e12312e00069ed4b2cb84801a9,t,21000,7793301,,5000075,2018-01-30 14:00:28,236
0x1e825a43d39761429b896936ae84b1ba63c6f6132959bca5575ba89ef5ba1f42,t,21000,7814301,,5000075,2018-01-30 14:00:28,237
0x82b623f66e49b1959e1652ce7ffbb220e6bf7670f4fd65ea9e74a9d612d9958c,t,21000,7835301,,5000075,2018-01-30 14:00:28,238
0x87d19ce445ab642901da3fe5b2c0121aca3ab99337a017a4199c3df644c3cbda,t,37886,7873187,,5000075,2018-01-30 14:00:28,239
0xb6d7f1723e5c5d63fe57fad9c7b442882b0ae8bf67cdff38a70552553e262bbb,t,52886,7926073,,5000075,2018-01-30 14:00:28,240
0xb0f8ba7e306e180103c063c4588f52b7d0cbd0879b8cc540dc89fc9ae57a3095,t,21000,7947073,,5000075,2018-01-30 14:00:28,241
0xf062fc01dbdd7d98a920093b16a795ad6c13f51b9672099d5f6d55f1272c1381,t,21000,7968073,,5000075,2018-01-30 14:00:28,242
0x635fb292d5710e309ae5d220a28515cf4aa2445ef3cc1cd1f5b3eb12da998456,t,21000,7989073,,5000075,2018-01-30 14:00:28,243
0x158860c50c3fe1f3840fad8e9e4d9edf96a0e95671d03c57bf7b826966b0b635,t,21000,21000,,5000076,2018-01-30 14:00:56,0
0xf683a144f1512647c9b8a01d8366965af4078209de08e0868f050011b18773b0,t,21000,42000,,5000076,2018-01-30 14:00:56,1
0x2aec2ddf0ee465faa223ce5bc5b1c80a5daa7121519e860eb85f05b701b8f3ee,t,21000,63000,,5000076,2018-01-30 14:00:56,2
0x3d780d5e4989805981db37950eb0590f4c73476271be1c3e92e7e4fb4e602516,t,21000,84000,,5000076,2018-01-30 14:00:56,3
0xee3e42d351b7973bfa833ec89d0b489e8ae00be2eaa564ddfd3f393c2f5bd897,t,21000,105000,,5000076,2018-01-30 14:00:56,4
0x000985363fae9c12acc6d074eb7b1ac1b8425d1307e8199779c105788747191c,t,21000,126000,,5000076,2018-01-30 14:00:56,5
0x93d2349bc45fbef29e26fcade6651939057f5ccda7e036e2d2db45f0ae1a9e56,t,21000,147000,,5000076,2018-01-30 14:00:56,6
0x5fef3fdb0a96f01c5ae7dcd306b607904b34ee4fcf622127520355de886f6211,t,21000,168000,,5000076,2018-01-30 14:00:56,7
0x2bb7569b1b9cb2348c30225aa6ded35117ae995a5853e6eb266a01ed30665bee,t,51342,219342,,5000076,2018-01-30 14:00:56,8
0xd215f3e29c5fddb1725c0b7eb7784e20c4d45ea4d4c0acd7aff122e9ee8dddb5,t,21000,240342,,5000076,2018-01-30 14:00:56,9
0x29b8ab6791bc35d14f8376ce4f263afae0ee4d9a960d8fd3f8ab32d693fc121a,t,52091,292433,,5000076,2018-01-30 14:00:56,10
0xf8967e7ccb52e6f3a345b0779ba61d01e4895785f0766d1b9f3288a444345d1e,t,21000,313433,,5000076,2018-01-30 14:00:56,11
0x6f2dbac6c5be5fe7ef31426c78049b3b11ffd20f1cb308a3f53d22960619b1d0,t,21000,334433,,5000076,2018-01-30 14:00:56,12
0x5afbcbf4c60e0dcbdbe1723d19b32a489e296881d06ab84a5af023faf79019ee,t,21000,355433,,5000076,2018-01-30 14:00:56,13
0x31317440a37d9a6fbaf1f403c877bc3165f6561f8aee7d5d2d17ffd0f54f1e35,t,21000,376433,,5000076,2018-01-30 14:00:56,14
0x6690a9e2fa9ebf53f78410e2296c825f4279d17662dd3196d73ee45a275376a7,t,21000,397433,,5000076,2018-01-30 14:00:56,15
0x1a6d081da064c7a2a5abe83079e2f93b912fe98fd5f6601a0e371db4c0a342a7,t,21000,418433,,5000076,2018-01-30 14:00:56,16
0xa0185c998d6b827c33fb4d13ef35e414a0ad866bd623375a94c4b82fff7f6865,t,21000,439433,,5000076,2018-01-30 14:00:56,17
0xcfd672fe0980a8cfc6df00d7c9ca77c864ae3ad2d52839dd8ae38e34f6c17c55,t,21000,460433,,5000076,2018-01-30 14:00:56,18
0xe239b438d6393de16d3d5f7a78f08293ae349f96143ea9e4a62168a046735c25,t,21000,481433,,5000076,2018-01-30 14:00:56,19
0xb542bbc1fe29d1da0d34b1a98689c010d947b4d32a9d294c3038adf14ebfea6c,t,21000,502433,,5000076,2018-01-30 14:00:56,20
0xccea0a2225b55c1526b57a63a9717d1d658dea72bfe001e677eae36595a64b4a,t,21000,523433,,5000076,2018-01-30 14:00:56,21
0x5c0ea73d2c40f0ff874da948cc1aff8a5456d48c8c53d2da2b0026a5deb09ad4,t,21000,544433,,5000076,2018-01-30 14:00:56,22
0x6715ffa7737ceea558ae0ca24eb7f4df142991ac392639ef087789970a519366,t,21000,565433,,5000076,2018-01-30 14:00:56,23
0x8f186e5d885226b1a30f7f433b003191f6f767fc762c60f45f75dc00982848e4,t,21000,586433,,5000076,2018-01-30 14:00:56,24
0x191a0d39d49caff8a12867185f1a2ac9c12ff360c676b0cf8e0a4cefba55d972,t,21000,607433,,5000076,2018-01-30 14:00:56,25
0xdb9417f25570c22b87222238e62f0b932f879e4156e1aa3875baa80917b02de3,t,21000,628433,,5000076,2018-01-30 14:00:56,26
0xae36a2869d415028e1e70adb5e95d03139e31d6187d89ef804f7083afa5e1257,t,21000,649433,,5000076,2018-01-30 14:00:56,27
0x5d0314bb9a4b9d2f22f2530601f34dafb9c1623b24bcd58d6f01b31fe4f10ed6,t,21000,670433,,5000076,2018-01-30 14:00:56,28
0x9c204bd6b263d12e7c5cc75337c5bd964a3797e965f13512a8ba3a64e0209a08,t,21000,691433,,5000076,2018-01-30 14:00:56,29
0x888cd0eba52a82d9b77244bf65375757f40905b14e3c3b7346791537a7b12e9c,t,21000,712433,,5000076,2018-01-30 14:00:56,30
0xa527a116e01b4844e26196181ce20fb1146f6bcd4f575972391fb545b0f4c5a8,t,21000,733433,,5000076,2018-01-30 14:00:56,31
0xdc5e605dd2a5329793d82f43831188f84ca826cf5984d76faeecae99525b590d,t,21000,754433,,5000076,2018-01-30 14:00:56,32
0x20ae435af7b4f33a9eabba6b850e34f7b08b8dbecbf0e9365a6973ea2a40252e,t,21000,775433,,5000076,2018-01-30 14:00:56,33
0x314f4a01d917745ee380899ed6779f3e59b3f4b4433229f97ed83643ae7c648c,t,21000,796433,,5000076,2018-01-30 14:00:56,34
0x34a2cde272225521b346a6745bddd2310315ba804fc7875ae21d28972ce3ad1b,t,21000,817433,,5000076,2018-01-30 14:00:56,35
0x1ca4e16945f6b5783b9487ac145305bb06c84d040a8ae361d258c3a9ae647304,t,21000,838433,,5000076,2018-01-30 14:00:56,36
0xee4a43d4324bf596f1641586e8e6456751f0086e23d4ee261a3f16d5760e7562,t,21000,859433,,5000076,2018-01-30 14:00:56,37
0xe44739dcf5c4c1f21f34988fac3852fd08307a12de19a8d77d9edbc1dd05075a,t,21000,880433,,5000076,2018-01-30 14:00:56,38
0x2df4fd777d3a8e21fc41cd43019434b8bc21e23b454295677d4635fe8f251cfb,t,52776,933209,,5000076,2018-01-30 14:00:56,39
0xeb2b20ff85611ffbf6690c5fe18a4249b928e8b9b7475aabff187367fa4a8c3e,t,21000,954209,,5000076,2018-01-30 14:00:56,40
0x0d6126bb849b52ec78ff7a3523bee5a6f282ee7b272e5be8bb2d95b57b0b94ea,t,21000,975209,,5000076,2018-01-30 14:00:56,41
0x07cf59f8c3245798c1bb6aa63e6c31d36612a5133b9550ddd87b0707c6f4b52d,t,21000,996209,,5000076,2018-01-30 14:00:56,42
0x67786b885f284d1556e86dae31d34f0181d7043b9d17fa92d1de365dcef8df64,t,21000,1017209,,5000076,2018-01-30 14:00:56,43
0x15973fd27cfe14af1140b38c12a296ed236c439bec14d81b3ea4fe9561ab7703,t,21000,1038209,,5000076,2018-01-30 14:00:56,44
0x88b4911f18cade10effa0713b82fadfe734559ec470268dcbb83000c4d91c445,t,21000,1059209,,5000076,2018-01-30 14:00:56,45
0xdbe3e05b34eb9d54b04edf9b267bd0b13fa9f9ae20925fd48eeb8a501c03bfd5,t,38297,1097506,,5000076,2018-01-30 14:00:56,46
0x867e9e9ca79d5e6960822fd5235335ead4b6fb59e41266395c018b396d83cd6a,t,21000,1118506,,5000076,2018-01-30 14:00:56,47
0xefd29c02b98c7c0d322bc6685844d3ba6ef4fbcbd1b3a9da6f8f6af72c2d7829,t,21000,1139506,,5000076,2018-01-30 14:00:56,48
0x5a5ddc50794874d510931c1642a6607cf430afbe26e7256adcbbcdc7fbfc80dd,t,21000,1160506,,5000076,2018-01-30 14:00:56,49
0x3df40fdf3cf8e7345028d8a05cd3966db5e0ca20288481b6bcd16b281e412368,t,21000,1181506,,5000076,2018-01-30 14:00:56,50
0xd1a837cbcf630e6193189a84a234c1a31bf7c4dcf4f2ad14d661ba03e5ff18ef,t,21000,1202506,,5000076,2018-01-30 14:00:56,51
0x3b0717e6b9a8479f5566767c71cb1cd08672aea91ffa6003ca238eef40e0f6b3,t,21000,1223506,,5000076,2018-01-30 14:00:56,52
0x2aa1b54710c3cbfb11ef1adbc1fe42bacbf1f9368c3f7dcacd29fe6a5373df4c,t,21000,1244506,,5000076,2018-01-30 14:00:56,53
0x383d1ea0e8c9f1e796e7d90ad3e6f96be6afa69464b3be3e231919c09765159a,t,21000,1265506,,5000076,2018-01-30 14:00:56,54
0xe5238a69186e862d07f122f1bbe35bd3b6a2dde6875d5d726ec48d4b4fb5c4d7,t,21000,1286506,,5000076,2018-01-30 14:00:56,55
0x0d7ea169f4f094760a7769b926906816487edc6b399eb9ed18298812db921c55,t,21000,1307506,,5000076,2018-01-30 14:00:56,56
0x56a15fb36d9d0327cc7f205dc875cdbea6225e99e2598a4860ec73e319b2d1e6,t,21000,1328506,,5000076,2018-01-30 14:00:56,57
0xb84754b56e771f60dcb8173fd8251e18eacb710308a06df18cd62ccfa17a3280,t,21000,1349506,,5000076,2018-01-30 14:00:56,58
0x001e0715a9d642b4c6c7d2b3edbde9ccc636ee63e5af6c1aef26eb52d63e0f27,t,21000,1370506,,5000076,2018-01-30 14:00:56,59
0x0bd00b7cc72620a4c157b404ec05b5ee2c195ce1e1b62d60e9d0472f94464ef2,t,21000,1391506,,5000076,2018-01-30 14:00:56,60
0x61b088eb4f622710b61eacb3e6c11d794ea4644977e80d9e9f9bd2360a976fe5,t,39538,1431044,,5000076,2018-01-30 14:00:56,61
0x4ea9f73a4766428d67e105652bfa7b9eeb52fc4586abef78bca6afa3271ffe48,t,21000,1452044,,5000076,2018-01-30 14:00:56,62
0xf876327e850d35414b3e116899d6d9be67c5159ff4de0da2509e234a076c7d51,t,51634,1503678,,5000076,2018-01-30 14:00:56,63
0x4334fd85979fbb8abbeaa8a797a3d8bfdb9f3811912a1068bb2023ca58c339a3,t,21000,1524678,,5000076,2018-01-30 14:00:56,64
0x90407b0f49320ca8b860e4ea7ba3f5f56fccfdd51d54ff114d73a6766baff842,t,24669,1549347,,5000076,2018-01-30 14:00:56,65
0x075edafec90ebb0b856bbd6da879e94591e3cd3d17d4256090c5536072037bb3,t,21000,1570347,,5000076,2018-01-30 14:00:56,66
0x6d7bfed96afa43fda568104eedf196cddfc9c8231dfb3b736d9b3ddee275ee9f,t,21000,1591347,,5000076,2018-01-30 14:00:56,67
0x09b7d33213c56142c89a3d823226ece5c19df9e1abe285c1655dd3ca8075b837,t,21000,1612347,,5000076,2018-01-30 14:00:56,68
0x95268877bef5dab4566285cebdb53ce4d5b6e776c3bc859e1642cae130a237dc,t,21000,1633347,,5000076,2018-01-30 14:00:56,69
0x95c163fff41b144267a88397e9195598af348f9c89f004c3108eccdebf0bb136,t,21000,1654347,,5000076,2018-01-30 14:00:56,70
0xbbae2767c5e37a8d09cfc34d21419bf7f745d94dd1ea1c08a578ffbc6b961dcd,t,23176,1677523,,5000076,2018-01-30 14:00:56,71
0xda9eec602a01afd17d97d801361e4249d53353d0d13a7dc9b2bcc1bef220ddaf,t,21000,1698523,,5000076,2018-01-30 14:00:56,72
0x46a64a46103915be5e02f62a8997ea0048da77f68978f7fc2a0a27d2f308c287,t,21000,1719523,,5000076,2018-01-30 14:00:56,73
0xb4a81c57a4ef9ed2f7a2cb7f04b0a1d6391b6db1ed057ef15e9417e971f61b03,t,21000,1740523,,5000076,2018-01-30 14:00:56,74
0x759307f0e25afc570ca2608a8f06f8340ef2d66e7779c732e6e5014b598aa1b1,t,21000,1761523,,5000076,2018-01-30 14:00:56,75
0x437ce4d7f83fa4e9d68d5db96b5776d0c84f7527c83e05f68c396894444515dd,t,51784,1813307,,5000076,2018-01-30 14:00:56,76
0x34becf22ac1c7dc78da7bb03c257ae27df8e67a6498d80b39800139516223944,t,21000,1834307,,5000076,2018-01-30 14:00:56,77
0xf9e270809fb691f97f2b76a712e8484d122f8a778834a55c6cfeb2203b9f3775,t,21000,1855307,,5000076,2018-01-30 14:00:56,78
0x7ea08129210c77ec20e35364cc747dec6fece8bdd4b25d2106e83d036fabd935,t,21000,1876307,,5000076,2018-01-30 14:00:56,79
0x1b51c569ade75e5fc6d1fb054e1260d8bf9541ff93cb5d419c856c9accf8ab6b,t,21000,1897307,,5000076,2018-01-30 14:00:56,80
0x8a39448b75c633c269533689cfedefe83c9088e98058c0d8c2682f260fedd079,t,21000,1918307,,5000076,2018-01-30 14:00:56,81
0xda1b48e174e812ad6def0c34124de01bc8ed68831d915b01d505447153e29b92,t,21000,1939307,,5000076,2018-01-30 14:00:56,82
0xff8c18b83647fac2379fb479cfcf44df5f60ee77fb3d68bd484d0cf5fcf94b93,t,21000,1960307,,5000076,2018-01-30 14:00:56,83
0xab269c840593f9b248a580865e596a76b615f5fa1f46d0d0c0019dd3cf6fddae,t,21000,1981307,,5000076,2018-01-30 14:00:56,84
0xa3bf40e929a5761cb8e6e9627c2cd4cfc66369532b04193dd7adcf345515d598,t,52155,2033462,,5000076,2018-01-30 14:00:56,85
0xd1f6d6fca69c9f64d18ca4aa8bac03c31f7d3ee71adcd912660df3961da5f01e,t,21000,2054462,,5000076,2018-01-30 14:00:56,86
0x053d51365b49461217d20fe8c3a5c180c66671696f57474ec9b29fb98f267460,t,21000,2075462,,5000076,2018-01-30 14:00:56,87
0x79c173b34ca7fcb06d0c1634882eb2085b557e72d8fb46d33f2594142869c114,t,21000,2096462,,5000076,2018-01-30 14:00:56,88
0x0c1dce8d27dbd7c25b9bd4c12562f9c8cad9bb586a6b06ee960694109e21e7f6,t,21000,2117462,,5000076,2018-01-30 14:00:56,89
0xcbe04a4792347193f665f9d9900137aaf6b02c4010454b2bf8eb086a26a8a481,t,21000,2138462,,5000076,2018-01-30 14:00:56,90
0xa5dc8f52b93098fbc9788b4fe989e62efd8c7f42270b33764273103f1e70bd64,t,23446,2161908,,5000076,2018-01-30 14:00:56,91
0x670f3dfa3a02abc70c1f49dca9239463c230342a75a37eaba5e9379cf225b3d1,t,21000,2182908,,5000076,2018-01-30 14:00:56,92
0xe5c31a4643ca0f5927e544353749d352846f003f09c2ca78f29cd0b95d98395d,t,21000,2203908,,5000076,2018-01-30 14:00:56,93
0x3ced4f61dc54afdc3c437dbecb7ae90b8e70bc77e7d0284d4371d6a19a7353f8,t,21000,2224908,,5000076,2018-01-30 14:00:56,94
0x01ca5827803a3bef3097b470e043fdc1f265f930c7d6e99b2063432f41572ad5,t,21000,2245908,,5000076,2018-01-30 14:00:56,95
0x626b75d95794037f9c5fad3f85e6bc01e0fb9dc04ed55cb03c14f82798c45fce,t,21000,2266908,,5000076,2018-01-30 14:00:56,96
0x3afa4859fda6646c93e024067a2733cc574c01f8725672ffa0f02c957468791d,t,21000,2287908,,5000076,2018-01-30 14:00:56,97
0x551728ee063eeda73ef227c0acd81fb54630b49b9cefe91a48426e8f14a2d96b,t,21000,2308908,,5000076,2018-01-30 14:00:56,98
0x9ce87e4103830d7d9f932c425f59c2b7ce98297d1f0a0bf8c7383c0810d51d2a,t,21000,2329908,,5000076,2018-01-30 14:00:56,99
0x17a1fbb9b8c865b98b89be5df35e93e162739cec82abe46e21ac93bda42ecabb,t,21000,2350908,,5000076,2018-01-30 14:00:56,100
0x5a8e3cb311889adef98e6b07a6b4b570779e711d4981319464c0b6abdfc37f17,t,52746,2403654,,5000076,2018-01-30 14:00:56,101
0xa39db5282dc872e0d3a0d079734d69b2869270e2f4bd2132bfd93a6c5800796d,t,21000,2424654,,5000076,2018-01-30 14:00:56,102
0xcb995ea607dd2ef1d251350dbe0215c31ec00929e36bcc0b6832f7f07daf509e,t,36772,2461426,,5000076,2018-01-30 14:00:56,103
0x87123a60fb527d25472b65421e29f6604b81d1df3eb64960ec4adfaa23389cdf,t,37155,2498581,,5000076,2018-01-30 14:00:56,104
0x9094355e684830852ca06efdf66af679ba3606578a05225326befdfd2a55c661,t,21000,2519581,,5000076,2018-01-30 14:00:56,105
0xaa72e3f9cd9de09b5b67cb5d106879bbf7685daf94fc3c8fb479ef413f233a7d,f,67349,2586930,,5000076,2018-01-30 14:00:56,106
0x873affacee71a8cafa931509b5597d68f53f8c0717656c47e9444d7ad0217a18,t,21051,2607981,,5000076,2018-01-30 14:00:56,107
0xbdde3fb546d86513f8b0c17d024a9cb144f2ab36a7e2fa8e5eda9961c9c8e678,t,21000,2628981,,5000076,2018-01-30 14:00:56,108
0xa2848acc72a97a580b2cf44e6fae48d70a231247ffd29cb3651312f473453679,t,21000,2649981,,5000076,2018-01-30 14:00:56,109
0xc70693fa99e6912b4d5e5a0a970c84f9ebbf49690fdbc1c6e60015d02a128d29,t,21000,2670981,,5000076,2018-01-30 14:00:56,110
0xba366984c0eca18d471f5e026c46538cd12cb5796972f6614da7a9bdc32efcb9,t,21000,2691981,,5000076,2018-01-30 14:00:56,111
0xaf1958421c6f3b1ffa4a75f9bfcf21795d0558bad0b26008465e858d5ddfb9e1,t,21000,2712981,,5000076,2018-01-30 14:00:56,112
0x236d0b31740453eec36d35fe5ba904b8caae3767dda79744cfd190c6cc9ebb7f,t,21000,2733981,,5000076,2018-01-30 14:00:56,113
0x0d7d7ef17a4a855bb24935e8b97c3425d5deeceb1bee38e30f21c0f8578a895d,t,63122,2797103,,5000076,2018-01-30 14:00:56,114
0x72e175a11ceefdb17940494995e4cea45e4d047a54963afa8ce8ad7808c8a429,t,59418,2856521,,5000076,2018-01-30 14:00:56,115
0x78b37ff44f5692fe7edc4fb9651ab341d5051ee5948f448328a919bb945901d3,t,21000,2877521,,5000076,2018-01-30 14:00:56,116
0x969a0d50e3e3c9cdf23fd78ba7f423d280ba71ecd8ea8414636cc1e45294175d,t,37084,2914605,,5000076,2018-01-30 14:00:56,117
0x3a84ade2f93d7f965d3d907a812ed72b37d20d725a95eef5b5c3f3bd071aa0be,t,21000,2935605,,5000076,2018-01-30 14:00:56,118
0xd26ecf3c4bf251b4fa602aeb4dc8b85cbcfba28ac392c42640ac485ca38451fb,t,21000,2956605,,5000076,2018-01-30 14:00:56,119
0xd6edb0c3011d83db3dbcbc417832637292ae5a47606f34b93c6eb9bdf913eed8,t,63240,3019845,,5000076,2018-01-30 14:00:56,120
0x7e0dea5e22db72f1579a70548bf833d9b8d08dc0a609d0a21c0f4c6a9cb4adda,t,45738,3065583,,5000076,2018-01-30 14:00:56,121
0x5ee61982e439963ce2f600a484cc4697145828a279c075f58f3cda7254789f9c,t,21000,3086583,,5000076,2018-01-30 14:00:56,122
0x9bc3f632003911a560155a9ded0f4ed5e55bc4fc98f667b7f36bd0e4f8cfcba4,t,21000,3107583,,5000076,2018-01-30 14:00:56,123
0x1302519b151ea9268ff6f554f83c9870cd274abe8125c3f1fc8dcd020d56ecd4,t,21000,3128583,,5000076,2018-01-30 14:00:56,124
0x5873a52a4cef9fa0b11e70aa18a7bf0b82f63812d567ab3c451227a288d6136b,t,21000,3149583,,5000076,2018-01-30 14:00:56,125
0x63bf4d40bc1f689618bf9634422ddd8461a630610e33eb6dacb0749716c0fb3a,t,21000,3170583,,5000076,2018-01-30 14:00:56,126
0x0489198b62eb78b01820b3ba1c5e01bd7a6a0e9004a1bb232d4ee2ba793d0c98,t,21000,3191583,,5000076,2018-01-30 14:00:56,127
0xbec24b780e1339b8b4acc6124b2038cfb1cac6f97ccd3cef8fba6cb6ec62fcfb,t,21000,3212583,,5000076,2018-01-30 14:00:56,128
0xd64f8fd75ade1f41c4faf28e19da0576a08404e4f784e55f95f9eb52c44da2e5,t,21000,3233583,,5000076,2018-01-30 14:00:56,129
0xaec9d5adc818c798969a95c3b70ef3b09f041412e652d85f2732c23a3cea3572,t,21000,3254583,,5000076,2018-01-30 14:00:56,130
0xd61087f2d6dd403be067933517f0f81282e998729a87e7b6d4d30cf07d405e91,t,21000,3275583,,5000076,2018-01-30 14:00:56,131
0xf64ee8a63b0f52158fbe4850fd91375e25413e5c8d4ebdd55343c761b3d8246a,t,21004,3296587,,5000076,2018-01-30 14:00:56,132
0x050526185e2927b4e1a75fcbbff0e38b5b445b5d23a668634221ebc14bb06ce7,t,21000,3317587,,5000076,2018-01-30 14:00:56,133
0x146ea9d8f67fc0947689af50797deabc8bed8a7ebfe6cb3e921b99ddb69b6893,t,21000,3338587,,5000076,2018-01-30 14:00:56,134
0x4352dcc6fda1794bf93bfe4418ad979eaee6ffa27624b8d6ed014b8d98fe219c,t,21000,3359587,,5000076,2018-01-30 14:00:56,135
0x2cb2f51b396d444e9573d89c6832dc7c74b0f9210b6e258c5c10487857d8779c,t,21000,3380587,,5000076,2018-01-30 14:00:56,136
0xcb432398a5b1cc8c0248b1222157089030ed9d2d7ae30ce63dd40d017d46a41f,t,21000,3401587,,5000076,2018-01-30 14:00:56,137
0x784d7f7f0a45a44685ff064357a11d688c5de3ab4c8d952e0e8ae8a41ac9338a,f,110000,3511587,,5000076,2018-01-30 14:00:56,138
0x12bb442a8a6df41b4198ae5d5f20b57de64274f5dae1a806396a81d6e222fc22,t,37426,3549013,,5000076,2018-01-30 14:00:56,139
0x748a5199800d9d16d0b0c0e99033f959308fc21c1ff70f6ae38e0cd4859b0221,t,38252,3587265,,5000076,2018-01-30 14:00:56,140
0x348f034e8650e0d7fb6dac17e42ba3a310bec2a5ab2c8a1caa318f042a685255,t,21000,3608265,,5000076,2018-01-30 14:00:56,141
0x3be2a5e5fcd79d24dc20372529bb4626611bf44a80ffe8500b82b80b9765f61d,t,53679,3661944,,5000076,2018-01-30 14:00:56,142
0xf19d8fae5ed4e30654dc4e41f226eeeac94e6d22f0bbddf5e17752d21e04ceb4,t,21000,3682944,,5000076,2018-01-30 14:00:56,143
0x14ef411fbad3893ac92f401c5cab0242c76f2515809bccb4eeebaf410f75ebd3,t,21000,3703944,,5000076,2018-01-30 14:00:56,144
0xf8d0d81ee70d16505af0e313ee140e5650c22b0b8aadcbc28ad392b5fb5c41e7,t,108306,3812250,,5000076,2018-01-30 14:00:56,145
0x570fc64e8234719678a8a546042f681931adaee509c3421b0dc2c2a40fb10498,t,32122,3844372,,5000076,2018-01-30 14:00:56,146
0x73c9e7c032a69267ccca4e6d3f3279215df18d5dd63dd1bc002777fb2b2de354,t,22588,3866960,,5000076,2018-01-30 14:00:56,147
0x49ea9491ee4c74ac21c3885d18af94c3c1aa71d9e2dea4497e8f6f593e39caf9,t,52155,3919115,,5000076,2018-01-30 14:00:56,148
0xd7b237a78be0849125f4b8347532a9f631764bac5d069f2afcde1b14e4f814bd,t,21000,3940115,,5000076,2018-01-30 14:00:56,149
0xa6ec2f458e6b90bc981717db160039fbb7d5ec90c27572d83e866dc6f6ef88d9,t,21000,3961115,,5000076,2018-01-30 14:00:56,150
0x5d247038d01842279d9bdded51560c27302b82b19fa5c5dcbee489ab04e6cf45,t,21000,3982115,,5000076,2018-01-30 14:00:56,151
0x8a453634f14952063f207bd9a9571ed50f8de1875279bf1224796996422c6418,t,37318,4019433,,5000076,2018-01-30 14:00:56,152
0x2fc24b3df15a9634a4cb857145b70185f5f1f48e365b677864f9bfa75b4af0f4,t,82941,4102374,,5000076,2018-01-30 14:00:56,153
0x16898d856e0d452d8a1ed1c556f06ee7d5a00746c136f374c711883ab7d00869,t,21000,4123374,,5000076,2018-01-30 14:00:56,154
0x1c63457ac049b2c8e91e3a0dfbfbed5306e84b4b4e94e9870cb604c1be43365c,t,52126,4175500,,5000076,2018-01-30 14:00:56,155
0xc1cc7bc0bbbff3c6441d11dfafb0f0bf91a12d14439e9e52432d255e8a496af4,t,30981,4206481,,5000076,2018-01-30 14:00:56,156
0xb9427476ced6e6127063f51795997276302cc01c52fc507ccea3727ecc5fd89d,t,30981,4237462,,5000076,2018-01-30 14:00:56,157
0xa498634637a980775763cf261767ef29852e9d2d1324a8ff22ffd73660e0ca90,t,52830,4290292,,5000076,2018-01-30 14:00:56,158
0xb5e915ed18577dc6a4b2052c46e675e03980d5dcb4e9348479a7b1fbb6402169,t,38004,4328296,,5000076,2018-01-30 14:00:56,159
0x10b856b41503167bbf3c23431964a8f70d1277b43d3c6ccee15e3354f116a7c8,t,21000,4349296,,5000076,2018-01-30 14:00:56,160
0x159c1517b0bfd3ff23c82811ab32c35b2adb476931ba6a290de5db666b7c8807,t,62521,4411817,,5000076,2018-01-30 14:00:56,161
0xabb6abe2af4399c0e81dfa4d5ba4397181dd99a4ede3d8524bcfbfa1c9b64b1e,f,22073,4433890,,5000076,2018-01-30 14:00:56,162
0x88eb582e2c7b658a98bc8b5faa7e85cfb9d1fc4d2fb1be52d32ae38330d3dce2,t,21000,4454890,,5000076,2018-01-30 14:00:56,163
0xb761431b20a1106bbffe17ac5ad33f0ebc8870161192be0b2f9d66d05bcd079d,f,50000,4504890,,5000076,2018-01-30 14:00:56,164
0xf35a68afb048c390665c3076e1f7c39dad936b7120b7f1fa9aeb50029fda3d41,t,51240,4556130,,5000076,2018-01-30 14:00:56,165
0x119ed236d956642dc4037cac9f860c72ca832abc74b34684c74c26cd621eea1e,t,52886,4609016,,5000076,2018-01-30 14:00:56,166
0x88af00567a812110881706e8314f77d3caeab589ca33a144226110f35675b8bd,t,36792,4645808,,5000076,2018-01-30 14:00:56,167
0x4153680e7f67815bf19b7eccda60251bd257283a42b6f59acc4fafd09bd36c01,t,21000,4666808,,5000076,2018-01-30 14:00:56,168
0x6f120bb172b9b3703171542da012a5be7c5911210a49d0b6ae151eb8d9e00849,t,21000,4687808,,5000076,2018-01-30 14:00:56,169
0xaabb66c41ae3e26d6b63293b0cd826372240e2bfb80fdb973438c4f83151ad15,t,21000,4708808,,5000076,2018-01-30 14:00:56,170
0x1cbff4dd1c9d377adea5f5a853c261f1c8edfb5491c781b8b705886d38900907,t,21000,4729808,,5000076,2018-01-30 14:00:56,171
0xb47b32d987552e71c80175c0248304f4bbe8569609e0d02f67449c1ddbdc30de,t,21000,4750808,,5000076,2018-01-30 14:00:56,172
0x6bfdb5816c631f5adf0292337137d5532d1ca66354e77f5eb13cb08ce817d205,t,37654,4788462,,5000076,2018-01-30 14:00:56,173
0xc960b5c5eaad93813d33cde0bb5f1328bd864e03145636e17cb3b6f9c8d2831f,t,39026,4827488,,5000076,2018-01-30 14:00:56,174
0x85446da207b003f4913c9a9312d7eb87190869e4f5a2f05132bcc470b75dfaae,t,21000,4848488,,5000076,2018-01-30 14:00:56,175
0x20fa078ffda2353735f34ccc883898ad4f328da00858dd69e7625a403b1e7514,t,63240,4911728,,5000076,2018-01-30 14:00:56,176
0x0b52ee3afa0c9b2c5274802cf985198d04232928bd50de3965ef479e966428ec,t,38094,4949822,,5000076,2018-01-30 14:00:56,177
0x9ca3f70c6c773120bd278da834e8ee8c8520d53888df791815f717e3ff906fc5,t,154748,5104570,,5000076,2018-01-30 14:00:56,178
0x4c31d3dc7d66faa8b5d227092bb3966c156ee5e71d9e1152bb031ddb176ac431,t,36984,5141554,,5000076,2018-01-30 14:00:56,179
0x3d294eab5f33b195fb05759d40e072b3f3568f074a74392056c5822ffc6eeaa4,t,98809,5240363,,5000076,2018-01-30 14:00:56,180
0x7f858897b6a9db2df4620da72bd8d2d0dbce937b926e7fe58b27ad2d46e34f55,t,21000,5261363,,5000076,2018-01-30 14:00:56,181
0xa3b5defeade4e63e6ac8b03dcbf2a9ee4ea765ab8f48e5760ff6e7a104f1e842,t,30327,5291690,,5000076,2018-01-30 14:00:56,182
0x0e489c711f43353b399e8da32767065347b294244269e63733343bd43837e951,t,22058,5313748,,5000076,2018-01-30 14:00:56,183
0x7270cfb69a06709ff0c5ba7df2da43badda1d436697eace56c0445f501a87897,t,21000,5334748,,5000076,2018-01-30 14:00:56,184
0xfbab5320236d5183c8e394f8a8fcffc42564a604fa1bab351ae7a4af31fe33b5,t,92613,5427361,,5000076,2018-01-30 14:00:56,185
0x9fdbeeaf62ce3051e69dbc64f73c73235bbd8cddead76c08eb26eb9b521c80c8,t,21000,5448361,,5000076,2018-01-30 14:00:56,186
0x72817bb28e5deee39c762e33959b8dfe08a1559e1dafe2d5c58d3be5acc17c2b,t,21000,5469361,,5000076,2018-01-30 14:00:56,187
0x839d3dd6bb6e3c798b77cae57604702be5ea7aca08bf1e857c100cc3fd930589,t,21000,5490361,,5000076,2018-01-30 14:00:56,188
0x1ff2ff471d3a8f5b99a25f4e348b4240498e791cfe745002a412e18e41a8cf54,t,21000,5511361,,5000076,2018-01-30 14:00:56,189
0x011ec526ec0e610b1380a540245824fec4bf740eee3fa8e89699380ebba5090a,t,21000,5532361,,5000076,2018-01-30 14:00:56,190
0x05eda743e628c444bfb5f5da87cdcac7c3c005dc3be1fe76ff2741dd2966352a,t,21000,5553361,,5000076,2018-01-30 14:00:56,191
0xefabdc1fde1b2b652030fffde879ebd7d2564f334afc18194334dcfa00844ddb,t,21000,5574361,,5000076,2018-01-30 14:00:56,192
0x8e841e6feb76f580961b7d3e9919564279059b9debba906fc5fa2bc083b8b584,t,21000,5595361,,5000076,2018-01-30 14:00:56,193
0xc88c6edf65b8acb68f3da241bca50b0d0476af982a4d0c3d0dec8c67f368d4a5,t,21000,5616361,,5000076,2018-01-30 14:00:56,194
0x9d68f32f68c28a40c877c80908417903ef4e7931b0e75a7f4adc793a2a05ed4a,t,21000,5637361,,5000076,2018-01-30 14:00:56,195
0xc0a5d883cd1a60258172334498fe8d03f58f09babcb2bfce692786920aa7e202,t,21000,5658361,,5000076,2018-01-30 14:00:56,196
0x1210a18a83beafbe7d95c91dd2099910a1ffbb3f3463bdbc546d8ddb0cb34908,t,21000,5679361,,5000076,2018-01-30 14:00:56,197
0x59de5b08c149f4706ff69506b628b658c29ae2bf49ebf0893b71b2930cc2a08c,t,21000,5700361,,5000076,2018-01-30 14:00:56,198
0x3e284969cf90ce84a23697aa9e3733c1e4091b7b625a6f7394e0ccba50b5ae0a,t,21000,5721361,,5000076,2018-01-30 14:00:56,199
0x0f607b5dcfb1d97c40957dba22029dec04e188c46131c4010eb98f44306438ee,t,21000,5742361,,5000076,2018-01-30 14:00:56,200
0xda1a90845ce8039d2de36c049a57bab60c637801e7af878c904883d27c5ab0c4,t,21000,5763361,,5000076,2018-01-30 14:00:56,201
0x906d1cf00060e25ae0d2297e96632bb6dc4fbb681732ea180ab09fe54a002391,t,21000,5784361,,5000076,2018-01-30 14:00:56,202
0x65e43a19ab574abf590774703b74c16774b92d31202e66535788ed71b1e011b0,t,21000,5805361,,5000076,2018-01-30 14:00:56,203
0x6e4d663eedbbe1010d4269c758843a2903efb05c4b0ace928f361d953c1746cd,t,21000,5826361,,5000076,2018-01-30 14:00:56,204
0xbe39f7b6f4f2747ae49af75ae6c92b85ebae7b1f8e8c2858ef5109fffdae3e86,t,21000,5847361,,5000076,2018-01-30 14:00:56,205
0xbf888380799c2de0b3ee507c2d7f1175a387f5c00023484e0169a4d7a40af163,t,21000,5868361,,5000076,2018-01-30 14:00:56,206
0x4c8af65d3494fb9d7bf3b0b9925f3977cec2fddbe869122f52054ae970ce5749,t,21000,5889361,,5000076,2018-01-30 14:00:56,207
0xb5cd7d541827620e6694c4725a2d165b8e21af4d4a0bc9fcf07a149a09d9496f,t,21000,5910361,,5000076,2018-01-30 14:00:56,208
0x5d5b3d1e988b7233d59e91018e70f373ed57ea38ab52e5822126c0534aee769f,t,21000,5931361,,5000076,2018-01-30 14:00:56,209
0x7a4e8e805e9445e4c2b312a67db4cf0fd08c7092464cc99ad9086b81707a7ed7,t,21000,5952361,,5000076,2018-01-30 14:00:56,210
0xd4d7888c822091663b525cd409141a0dd6ce3b094e3d123233cb82ceb5bd118e,t,21000,5973361,,5000076,2018-01-30 14:00:56,211
0x69ea845f2c2e33e0e6f6fb2e8f70c234c0d939af803516eb926dc00c9d67a3c2,t,21000,5994361,,5000076,2018-01-30 14:00:56,212
0x88493b0554275a87b7997e11fbec189d512fbc44c3ef0de9610f7b7012dee183,t,21000,6015361,,5000076,2018-01-30 14:00:56,213
0xfa870a8decdf014610a8d039891792a507d75b67d60417ba26216bfb9c26cdc3,t,21000,6036361,,5000076,2018-01-30 14:00:56,214
0xc6da7ecdfa56bdbe9e12ce327509d8f1d80421cc2217ca65203e5e6e3a3707f1,t,21000,6057361,,5000076,2018-01-30 14:00:56,215
0x34d5665f95391a62d6ce1e1f4aa2d3ac4b293f5b04d880cab1121f635b44164a,t,21000,6078361,,5000076,2018-01-30 14:00:56,216
0x7feced845f2eaedbbf597c6b2ffc837e1ffdce404023ad6ef374d19f466a252c,t,44134,6122495,,5000076,2018-01-30 14:00:56,217
0x2be8f75b912bf5554f458b2b405bc1e6e0f393bc1a57a3e3e6d673a29d55745c,t,21000,6143495,,5000076,2018-01-30 14:00:56,218
0xdcf0a90dbb790998d908cff2671118a5eacf0cacab6609d7638b73e32d06e2d0,t,21000,6164495,,5000076,2018-01-30 14:00:56,219
0x3da79d3f43dc15a361cd60ba735aeb41a12c2a9e70e0eced89dec22f697f104d,t,21000,6185495,,5000076,2018-01-30 14:00:56,220
0x4efae8a190cbacb93df24a24b0af8d2d6b7412cd0d31113956f3adb0a046c022,t,21000,6206495,,5000076,2018-01-30 14:00:56,221
0x15a7226fe69e29c0c7fd7bb0a128bc3d4198b6e18691d9dc23a1789d092ddb67,t,21000,6227495,,5000076,2018-01-30 14:00:56,222
0xf93a29972f36c50ae94f9e95ebb31849f68af7c3b91b34b610448eadf7a75f35,t,21000,6248495,,5000076,2018-01-30 14:00:56,223
0x78d7b3167a8f00f4f33c8953b49529e549b5768a784cfd6141f3534b3784859b,t,21000,6269495,,5000076,2018-01-30 14:00:56,224
0xf3bab401639a9a9059fcd62699747d101b4b1cc447d3537e5cacc247ef0feb89,t,21000,6290495,,5000076,2018-01-30 14:00:56,225
0x8fd93f1d9609766b056c5d32c38a6de3b0324997c28c089a9ae57c15818aa05a,t,21000,6311495,,5000076,2018-01-30 14:00:56,226
0x83dfbaa1eb774084a9e3491d600a773b1857d3dfd72a05f0657a4d5425257510,t,21000,6332495,,5000076,2018-01-30 14:00:56,227
0x047caf6e7fd181ef0b4e9e266d969dbb14251d7267695c19adc59b94049c1936,t,21000,6353495,,5000076,2018-01-30 14:00:56,228
0xd998f1dc173e23f81cf011b5b6d45c2dac69edd3eab4981707bc1790dd815573,t,21000,6374495,,5000076,2018-01-30 14:00:56,229
0x19ad62f4ed14b194a2ee6784fe1a480dd77a41e854a105de64fc665970a61c4d,t,21000,6395495,,5000076,2018-01-30 14:00:56,230
0xa3eb4de31a2967dd5b2b4ba291d8fa411c2629c1fbc6ca0aa718f212adcdaa23,t,21000,6416495,,5000076,2018-01-30 14:00:56,231
0xe943d70a52d311bbb84dedd32fcd7e62a739ff51a03b7bb0542b62a93973b2cc,t,21000,6437495,,5000076,2018-01-30 14:00:56,232
0x570874f68fc2ad4f74b5b8992b8bd156b085342dfd59153940b08e6f7420b733,t,21000,6458495,,5000076,2018-01-30 14:00:56,233
0xb30b0c1f957977e9bfd04e3dce362bca61f525ca311a9e4f9e1a4a9be49eb25d,t,21000,6479495,,5000076,2018-01-30 14:00:56,234
0xba97c7157bbcde3748003611aeb55cfb0450f977a0fdc64af24884c289437609,t,21000,6500495,,5000076,2018-01-30 14:00:56,235
0x58b7bf0cc83a2d565af0e6f0201e8da6acf449739ebbc2f80d62c9f111d32405,t,21000,6521495,,5000076,2018-01-30 14:00:56,236
0x24396cd061b70c34f0d33ed3be86feb8de8d263f36f61e185a68cef4408edabd,t,21000,6542495,,5000076,2018-01-30 14:00:56,237
0xec38b4a36e340cc359bdee81a9a6a408ea5c78c015f3f5b3a7a3793212bbf40e,t,21000,6563495,,5000076,2018-01-30 14:00:56,238
0xbeaab45090c4c3ddabce51134781eccfe7c217352b763cad587a651f11ac2963,t,21000,6584495,,5000076,2018-01-30 14:00:56,239
0xff745ad35333be1e839e908784ae6268684a48cee608958407c54432d193e20e,t,21000,6605495,,5000076,2018-01-30 14:00:56,240
0xec6408c7a62b0bac76b39baba53eab4d8f423053c18d64d1992f6df4e3f21b85,t,21000,6626495,,5000076,2018-01-30 14:00:56,241
0x25a6acd5acd509470b7243d27730a64f4e8a0f4b607341d79ee755885fde870c,t,21000,6647495,,5000076,2018-01-30 14:00:56,242
0x2c98b2d09e5cd41560ee045fe65b7812d6fde486f1d4dab9bca5f7f1a012a3d0,t,21000,6668495,,5000076,2018-01-30 14:00:56,243
0xdd771e3e5f0c7231a38f3bd72388e302eb8949b031640e83bd3eee0cd3a29079,t,205259,6873754,,5000076,2018-01-30 14:00:56,244
0x7186d918f4b864160610a88f954e4dc29c0aba2d308534bf1c8ae24cef1c11f8,t,21000,6894754,,5000076,2018-01-30 14:00:56,245
0x536baf6f5e82e9380f154014f1b428cb67e4014788cacc9e86d75ac944905ee8,t,21000,6915754,,5000076,2018-01-30 14:00:56,246
0x4101c9449e98e05a8dd206e01a4f7bafa13139985b10e86d6520cc4722eff2b0,t,21000,6936754,,5000076,2018-01-30 14:00:56,247
0x2569a3bd746c3dd52c902c51b3bc47973f260f4f60a8c6ee65f3b778074763bd,t,21000,6957754,,5000076,2018-01-30 14:00:56,248
0x4c61516c4ecdf3887555980f26303396c4f153c11bea82d45187c1d7910e9977,t,21000,6978754,,5000076,2018-01-30 14:00:56,249
0xa59663959eb51683ca3efd7358c7584f274b672546477aa4629be856a96f4a66,t,21000,6999754,,5000076,2018-01-30 14:00:56,250
0xf5cbc01c337fe017e564a538aac0987381ed4049c350a28708d2b7db3f2f4b46,t,21000,7020754,,5000076,2018-01-30 14:00:56,251
0x17ed6580de84ddbdd06beaf6e4f78a9c5d3d9e74967912f208d7a5a86d8535e1,t,21000,7041754,,5000076,2018-01-30 14:00:56,252
0x568519c67d10041709007c55ffb838af8481d749f30ee9605800356ac502319b,t,21000,7062754,,5000076,2018-01-30 14:00:56,253
0x96cc7af94e8ab91af46ddc20887e9d659d179e2ff98d9bee8d53bd0383f0c7ba,t,21000,7083754,,5000076,2018-01-30 14:00:56,254
0x8a03c197ffbd42497b4fe9058ff8ea7a21c5950a4ef37ecd9f4cb019d4161aa6,t,21000,7104754,,5000076,2018-01-30 14:00:56,255
0x801651a99c3dfe0b9cba9814bae816f210ad8c44a0d65796ad191ec0cfda3df5,t,21000,7125754,,5000076,2018-01-30 14:00:56,256
0x1f57553427a748d2a3b2db12f2be85f47c01287206cb567b73b5233b0e0729fe,t,21000,7146754,,5000076,2018-01-30 14:00:56,257
0x30c062490128b0f602a0458c1b69df91783bf7600a678baa8da204ca9692da6d,t,21000,7167754,,5000076,2018-01-30 14:00:56,258
0x40c1f2b5bd1f472f01c93f3447d3a03c1927ede7bff86a2c680123ec5475ebac,t,21000,7188754,,5000076,2018-01-30 14:00:56,259
0xe0cc6055ff7c58ddeefcdc914bb07b931eb6b56fdcd95b8d43c87c6d7f2c13a1,t,21000,7209754,,5000076,2018-01-30 14:00:56,260
0xf773bd2782e14f9850307dc9c13ee22a5ddc6f4f67d0914492c8e3baa99562d8,t,21000,7230754,,5000076,2018-01-30 14:00:56,261
0x5862980f1b692dbb0ecba3039a0c3b050a121b25896ddaca5cf33d5fc1255e60,t,21000,7251754,,5000076,2018-01-30 14:00:56,262
0x46ccfc483e749cbb6c80de5ba0b64f5278e5f0e80e4d40614a0943c07896dab9,t,21000,7272754,,5000076,2018-01-30 14:00:56,263
0xaf4b4ca167c735f9627ce234b4e026577e3e78a725a860e6dd874e8379c08da7,t,21000,7293754,,5000076,2018-01-30 14:00:56,264
0x9114f4d99656e109150dfbc596f893639d44bab7285be089166cde624a52be0a,t,21000,7314754,,5000076,2018-01-30 14:00:56,265
0x3b6dbd079c34c7fce9915cc72aedb2854dabb1f6ef76e385600a73c2d4abb42b,t,52756,7367510,,5000076,2018-01-30 14:00:56,266
0xbbda63f7ca7a31f386d5094f6d21be889c772998e6e311c9287274693392bb65,t,21000,7388510,,5000076,2018-01-30 14:00:56,267
0xf66691858c1c6a9a19273976b0e7e1b410b8eee81ea3919873094bc496291ff4,t,21000,7409510,,5000076,2018-01-30 14:00:56,268
0x8a476c629d89932fcdf2ea9bae3bc500dc1de6287fb4b46ec54b7dae4bdad08e,t,21000,7430510,,5000076,2018-01-30 14:00:56,269
0xcdb6c01f08a825bb7f5a1a5e4aae5a43ae1ececbd3feac9f144fe16f9ba9092b,t,21000,7451510,,5000076,2018-01-30 14:00:56,270
0x6adeacd6d9837e6101346cc7252ec58821448e46bc93f350945b743ab2e728fe,t,21000,7472510,,5000076,2018-01-30 14:00:56,271
0x096e153c39a5511f895c90c21a853ea99266eb3dc61b3da11b98eca48bbef6b4,t,21000,7493510,,5000076,2018-01-30 14:00:56,272
0x35227cc068486db75758d61449384403bef3976a041b6be2ca8d1cd47534847e,t,21000,7514510,,5000076,2018-01-30 14:00:56,273
0xa8b013bd85549657dbb91f1cba01abf745194f108d4b32c799248cce75063cc2,t,21000,7535510,,5000076,2018-01-30 14:00:56,274
0x279b8086989ed91fa9cb4c3708a676fdf22b4533768fa1615ec0e709e1aed591,t,21000,7556510,,5000076,2018-01-30 14:00:56,275
0xbcdaff098bbfcfc8bbe24e305a8b8d7b02cfc0850767cb39979daeb50c010ea9,t,21000,7577510,,5000076,2018-01-30 14:00:56,276
0x308e0ea1052557fd00cd25335d44f4ba4311604ff7467c9053b7a296bb903186,t,21000,7598510,,5000076,2018-01-30 14:00:56,277
0xdd2a49c4a67c18a944c98e72aa2d69b6e1d71fdc39bedb95ff3ae7be8134580e,t,22169,7620679,,5000076,2018-01-30 14:00:56,278
0xc78728a8defefca493966690ed24978fc7645d41c2a72e53dc60540a6ee0480a,t,21000,7641679,,5000076,2018-01-30 14:00:56,279
0xce39c32b982f6b9fa4066fbc90e8028a02b42813624d2f6e3625de4e8a7f5f3e,t,21000,7662679,,5000076,2018-01-30 14:00:56,280
0x159661cb534511eabb1bc34632b2fba51ebd5e9f0016893d82c23ab97fc39df2,t,21000,7683679,,5000076,2018-01-30 14:00:56,281
0xcb3b6764dd9fca362d323b9715283ec83ff6a727b34faa6bd879de67c255c74e,t,21000,7704679,,5000076,2018-01-30 14:00:56,282
0x28858bdd40b8f4665cff30e469f9c0dd917a18953ca7ee51a93d8edbf98399e2,t,21000,7725679,,5000076,2018-01-30 14:00:56,283
0xcd2136480e81fdd61761a7221d836cdd6b6c9ac94309ace420f78f616712c162,t,21000,7746679,,5000076,2018-01-30 14:00:56,284
0x7b4bfd0e04b39cb77288551427b13b703dcff2a53b397593610f734b02364d4a,t,21000,7767679,,5000076,2018-01-30 14:00:56,285
0x06fdb41343ac16496aa735616cbfd55942ca919bc8c6b6189b6966d71e19e2a7,t,21000,7788679,,5000076,2018-01-30 14:00:56,286
0x6ac1887637ab8ba8eea0a91c7c3c04c28aab782c1fd4e69b12ebd0e5e9b3aede,t,21000,7809679,,5000076,2018-01-30 14:00:56,287
0xd7da62c599e8d3a46edd2f47a99b2862c0f76ef6d74a0e217de124b28a1f3aa5,t,21000,7830679,,5000076,2018-01-30 14:00:56,288
0xe953a97e99ed10637b893a5ac3c208efee3940397e83f8290337bc15f82ac247,t,21000,7851679,,5000076,2018-01-30 14:00:56,289
0xa8afb41ceb6c4ab039e8fee7215b11b4f5958c358cd7e3845823e22451e639ca,t,21000,7872679,,5000076,2018-01-30 14:00:56,290
0x4541feb5e32e642dfb10038b41d844c019d94c6c9a2e1ed7b1a88f5e4d13ec27,t,21000,7893679,,5000076,2018-01-30 14:00:56,291
0xd4122b47abbbfb87d438620e7acdd40e91c3b31f573f0bf35d1a2c7b59be1389,t,21000,7914679,,5000076,2018-01-30 14:00:56,292
0x4cb7d1b392cc34cf1e707cb6f4bd0466be90e5d88dbd5ddd77886e59eb696400,t,21000,7935679,,5000076,2018-01-30 14:00:56,293
0x6828bbddbd94b5e47f8fb6c65cc28555f2e0bbf3614e76aea1a543e25af2ac94,t,21000,7956679,,5000076,2018-01-30 14:00:56,294
0x43093492a194d5c38422c7c2df70d498aef78c96291ba0aef46d19845a1871fc,t,21000,7977679,,5000076,2018-01-30 14:00:56,295
0xcb1d6a01293860375831ea5d18ce5c6580f4f7a7eabbf53632fd6da01a0e7ca9,t,21000,7998679,,5000076,2018-01-30 14:00:56,296
0xd16774e244f5b1f07d35f300c5c1bc7f1eab5374f3ac299f55cb9c581ec10c98,t,21000,21000,,5000077,2018-01-30 14:01:26,0
0xae672502848e2e06f21917a7439f8e5a0a26c194f9b4f728efcc26d986213eba,t,48404,69404,,5000077,2018-01-30 14:01:26,1
0xff28b6ff6a57e238387e3a1793ed4a40d9a96a14625bf2bc42c8bb25115a33a7,t,21000,90404,,5000077,2018-01-30 14:01:26,2
0xdab17da0b3aeeb00e7da3446c7de09344b7b98943ecc761c529397fabb4d051a,t,51752,142156,,5000077,2018-01-30 14:01:26,3
0x58632106b80eba85539e59dda02c16a6b7d6eeb8214e4ac222b4496ad2d5b3dd,t,21000,163156,,5000077,2018-01-30 14:01:26,4
0x267d557523f198ddd582eb2e540ffa59d943a721bee4925cc813b362ba7f0aed,t,37884,201040,,5000077,2018-01-30 14:01:26,5
0x8a6755d7a6636134261b01f51706f8042243c5c065910777cb1b8e6c2c0e45de,t,21000,222040,,5000077,2018-01-30 14:01:26,6
0xae2109d260d71a3b5f6d75ecc50d3aff013717420585ea0956a4018ce4831712,t,21000,243040,,5000077,2018-01-30 14:01:26,7
0x3bfeae306bf199b4be5bbbb90d093d2e34dd8ad95976d94ae8838fccb19a92a5,t,21000,264040,,5000077,2018-01-30 14:01:26,8
0x252822381b90d430c674d0f9747cb63302447b430b306be7dcaa63c824334052,t,37547,301587,,5000077,2018-01-30 14:01:26,9
0x2238bd51927037eca9bd0f1d6106fcb12601f3996ec1709b9209892b59f8632e,t,52091,353678,,5000077,2018-01-30 14:01:26,10
0x267da27617131d69fe979f3b9203430903726d826e0bcd709c535dd18cf19738,t,52396,406074,,5000077,2018-01-30 14:01:26,11
0x65e04a7d1017e3d5ee60641f64c5e24e61dcdf53be9b784daf83c0d5c2289b9d,t,38047,444121,,5000077,2018-01-30 14:01:26,12
0x637019a696d2804d260839f67e3f8658efcf3a779dc727c17ad1d8913d77a062,t,21000,465121,,5000077,2018-01-30 14:01:26,13
0x18be336c78b5592f525eaedb7b50723379626f94aaeed5beec64ce061ad71947,t,21000,486121,,5000077,2018-01-30 14:01:26,14
0x808d32cab478f3f0d49981d9bba423798e28829ad741d69325e94237b08d59a6,t,21000,507121,,5000077,2018-01-30 14:01:26,15
0x77a55561bad8d5798239fb40e241a611208a6adf8550f706afc6dc9c51224bdf,t,21000,528121,,5000077,2018-01-30 14:01:26,16
0x1ee9de5fc1500fd41066c499e8b43b9069d7ecdc456b686cfd7ffb98abb722ac,t,21000,549121,,5000077,2018-01-30 14:01:26,17
0x2fd0a1250745bc91b997c23048dc25b727117da8501a3380a881365150dc3224,t,21000,570121,,5000077,2018-01-30 14:01:26,18
0xa1f0488f44ac661383ba59bad5ecc188977225ad16951f14a3783721501d96cc,t,21000,591121,,5000077,2018-01-30 14:01:26,19
0x85e493aa6c5dff83e0354dfb9a963ea9730c508dbd23cf463fe7e90694f4b44a,t,21000,612121,,5000077,2018-01-30 14:01:26,20
0xc46b39d6727df451ec90dad5e777285c32e6dbbae58121cbdc91188d8274f55f,t,21000,633121,,5000077,2018-01-30 14:01:26,21
0x37abf145d5c354f13a2987758482484488bb5edda977389c14386ed5bf25bf73,t,21000,654121,,5000077,2018-01-30 14:01:26,22
0x106275b24c5c216efecdc396cc5c896d7429c51f3498043036e9bdcea728d097,t,21000,675121,,5000077,2018-01-30 14:01:26,23
0x6a2478404b21091f6e92798a7adcc045f39e53db710a468d32bd007ad01ddb5a,t,21000,696121,,5000077,2018-01-30 14:01:26,24
0x03ca69c123f1f6866537288d9dcf75b6139ca2959b0ce172da9f6f1f1aea0911,t,21000,717121,,5000077,2018-01-30 14:01:26,25
0xf9c31deb75b666b027bbdb24f16c7eacc566ff4bdbdf0de5220e4a0b90bb2978,t,21000,738121,,5000077,2018-01-30 14:01:26,26
0x31fddbf27265934cf454ca7a805ab93ed80acee968372a3305182c929a671cbf,t,21000,759121,,5000077,2018-01-30 14:01:26,27
0xf6a2b3f41c4ac153d86f22c8d0864faa5968d877fdc37f50a307307904278418,t,21000,780121,,5000077,2018-01-30 14:01:26,28
0x3c55842f1ac38d5100cfb71cee3e175c8e5cae9428aefd888e762b0d397f14fc,t,21000,801121,,5000077,2018-01-30 14:01:26,29
0xe4a756d15254fd737530341b6d10d106ba4c5f591047b01cf9b33dc9fa1a642a,t,21000,822121,,5000077,2018-01-30 14:01:26,30
0xcd4f684cc67ae912a50d718c8db27bfacb9260eba8084dfebab59124406f85e7,t,21000,843121,,5000077,2018-01-30 14:01:26,31
0x87d115deb0242f576560c13557f2d585c8261a04d9d10f21020f6678873bcb18,t,21000,864121,,5000077,2018-01-30 14:01:26,32
0xd9f5316395fa0783eb2698400ce8f8cba8feb14d6c24cad2994a074de9c11843,t,21000,885121,,5000077,2018-01-30 14:01:26,33
0x575ce8a509e95945799e2c5104bde605393769f65e78841b6f9c1cb9345b2cff,t,21000,906121,,5000077,2018-01-30 14:01:26,34
0xaf031ba44a7f4fe7a1e32549c4f9dfd69c306768b30e382af300a1126151f7fa,t,21000,927121,,5000077,2018-01-30 14:01:26,35
0x286533c38d0939499523ba91a207a0973813b63100a3764eef55dd12afe59526,t,21000,948121,,5000077,2018-01-30 14:01:26,36
0xd7158d86176981fe41841d0ed63f0ff61822ffe44424bec63342cdd7b9f3dd59,t,21000,969121,,5000077,2018-01-30 14:01:26,37
0xa059b70c7774d8ee9a71cc14a8fc503757937f60cdaa2f79c5e08fa317cf5826,t,21000,990121,,5000077,2018-01-30 14:01:26,38
0x69ad7609c81f8665580369dba46bb4a268ee0a6cdbeca150aea7ce5cd200f91b,t,21000,1011121,,5000077,2018-01-30 14:01:26,39
0x38aaaba0fd799f2ddac2ca8961414ab0350d63949275287b4fc8f9e9dacb0aec,t,21000,1032121,,5000077,2018-01-30 14:01:26,40
0xf1f0c72925755a87a73f3c3558fd08231e3f16140db7827a854c2e58fc0ddb39,t,21000,1053121,,5000077,2018-01-30 14:01:26,41
0xaf59e0cbfc82395ffbd1019ef108c70a9a40ea2054e2b6e2e4a1d18e388baae4,f,27563,1080684,,5000077,2018-01-30 14:01:26,42
0x43d6da74d188951e79883201aefb13c2d14cea0b689daf4b23841039e3f7df72,t,21000,1101684,,5000077,2018-01-30 14:01:26,43
0x786f1252c211699af6241fb1823defd62cb4fffafc8d38afbd6c58e02a5e23e5,t,21000,1122684,,5000077,2018-01-30 14:01:26,44
0xa80fa19db69a6cef695c9588fecfb084b2dcd53f41fd50705b72b125f1c3ad01,t,21000,1143684,,5000077,2018-01-30 14:01:26,45
0x2530b6b13112359f199f0f3018cb635ce69eccf4b443176ca8344e42b8ff8522,t,21000,1164684,,5000077,2018-01-30 14:01:26,46
0x8a712be09f6de8b4cb06c7a47ac24e6cd2386fd6c0603135968ac215d8f01512,t,37089,1201773,,5000077,2018-01-30 14:01:26,47
0xc98e562fd6f8d8922cbc0ed92ca93a26ee7f1a84774b876576da517f907055d6,t,21000,1222773,,5000077,2018-01-30 14:01:26,48
0xd5b4afdce6c12594976db7afd041bafd57d4be410e005c4929480f89ef5a04d4,t,21000,1243773,,5000077,2018-01-30 14:01:26,49
0xc4612d2788bf860aed68a3cd75e7ad43d59e74d259552124c0a7b8e0d266d6ad,f,21046,1264819,,5000077,2018-01-30 14:01:26,50
0x1efc992ebc2d78150614f69d45f49cb9a34d567f9707a4814e9167efa4b44028,t,21000,1285819,,5000077,2018-01-30 14:01:26,51
0x20a24f6160ef294628fbed5d151b55ccb253f175debc5cf247a3e604e46368c2,t,78942,1364761,,5000077,2018-01-30 14:01:26,52
0x7f9cf6b0ab74891a648b768de616a9cc49cd17678c9e9af9782571de7a6aec59,t,22948,1387709,,5000077,2018-01-30 14:01:26,53
0x7e51ae5c918823567f5d629dac890df1ba52140cf393dead4d6db305790c76de,t,21000,1408709,,5000077,2018-01-30 14:01:26,54
0xc9585f052f9ce398a6d429bc4c26acf87410d817d96ddd710bd795fa605b4b00,t,22173,1430882,,5000077,2018-01-30 14:01:26,55
0x32eece67a12ac562ace114e60b2de96e0fbd501ce8deac550059686a8c563428,t,21000,1451882,,5000077,2018-01-30 14:01:26,56
0xdccb969c728833dae3c41606313e67f9c3ce75cd66eee1ceeee6343cc075a1b6,t,21000,1472882,,5000077,2018-01-30 14:01:26,57
0x345a1b4bcb7ef96f44ade819a7572d3128037ee6f67146792d7c41775fa438ca,t,21000,1493882,,5000077,2018-01-30 14:01:26,58
0x253585dcae461d861d3334d5e8d4dc5fb00d34a1c959e54f4f642693d250f125,t,48144,1542026,,5000077,2018-01-30 14:01:26,59
0x01a64b9bd173adc87fa3f0699e28cb690845e7a8410e94ad5e43542653c06216,t,21000,1563026,,5000077,2018-01-30 14:01:26,60
0xf9afdb8b1437cb84d85485b49d32954a58d11d126d6738a08ff129e478229d1e,t,21000,1584026,,5000077,2018-01-30 14:01:26,61
0xabeabd6eeeabddc409436bae3ddd6a6444481c2434ec70d9563748622956e599,t,21000,1605026,,5000077,2018-01-30 14:01:26,62
0xcf6a1a72f999997c2d6efbc46035ce7c23804c658fade3bcd3b3b1058f394cd3,t,21000,1626026,,5000077,2018-01-30 14:01:26,63
0xe34c0a2d6debebc30249f9c6b937951d6ddf19dc736439cfe8eb53e394463377,t,33296,1659322,,5000077,2018-01-30 14:01:26,64
0x424c61799179a2b7b75b2130f7b15f4eb0fed5dee695fe35590ed0921f702f21,t,33296,1692618,,5000077,2018-01-30 14:01:26,65
0x3cab80a1a62bb89f136d990bbe3fd8ed4ec78962926596ffe547de406355c37e,t,33296,1725914,,5000077,2018-01-30 14:01:26,66
0xc2de4390bf5aef0ed7e679b9d5f955039c46e694f67b5df9fc08b7f1ce4e6269,t,21000,1746914,,5000077,2018-01-30 14:01:26,67
0x81814187fca848a116f31a609e3430519e368a443518fd0263d05e241f3683b9,t,21000,1767914,,5000077,2018-01-30 14:01:26,68
0xb57e59fdd70e89ba980b9511412b13756eeb061688a203a2d7e86c4c397ec55a,t,33296,1801210,,5000077,2018-01-30 14:01:26,69
0xf237f02170b2b06007acb276687b44a8939fba8d56d07ec3ab6e7cdfbb803556,t,21000,1822210,,5000077,2018-01-30 14:01:26,70
0xd28444d6e378fc5e0e2fbe48eacb4383300ae64a5067af524f3b3fbceb66b7fb,t,33296,1855506,,5000077,2018-01-30 14:01:26,71
0xd20eb687ab74ac4b9cc2d79cdd68466816fd3d4309e1047959f7f3abaf023931,t,21000,1876506,,5000077,2018-01-30 14:01:26,72
0x630d50021d52c0ab777de372762bc2ea183c10adddc3bef119f9edf290d3e0a3,t,33296,1909802,,5000077,2018-01-30 14:01:26,73
0x399e6010df542750f2f6648096c13ff1b57cdeacbf38bcd7ea5561d94f21b2bf,t,33296,1943098,,5000077,2018-01-30 14:01:26,74
0x83295f0d5c658ab9fbf6474ee8202f0383bedcc827beb6718d40695715403524,t,33296,1976394,,5000077,2018-01-30 14:01:26,75
0x7981326acd4088e48dbbc82b32533a2280690f1b8cc14c910e53c0476319a10e,t,21000,1997394,,5000077,2018-01-30 14:01:26,76
0x042abc2e3826bfd3fdcdafdd93a2d836b86b677fba76ae44f18f838412472ca4,t,33296,2030690,,5000077,2018-01-30 14:01:26,77
0xafede88845d80214029a24e2ca55a437f57ad354b1e51b30d1929e3fc747583d,t,21000,2051690,,5000077,2018-01-30 14:01:26,78
0x471f640fc6abc824db6271e5d710cf46b8150afac8cb99939ecefec0008881a2,t,21000,2072690,,5000077,2018-01-30 14:01:26,79
0xca1d9b3430ec991fd6353def42a2cb60294a434ddc42069bba7fdacbd13f7990,t,21000,2093690,,5000077,2018-01-30 14:01:26,80
0xeb6674cf97b9c9aea1f30d10b6872eebc29e29671ccb6eeb2c8f0ea82e106aa5,t,21000,2114690,,5000077,2018-01-30 14:01:26,81
0x7c7af51cf7e7e9661484c096d47d0e985e06ae04ce895b527bcd4acaab747338,t,21000,2135690,,5000077,2018-01-30 14:01:26,82
0xe28a1f081363808968284b3b0117a5dc7a3999826d54cdfbff704516528a4fd5,t,21000,2156690,,5000077,2018-01-30 14:01:26,83
0xc79508813a90e5de3a95a81af8bbde113126ec7fac3374e84953613abfa2347b,t,21000,2177690,,5000077,2018-01-30 14:01:26,84
0x1ff13ea17bcf285910831d4f73509006f3f173f864bb42d8f83848a3b92b119b,t,21000,2198690,,5000077,2018-01-30 14:01:26,85
0xdc38695b6f49243d1ebb3f7e760b43aa23f6cdb560b4e745ae775865d83d457f,t,36723,2235413,,5000077,2018-01-30 14:01:26,86
0x221b263c860c63acce48655165d923deced693cde67c8930ca15c6cb976cec1c,t,21000,2256413,,5000077,2018-01-30 14:01:26,87
0x714fcd24a9beee483cd92f828373d7c226cd706f298ffa7f73cd37994ca4bff1,t,21000,2277413,,5000077,2018-01-30 14:01:26,88
0xe2db5287adf003de703aebd9e462b761ffa27fad1874d3a251165da61d96f127,t,21000,2298413,,5000077,2018-01-30 14:01:26,89
0x2b0993336d4f84ed3e3ed9759070cfb1914b7dd20069ae0680b4f64c6dab1b32,t,21000,2319413,,5000077,2018-01-30 14:01:26,90
0x8f358473884ab0b8c56118cbd87ec18344d1909d1390a51ded71b87c48f56803,t,21000,2340413,,5000077,2018-01-30 14:01:26,91
0xb179bf66727b744e7597390b603b469b630b98530efb459eafb66dffa27b9385,t,21000,2361413,,5000077,2018-01-30 14:01:26,92
0xbc918642c2276f20c079e04835ea5484ba92db2e41c5a54651493d6b1dd48638,t,21000,2382413,,5000077,2018-01-30 14:01:26,93
0x252416284983ab739f42257c290c421bbd44d0c7a53b0c2c71614e90213838b0,t,21000,2403413,,5000077,2018-01-30 14:01:26,94
0x0c78e4d755aadd08e88336410702894cbfb54faa9f285ec9861dd60fc8835e69,t,21000,2424413,,5000077,2018-01-30 14:01:26,95
0xaccbd0ad2c5472d9ba9d35341f7ab67f00596ccc3fec1b2a8ae3567707462a1f,t,21000,2445413,,5000077,2018-01-30 14:01:26,96
0x5523230ac9baddebdb5882e87cebaacd06a5ceea557591d01fcd4313052186e3,t,21000,2466413,,5000077,2018-01-30 14:01:26,97
0x0e805b4458103a25c28d314d1934164a0e7bce6223d0e9c9364fa7d5397ab212,t,22292,2488705,,5000077,2018-01-30 14:01:26,98
0x2ca13dbd39bb28113b2937c3396779be83aca7361e2d7c95d8752587339a23a2,t,21000,2509705,,5000077,2018-01-30 14:01:26,99
0x7f6d652b9d586aaf9ecf713cc0417ad508994f87f22527a526d21e215bbdfcfd,t,21000,2530705,,5000077,2018-01-30 14:01:26,100
0x00cdb4f470fd0876e5f49221b8529efea7792cc5b2a189fe61be309f1abd94d6,t,21000,2551705,,5000077,2018-01-30 14:01:26,101
0xad68506eedce4389a1c821273486b7cf227e0173c1a842547194623226973947,t,21000,2572705,,5000077,2018-01-30 14:01:26,102
0x2ff655fbc008786d3f78ce704d4711120f4d65f712d3e0b081fbc8e13e40e8f6,t,21000,2593705,,5000077,2018-01-30 14:01:26,103
0xa2b689ba0ff66c4b1a53dd6118046f517d7f0dcd1cb2e3199c4b87256fb8d949,t,40907,2634612,,5000077,2018-01-30 14:01:26,104
0xba7d9a477046f098cad94891806c589f28bcd661ef5c4cab4d9a6491c10f0fc8,t,21000,2655612,,5000077,2018-01-30 14:01:26,105
0x804aa5ed1ca8fcd5a046938f65ab8558e8b6b3eb7f790cc6eaa88caf67a7e2d1,t,21000,2676612,,5000077,2018-01-30 14:01:26,106
0xfe3c76370c4b70aea74df4e56b9719ff1b8687bc9bb2d10037818b3939f6d5a7,t,21000,2697612,,5000077,2018-01-30 14:01:26,107
0x36ca2371f6f4ca685107c53e87060d2c041bca10e64a8b881d870927ad7985a3,t,21000,2718612,,5000077,2018-01-30 14:01:26,108
0x4f385a5506d390d5ba8bafd511fca2c41c9b8fbe801868e8495562b4b681e6a3,t,21000,2739612,,5000077,2018-01-30 14:01:26,109
0x58c87ecd65e9c41c7d14c4c459cd14091e319f622d65c61c1c227a5ee873f905,t,21000,2760612,,5000077,2018-01-30 14:01:26,110
0x1722cdfedef24d51705bfcedc060490232bd118ab6c42331a0c8ba8db9af0345,t,21000,2781612,,5000077,2018-01-30 14:01:26,111
0x97726a379f30fe8f3ff4970a41a631580a889ea491d1740bf6931fe0cd1be6d7,t,21000,2802612,,5000077,2018-01-30 14:01:26,112
0x3dcd166bbe45f2cd022c6b1121540f3d8712105c80eb034974b4731a90345da2,t,113736,2916348,,5000077,2018-01-30 14:01:26,113
0x8d7c41e2d321d768fbf3823da75fdb5d2ba9132d4c8bf4702c5132359eff0b8b,t,21000,2937348,,5000077,2018-01-30 14:01:26,114
0xe94c5983c692167e5f7ea069409143d1a745eefe0f4a605603ea40eb09df7e55,t,21000,2958348,,5000077,2018-01-30 14:01:26,115
0xc01744c56946e8f7670236c667c8b02c4601616b47cbd9ed153a4d9915d2e5c6,t,21000,2979348,,5000077,2018-01-30 14:01:26,116
0xe45fa630c1fdcf56c5d79f93f650caa364ecd9eaabf75cc2540eb6259492d2b8,t,21000,3000348,,5000077,2018-01-30 14:01:26,117
0xa6427ccb00b57817e86190e171ac99f7f477370fb0cf3b3f199b50abde631622,t,21000,3021348,,5000077,2018-01-30 14:01:26,118
0x020e474cef15b32477f76c0d8c9d110417d4fc70e6c30733e5533e7d5def2f87,t,21000,3042348,,5000077,2018-01-30 14:01:26,119
0xc06f3d68859e809e83bac67e2c486a0f2cb97368b6f419bdbf80ca9747f23da2,t,21000,3063348,,5000077,2018-01-30 14:01:26,120
0xf1549ee62905caddc9951dd06feb8088cb597faa88dc3127202963fd5dbd8597,t,21000,3084348,,5000077,2018-01-30 14:01:26,121
0xe64b5dd820d6265a5d11ba0e4dc36fab2f6aa6f51cf41162038fa61241028d15,t,21000,3105348,,5000077,2018-01-30 14:01:26,122
0xda04d2c1b40657a194cb0ef8108e3344fd481a74022368d7f5016da46f663869,t,21000,3126348,,5000077,2018-01-30 14:01:26,123
0x0bc5a4bd23e494c790cfe764a3cce5002af3229cf3d34d8e08322589437564f0,t,21000,3147348,,5000077,2018-01-30 14:01:26,124
0xcad898fb9e9378de7b0de628646ca78ce8fd1a9db53e0e09bc809b1e1dffc122,t,21000,3168348,,5000077,2018-01-30 14:01:26,125
0x50fabfe963be722cf438a8bb54f2402a1216d0acbdbb03cf451ee1bc0fc6041b,t,21000,3189348,,5000077,2018-01-30 14:01:26,126
0xc0b0f4f7d2797b74e54da641ec8203599a6d2615f3168d505df69ebc44e241dc,t,64725,3254073,,5000077,2018-01-30 14:01:26,127
0xa2bb815e2b2ff10d0f59d5aba6000005600f72bc750fc7b32a3196aea2eab2eb,t,21000,3275073,,5000077,2018-01-30 14:01:26,128
0xab97aa89abe1ae37bde20bd05cb5db09773866b95843c8c0fffc1a058d5d8eaa,t,37912,3312985,,5000077,2018-01-30 14:01:26,129
0xb04c2e2b34e2522e27609b4f1a964cd7c456920554ebf1d2e3804de4a41165ab,t,21000,3333985,,5000077,2018-01-30 14:01:26,130
0xe2287db4b8d001c3913bc836b8f6fa8e7a2445e1b568d27c848b8542e098c95a,t,34725,3368710,,5000077,2018-01-30 14:01:26,131
0xa89dc5dd48de18a0496229bf681a476a7cff0dd335ae4a04ad28c5821448e9fa,t,51762,3420472,,5000077,2018-01-30 14:01:26,132
0x9bdde7bfc874f82e5b832c87524eeda49f33c4b8835e0144a85ec28caa8534fd,t,93370,3513842,,5000077,2018-01-30 14:01:26,133
0x3a10653fa8a04f26b57af2dbc6e25fe753967f4b700722df3c7b89972aca951c,t,37084,3550926,,5000077,2018-01-30 14:01:26,134
0xcbe227426f7ef73633a83bdd6e1ef2fcf0c99f6146254b112c45aa17eb0fe021,t,21000,3571926,,5000077,2018-01-30 14:01:26,135
0x726d78e8eb05ee924a08760c2cf70b1c79659dabac58385796e15a2f0f25e1f4,t,50875,3622801,,5000077,2018-01-30 14:01:26,136
0x0d98a9ec0aeb97a2f7d8a62acc42c0bd6e0bbbd11936b82ff9281c431bcfb8f8,t,21000,3643801,,5000077,2018-01-30 14:01:26,137
0xb8343edbbc0c53fd271e11b49a2be114dbaf78b2a87f24065dcb274f49936a34,t,21000,3664801,,5000077,2018-01-30 14:01:26,138
0xd6b89e6fa778dc176b8fffdd16c30aed94f5610dc59c6ee9c7c949995febead1,t,21000,3685801,,5000077,2018-01-30 14:01:26,139
0x3fbca520eb3c02536f2e612485276935b89db12437b996744ab1ee084b606802,t,29372,3715173,,5000077,2018-01-30 14:01:26,140
0xfee770b0c738cf0ab138953101b6548869a956d781cb3df74268150f78b73f13,t,21000,3736173,,5000077,2018-01-30 14:01:26,141
0xc951188c03350dfd3dc4fdcd34f32dffe258aa328c949a5c6b9b34a5e9bb8209,t,22091,3758264,,5000077,2018-01-30 14:01:26,142
0x6fb30f160d066aca28b964dd8b6100fa480ece24c63d59dd449c2faa67e2fdb7,t,21000,3779264,,5000077,2018-01-30 14:01:26,143
0x31d7adeed3965d4a212a722034240a0f22073e31498892c813e7a11818e6f48f,t,22091,3801355,,5000077,2018-01-30 14:01:26,144
0x952e9200c85846b5423393af75db5fb71de4f8b7460ca7d22e664dc02b53cdef,t,21004,3822359,,5000077,2018-01-30 14:01:26,145
0xf6f9a6b7820f995b725b59448075aa0cce6d3c91b42f1fce162904dff7122361,t,21000,3843359,,5000077,2018-01-30 14:01:26,146
0x5a71400f593c09f907301d625d7883d6492d6b87bb12e46e371ed3394df3660c,f,24000,3867359,,5000077,2018-01-30 14:01:26,147
0x5bf05073aadf8354bc9d43d4577bba2853a71942dadb330cd70828415b734750,t,21000,3888359,,5000077,2018-01-30 14:01:26,148
0x020dc4136a7414aabebade7febba3e77a3e8e843cc793155379dbd533ad95579,t,21000,3909359,,5000077,2018-01-30 14:01:26,149
0x50adf5efda4a21f248ae88e9f501b8868b696ef8fb6ceed2a8042b21f9efd889,t,21000,3930359,,5000077,2018-01-30 14:01:26,150
0x84073a3c9da7f6d51d781ab629c45a6510ffe4bc40b5a936b43542356fc29610,t,21000,3951359,,5000077,2018-01-30 14:01:26,151
0xffb343ce2058bf3d984e7126def4b42bab3350d0f786fe0485c73e91375d082b,t,37742,3989101,,5000077,2018-01-30 14:01:26,152
0x74d48f52219111312dcda4bbc6804fb445092d7538de8e40c723a7ee64a4e2a2,t,38316,4027417,,5000077,2018-01-30 14:01:26,153
0x2ca5cb6658b1d7dcc55b593acb94998587fb86a2128e80724a29ba7707066cb0,t,37742,4065159,,5000077,2018-01-30 14:01:26,154
0x5a8a67b81ef95dad0fa326aecfef10c29d2da99e1c07b9c4bb29946b7af9400a,t,37678,4102837,,5000077,2018-01-30 14:01:26,155
0xa76cb8bd4b80f093b9308386d30c7ac2949265b62d720789e90338f6a90c047f,t,37571,4140408,,5000077,2018-01-30 14:01:26,156
0x2aefe9dbf6e238f01f6cc9555bda1747e7511d4ef442b1509e6f5d7cb9466185,t,37640,4178048,,5000077,2018-01-30 14:01:26,157
0x69548ae3f153bd282058e32d91bb81d3035c90f17ba210ef05a83ab76ec45fe5,t,37075,4215123,,5000077,2018-01-30 14:01:26,158
0xe941c841f8f8128555406505339f795b7cb9b334c0afed75f0a18a3aa12fdc90,t,92986,4308109,,5000077,2018-01-30 14:01:26,159
0x84397c8137d39744d1d2d5df6c8810701c76f688a7c670ed62428690adbc6c6c,t,38233,4346342,,5000077,2018-01-30 14:01:26,160
0x90574ba9d353790e53fd32c30efad31dc73c48c5ba480fed2332e9f3454b0fb2,t,21000,4367342,,5000077,2018-01-30 14:01:26,161
0x9e66b1ef430d97eb2f244d765eb4195d0e15a4d3e739774c11477c8e7dd1b32b,t,64725,4432067,,5000077,2018-01-30 14:01:26,162
0xafbb880a3ffdd5ab007dc3c43a201bdea1c86967c9b302196853e57c3ff1e4d4,t,21000,4453067,,5000077,2018-01-30 14:01:26,163
0xf7044c9f143cf941b840904a62796cfc2e308b93c5d030ef4454d99726709079,t,21000,4474067,,5000077,2018-01-30 14:01:26,164
0xec6e24a175e8c4b425546d9014a88b21e841847c35ecb40550dba52a3db7e612,t,21000,4495067,,5000077,2018-01-30 14:01:26,165
0xe0a4aa615368bc73d4c8123c78b64a92cc6ca7f9ab3244a9fed5384e43753797,t,21000,4516067,,5000077,2018-01-30 14:01:26,166
0x148e856e504630590f8fab8560596926449fbcfaa21af061d4a2c81ef794bda2,t,31508,4547575,,5000077,2018-01-30 14:01:26,167
0x1f4561625724b9a06e1e5b4e3fd93295df1d8055e88754ab89f53ac687fd0664,t,21000,4568575,,5000077,2018-01-30 14:01:26,168
0x0c9cc579211325dec25d17e6fc22794444b31364756632f3b8cfc68cdcfb0f19,t,21000,4589575,,5000077,2018-01-30 14:01:26,169
0x2b101ac9b836000bf88c348ea90fa06533828e1c377ba0e9605d8a94a5992917,t,21000,4610575,,5000077,2018-01-30 14:01:26,170
0x2f5e0fcda7c8120fe78cb1f4ab2c867185403a6ac55498cc4b09a38ed5fa938e,t,21000,4631575,,5000077,2018-01-30 14:01:26,171
0x570d13feb66fa3ffc90611f5fa76634c388469d804f96ac2b91e4c8c963ae4a3,t,21000,4652575,,5000077,2018-01-30 14:01:26,172
0xb633cbe2e328013ac35bb67e58715985f26a5e4abbfe3812e3b6758ef0813c19,t,21000,4673575,,5000077,2018-01-30 14:01:26,173
0xc659d991a73a72056ecd8ee12cd9eae5112d15172c940ea3158512a766993617,t,21000,4694575,,5000077,2018-01-30 14:01:26,174
0xf212c07152156fc1df016652af85a8456986235f2157eb6103ae01a91409f911,t,37380,4731955,,5000077,2018-01-30 14:01:26,175
0x15d1aa522966522f66b2373b150a4550785c024bf73b48cc0d79c43eaa33c259,t,21000,4752955,,5000077,2018-01-30 14:01:26,176
0x662ffdc077aacbd8d2a65e0d47c4db9651f96d3733effbca0d11b026e7a04508,t,21000,4773955,,5000077,2018-01-30 14:01:26,177
0xabf018d24427c5da6e08ee2314287696ec5daf79a0514ab4c6b20ab2ef47cdf7,t,21000,4794955,,5000077,2018-01-30 14:01:26,178
0x5929d35cab1ab67c3bd552191cb5fd6dc5f71d524056851498f2da832cae5c6b,t,21000,4815955,,5000077,2018-01-30 14:01:26,179
0xfd486a722be941c82711af00ac0e0ab45a0dccd9a4f49c26ea16420794b37bfc,t,21000,4836955,,5000077,2018-01-30 14:01:26,180
0x0336e2604199451d6883f4f268fc7c96d6f1830c2415fb65e4c9c7fa95d5d42f,t,33571,4870526,,5000077,2018-01-30 14:01:26,181
0x2563f9e9e8caa96451d4dd6f0aeb8ee62aea5cd7127262cc4fab65202ca592d3,t,33571,4904097,,5000077,2018-01-30 14:01:26,182
0x076a79f65223257c81dc6d8480ede02849360ea3f95a8e24c868e596b3fd8745,t,21000,4925097,,5000077,2018-01-30 14:01:26,183
0x7ae2628fb2e31f288d5cfd1fe35773792632a496cb1a6cac19d04c8700c45721,t,37158,4962255,,5000077,2018-01-30 14:01:26,184
0x2627e7810aa39428efaa3c6790001a805bd6f0dc97d1f48e28728bd86dcca80f,t,21000,4983255,,5000077,2018-01-30 14:01:26,185
0xb3d2ba83a752afc0a30ce5d87ad4601cc368496346ab2b149d118d2aa13bb63d,t,21000,5004255,,5000077,2018-01-30 14:01:26,186
0xeb12e199629dfd633e867a6b655b813bd8a0eaeea216fc45d672b12c3954bef1,t,37696,5041951,,5000077,2018-01-30 14:01:26,187
0x67416797ed9e45966d72f4ea218199f477bbebda602d9cd3c9b19a25adf4251e,t,21000,5062951,,5000077,2018-01-30 14:01:26,188
0x21655c49ea3e91db045e85c352358f661af5994e0a7168f6462c240a89b3bcca,t,21000,5083951,,5000077,2018-01-30 14:01:26,189
0xe6a9a535f9c7140f22eb7078ea8570186b0452d19ee33e6e50e8b157709b53bb,t,21000,5104951,,5000077,2018-01-30 14:01:26,190
0xf72939a8bdaa7ad8146db434871146820e68faf7429ca7b9b5cfd091bab4bbdc,t,21000,5125951,,5000077,2018-01-30 14:01:26,191
0xd4f391e4d88635d523529f59d9129d4ea6c4e1f26c5ec840ca8f8645c3d147ff,t,21000,5146951,,5000077,2018-01-30 14:01:26,192
0x53b64c9b2a165abe83bd9bb2df2e641fbfc01be89747a2890dac07d224a694b6,t,21000,5167951,,5000077,2018-01-30 14:01:26,193
0x0c774d43145c9ecf5389993d17bfd3be9203fcb941b6df928060065b99c095cf,t,21000,5188951,,5000077,2018-01-30 14:01:26,194
0x762c56f86877f906b54b74d442a3abf379a775f97d53173fa601705e7919169f,t,21000,5209951,,5000077,2018-01-30 14:01:26,195
0xc0c8e9403a983433a539fc266a31e120a3593293cc4669161237e185761ef5e4,t,21000,5230951,,5000077,2018-01-30 14:01:26,196
0x277b4862c259090e1efeadff76fc5145a98c516da924c8f4ec551f358ef21c38,t,21000,5251951,,5000077,2018-01-30 14:01:26,197
0xc2ebe1ee228b3656bda16b75fb3d930473242e287a3f13d78cddbf2b44c1c3c8,t,21000,5272951,,5000077,2018-01-30 14:01:26,198
0x92c28fdb562de13e8642e6dfaca75450958a1fad0da8d778e15d77480189f1c2,t,21000,5293951,,5000077,2018-01-30 14:01:26,199
0x4cc73db8d407b32e93b2a32ecaa05e0f0993c9015fe56bd62b6fe8e3dc2239cf,t,21000,5314951,,5000077,2018-01-30 14:01:26,200
0xbf5dfc033eedeefdd293665dc074b58a5e7743b068c18f42554baaff17e4bf3d,t,21000,5335951,,5000077,2018-01-30 14:01:26,201
0xa3830811672bb8441b8705d646af2311d0f4e21a73545fc47ac5916feae2a91d,t,21000,5356951,,5000077,2018-01-30 14:01:26,202
0x18899859e1eb325ba6092eadbcc36d6445d0284233054930ae8eebb6d044e6e0,t,21000,5377951,,5000077,2018-01-30 14:01:26,203
0xdb67b3ec7c3b973345c4e0039aecda5da0b9563824c9f8241c59ad8385276dfa,t,21000,5398951,,5000077,2018-01-30 14:01:26,204
0xb9372ff44f4ea09f36734406820e0faff892d727bd190ceb5bcc63baa3ac832e,t,21000,5419951,,5000077,2018-01-30 14:01:26,205
0xc580bfbece81e679fa83855afb6aa5ee8d328979df375960aaeb2579ad5b4028,t,21000,5440951,,5000077,2018-01-30 14:01:26,206
0xaa9608ec0f14c9c49b372b486d545664a63ccb2df76125b1c65e947504f2641a,t,21000,5461951,,5000077,2018-01-30 14:01:26,207
0x857251afc9becb9d2df3377a9fdbbd2f5a8e086cfdabc4df9dafa4cdbd05e8f3,t,21000,5482951,,5000077,2018-01-30 14:01:26,208
0x6fcc215e4d0edb4030691e6b6a5490e2ed695610d64561bd259b4175cd9ffda1,t,21000,5503951,,5000077,2018-01-30 14:01:26,209
0xd080a1b05cb9d8b68e1bdfbfb629096915738768208683a4b592ece71fad0f23,t,21000,5524951,,5000077,2018-01-30 14:01:26,210
0x983c35fa8e5878a49b3485e019f28028aa2b95154ec1682c1cef76c64831dc29,t,21000,5545951,,5000077,2018-01-30 14:01:26,211
0xd898027a1e703b410e81f5b1475503206533f0bbcaf0df1e0ff16b0432090bf3,t,21000,5566951,,5000077,2018-01-30 14:01:26,212
0x0b5f98edaa6ee5ee66a9b7bd43bd0b7b0adb66b98df594805e95dcad68ae1b3b,t,21000,21000,,5000078,2018-01-30 14:01:34,0
0xa26749a96f5566dc30e6a2030223cbea183c8be6fc5405dbc6db856db5288209,t,52596,73596,,5000078,2018-01-30 14:01:34,1
0x82ea8cef0ddf5ad2f1726f1842c773400ff20a769616598536a5f8462f02b036,t,52715,126311,,5000078,2018-01-30 14:01:34,2
0xc6a1ef1f09c47fdecbeb7aecf15af0333add80ed634365bf01bb6724ca502449,t,22193,148504,,5000078,2018-01-30 14:01:34,3
0x013a0eeb0b6a465b99518b1bc3c65aebc3c28227f3c0507deeb49dcc13f65f5a,t,36925,185429,,5000078,2018-01-30 14:01:34,4
0x5cdc147d5271b681d3493377246ccd582fdb77b6c465abad8f78965d2a03bed2,t,40843,226272,,5000078,2018-01-30 14:01:34,5
0x4f5bc455e710b606d180d93b7f2c2437515f29a6f186dc7db69f580fb54e2786,t,51733,278005,,5000078,2018-01-30 14:01:34,6
0xb0258bf7f69b51722506da9bae1be26abb72be4ed7e73cb521e617880cc96308,f,250000,528005,,5000078,2018-01-30 14:01:34,7
0xf03821f109aa05ba78efb740dbbb65a8cae0133519294b7912d6d75dd30fd0ef,t,151510,679515,,5000078,2018-01-30 14:01:34,8
0x1593f877896fea70ecea573c33ff9c6679c77155b31acfde1ce5d4c3922177a4,t,37849,717364,,5000078,2018-01-30 14:01:34,9
0x4604c0d6c7c2bf3871146f383e16c4547dcd15f14d987b19d71268c56c752ebc,t,33089,750453,,5000078,2018-01-30 14:01:34,10
0xb07bde3643d53cf6b70c2b0deb68e793ca03048c3b0a2377a6a79b54714ef3b6,t,46096,796549,,5000078,2018-01-30 14:01:34,11
0x3e6c2eede598d32da2235d9ab59d994a3ae7ee71331f185da4ed0b379eccc940,t,22624,819173,,5000078,2018-01-30 14:01:34,12
0xb118f31530aba28eaa6f16361b82f3668f96da03cb57a2e14d43b37d264b1e7b,t,21000,840173,,5000078,2018-01-30 14:01:34,13
0x7830b9c05d15cc6e27574617fc3fc18be7357f3cb746b275e70fce1177cfd337,t,121834,962007,,5000078,2018-01-30 14:01:34,14
0x50f924b21eee0913b651fd6aa34d18afc7a29eae063549974bf19ed6a14830d9,t,66316,1028323,,5000078,2018-01-30 14:01:34,15
0x88e6a5b695ce6fa2d17292fc129683630bb3ac5b6409e9b2e312b8f5b0c91fc4,t,426200,1454523,,5000078,2018-01-30 14:01:34,16
0x14427ce2c343bba932f64eee500262dd94838b95107f6389eb9924319732b6be,t,93434,1547957,,5000078,2018-01-30 14:01:34,17
0x6015627c7b2e77e925ef6f57648f02d8df188e8e3b300b20cbe7709b4dd05a1a,t,59290,1607247,,5000078,2018-01-30 14:01:34,18
0x0b00413d54eab12e30f71cf1364f5af2ec04eec96ff1838158ecdae3eb61119e,t,29493,1636740,,5000078,2018-01-30 14:01:34,19
0xfa94e7860bcaaa21314029c03bc1dbfb4e7186fa037accd310c955c1a5566af1,t,37964,1674704,,5000078,2018-01-30 14:01:34,20
0xdb829578631dee71be47ef71cf9f993327220f0a8452a9c0543a16a20b567072,t,78114,1752818,,5000078,2018-01-30 14:01:34,21
0x77e07cad033f2256aa361144886d19452c2fd98925de6b1a765583ce41d8366d,t,44493,1797311,,5000078,2018-01-30 14:01:34,22
0x4acd2c78529515bec2a5f0ac214d0f9337288ae27b1d038e906892710960d19c,t,44493,1841804,,5000078,2018-01-30 14:01:34,23
0x02053f2a6f07d9d7bb9201af22c33dc260436b46a15e190748a3729f39f46177,t,39167,1880971,,5000078,2018-01-30 14:01:34,24
0x9df5a5526ba29360b2d1212d716b1e9e597b39e6234ddfa290f493a6b8eebcb4,t,21000,1901971,,5000078,2018-01-30 14:01:34,25
0x9722dccf61b6917330a4d95822fbbcd92bab91ffbe1b5cb04b7915b13b74b904,t,21000,1922971,,5000078,2018-01-30 14:01:34,26
0x1c48342ff05626b1cbc2470bb2d3343dfb06406bc2086aa2299042ccfe6e5c15,t,21051,1944022,,5000078,2018-01-30 14:01:34,27
0x7f0bc41a1cc144e7da799ddd5d926a470f49c09e451be99c85ad82cff7541e99,t,21000,1965022,,5000078,2018-01-30 14:01:34,28
0xffb16a54b7fcee58e12299668ee5e4bd9aec62ab2de81c28e5fa1ad923734786,t,21000,1986022,,5000078,2018-01-30 14:01:34,29
0x9b8c3f1e0ef703bce92fe6e265debd256459e5fba761cfc479afd490d5d359a0,t,21000,2007022,,5000078,2018-01-30 14:01:34,30
0x94f666318d894db1d0ceec6772a5b387552fc9971cdebe8131f42ac88aeefe00,t,21000,2028022,,5000078,2018-01-30 14:01:34,31
0x7cb6340c06e9e4358cf72a7183fd87896e9f300b11b9d6889ccd950083b6883d,t,39835,2067857,,5000078,2018-01-30 14:01:34,32
0x2f6cc4c9a34d446a2f7749f9d631985db67cae2a637ac1985fb1668213550572,t,21000,2088857,,5000078,2018-01-30 14:01:34,33
0xeac89f8062952ce2263187f6918d302a5c1a929acd35e304dc4fcf348d569156,t,21000,2109857,,5000078,2018-01-30 14:01:34,34
0xda4b01af27f97f58668cc5467e9718dccf49851788734ebf08eb7f4209c019f3,t,21000,2130857,,5000078,2018-01-30 14:01:34,35
0xd858c91d734588719c80425ed370527ffe87c0f443ee7d2172154a87d964df44,t,21000,2151857,,5000078,2018-01-30 14:01:34,36
0x371cf0484c443272e02a5139c13623d9a6fd1faa2009161ff183348d4e01ce90,t,21000,2172857,,5000078,2018-01-30 14:01:34,37
0x794c26269dde2fd8dfbf4689591dc5eab157b092391095ccbb5c6b209ed5d49d,t,21000,2193857,,5000078,2018-01-30 14:01:34,38
0x22812b29f16b017438966a935d35c535b4353d0ad150760e9b021cc189c27722,t,21000,2214857,,5000078,2018-01-30 14:01:34,39
0x30544bfcf0dd346ca9ef2e5f5a2433b387d31ffa59afd3cacdac6158e6f1a13c,t,21000,2235857,,5000078,2018-01-30 14:01:34,40
0x377bd9989907c3c650df64d922f046d7b4b392076abd6d497ade4394aa2bf178,t,51779,2287636,,5000078,2018-01-30 14:01:34,41
0x54efaa50ff5c571f8d1ee6ee898925e747bd9d9df7506c20707b17ee8b6be80b,t,21000,2308636,,5000078,2018-01-30 14:01:34,42
0xb9fec09fdfd8a5d629f4ab6e6f061b7dad0c432c018730c4ca329d66ec10095b,t,21000,2329636,,5000078,2018-01-30 14:01:34,43
0xea2c0c63b8ac1e2a8db8c4ea963bf0ea3f9ed7ccb4a2e7f24f7cb57d770e65ed,t,21000,2350636,,5000078,2018-01-30 14:01:34,44
0x951c93dfca47d3c58995274552b66fb29fd978e25e9c6555b48accc3d4fdd25f,t,21000,2371636,,5000078,2018-01-30 14:01:34,45
0xebbfec984791dad759da3a781eb9a80bd0debc1c260490b03eaadc465c0e3dfe,t,21000,2392636,,5000078,2018-01-30 14:01:34,46
0x7995ce5a8414c1c6fe1efb0ea4a69793afb20b4e751323e49e7a6bff08039017,t,21000,2413636,,5000078,2018-01-30 14:01:34,47
0x0d1d8b2b83d83482a8aa29c1d0e3fba97a9e105e30d58354d86d51911673f899,t,21000,2434636,,5000078,2018-01-30 14:01:34,48
0x961e58c779b973c575e2a3c62c14cf880ef771400792e510098420fad620cfdf,t,33296,2467932,,5000078,2018-01-30 14:01:34,49
0xa63abe641948e07814d6a07e4afd0ceb36bcd61307f7140134be9824bf16568f,t,33296,2501228,,5000078,2018-01-30 14:01:34,50
0xb065c57162ca90d4f30bfce03ef3027db9734f19d969b0b3fc9dab9099415f19,t,33296,2534524,,5000078,2018-01-30 14:01:34,51
0xd79d300a54fdf5476c9b49d4955548576312c4e129ce79fb87d870a54f3ec433,t,21000,2555524,,5000078,2018-01-30 14:01:34,52
0x5ec897bf2eb893de0438944cd46fc940f29e67cbafb071dcfe834a0f58d1fbc3,t,21000,2576524,,5000078,2018-01-30 14:01:34,53
0x2e92c55f1b0058c473c535dea15f91a4b9fc68119db77f733b682683834b2d39,t,33296,2609820,,5000078,2018-01-30 14:01:34,54
0x787add5dcbb1a7550260d1bcef72e846e256ae3146063740f92dd9de9461d649,t,33296,2643116,,5000078,2018-01-30 14:01:34,55
0x2194441b94677fe27e41fd879d19f498fea303139d0dc4abcad512b5e7acd6a3,t,33296,2676412,,5000078,2018-01-30 14:01:34,56
0x09fbc30df8b9c040600cf26c472d5b010aa78dc15ca0483d27b33909119283a7,t,52514,2728926,,5000078,2018-01-30 14:01:34,57
0xa0d719848361639aed51497e7be6c5d1b6120c4d2f1f0029b97df67bfa24431b,t,21000,2749926,,5000078,2018-01-30 14:01:34,58
0xbef9492c6ebbc5e7dbf9e9ab548a1026678f3eefc4bd40ea24f2ef56a2f5a4dc,t,21000,2770926,,5000078,2018-01-30 14:01:34,59
0xabd1db8694ca9191c6b1a52b7e33da3e9fb7f789b7e065acb1566bab620936c7,t,21000,2791926,,5000078,2018-01-30 14:01:34,60
0xd56529ca13a97ca73fee0240420742bd25a2fb1727622a1fcdb8b175a824d7bc,t,108178,2900104,,5000078,2018-01-30 14:01:34,61
0x8342dd4484da61f9c8e28c1bccf9edd23193151353d078e12cc428b8c825612a,t,53361,2953465,,5000078,2018-01-30 14:01:34,62
0x35dc16c6e492374402dd6704986918367591c1fca96f9961b9c66073469e7a5c,t,21000,2974465,,5000078,2018-01-30 14:01:34,63
0x7bc4eab25a86fbc6890655a28ffdc1ebfd8007b12e3e04daf5ac6ce4cfaefbf0,t,52859,3027324,,5000078,2018-01-30 14:01:34,64
0x520abd271702376ce6f1d16e323ae120c24d037cf77fadcde11677e0d67de5ee,t,21000,3048324,,5000078,2018-01-30 14:01:34,65
0xbe2a33338a8f17af71b9a0749bb0f51b2f2396a6479c6c8aad5db8503bf4b093,t,21000,3069324,,5000078,2018-01-30 14:01:34,66
0x5a3a5f151affa1268780f7bf30c41dd1b8beba90f18553f3474199d544e6a5ac,t,52267,3121591,,5000078,2018-01-30 14:01:34,67
0x9533d0a859741775b28289d3efddcc37617973638255b2ca2b42296e0ade546e,t,21000,3142591,,5000078,2018-01-30 14:01:34,68
0x727cef668ebdd1543e9f3829b94ac1a5f1dd8a1becbaa18b43f19fe1209881b2,t,21000,3163591,,5000078,2018-01-30 14:01:34,69
0x1a77c7639b941b516f8aeb825ab857a8b068189e92c220f67126ba824692bd3c,t,21779,3185370,,5000078,2018-01-30 14:01:34,70
0xfa0f284bb4cf9bfcf9d4f6f7d1b216ec77aeb83aacd55c281fe6c2ec908c1b09,t,21000,3206370,,5000078,2018-01-30 14:01:34,71
0x2bafc6b365335e61b5191868c0198be53c6c03a371c79173eae23bf4d91f100b,t,21000,3227370,,5000078,2018-01-30 14:01:34,72
0x100a520657c5d973c20abd43e33f75b8e22af71f8ac8aa392c2b2942d81cfef8,t,21000,3248370,,5000078,2018-01-30 14:01:34,73
0x7d074416f513c287c78935ddf99f21abc87bac4b044a2481d26b0afecd3f2668,t,63122,3311492,,5000078,2018-01-30 14:01:34,74
0x109d0d0e5c74814989e052a152a4193dfb1c8cd1b596ec1168b9c59fadf9bb12,f,100000,3411492,,5000078,2018-01-30 14:01:34,75
0x95eb44cb9140697df0dc3fe02ffcdcad8d529eacf044eb6ce43eee0cf73fb05a,t,52148,3463640,,5000078,2018-01-30 14:01:34,76
0x8b9793c09679c6843111ea62f23efc6d24b88a8a9c7016005d8332b08f14eb09,t,91781,3555421,,5000078,2018-01-30 14:01:34,77
0x2642fa428fde465419e9d7be81aef47f713879e6e7150111c93a7efd94269411,t,21000,3576421,,5000078,2018-01-30 14:01:34,78
0x7bccf9bb629e1ccdbc78748ada302d0b23894aefa4d6918ce970dcd0e8959f87,t,22118,3598539,,5000078,2018-01-30 14:01:34,79
0x751e387f5c58905559d5b891c0d4b855b69084ecf37eba561ef51b033d2105b5,t,21000,3619539,,5000078,2018-01-30 14:01:34,80
0xf10a9fdbf76a6419e1da5f0515dc09e4895edaae3a3f581a90d92f80abe7db4b,t,21000,3640539,,5000078,2018-01-30 14:01:34,81
0x7f6d36f718fdac0597fa142ea5cc7710f3ffad02ed58b4d6a2bb69eeeb251d92,t,21000,3661539,,5000078,2018-01-30 14:01:34,82
0x6b719c6b4bd9ffb31b0fb9ec50e5f8eeb433d3315d06a304c060bb1ae90a96e2,t,21000,3682539,,5000078,2018-01-30 14:01:34,83
0xe041a5f61eac9abe5106f7078e9113362675dbbf790682b81c0e60f54162abc8,t,22027,3704566,,5000078,2018-01-30 14:01:34,84
0xe8bd4bab38d9cadcc5db30d245ae6ad5a8625eb7a9cd2cbfbebf3a3ffe51a934,t,37848,3742414,,5000078,2018-01-30 14:01:34,85
0xf5e6df37ff3514a5fc43a31027a855b71ba23c7baec02dffe0a1bd304c052f92,t,37683,3780097,,5000078,2018-01-30 14:01:34,86
0x708e257aa3dffe9afb0abe2292c0f4bf76fd4fa56a2b06c8cc315be59a3b9406,t,37683,3817780,,5000078,2018-01-30 14:01:34,87
0x7ba88e27c89ea4843ab482b7ba7d8cc24a0d6ff6e8476e1aaf9aaaaa686c29bb,t,37619,3855399,,5000078,2018-01-30 14:01:34,88
0x37c3ccb8ff20764b1c017141e1db74d56afd21f52aacf70dd32a8383528d8563,t,37619,3893018,,5000078,2018-01-30 14:01:34,89
0x91cd7741dd57065405654a3136d198e01b550438c2251077f9ab6f721b045526,t,37964,3930982,,5000078,2018-01-30 14:01:34,90
0x3fc7449637759231a2d3ec326e5a394d097c1541734d70ce4851e817e570a790,t,53233,3984215,,5000078,2018-01-30 14:01:34,91
0xda8d9d84184f02e7cfa001c3571772b9f7cea47b939fe889d59bba12201e3625,t,102934,4087149,,5000078,2018-01-30 14:01:34,92
0x8d5d654829ab37a472f32547552663ebcb7339079b090e88a791493d9e3a2c72,t,21000,4108149,,5000078,2018-01-30 14:01:34,93
0x416ef66a265d0e1e19f6aca481eb24b27bfbab6e208731f5fb1e2827c9c24bbe,t,51782,4159931,,5000078,2018-01-30 14:01:34,94
0xb98580698097276c78f9391310bc99ec38188bac360a515c89bbdc172c19fe91,t,21000,4180931,,5000078,2018-01-30 14:01:34,95
0xd044fd450e5a987ce1022b253442483ab50bcf0922f44ef0a849f55a697607c2,t,127388,4308319,,5000078,2018-01-30 14:01:34,96
0x2a3dabafc5fa654a71339c2414950ab0183619bc307e931898652a724bd0f337,t,55907,4364226,,5000078,2018-01-30 14:01:34,97
0x65ccdb472d51d47215a6236627889dd39eb2c8f2114f1609522481c924d54447,t,21000,4385226,,5000078,2018-01-30 14:01:34,98
0x9099cea095429d4c31e6bc1feb4b11a40d26cda582d86f268f80d774d3e2de7a,t,21000,4406226,,5000078,2018-01-30 14:01:34,99
0xe152b5be7f78f72759cb971bd22801b6bf89dfc90ecd7b86b1e4b581ffe35047,t,59967,4466193,,5000078,2018-01-30 14:01:34,100
0x48b9c48b33185e38860a70bf9dede932d10b20399529f8e0c058db9a7f0dd263,t,21000,4487193,,5000078,2018-01-30 14:01:34,101
0x67359b8453ddc6720f1aebb6138d33b5a14e035fe3b738b8c56cbd1006391123,t,21000,4508193,,5000078,2018-01-30 14:01:34,102
0xc7437161bf999324ad7bfcb9e4bb76cfb6e86ac081b4684d6759154e3d0e94d6,t,21000,4529193,,5000078,2018-01-30 14:01:34,103
0xf242e30c95d8eff07e251a73971ce05ec6080d039e25b2daadf5fb9a63f36ad3,t,21000,4550193,,5000078,2018-01-30 14:01:34,104
0x6b055ed5a4b68df3115d962d588fe5564d4a0536884cf2e6202a00c188a21a86,t,21000,4571193,,5000078,2018-01-30 14:01:34,105
0x0161c6bf7134d72f2d5c8a40ca22cc4b41b9e6b4303d696702214ba56c18968a,t,21000,4592193,,5000078,2018-01-30 14:01:34,106
0x56d1120153c84c563daa68d65029c9b4d37b5ec423ff288e500313d13cdb9717,t,21000,4613193,,5000078,2018-01-30 14:01:34,107
0xe2417de0fac246c0d432c6b31c3b104ef2cac79cf601fa80cc62b5023b685bf7,t,21000,4634193,,5000078,2018-01-30 14:01:34,108
0xa7475dd2018d509eaed673b6c41247cd82de827073e1fc4c44ea657be3e5517d,t,21000,4655193,,5000078,2018-01-30 14:01:34,109
0x7c56fe3efbe69c411b276d473aa7c326176c3a04023ec99094f33f9f9691c8f8,t,21000,4676193,,5000078,2018-01-30 14:01:34,110
0xc2b2651f9be583da332d0d72de0c01d661228d7390bbddd81f8fe110b928af8c,t,21000,4697193,,5000078,2018-01-30 14:01:34,111
0xd0d54439e68bbc85a09ee3c9245e3633abac62eeec53506403a9fd1e22fc0060,t,21000,4718193,,5000078,2018-01-30 14:01:34,112
0x013efd67c1c721e58d0ed8c34e138af66058706dd0d2e8354be9aa340cd47119,t,21000,4739193,,5000078,2018-01-30 14:01:34,113
0xdb0e1c9bdded7a48922c6f68e005b2d9a91eb640c991ccdf290d4d0b1e457ae7,t,21000,4760193,,5000078,2018-01-30 14:01:34,114
0xc20ebbe4f4b3855d91bcd46459002f66d4822d19771134f66e507a49a3e63212,t,21000,4781193,,5000078,2018-01-30 14:01:34,115
0xb564513d734829e01d31bf1537523b370b75d42668143ac76ee22417e842af65,t,21000,4802193,,5000078,2018-01-30 14:01:34,116
0x53ed919731dbd75902d0b273d4ae00bec53e14c5e5b97b350dfbac5eb9e0d474,t,21000,4823193,,5000078,2018-01-30 14:01:34,117
0x4059e422032b7c0b28c532f1ee54e746bd6181770f8656695146654888779c36,t,21000,4844193,,5000078,2018-01-30 14:01:34,118
0xf4153b2a674b72c79d956df66b493e304cfab679d1e1c367ab02abe00c22e1aa,t,21000,4865193,,5000078,2018-01-30 14:01:34,119
0x1805bde07b523e84066fdb9a7752231e56fb301d0d5f98ebff531d46308cb65b,t,21000,4886193,,5000078,2018-01-30 14:01:34,120
0xcc85ba44aaae35f8382ea849225ee891961648c787838da1d8ec7790686f6334,t,21000,4907193,,5000078,2018-01-30 14:01:34,121
0xf12ddecbca69d822491ee1f28e93ca3de44f979454c5b4f5b4929fec75695f9e,t,21000,4928193,,5000078,2018-01-30 14:01:34,122
0xd1801a7fd5b60ae88d3678f9cb2ede6af5be461002ad9905ea2c84821284841c,t,21000,4949193,,5000078,2018-01-30 14:01:34,123
0xe149337f273b541cd29c8f7795192ffde20153b474770b3df819ac837542602d,t,22948,4972141,,5000078,2018-01-30 14:01:34,124
0x349a9d4138664eb5baabb478592d904301c6b954284be73154c507f32d11ae15,t,21000,4993141,,5000078,2018-01-30 14:01:34,125
0xaba042f11f243956785e303da2ca3fb9e73b9feae47cb8c1b66de6359eb1ceba,t,22848,5015989,,5000078,2018-01-30 14:01:34,126
0x5e429cb6e93427962d2c7f83c2f10647e200773479ab884206117175f9337aeb,t,21000,5036989,,5000078,2018-01-30 14:01:34,127
0xeab11abcfc130b5681ac321ef8ded710e5d7f2ab0ac4ea6b0fce99120e94a2e8,t,21000,5057989,,5000078,2018-01-30 14:01:34,128
0x0944020af9cbdd117adb34c08d1166fec1c4746496a61ed66a1ac9e82001ecac,t,21000,5078989,,5000078,2018-01-30 14:01:34,129
0x8e8b449afe3c322ee348086c1bdc1e23065076d7f26e3c9bc0132cd05b2f4c5d,t,21000,5099989,,5000078,2018-01-30 14:01:34,130
0xf51cae2cf61a73de55a7447d0376cb25247c635cd4735fd9050b09655b73b795,t,21000,5120989,,5000078,2018-01-30 14:01:34,131
0x37883ee595b8a21736d431e13e9c6d9a419617d5a34de788822021a5685137e5,t,21000,5141989,,5000078,2018-01-30 14:01:34,132
0xbe2af75cd338a2a14f5be3ad2374f04ca999ad6f7d2efce05fb7b10177033b56,t,76670,5218659,,5000078,2018-01-30 14:01:34,133
0xeec20754a1a8b5829bbc68fb055881d173e0d00e6c9a5aaf7943c430511586ac,t,21000,5239659,,5000078,2018-01-30 14:01:34,134
0x1c55a6e4b19be64b219c11f94054f560ffdb04bbefe5b9b791bc8a52530839d7,t,21000,5260659,,5000078,2018-01-30 14:01:34,135
0x36b4488abb4e41e588ed8b1a35f0740cc5ec05531f02ac36ce2e22ff88eab855,t,21000,5281659,,5000078,2018-01-30 14:01:34,136
0x49f3fa245890e298f8458e35e2940bd1771a24f86dc973755d1eda25401dceaa,t,21000,5302659,,5000078,2018-01-30 14:01:34,137
0x4efabd33172b47e679658504983e811a863a3c49e2923f1cc17c6015bfe591f3,t,21000,5323659,,5000078,2018-01-30 14:01:34,138
0xa8e6639ffe524d9b58fbe0a427b5bfaacb17dfafdffb75a0ab26ecd2bba8b02c,t,21000,5344659,,5000078,2018-01-30 14:01:34,139
0x55a911bef46d16f8ef6d178bdddc93b6876cd1c3e18a7e3534b9ed926c7adf04,t,21000,5365659,,5000078,2018-01-30 14:01:34,140
0xf66496084b0a431bf576deed98a84251b764e34b05040499bd7e02159601b04b,t,21000,5386659,,5000078,2018-01-30 14:01:34,141
0x3eb1446ccbe612e87d782cf00c17f74055281c928fb2f0bc3bcd94ea43ed9373,t,21000,5407659,,5000078,2018-01-30 14:01:34,142
0x69a8a4bf10d56445d684ecb0d4edc4010edb20bcb91e1cfaca93cbdd316ffe8b,t,21000,5428659,,5000078,2018-01-30 14:01:34,143
0x619a411a35b0da179101e3105243bec38f2bee426439bb5b8f85e36d90820505,t,21000,5449659,,5000078,2018-01-30 14:01:34,144
0x4be4340c7e17bec10fd8a981fa137bada00f19d950cb7511b1b941dcc2b05183,t,21000,5470659,,5000078,2018-01-30 14:01:34,145
0x0b3ed0591d4af6e6d2cdb5a8715edbd89fbf0f799d8753dadd6cf9b4f04e16db,t,21000,5491659,,5000078,2018-01-30 14:01:34,146
0xeb41825d36c3e53505b73f93333eeebadfe7d50f0991a8c9b5a9cd4df4886592,t,21000,5512659,,5000078,2018-01-30 14:01:34,147
0x9c4d7d3eb34c87baaaa80883ad039383c0cbc28984443707b942eedbccc371e1,t,21000,5533659,,5000078,2018-01-30 14:01:34,148
0xcde03d323a1e1631477b45083acee9082ed348bcc335412e0c7b56c4b2c14f04,t,21000,5554659,,5000078,2018-01-30 14:01:34,149
0xbd0317372f8442d4b502297f7f8761f099cc3865a927edc86ac5caf544e59343,t,21000,5575659,,5000078,2018-01-30 14:01:34,150
0xb4b1ff3f8829ab67b289473bfa4325462eda81bc371221495c4f3a6840e5e00e,t,33705,5609364,,5000078,2018-01-30 14:01:34,151
0x69906b952d42671a18867a12516ac1fd798937ca223e3d0c3f5938dfb49b8f55,t,21000,5630364,,5000078,2018-01-30 14:01:34,152
0x8d53328446bd6377bb210bbd92142cc5327e2d6d168d3ed89eb3e385a617ae74,t,21000,5651364,,5000078,2018-01-30 14:01:34,153
0x86010b58a45c31878a8dde8f86a5ac4d79df59a05957a8f5105986e232c14c65,t,21000,5672364,,5000078,2018-01-30 14:01:34,154
0x0e334206661c5cb6c1a2a6bbe9fe6ef4e655cc56ccfa504e7021a1fed9df1a54,t,21000,5693364,,5000078,2018-01-30 14:01:34,155
0x1d0f5d7c67932d3b77d88e60f4204fd716948fee7d0b8ae1e1618766b726691e,t,21000,5714364,,5000078,2018-01-30 14:01:34,156
0xdccce4c382a7f492e6716a74a08bdd079f72631f4ce85e5df8427291c75b4e3b,t,21000,5735364,,5000078,2018-01-30 14:01:34,157
0x47401c3dcdf61f6f8f3e739e6e73af1c3b5abe9d0b66ab21825305f7d498c729,t,21000,5756364,,5000078,2018-01-30 14:01:34,158
0xcedd43e8c1a88724c3fc460703aaa917600100bc3e47cac5a8dddf8cba667126,t,21000,5777364,,5000078,2018-01-30 14:01:34,159
0x2c68fc8e99eaf270de8e3101b121324b33303f19ec2bf191f8c6fd42cccb23b1,t,21000,5798364,,5000078,2018-01-30 14:01:34,160
0xd0936b1fe1afb663b4b7c2df6de4bdcb56fecd772f3c164982f481b596e93ecf,t,21000,5819364,,5000078,2018-01-30 14:01:34,161
0xcbe9f4fdf6b3d3973caec095b79cd2bf32c074a8c99911508c6be8753091a7a9,t,51877,5871241,,5000078,2018-01-30 14:01:34,162
0x223c05bb8027c58e17651f6c3a240aea360f41c7e22baf8de175cbba80d3043a,t,21000,5892241,,5000078,2018-01-30 14:01:34,163
0x3ad9f50f2f7b499cb8f58a0661e3755b5c6ab8bec71e7533c1fda7f48a10f236,t,21000,5913241,,5000078,2018-01-30 14:01:34,164
0x55dbfcc1cdfa2841a2b196b3f22493590c44420552b278623ef2cea221098ad3,t,21000,5934241,,5000078,2018-01-30 14:01:34,165
0xd20e148336c1e0b1a47ba2c5f7de66fe88d80ceb67f2fd9e5bdf356003704490,t,21000,5955241,,5000078,2018-01-30 14:01:34,166
0x9c3cfb5b16b5b03d4a85d6155c884553aabcb2819e2b78989deb52c32a07763f,t,21000,5976241,,5000078,2018-01-30 14:01:34,167
0xf1b050cc2c007df3a353d98ac2602ef7d9d3c9a7a6f1846271d2cc270e96e4e4,t,21000,5997241,,5000078,2018-01-30 14:01:34,168
0x75d8d6650be4d784874b498dcf54fba1367585ef4c1ab2caa8f547d47e010c71,t,21000,6018241,,5000078,2018-01-30 14:01:34,169
0xe82caf29665e4a10f73ebc60e06b48a91b494ecd920f43a343a7e954dc29e49a,t,21000,6039241,,5000078,2018-01-30 14:01:34,170
0x3fb4286853ed8ddd7494a498a5e223214b371507efe9c91df4f7348501d81e84,t,21000,6060241,,5000078,2018-01-30 14:01:34,171
0x0d57fb3dd813df022096f781dd6c77d206cee97c681e3cca600cf53daf6a2694,t,21000,6081241,,5000078,2018-01-30 14:01:34,172
0xb99fb0e45ee0fadcbf21b3a20058ea78bcef63e959826ff4dec79ab2a5d93d64,t,21000,6102241,,5000078,2018-01-30 14:01:34,173
0x65b7153bab7c911a9874ec02642835dfc55399b6ba8dcb43a2e9156ea3340ca2,t,21000,6123241,,5000078,2018-01-30 14:01:34,174
0xc4f7ceadc2475f59b9e6214a89033b9d301cc2ea45c892862cdbacb9bf92d914,t,21000,6144241,,5000078,2018-01-30 14:01:34,175
0x1b28b7724bf49952a8fa99ce61c8163497c0ba6f8c6409856c9b22d3be42f636,t,23526,6167767,,5000078,2018-01-30 14:01:34,176
0x7a96427e77673279225824d27eea9cc75e53386d8c9bbf420f463a68d035b0d3,t,21000,6188767,,5000078,2018-01-30 14:01:34,177
0x7e378a81c0444ff49477a390ab265ab94ac3a849fd1eadc7b26fd6e254c994d1,t,22007,6210774,,5000078,2018-01-30 14:01:34,178
0x1438dc004a649226c8c2af989ed08016619c71040910f0786da035adc2283440,t,21000,6231774,,5000078,2018-01-30 14:01:34,179
0xf6ab0ea9eb6239d0b230de4be2aa8f0ac2201dbb95be673476e1eda3ef2fc6ec,t,21000,6252774,,5000078,2018-01-30 14:01:34,180
0xc787e0ef65b282013c358313bd77bad5dbd73c4a15b6a237a9f5196aae2fcfe6,t,21000,6273774,,5000078,2018-01-30 14:01:34,181
0x4f1773e2333f5349a9171b8b91b2f1637686addb99bcafbed7c234867fdff0cf,t,21000,6294774,,5000078,2018-01-30 14:01:34,182
0x829c2a0816d8e3e672bbe644a03801839c9ed1a9e73ec395e2a71a13c6f7cd89,t,21000,6315774,,5000078,2018-01-30 14:01:34,183
0x86dc3810a7503533c3d2d3c3e58a948fc89c7c1c4ac403b068023c3aee7e83ae,t,21000,6336774,,5000078,2018-01-30 14:01:34,184
0xb3f3c1e31f6f0badb89c76f713d141a7af910abacc95d2a80f009297597c41c1,t,21000,6357774,,5000078,2018-01-30 14:01:34,185
0x8309d125ad064cf58245616fa67975d28e132557cf18e554030615dda8312200,t,51618,6409392,,5000078,2018-01-30 14:01:34,186
0x79121957ab33e2334c4326b9d9ac6f36e4a9ffbf1259ab931b0647a19833f542,t,21000,6430392,,5000078,2018-01-30 14:01:34,187
0x7b6ed02a98854b102488e2bf76962a06c1e6a0e846c34f2624c8b59e28393b3a,t,21000,6451392,,5000078,2018-01-30 14:01:34,188
0x737c11648a2725e363bd7f4ac46bb8f512a8410191800347eaa96d8e018c3c49,t,21000,6472392,,5000078,2018-01-30 14:01:34,189
0xe0b8214b553c70e9a7790337885783c36c1ad61c24cdd41b65e45b55960a75ed,t,52886,6525278,,5000078,2018-01-30 14:01:34,190
0x810a27a11b34a17968aec33fbd9e74cbb42159ea8e29e15c9b91ec57e8a17ea9,t,21000,6546278,,5000078,2018-01-30 14:01:34,191
0x64567762a75d650fe9482c0b35e8ead02e849e55a442f23bd65820cf0ad833c9,t,21000,6567278,,5000078,2018-01-30 14:01:34,192
0x8ef7d9a046c1ae77ad2e01314af9aa21ccc088e70ecefe4e74c203563e72e252,t,21000,6588278,,5000078,2018-01-30 14:01:34,193
0x84474ed151d1f2fa79e4318c5282ee5daaa3d845c1fde7faf828deb15f8e496e,t,21000,6609278,,5000078,2018-01-30 14:01:34,194
0xe8e1998f617137fe660c5e785275870fdb3d1545439f499e96678bcdf1a9a30c,t,21000,6630278,,5000078,2018-01-30 14:01:34,195
0xd8de769dbaf6de923e01e8850e3e98a42755fadab656db63d7fce7ed5a3a1662,t,21000,6651278,,5000078,2018-01-30 14:01:34,196
0x21d031fdf5dfd44abce22935ea51b79ae8fe9851256af403231bb5fbfe573323,t,21000,6672278,,5000078,2018-01-30 14:01:34,197
0xbd11847b9986a3ef257ea6c594e3082536305b75a7cc815c2b11cc4426037a80,t,21000,6693278,,5000078,2018-01-30 14:01:34,198
0xcb5c23485eaab778065824822755b8f2b30354aa5426199e9c788b3749f7573e,t,21000,6714278,,5000078,2018-01-30 14:01:34,199
0x09a550f75b9f756ca99ea9ddeba739c74f2d6c857cc95de550d23d56ddc85e2c,t,22848,6737126,,5000078,2018-01-30 14:01:34,200
0xcad92b08a5569d7701d4e4cf16cb6e148ed4c5805737cac7a9c38135db56fd8c,t,21000,6758126,,5000078,2018-01-30 14:01:34,201
0x953892bbd258b3fc3d14b240a003559aa0119a6ba7df9d6a58a8ca419705475d,t,21000,6779126,,5000078,2018-01-30 14:01:34,202
0xcc8413eb200684824753fbfc4ca49e71568d44e0f4c3cba56c8e1b23a0c81f54,t,21000,6800126,,5000078,2018-01-30 14:01:34,203
0xd5e9c8c5b9b637e479d3447f8b00dca1bb99c1d9d3cd5bb9621a60d6d2620a61,t,21000,6821126,,5000078,2018-01-30 14:01:34,204
0x0f5f1019694759ece8d23070bf036da3da8957f0b6b9a17274c77f3227aaf032,t,21000,6842126,,5000078,2018-01-30 14:01:34,205
0x73287853cdf8a17f69b30f8cab91d5028f5ce884f67f31e491beaea6a03db391,t,36706,6878832,,5000078,2018-01-30 14:01:34,206
0xb38fbda53ec0cc720dde4ccc4c0ad2da95f754abd85bfaf8c3a976eddf682da5,t,21000,6899832,,5000078,2018-01-30 14:01:34,207
0xcadbab6b40409ee6565944afabbdbba521a15f748817b1441ee4e3730ccfe54f,t,21000,6920832,,5000078,2018-01-30 14:01:34,208
0x6390b194836e2002635c7bcb4ea76da44c06c63d5b2a97557e5976afaeedff34,t,21000,6941832,,5000078,2018-01-30 14:01:34,209
0xd00d9d1014d7e9e8a0b001d2a08781c814e94099b1b27d6075d2422f2ea75551,t,38615,6980447,,5000078,2018-01-30 14:01:34,210
0xb771104d089d5dce9a1fc482630e2ab9602ff2af347c6c96407fcdab7e654bc5,t,21000,7001447,,5000078,2018-01-30 14:01:34,211
0x218b59c2c839b8db7faf1a70df35cc815313a28f50c8f8e1b37deb239ba6ddf1,t,21000,7022447,,5000078,2018-01-30 14:01:34,212
0x0d5951045e71f584bca5e78bb6947007b6d3f9ce8cfe27a80d0f84da0ff7d591,t,21000,7043447,,5000078,2018-01-30 14:01:34,213
0x4733415d76a40cd3a91d5be1cc6bfa41eff7427a022943bf4ec90b08aa539d86,t,21000,7064447,,5000078,2018-01-30 14:01:34,214
0x8f9988d50b724c318b1e68224d805b62bae92ee0da84269239ccc3873fa26465,t,21000,7085447,,5000078,2018-01-30 14:01:34,215
0x786dce6ec7f1e6bc4efff247f142fbd165ca4b7111b1911f99db2d6402eaf8f5,t,21000,7106447,,5000078,2018-01-30 14:01:34,216
0x7307b401eda3e417764bc94bdf06b7a2aedd4dd85ff2455adb12252ed4356755,t,92882,7199329,,5000078,2018-01-30 14:01:34,217
0xe56b5705cb6adbe44654bfb59cac4aa1c92349ec334cb2f48a6e4ab3f77d4362,t,21000,7220329,,5000078,2018-01-30 14:01:34,218
0x3e0055512d6112ff4c88107a7e10db1d1a1144b4da969a53139e6a6fbc577a97,t,21000,7241329,,5000078,2018-01-30 14:01:34,219
0xd6c477edfa2e614eea4ff7e8736e53b670f3ccd0ef002f82d77d5b4780e55baf,t,21000,7262329,,5000078,2018-01-30 14:01:34,220
0x65721a82b2f63bbe94d69ba8118eb510909f1786b604e8c2e84134c883831ea4,t,21000,7283329,,5000078,2018-01-30 14:01:34,221
0x23a96849553083132fc1ba7253cf39899ded9b2ad0334e20973cf38b770487e8,t,21000,7304329,,5000078,2018-01-30 14:01:34,222
0xb0a301b4f6eea8d86f7185ac720e7631317927bfe8e71dea665bb118a40844c8,t,21000,7325329,,5000078,2018-01-30 14:01:34,223
0x4c4d87bc0327b12a924936f98b658329364b0c62ca7ae24ffd5c66da10ce6b2b,t,21000,7346329,,5000078,2018-01-30 14:01:34,224
0x8cdba7ec353a784ca3305be9a5d0d0a15a5ba88cfc690ac1fbc552b4f0857aaf,t,21000,7367329,,5000078,2018-01-30 14:01:34,225
0xd54c2c66b5173e9b4268133224ea6a60f538fc029e50799c78769e4038017c34,t,21000,7388329,,5000078,2018-01-30 14:01:34,226
0xa1a1e0f3ec1e3ca54cebb35cdb52b9e9e4ab395d5f6cef20121e836453bc0fe8,t,21000,7409329,,5000078,2018-01-30 14:01:34,227
0x5108e6d943dc20c622e56e81ecad1059d66d603c382cb9da01464fa20554693b,t,21000,7430329,,5000078,2018-01-30 14:01:34,228
0x5f1077f7217fe67214636f8931bd85d77765a4d32e75c486d09403a887d1eb90,t,21000,7451329,,5000078,2018-01-30 14:01:34,229
0x5c7db4911b60b4d1329a763c25eaf05ac99def38c2caf3253bebd6e2b810b325,t,21000,7472329,,5000078,2018-01-30 14:01:34,230
0x20aa4fcccfceafd246bacae29e3a2933ad5c428eec2a1b824842aff9ab148169,t,21000,7493329,,5000078,2018-01-30 14:01:34,231
0xb5832512071a03faf5421fd3f1176c57b97ce896d01ea53da58d1fc937c6d6e8,t,21000,7514329,,5000078,2018-01-30 14:01:34,232
0x8781178ccfb3dbcc955658b14e00038146ad9ac9a47c821f4c50fe093a104328,t,21000,7535329,,5000078,2018-01-30 14:01:34,233
0x226ad12c92981d1d047d1c808279fba0e012f972b47aacf3506507fc9131b1fc,t,21000,7556329,,5000078,2018-01-30 14:01:34,234
0xd8ccf8e6e579c1c78d12a2b1ef0fb1980cea7498182caf78eaf5906b5c760d9a,t,21000,7577329,,5000078,2018-01-30 14:01:34,235
0x655e418385c6827435195a4e58d77189d8c1426ea881af703a3ce173dfec8268,t,21000,7598329,,5000078,2018-01-30 14:01:34,236
0xea3d35913a9e4fa4e3ce3c9dd179f48ceffbe3deb70cadfe9adc14a957d95d8b,t,21000,7619329,,5000078,2018-01-30 14:01:34,237
0x8d7c086ba8854df742bbba4ed72be0be04961dc00019cdd860b9c792e1ee97d8,t,21000,7640329,,5000078,2018-01-30 14:01:34,238
0x61afe399c6f576d595b40ae167db6edca2a1e3a55ca6a820b3d33ccca5f2ef5f,t,21000,7661329,,5000078,2018-01-30 14:01:34,239
0xdfab7c7ef7800f302fd5846667798f946d5ba3807702c17858ad03c8b8753e38,t,68232,7729561,,5000078,2018-01-30 14:01:34,240
0x873ac2dd41be17ec102a21be11942542f45169adf67824eac0de2d0443177614,t,21000,7750561,,5000078,2018-01-30 14:01:34,241
0xc76e76882c52cd49222b3b93a53278fc22a0808f718c110353201e50ec5cb1df,t,21000,7771561,,5000078,2018-01-30 14:01:34,242
0x8383be73d408510c83c8352dddbaa217127d9ef0f30073b230e8f327a34ef845,t,21000,7792561,,5000078,2018-01-30 14:01:34,243
0xd48e7c640c4ddb4cddb8e869e1fa7aee29908b0a04113e2fb8f70ce27934bac5,t,21000,7813561,,5000078,2018-01-30 14:01:34,244
0x7c4aaf1724c437506127d81a3c26e3f0f37a99ae6bdc32e684ee14a917a196cb,t,21000,7834561,,5000078,2018-01-30 14:01:34,245
0x310d3512f01f16c69b81d1e20bedc80a557009dd1e13f251742526d7d3491c16,t,21000,7855561,,5000078,2018-01-30 14:01:34,246
0x0f3e7a7fcc231ac276f1864077954aab7022e2a19eb1e0b4997ebf41e3c10da7,t,21000,7876561,,5000078,2018-01-30 14:01:34,247
0x3223854b6c9b0a5714800dff82337de38da283ea1cf84ed8016a8bfbe43132e8,t,21000,7897561,,5000078,2018-01-30 14:01:34,248
0x03c719d358a805a7e10c05e05cae249f396b796bdd131f732e505508fd05dc9f,t,21000,7918561,,5000078,2018-01-30 14:01:34,249
0x7e852d783cb8b6cd0a2468371c1c9b1e11f2f3d7cf7f42f1631786b53f739488,t,21000,7939561,,5000078,2018-01-30 14:01:34,250
0xc49c2362e65e1bafa272e38a25c49544bc59e86222075c439b98d8f65ad82873,t,21000,7960561,,5000078,2018-01-30 14:01:34,251
0x356f17aad37d368cbb898b1de8ef9ec3f60dc4a476493a90d872caaf5af899a8,t,21000,7981561,,5000078,2018-01-30 14:01:34,252
0x546c4f1e44a60376795af5a010c0e6799a540d1957e14d0b0b7966dd7218af2a,t,21000,21000,,5000079,2018-01-30 14:01:45,0
0x1a2f2095967fc1bc3d0d53a4b2cb39da9407a609656592c7bbc05c8eea11270f,t,21000,42000,,5000079,2018-01-30 14:01:45,1
0xf1e9627720fe0346b4f8b169240640a89be9f2692a12917223cc8a249dc047fb,t,21000,63000,,5000079,2018-01-30 14:01:45,2
0xc95ac9c494cf2c69789791c56ce2871b01c4967c077ca801aeae1e7eb0940da5,t,21000,84000,,5000079,2018-01-30 14:01:45,3
0x61bd1dbfd732977e489db730474dfd96e89922cadd47eebd813374c9bce978bc,t,21000,105000,,5000079,2018-01-30 14:01:45,4
0xcbe002442ea04b8264286097def0bddb8e350c90fffb92fb46b2298452a3725c,t,21000,126000,,5000079,2018-01-30 14:01:45,5
0xbd046dd1d1d7320c59051f9be93f905b377fdd2657b6dce71b9cde6f863908f5,t,21000,147000,,5000079,2018-01-30 14:01:45,6
0x18e616b3ec805275fafdffd5e2bd3810ebf695d4b3d9a55b4dc28c3887c06e57,t,21000,168000,,5000079,2018-01-30 14:01:45,7
0xe554c72a36bebabdb82d9301866387323ce695a69adc0ddd176ca9a5adeb64c7,t,21000,189000,,5000079,2018-01-30 14:01:45,8
0xb8aada0c59d8311c68f46940ec709a20f335423b0df0a1638970b68ae4f46a19,t,21000,210000,,5000079,2018-01-30 14:01:45,9
0xdd820bc1ac31e4f051b81808633c873b52b88ea14037aefc0331a0b1662e2ecf,t,21000,231000,,5000079,2018-01-30 14:01:45,10
0x777f535049e5b46ed3011b2418bcec171314bb2ea3fe743a249acc4e46ca1d74,t,21000,252000,,5000079,2018-01-30 14:01:45,11
0x7d0060692e801912d644ae3da1a026115bfe309f03de4efa88c0992df40a70e5,t,21000,273000,,5000079,2018-01-30 14:01:45,12
0x879c11131fb14b805678969b8329526e3564ff60996fd24a05d045022ba6742a,t,21000,294000,,5000079,2018-01-30 14:01:45,13
0xeffa81195828ad78fbfe051a11cb2a52bd9ef5a2491715724868a1df26f02106,t,21000,315000,,5000079,2018-01-30 14:01:45,14
0x02c9b18e5c2f890f4e950b8918811513176af3ce3a22652a7d5dcb6b30cde284,t,21000,336000,,5000079,2018-01-30 14:01:45,15
0x6a191da8599db0a8024d3fec6ed026a99abbbe5fa7b9686bdb7afea67b8bacb2,t,21000,357000,,5000079,2018-01-30 14:01:45,16
0x94abce7ddca5909ca50ec12a71e93f7baa352df3520e44b02668e799b90ec4e9,t,21000,378000,,5000079,2018-01-30 14:01:45,17
0x8dd3daa5702f2b6653bfcacfc22384b0b783e16fb223307991f1f6bcc970c40f,t,21000,399000,,5000079,2018-01-30 14:01:45,18
0xf6e505fad0c58ad6fe98939cf1e4fa5376a7820b1a24ffefa42dd0bfeeede1d1,t,33705,432705,,5000079,2018-01-30 14:01:45,19
0x5f599550542aca6a1223142e064220c754e22491c20075ea3738cf1fcd385d1e,t,21000,453705,,5000079,2018-01-30 14:01:45,20
0x9d245d649e467fc780a53b29a1986da33725f8181b0038aba7725055be434239,t,21000,474705,,5000079,2018-01-30 14:01:45,21
0xc85b2353a927297b934d8ab7be977b363e90c11bf3c9baaf3a4926ade4e1e089,t,21000,495705,,5000079,2018-01-30 14:01:45,22
0x28a8df4b9d81a710e41723bbef0fb9f2b0d66468a5319906540c70189ef06bba,t,31005,526710,,5000079,2018-01-30 14:01:45,23
0xf8b15bbbf86fab36cb771d0a663211d24f3f9f07604aabd83a202362ed7bf33f,t,21000,547710,,5000079,2018-01-30 14:01:45,24
0x392d87f8a3446a3d3cfa084d45d7d3aef541af6de05ea2694ed1d9361633c868,t,21000,568710,,5000079,2018-01-30 14:01:45,25
0x76b342625f0ff5b0280b599e2e71733a76d967ab89cbcace8dd96e43e58c63aa,t,21000,589710,,5000079,2018-01-30 14:01:45,26
0xc673307baf7912161afb04b4d9bd6f3e2b25b80c21a01280b9dd732e56d4d058,t,21000,610710,,5000079,2018-01-30 14:01:45,27
0x5c5beb2ca8b832a151a40eb644240c8a56cc87ffb345733aae3b193974eb5bd2,t,21000,631710,,5000079,2018-01-30 14:01:45,28
0x17af72a359f8c97e08442c8df9c3772f45db901987687edde00cda52c1300b92,t,21000,652710,,5000079,2018-01-30 14:01:45,29
0x01a1673eac5f38c74ea2be4453faddd13e37719407fa37298e65d130450dac51,t,21000,673710,,5000079,2018-01-30 14:01:45,30
0x196f395bb5ca1c7e6d0fde51022d552ead15a4c7da87ed646f868960c6514cb5,t,21000,694710,,5000079,2018-01-30 14:01:45,31
0x2e74f92d3d3cbecf99c7e3f7a79893f44dd45f518cfd86d7bc935336957f8b2f,t,21000,715710,,5000079,2018-01-30 14:01:45,32
0xfa6b85f0b17fd26e4afff78f92a0de80ef0d770bd4890a9132a035d8c76ee536,t,21000,736710,,5000079,2018-01-30 14:01:45,33
0xeabcdcdf17ba8fa94d70eff71682bb338d40c0474e16958c4b1618d7b7ec7b1b,t,21000,757710,,5000079,2018-01-30 14:01:45,34
0x45ce5625198df64dd3fb613b9be9416aab3422a10d275d2c642b1bfc4bd78207,t,21000,778710,,5000079,2018-01-30 14:01:45,35
0xb9e4e736f9aa4b4aa5fe2c89b8331dec994b237ad5ed74f58888aebe5e6e6bca,t,21000,799710,,5000079,2018-01-30 14:01:45,36
0xd545656b7f4e191eb60192d4e11b70af117bf89308d58d77e6d30b51b4cea359,t,21000,820710,,5000079,2018-01-30 14:01:45,37
0x65c0c156852d09ad2882ed3246a04e766a7cf5e1a8c7d0a9ffa20d9beb86b49c,t,21000,841710,,5000079,2018-01-30 14:01:45,38
0x596d3e744948ed9f2b8d4d535b82e87d14e7ebfe78fe4d301683e461c06acbe0,t,21000,862710,,5000079,2018-01-30 14:01:45,39
0x59a89eaada5e8536ed7951a5f83e6c4dac8f3ca88d2fa2a63f90380e714bdcb5,t,21000,883710,,5000079,2018-01-30 14:01:45,40
0x125455c0077fd6b761cfddd2af0d4f2c59f1d5d7bbf64d0e4008f628ccb487a6,t,21000,904710,,5000079,2018-01-30 14:01:45,41
0x08d6a96a046a298d8e87dfed17362472b88c119b31057f6d611d393f6aa827a1,t,39512,944222,,5000079,2018-01-30 14:01:45,42
0x8abc7090af7d444fbc3578b7e76726a5f7587e87a133625e9afc0fe2194eb540,t,21000,965222,,5000079,2018-01-30 14:01:45,43
0x3b081b16141cda3110e47715767895f793036f8cfbcde7d2854b3d87e4c91294,t,21000,986222,,5000079,2018-01-30 14:01:45,44
0xa321f5dcef84b6fa449c06cbfd166c6a34b4693b575c8498027e266dbf5f0786,t,21000,1007222,,5000079,2018-01-30 14:01:45,45
0x908adb3ed4ac1d0a833f9bc2b866af9be35c8289492fe4afc24662aee0263a9b,t,21000,1028222,,5000079,2018-01-30 14:01:45,46
0xb76f6a4482f707d044f079ad00d46b4142403984db1913b2bba3c035b7ca72c9,t,21000,1049222,,5000079,2018-01-30 14:01:45,47
0x5043edb21198ef3050070e8a2f14f4b23ccdd929c2d7514e515a66755f751b2f,t,21000,1070222,,5000079,2018-01-30 14:01:45,48
0x3457b8e979a4bc1f5a260b66e37faf275045ce031d85233b074cf7ef4c0c7d60,t,21000,1091222,,5000079,2018-01-30 14:01:45,49
0x227a23a97c1e62252b48adea26d02d226132970397faf335d835e255a2181f43,t,21000,1112222,,5000079,2018-01-30 14:01:45,50
0xa79dd05603d89fc1e1e64fd30c236a8e9080b8355de3f53298f0a10ae0049706,t,21000,1133222,,5000079,2018-01-30 14:01:45,51
0x4a1bf24faa6a7b80125fadfe2257c4bf6869b9cfb03a62f3e87eb981f9cee9d9,t,21000,1154222,,5000079,2018-01-30 14:01:45,52
0x80f3f87046e0bbd62d6da4f5d0615b61b502395929d8d12096b60a57757c9ea9,t,21000,1175222,,5000079,2018-01-30 14:01:45,53
0x5c77f54755d62f163edd67838502cacdf7d4bbd07da9c048bc6c2c4fa8a7d8b5,t,21000,1196222,,5000079,2018-01-30 14:01:45,54
0xca97b0f5b509343b6c8c1fa2d02d160daac2dff2a62c86124d839d6c69cdda60,t,21000,1217222,,5000079,2018-01-30 14:01:45,55
0x6d892567e1cb2d91ef728122b0c4fb884f793a3d811deb8f7c32b165a09abddf,t,143081,1360303,,5000079,2018-01-30 14:01:45,56
0x618b583378b18e07b8f679129d88721ebacd9eb97743b4a32103a7cee166d74f,t,37292,1397595,,5000079,2018-01-30 14:01:45,57
0xb468e924c24b6e5e863677a66b8b61be30312d9a5f50b010421554db274b5576,t,21000,1418595,,5000079,2018-01-30 14:01:45,58
0xdb53a6b9a2b62e63873f6ab6832b14e18922d11bffa95e7c90702a2f620598da,t,21000,1439595,,5000079,2018-01-30 14:01:45,59
0x64aa9b906dfde0f084521751778a27d24c183a68d6b4b091dfe955255ec9e82d,t,98809,1538404,,5000079,2018-01-30 14:01:45,60
0xee9b2d9e54da77bcbb6a862f1662edea63fb6b7e2e0c68ad4fe48a19bf599261,t,53175,1591579,,5000079,2018-01-30 14:01:45,61
0xe8bcf2e11c47b8c3f7b8fdf8f8916400bb96c4d36bbd687660e3889ad2c82eae,t,40843,1632422,,5000079,2018-01-30 14:01:45,62
0xe86619a8f8dd34199e157e69cee67cbbd526129ea8270e04f367ba4c76ec2a16,t,37155,1669577,,5000079,2018-01-30 14:01:45,63
0xc836de4452805b206e4ed3d44d600ec56b5f2562762e0f29830f778172ed9514,t,21000,1690577,,5000079,2018-01-30 14:01:45,64
0xa9705d5d941779ed892bf9c1ff5be0a731c00ad07613587ba2fb2a8efb87cad6,t,21000,1711577,,5000079,2018-01-30 14:01:45,65
0x4e34c6dcd63c642bd9811587382ae2c55cfcd872190e2c5afc5a61668fb384d3,t,21000,1732577,,5000079,2018-01-30 14:01:45,66
0x990036dadaf08e5a41077cce29c32c133a86ee4f4027d6bd5d1bb5ed28b997a7,t,36784,1769361,,5000079,2018-01-30 14:01:45,67
0x423ccfbcab88c38e60751e7c5eee5bb5f8ad92ee627fd440f791209b0bc921ef,t,21000,1790361,,5000079,2018-01-30 14:01:45,68
0x83816ead07318320e19faa29e7dcc31ce1b87a5c058397709dea4a08765006b6,t,21000,1811361,,5000079,2018-01-30 14:01:45,69
0xc917c2203ae4681fc298238dbf06b156654ad9fda014343a0005c7e8c574fea9,t,21000,1832361,,5000079,2018-01-30 14:01:45,70
0x97078a607924b190180fba790196f8ef46b13474ba2be3dfde768e7b95ca47c2,t,24090,1856451,,5000079,2018-01-30 14:01:45,71
0x814903fa968c3143f8792641da78089609b8a3bc95e03d156de4ca3d80e5eb62,t,21000,1877451,,5000079,2018-01-30 14:01:45,72
0x17ac10e84a969867f6c4c84a964826b605326b376ef4c89754f0e249c2109acf,t,33296,1910747,,5000079,2018-01-30 14:01:45,73
0x6c4900aabce68da2d88237113fab31c4e4daf80397c36c6637dc80bcfe8dfc48,t,21000,1931747,,5000079,2018-01-30 14:01:45,74
0x5ef1e3f3b3021190e8eef04f999f083bbc85759f59c4fe9469b3afc5fc9443b5,t,70195,2001942,,5000079,2018-01-30 14:01:45,75
0xd66664ff908a09974ebe574b7cc5dd46512ec59062bb3f4bca648f9d5c2d92d8,t,21000,2022942,,5000079,2018-01-30 14:01:45,76
0x0e649e1ff1789111426612f58e14752c73e0bbe324ee4641710d9c20ba1bd6b5,t,37094,2060036,,5000079,2018-01-30 14:01:45,77
0x63a359f38384470af80d456b238f56ed0365f08fa5eff22bcbe2c31aa33fd07d,t,53361,2113397,,5000079,2018-01-30 14:01:45,78
0x43dc7d57a0af0171ce8a6a3a0faff41e28cab23971a33a1f55c5db224727cf73,t,21000,2134397,,5000079,2018-01-30 14:01:45,79
0x6ded2fd988a8a04b083d81418025f1901f8ec2a5e8d6bde890effd765003ecaa,t,21000,2155397,,5000079,2018-01-30 14:01:45,80
0x4a6c3e74e82746f2906fd3f366bfd4abe367ae2d74f83ae73ca565e42057bbe9,t,21000,2176397,,5000079,2018-01-30 14:01:45,81
0xcf7409439e5383c098ef76c6847793f47f5dc044e659c3ad769be746eaa45c94,t,77986,2254383,,5000079,2018-01-30 14:01:45,82
0x7d422b3b20c4cb2b058f9b882f97e4fc9a99bbe81c8405569778c3649550e614,t,48058,2302441,,5000079,2018-01-30 14:01:45,83
0x25469825c1fbfbc0eb743f26d4359180ed0cbb9f6da11638576b2386299afa9e,t,21000,2323441,,5000079,2018-01-30 14:01:45,84
0xf3a450e160083639a2ce078e475c5da89f4d8d75b0779cb6afad6f18d26c5fae,t,38318,2361759,,5000079,2018-01-30 14:01:45,85
0xa43ab7fe2035699e5d59d350fdc79aa1d473adfd54b9ab746ece8c7780c955bd,t,21000,2382759,,5000079,2018-01-30 14:01:45,86
0xe7ff9bf1a90e24d1d106f2c1e2d94081b3504cc0b3c83d3e4186ca943e18a22d,t,22088,2404847,,5000079,2018-01-30 14:01:45,87
0xff6b16923d4d8bae62fc6ae0fa61b31e9b9daf8dd784bc29299174811d53dcc8,t,54908,2459755,,5000079,2018-01-30 14:01:45,88
0x5c3d40b47754a995ba63038f5642967e83b590053e49893f32ebacdefc6c8037,t,21000,2480755,,5000079,2018-01-30 14:01:45,89
0x2012ed88d938bd7994ce23ac77a44b8e2153b18c5f3f12370c14a3ee75748600,t,37571,2518326,,5000079,2018-01-30 14:01:45,90
0x7c32986ceff158bd3598ea5fdb8e68d9b35c6e271b0590097b7be047670c5de7,t,38233,2556559,,5000079,2018-01-30 14:01:45,91
0xfe0602c4b61184e6a05a0122d9b0f3c47eb7087b6ffa3051e8d562882d02448d,t,21000,2577559,,5000079,2018-01-30 14:01:45,92
0x67030ccd46d71341c1a4a1cb94be99146b073a6f43e7dea344c3bbf6e3b595d8,t,21000,2598559,,5000079,2018-01-30 14:01:45,93
0x971e2c14fa537a5aa424e425108826c86f0461ca1f2a8f7baa749d64a8fcf488,t,21000,2619559,,5000079,2018-01-30 14:01:45,94
0x69613d1312bcf106a78459a7edd9cb5493b65d800a073ed37c443dd4571b33c1,t,21000,2640559,,5000079,2018-01-30 14:01:45,95
0x5aeffc3d5e57c40b8e993bd162b0ef7b35123e716e683b9ae22c61f1f3d3b398,t,52886,2693445,,5000079,2018-01-30 14:01:45,96
0x3c1339cd0563749df4ac9abea9428e14573b2ac228d3cedc2d02dddd6402f4c7,t,36792,2730237,,5000079,2018-01-30 14:01:45,97
0x2d036b661e178188e9c99a67307cca5d1d228847b7ba2798eaa007b050a69f8e,t,67621,2797858,,5000079,2018-01-30 14:01:45,98
0x836944bfca2635475a65ea7e9500f195422d2eb2f1ac16637e25ae7785f8bb41,t,205259,3003117,,5000079,2018-01-30 14:01:45,99
0x43e8372801b21dde37c3dc541f5bf391b3437fc2bf7c408e76f3abafe690a685,t,21000,3024117,,5000079,2018-01-30 14:01:45,100
0x315f0ac6e672a56f44a06bfd9387074b68ea5454d8aca1c3cbf7985589cc3749,t,21000,3045117,,5000079,2018-01-30 14:01:45,101
0xe2968209bb786f31a77e646418df32f87eee7a0714a2385311776db410189c0b,t,21000,3066117,,5000079,2018-01-30 14:01:45,102
0xd0782342f8fc7e72957132f9a039bc6edcdbd2d7c52180d4777c5902ba06c078,t,21000,3087117,,5000079,2018-01-30 14:01:45,103
0x2698722c3d79c7db0cf082b7e5d9f0da683bdf995fa42b2721528b988abaf1d4,t,36553,3123670,,5000079,2018-01-30 14:01:45,104
0x264a9cd6cf99b7c63bbe440c81f5154f7d1639f857b1ea68948df523eebe6fe0,t,21000,3144670,,5000079,2018-01-30 14:01:45,105
0xa2fb0a824a336af7b5b00ec1232cd59f50bd5ebe6b2c8c418c4ccc507bab3b48,t,21000,3165670,,5000079,2018-01-30 14:01:45,106
0x98b7184e00b9b4a355099bc3fbd2f23fce0b773db75e9efd144b68a096d5c25f,t,21000,3186670,,5000079,2018-01-30 14:01:45,107
0x3dd1b7e0e500063b8d62ee1ccfa7f8d0b89905918299d472345252f917aa88be,t,21000,3207670,,5000079,2018-01-30 14:01:45,108
0x1b9743ebc1350b78c7aaef9061e39cb08721dc93e2663d6eaa8a087d4359dc54,t,21000,3228670,,5000079,2018-01-30 14:01:45,109
0x154eaa2dc98ff4d4c31511c05f63bfa697069d75a9c1f96bf7cff78d3e57a482,t,21000,3249670,,5000079,2018-01-30 14:01:45,110
0xe0bb9d7b7213fc5f709016d7411d6a4153be83d95259729fc6ac4ff2cda8b794,t,44198,3293868,,5000079,2018-01-30 14:01:45,111
0xf90141b86f141d2ab12353280a02e745a210631560fc7aba73235509fd1e83fc,t,21000,3314868,,5000079,2018-01-30 14:01:45,112
0xa6a77eb1f53110844151fae0a2139a3411c3bfd00afe3c789651ca8bbc00c1e6,t,21000,3335868,,5000079,2018-01-30 14:01:45,113
0xdfafce68414a99aa8d5b526476764b623c7a4f61ae08eee50d5b83460a1721ac,t,21000,3356868,,5000079,2018-01-30 14:01:45,114
0x0cbf968fa0f1d2d61f97b7682354907d46280efc306d91ebe89544e6b1b8136c,t,21000,3377868,,5000079,2018-01-30 14:01:45,115
0xa68c17456a4558568952740e2b1c2e81bba50738287c65edbc4cdcf5f718a161,t,21000,3398868,,5000079,2018-01-30 14:01:45,116
0x78ea527022ede4b25852658f95db5c57df6eadc48cf4ebfd649c73e850ffcdde,t,21000,3419868,,5000079,2018-01-30 14:01:45,117
0x8d1f2304dc32eeb65bbd58192af325d8fbfb7b1ca8417d1153760749ba747403,t,21000,3440868,,5000079,2018-01-30 14:01:45,118
0x55577724ab0e143d7d4ed3fb0803277fb8153bd38a08ca0543280d04afd0558a,t,21000,3461868,,5000079,2018-01-30 14:01:45,119
0x143f5a5fe03ef51306d3b269653b4bf436b6ef25dae7371ca6294e4031f103bb,t,21000,3482868,,5000079,2018-01-30 14:01:45,120
0xa424996c3cc7e7286e2cec3b3e8af277506b899e757dd06653847c3d575c4006,t,21000,3503868,,5000079,2018-01-30 14:01:45,121
0xad8f1141c3ff0e378f4f55a8a6835ed5e61bc48cbf3ef9bdc7a2c1b1ca4885ac,t,21000,3524868,,5000079,2018-01-30 14:01:45,122
0xe98662d46cb173e4d47cc6647e2ce9acefc7b8747269599c6b4d76478f9bf5e5,t,21000,3545868,,5000079,2018-01-30 14:01:45,123
0xca4e20b634edd6d34f313f884ac6f35fa9f6cf83a919ce2ae327a49d0bb7193f,t,21000,3566868,,5000079,2018-01-30 14:01:45,124
0xe598ef9f6b25923b5afe212dae35db8c2508ca14d1e62497816bc3b4ede2d03e,t,21000,3587868,,5000079,2018-01-30 14:01:45,125
0x2fea03caf91743f92adee63fdd0d696a01d3babf84b75119ed2108bc2c472e36,t,21000,3608868,,5000079,2018-01-30 14:01:45,126
0xa407e3d175cac7bfa2de8bf0c790a8b6fd0d9a4101581d1e1873142de132d49f,t,21000,3629868,,5000079,2018-01-30 14:01:45,127
0xc5dcac90a6db00bde36e221c1045971994a6a5fb5d336c46ea211204c30d933b,t,21000,3650868,,5000079,2018-01-30 14:01:45,128
0xc950dff491e009a9529a2efce3af4bcf86fdadbf82e520daa4e5d13ce9fc17f4,t,21000,3671868,,5000079,2018-01-30 14:01:45,129
0xe0a66d0108a74d8c8a8a3ff8977da1bc37cd85beae9fc532f8d7f79b6a0c633c,t,21000,3692868,,5000079,2018-01-30 14:01:45,130
0x550a4cccca8c7fbe7e35e937afeece6601e9743ff7223e27e7066fd4eb3f42e7,t,21000,3713868,,5000079,2018-01-30 14:01:45,131
0x7ab852fba6449153118ebb1df7ff1b5b2e0e98edcf308f1d6b93df03631c4420,t,21000,3734868,,5000079,2018-01-30 14:01:45,132
0xc7c7ecc7f8567cc80a72ed15978b7b6a040ad14b62cbae49244c8ae677ecc268,t,21000,3755868,,5000079,2018-01-30 14:01:45,133
0x02d3a3e43e4ae3f10d915d4aed40f52d99a3f089cd73bf667c5cbb80e6698048,t,21000,3776868,,5000079,2018-01-30 14:01:45,134
0x0d2a6257ac2473158861a3663020411c7c7c6a1950ec151a2d8d02778cfa90fa,t,21000,3797868,,5000079,2018-01-30 14:01:45,135
0x4432284a4b341c979c2e1120ac898d09ed6bad9cbe15e691ddb61bff62950198,t,21000,3818868,,5000079,2018-01-30 14:01:45,136
0xafff68f61f73262313427ccf6982955c6d16eea5c71502bc2dc03c9266f20aef,t,21000,3839868,,5000079,2018-01-30 14:01:45,137
0xcea9b504cf7206fc9b320024a54dd03ce1f4c9921bd738212a2519efaa3a76fe,t,21000,3860868,,5000079,2018-01-30 14:01:45,138
0x2a7294d069b2c94077bded374b5a0915f3d0d34f3f1b393cef437d3d18fc5064,t,21000,3881868,,5000079,2018-01-30 14:01:45,139
0xc58c77c71521f92f2632a29830709873f01f25b7e1cdefe2182a4201f71d9834,t,21000,3902868,,5000079,2018-01-30 14:01:45,140
0x1643fbcf8f5cf147ea5a6d9be5099dcc554b913c57f90a94941f1a5a21796c58,t,21000,3923868,,5000079,2018-01-30 14:01:45,141
0x14350dc76f541ab6cb6014fa86f4fd0f1cd8f04316cedf0a127aaba2a7e2c777,t,53803,3977671,,5000079,2018-01-30 14:01:45,142
0xb643a3c77dff83a2d0c2a554aca1b04216600291f4c753e3113ba5c73dea51d2,t,21000,3998671,,5000079,2018-01-30 14:01:45,143
0xbf61dcf78bea1c8bba458686aa99e00995aa6fcbd6f6d95951aa25d1c71a7b64,t,21000,4019671,,5000079,2018-01-30 14:01:45,144
0x24d0cb70c6d3260d4cf633ab09d4d2fbaf891cf14cd4aafc3396b322815f2d21,t,21000,4040671,,5000079,2018-01-30 14:01:45,145
0x5af391c02ecd6b8122f299560e7298462304b27497d7f1bb5e1772fa1f3289ea,t,21000,4061671,,5000079,2018-01-30 14:01:45,146
0x8866e74385986fd44bd038b5d0b17db13db9045678eba44980a281edcd49d71e,t,21000,4082671,,5000079,2018-01-30 14:01:45,147
0xaaf9996f17e9bd91bdc38c27995e37b9fd6c73d8820d87959dc165a8ccc7044c,t,21000,4103671,,5000079,2018-01-30 14:01:45,148
0xf7231d54eef581fa97a69478133a2c1c6b26183dee2f0c78d5731dc2e216982d,t,21000,4124671,,5000079,2018-01-30 14:01:45,149
0x4a66f986894cb300697e3b550a36119e8040bef3cf458dcbe18c2179f74130bd,t,21000,4145671,,5000079,2018-01-30 14:01:45,150
0xfc8fdb3d28e31ff93f07daf4bd3057882ff4abb2a82e9b8873ac1e49c8222b67,t,21000,4166671,,5000079,2018-01-30 14:01:45,151
0x5394b3717d435db85ab49eccd69ef1c768a8ecdc7cf03bf3f272148ae0dbcaf2,t,21000,4187671,,5000079,2018-01-30 14:01:45,152
0x07b862f7539ecdb2ecee2be8664b394912f1cd12f5be02a2dfef6efb853b049a,t,21000,4208671,,5000079,2018-01-30 14:01:45,153
0xa9250cc52d2d95a790749a063f64b8f950674b6d6e0fdf0b65d9440a77571946,t,21000,4229671,,5000079,2018-01-30 14:01:45,154
0x27279cee5be3505378cce62d90a922431d16e232a44d87a638fdf5a12c878eac,t,21000,4250671,,5000079,2018-01-30 14:01:45,155
0x8174dd0ccb886d09167c3cd114a5ae1467f38589cf68aa88cc8a05b003507ccc,t,21000,4271671,,5000079,2018-01-30 14:01:45,156
0xcfb53a6b2159fd2213cbd19aaec927d8e89a8f9a3d6dac78df9dec617558ae2d,t,21000,4292671,,5000079,2018-01-30 14:01:45,157
0x7f897448d423acf14a19c1d016a49017f341efcb3eebde3b2ad048b4a5ae0924,t,21000,4313671,,5000079,2018-01-30 14:01:45,158
0x4b89d12e867c905fddb1b102af3aade043a60afc8d7ef7aa99539b4e596925a5,t,21000,4334671,,5000079,2018-01-30 14:01:45,159
0x2d47dacbfb94329081d1828f2d77155ce5915e1cc7d8356d5660f23e8d81fd80,t,21000,4355671,,5000079,2018-01-30 14:01:45,160
0x2a6e203544757321bdd5b75123ca718dbb52478e8a31e12e0ea360ac5d29d6cf,t,21000,4376671,,5000079,2018-01-30 14:01:45,161
0xe224ef4e21d61de6c1579061d764413e37d16cc423e42b0f1f7465fab68b2920,t,21000,4397671,,5000079,2018-01-30 14:01:45,162
0x13f548d76c8c04e459bee41b66e6d88aec9f1211e6d1a3446f614af2d12ec1b3,t,21000,4418671,,5000079,2018-01-30 14:01:45,163
0x33ceff20f673a73231a5d921a5c3184c3031bdca1fff4ec98190ab1e8690b52f,t,21000,4439671,,5000079,2018-01-30 14:01:45,164
0x8c6d67a52541d8dfbbb53f6f5e41df3d834926f4f035ad30d4fb4a8b604bf27a,t,21000,4460671,,5000079,2018-01-30 14:01:45,165
0x19b17faaa5404980ec2b72ca29664f887a68390ef1bdbde71f43378fd05313ae,t,36779,4497450,,5000079,2018-01-30 14:01:45,166
0xc3e3b1305a3ebcd1bc88b0e40ba10c440371a82d4111430994c30d41492f14e1,t,21000,4518450,,5000079,2018-01-30 14:01:45,167
0x358926d9f0bf60c64d8cc3d8f8bb0e61cab56e373cc17d90f129c5cbd0a77aa3,t,21000,4539450,,5000079,2018-01-30 14:01:45,168
0xf3b4ce96d7d70fc9d13df9664ebc06d8dda09c38f1d15a38d64bbfb8436c3dd4,t,21000,4560450,,5000079,2018-01-30 14:01:45,169
0xace2d99f9a0993a3b6224504505cb1075d17e4facc26de9dc5e625212b16f491,t,21000,4581450,,5000079,2018-01-30 14:01:45,170
0xc970f3f3c16759bca192fd4db0b2f0709532aa2abf4804f29e2e441f3c428fb3,t,22848,4604298,,5000079,2018-01-30 14:01:45,171
0xec3d01534e3cecfd8604529abc2a0dad0d6290fac09bbd09d4de6e7acb5bd6df,t,22336,4626634,,5000079,2018-01-30 14:01:45,172
0x540fa73c04b7b7b4cc633a9451240ee6f1bfe7f937ea25694ef971089b62eba9,t,21000,4647634,,5000079,2018-01-30 14:01:45,173
0xb80b88d3703b1065ec536be51a939192929757b841f314e5f3cb9a8ea16cdc44,t,21000,4668634,,5000079,2018-01-30 14:01:45,174
0x0383e226537d87702dca47efb2795d159562742df113753bd4a212117560cffb,t,21000,4689634,,5000079,2018-01-30 14:01:45,175
0x87394ad6e5e93946dffc917f24433c24c38398e843eb071b9513be1e5e0bcbb5,t,23590,4713224,,5000079,2018-01-30 14:01:45,176
0x0d5293a90437c9f2046966ea4fa9cd6a18a99ad0531626daf3c6f678590d41b0,t,21000,4734224,,5000079,2018-01-30 14:01:45,177
0x4ddc1b8a8085f185534ea526af52ddd6cc7e74a53988849a79a9d56b8c131279,t,55327,4789551,,5000079,2018-01-30 14:01:45,178
0xa046c0f9e6597d5705367e4171bbdc023b501ae204d578a889eacc305f0a9224,t,22912,4812463,,5000079,2018-01-30 14:01:45,179
0x3c1a9b4ba785a05b3abe8ecd287f50ae00bddda6667ac95b91c9f71568e437ca,t,59226,4871689,,5000079,2018-01-30 14:01:45,180
0x8b92cf5b64e887f8ef2529342ca4b603e0cb6d38c5726d96c75218d73fa02283,t,21000,4892689,,5000079,2018-01-30 14:01:45,181
0xc5768e1261010530a810745d00fbc515cad8229f5ba50e94086629ec887ec0ba,t,21000,4913689,,5000079,2018-01-30 14:01:45,182
0xf4bde3442bd80d4056ca97ac0cef8d343bb2d460197e118303075ce5f6df17c2,t,30327,4944016,,5000079,2018-01-30 14:01:45,183
0x1692fb91a582af5fd12375bae9e3adacde66268f88cbe98286bfcbf02a5c1774,t,21000,4965016,,5000079,2018-01-30 14:01:45,184
0x4b1786eeb24654fb8a8aabc552feee7340e515cdd1018d377c9592ee4e962250,t,21000,4986016,,5000079,2018-01-30 14:01:45,185
0xd0969afb29e120c3ef520208062231becd1fbc4bb3beb66df485176614172d5e,t,21000,5007016,,5000079,2018-01-30 14:01:45,186
0xf4f4275cd1b35e424c3b68caccf9e9599b2ce98faf91ed6889e370107fcaff32,t,21000,5028016,,5000079,2018-01-30 14:01:45,187
0x381662efa3d8fb8d8a4a1463bdb2cafd8db78dca539f40539bc1156821fe94ba,t,21000,5049016,,5000079,2018-01-30 14:01:45,188
0x952c38058d6947f0a727ac56dff5fff6b67aa20ba35a3d8e4f084bdbdec2f2d2,t,21000,5070016,,5000079,2018-01-30 14:01:45,189
0x320f0a4ae3ad434db8136ae9986f4b8a9f0c7e95669f5908d34c53435c35e422,t,21000,5091016,,5000079,2018-01-30 14:01:45,190
0xbedf8971e1fe2358962b37c248e58c4081537f729e3219ee53502e621b8ad131,t,21000,5112016,,5000079,2018-01-30 14:01:45,191
0x0658db06e04577f42b66d2d66104e17a22b5ee740902bca9b2d524e609e9139c,t,21000,5133016,,5000079,2018-01-30 14:01:45,192
0x926f0a5230c4729a9e861fee1edc0c6b782d1100682c67ccfbe339283d4de651,t,21000,5154016,,5000079,2018-01-30 14:01:45,193
0x6ef410fc888ded52bc96a0711968578f1c345eaf5a0ed87b17bf3b86db9a27b3,t,21000,5175016,,5000079,2018-01-30 14:01:45,194
0xee4cf5b40fb563bc0cfe6c12c724d3b0b1c7bea054f4f238f920e8ef547dc117,t,21000,5196016,,5000079,2018-01-30 14:01:45,195
0xa851c808ec90e47f90cc1cab942a6be06cd6a3a1aaf2d75c07a3b3dd7657ee5d,t,21000,5217016,,5000079,2018-01-30 14:01:45,196
0xd3ec339355385cad9e71105183be3136f2d31b6e187f9a824176464952877795,t,21000,5238016,,5000079,2018-01-30 14:01:45,197
0xb93ee16a9b6369205018a89f9884cb0e88ff46ec051aee58b493de69b53ed55c,t,21000,5259016,,5000079,2018-01-30 14:01:45,198
0x0758f73f1f41c97bb1a99d96364e4134f5f0ca9afb77207b83b1e01b38d66e5a,t,21000,5280016,,5000079,2018-01-30 14:01:45,199
0x3a18ae5e46742dd68f2160c9e8ac1533d78bd106977adb9cc66d16022daea9a9,t,21000,5301016,,5000079,2018-01-30 14:01:45,200
0x4fc4dbdade83c58c5dc4bbbd12ac11cd01383a88d4a3cee9a72fde3eb1aa7af6,f,24769,5325785,,5000079,2018-01-30 14:01:45,201
0xa1b7d70713d5b2d5c8b603f39268438b96365e1b4adf0ca044aa547e03adcc9f,t,21000,5346785,,5000079,2018-01-30 14:01:45,202
0x75fb4453f5834d588ca31cc853f399331ac33cedc7994127fbc6d4a159a2b0bf,t,51698,5398483,,5000079,2018-01-30 14:01:45,203
0xa326728f38008ca77e7835e8672f70699b09187ea738014cc271f3958e8771be,t,29493,5427976,,5000079,2018-01-30 14:01:45,204
0x28faf986d82819c628ce921ed5a6c7ee5465e4b16ce0a66e253435b8e4458c0c,t,21000,5448976,,5000079,2018-01-30 14:01:45,205
0x53589544caf1813bb96e50cabcbc750929c1d070bf113bf3e78b96c41480f4e9,t,77858,5526834,,5000079,2018-01-30 14:01:45,206
0x559bb45f72e4475fbe09bef7f29219b095e33acfa95729e9b73eb39e5229bc2d,t,21000,5547834,,5000079,2018-01-30 14:01:45,207
0x086d3e7b8525349b8bdba116c6e1296eefb0595c0eeaac3884b505bb21f21af0,t,21000,5568834,,5000079,2018-01-30 14:01:45,208
0x894ecdeb23c9181a4410163aaeaadf11d7d08cadfa7b61811dd5e8d069e41b4d,t,52460,5621294,,5000079,2018-01-30 14:01:45,209
0x75ea089ed12a54cb5aab9c25c786c3c026c481a06f307ea03fbe094604e81366,t,21000,5642294,,5000079,2018-01-30 14:01:45,210
0x08fe396aed2da91240a1ca1a2249ecdbd4dc47d1b2ac87fbe439a88318f552ef,t,37947,5680241,,5000079,2018-01-30 14:01:45,211
0x88ba1e6b77999804b32b0121eeb29ad70d95c7ca3edb93353de5fc1ec0a1a18b,t,52904,5733145,,5000079,2018-01-30 14:01:45,212
0xfb5126b177871aea3e7daf634d72e49a94238790a39b12ef2f6938f650de7783,t,21000,5754145,,5000079,2018-01-30 14:01:45,213
0x80c65abdcec47481656e5b0136050d4aa442ba035ca8ccad90c3d3b9ddc3135f,t,156852,5910997,,5000079,2018-01-30 14:01:45,214
0x4e6adf32e8b61474858b2ad50d6ffc56669a2a691eff91968a886b4083de26bf,t,140340,6051337,,5000079,2018-01-30 14:01:45,215
0x3f34fabd2519bba525b0966b1ff22871b88b6c48879adcd5950d480ddb416ffd,t,22193,6073530,,5000079,2018-01-30 14:01:45,216
0xe388fbeb3f6ab35f12993e2feaa645c57f8753268f8ffd3064bc056b84b9be2b,t,23316,6096846,,5000079,2018-01-30 14:01:45,217
0x3fad9894181ab9ee5ec765c1ef5e2c845791e4eeecf9012505589ff31800ec38,t,52460,6149306,,5000079,2018-01-30 14:01:45,218
0x6e8aad5b944430adaed7dab27312411a7fd1cc3d717b538c66c5ffe64120d1d6,t,27923,6177229,,5000079,2018-01-30 14:01:45,219
0xb8d6819ece8de8f213fe68d77f081c38f55e2e45e9dd3d9826a8bedec934a1df,t,39624,6216853,,5000079,2018-01-30 14:01:45,220
0xb8b1d961e200a7738d62839a5440b14ccc0402571c790bc31e9f62a387a0c95a,t,43372,6260225,,5000079,2018-01-30 14:01:45,221
0x92d04a1bb92438c5af1975f9a019575bb0f50ead5beb114d1b33e2c59942e2b2,t,21000,6281225,,5000079,2018-01-30 14:01:45,222
0x329a220e586c0ec4feeee30032360895cd2322a30b370aa8fb364d8a95d122cc,t,21000,6302225,,5000079,2018-01-30 14:01:45,223
0x33c627ded6366e3113b1a77560c8801fc45e1ba9298ea865c241cd6188109e00,t,21000,6323225,,5000079,2018-01-30 14:01:45,224
0xb2c0bc57b9a7e3e89f9b96a8b778f1195ec79fe5919ecbdd05ba2f0b00e832d0,t,21000,6344225,,5000079,2018-01-30 14:01:45,225
0x5829e91617dc43d2c67df6cc15cbac2e8fab679b9f8042707dba1b9a8c921c6f,t,22148,6366373,,5000079,2018-01-30 14:01:45,226
0x34a1cd952ae7c0ff6a84bba9b0f3aa11518172c512225bed74dc912b70ee5456,t,27274,6393647,,5000079,2018-01-30 14:01:45,227
0xdb27947ed76c3effa72f6f61280e1afe0230dfa0b9c8b46f074f1aa9d522568a,t,21000,6414647,,5000079,2018-01-30 14:01:45,228
0xae9298cd9718f3560a60b3a7af4b0173503d775db751656201dcf862ec47edf4,t,21000,6435647,,5000079,2018-01-30 14:01:45,229
0xc9d125af2643d2cfad0670bbeb167a70719555831764439d2c440579683b459f,t,22460,6458107,,5000079,2018-01-30 14:01:45,230
0x72fa8d6f308193290a53537997a48da4912f895f76d951c588c01891a66cb26e,t,45591,6503698,,5000079,2018-01-30 14:01:45,231
0x7c82ee386d1e12e819c7fac70df1ce8084882b13ddc01f358ce6742c43e28a2a,t,45318,6549016,,5000079,2018-01-30 14:01:45,232
0x72efe6a2b03878944415ecb2fdfd264b4b95709c7161b43b440e156d48328ab9,t,66253,6615269,,5000079,2018-01-30 14:01:45,233
0x289eb41cd5f3912146532c9f6ee23f70fa003827722206c287a958ccbf929ee4,t,59098,6674367,,5000079,2018-01-30 14:01:45,234
0x6ff49806956a3b713469a47e03887a47d1089b8e2adfef3f708e5dbefd87d898,t,59162,6733529,,5000079,2018-01-30 14:01:45,235
0x52a1b911f173c72a6a218e7b4a301c2d4fa9d468c68a0c7c50c9ba8dfcabd820,t,169943,6903472,,5000079,2018-01-30 14:01:45,236
0xf9f03a228d6df7498c28b842bc477d7d7f136cbe12a04880e48a237aff7de461,t,23440,6926912,,5000079,2018-01-30 14:01:45,237
0x9c945ebd711528c6fc31c626ac29b6f7e22ef17464790e95f76f98bbdc69ad8b,t,21000,6947912,,5000079,2018-01-30 14:01:45,238
0x65b45ef0330d3a3d1be343bde37c7195bfaaf31a9eaf13d7ecbc16a0b50c4bd9,t,47604,6995516,,5000079,2018-01-30 14:01:45,239
0x24ac0735534ba9bb3cf247feb73af088e517c422774344353b3cf960dbc5a3ba,t,77858,7073374,,5000079,2018-01-30 14:01:45,240
0x176970ec495ab322c80d52a2f217c9c0b146a79e2ba60ee17bded81b1667e693,t,21000,7094374,,5000079,2018-01-30 14:01:45,241
0x10d84ef5b18aadb61c67dc3819572a6b02d643d312e96009ed6fbf44164e270e,t,51988,7146362,,5000079,2018-01-30 14:01:45,242
0x6ea3b6744a3df438734492712bd929b1ca39871b2b61a276e4d78354b1f014bb,t,52643,7199005,,5000079,2018-01-30 14:01:45,243
0x0644e76caaf62fae063919ff807f868f65ee61432454865ed0de43d156a7810d,t,21000,7220005,,5000079,2018-01-30 14:01:45,244
0xaf03888562f6be56c9e8310be6b91e1d2ad4365436eb37aa6345301acc6e5e94,t,44493,7264498,,5000079,2018-01-30 14:01:45,245
0x077ae88f68acbc672da35e9c3691979b8272b8eea6b46b8ffcc1ee291761e3b9,t,21000,7285498,,5000079,2018-01-30 14:01:45,246
0xbad7be86756a923bb562210391c4a5799c1355f3c87ef317afdd769dd1a18c55,t,41872,7327370,,5000079,2018-01-30 14:01:45,247
0x9c36e76314ad802df34c2295e41a934e51c30590e4b8d36ac144870cfb593210,t,59226,7386596,,5000079,2018-01-30 14:01:45,248
0xc0a42fe9507df647c1ab547051e864db15b958ca12f495407579c1ce358179ac,t,79985,7466581,,5000079,2018-01-30 14:01:45,249
0x0df8835454bdb7e23dc9c25c5a2a9b9c4f93d626110afe0c275fb37cbc4a1ac1,t,26937,7493518,,5000079,2018-01-30 14:01:45,250
0x5d318c63106446c2cacc971d221d601a26a09dde8a52817b6822d57defd7c470,t,75156,7568674,,5000079,2018-01-30 14:01:45,251
0x08aa9f1ec4f5cd6e06975ee076ae1f1a41f3dcc2d5b28065d2c7f005b18ee24c,t,140212,7708886,,5000079,2018-01-30 14:01:45,252
0x5ca374d10decc75a7c55d64429e2e694d9e7e2fa1659d201eaf57032092ea628,t,51560,7760446,,5000079,2018-01-30 14:01:45,253
0x559bed1938f3971fa4dc56f52bd67df36976fff77ca5ac0c3a88c45029921f38,t,58919,7819365,,5000079,2018-01-30 14:01:45,254
0x930d099321107340abe1420ea2053e678c933c0c855344b6713dcc4d34df401b,t,98113,7917478,,5000079,2018-01-30 14:01:45,255
0xc15bc98aa4f1a5033a5b2ccba0cb4a87db5d06f2d98e3c2a19d668a4f819cd05,t,54195,7971673,,5000079,2018-01-30 14:01:45,256
0xb8dd583a3682c32a79cc79481c681b29956e87875703e36b38a5240155c3eba6,t,21000,7992673,,5000079,2018-01-30 14:01:45,257
0x53ee751e209fc0a2414f387d2799b06826b454ed94ef60cf3fb494316e4ef989,t,21000,21000,,5000080,2018-01-30 14:01:56,0
0x3181f71dfa1fd729e89f43b12530ddaff77a0516d7687b448faa87a94d9024a6,t,21000,42000,,5000080,2018-01-30 14:01:56,1
0xb6d02fbc5108d2db784628ec5df6efcaaedd735f9a652cf2a2edae2146792588,t,21000,63000,,5000080,2018-01-30 14:01:56,2
0xcb38dfbcb75bb6865a1110963f9e8adf757d2dabffba1b74d61f6762914f1ce9,t,21000,84000,,5000080,2018-01-30 14:01:56,3
0x3abf9b92aa85e182d24d68253c5e50ffb541736f92d970536afc409634bdc601,t,21000,105000,,5000080,2018-01-30 14:01:56,4
0x26926d53225e2f07f52c9da89b9a949b8f00de35f8f54e1d799d6ad4d9fd9844,t,21000,126000,,5000080,2018-01-30 14:01:56,5
0x7087eae2226d1fbe22641af93e15d6f4ca2d491de460b79489ca25f3b84beefd,t,21000,147000,,5000080,2018-01-30 14:01:56,6
0x9e4ddfdfb5f0668f8d679b1fbba2a99f544501e0a046936447205763e952e95e,t,21000,168000,,5000080,2018-01-30 14:01:56,7
0xdaf84405aae5de269e5a0c7d7ab31e0002ccc06b3cebb82dd845bfd1b6428542,t,21000,189000,,5000080,2018-01-30 14:01:56,8
0xd670504527cfb1c2246ccfcc9b130cfac80d3acbd44c440878880ab2f0132dcd,t,21000,210000,,5000080,2018-01-30 14:01:56,9
0x5ddda8004a57761c2b6807c34ff3343f90617e591c861daa6a0b92d48c6637b0,t,21000,231000,,5000080,2018-01-30 14:01:56,10
0x6df31f83301c8178452ac53c56ce961138406de499b4b78accd4f9a8f7f876b2,t,21000,252000,,5000080,2018-01-30 14:01:56,11
0xce0d7134398b1304760ce4a8830642806973499c1fb0ad50877d469f50928aa2,t,21000,273000,,5000080,2018-01-30 14:01:56,12
0xc48d62e8c2a17f186329e1fd788524d17616648c8906fae6c0c1096700a284dc,t,21000,294000,,5000080,2018-01-30 14:01:56,13
0x02884431250570f0f8877956c0089187ae45cd73350e649daeb1534c6dc24c1e,t,21000,315000,,5000080,2018-01-30 14:01:56,14
0xdab230c184d4b067e6168ea4c4b73ec81a91fad494054b69453ba735b4bcb2ef,t,21000,336000,,5000080,2018-01-30 14:01:56,15
0x32a73a320bfbdea3c0364f18d4776cdbadf7ab082d966b2d678f707cf74566a5,t,21000,357000,,5000080,2018-01-30 14:01:56,16
0x43561cac2359d878f89be9c7cfccf3af8bb3eede333ae117c2d9c5a23840c72b,t,21000,378000,,5000080,2018-01-30 14:01:56,17
0x8fa4221c003bd6ef60c71d39e3f8f0ae65783665d68c22e84e685cad70909f10,t,21000,399000,,5000080,2018-01-30 14:01:56,18
0x29c775e1ea7c6edda8780d12f507f222f5ff766ee338b19b23f712ca166cbfd8,t,21000,420000,,5000080,2018-01-30 14:01:56,19
0xeb4970cf8b79855997e863f59e341e5ad6d3b44e2dc35a1fb10b1ad6e8aabd09,t,21051,441051,,5000080,2018-01-30 14:01:56,20
0x6be4328d3fca344240653f22c052fc26785ac6db76e1c27a040cdf127544e7c1,t,21000,462051,,5000080,2018-01-30 14:01:56,21
0xd3f91d014d2cbffdd99241f7d40a33bfa949826724fbaf6f7e107aa6f06bf2c6,t,21000,483051,,5000080,2018-01-30 14:01:56,22
0x408dcba2200fc27b9ee6d12568604d7c4516c4796c3445a5eda4a6074726bf29,t,21000,504051,,5000080,2018-01-30 14:01:56,23
0x206380a80eec6a2d7d88875f72c42c05fe6eff9db189af56d895cd3a0167148a,t,21000,525051,,5000080,2018-01-30 14:01:56,24
0x62af1014e4c3d99299d60254774e1b27229389b8d88355285084effa64401d92,t,21000,546051,,5000080,2018-01-30 14:01:56,25
0xb0cd86eedbbcf540aaf47ebb051e9b86796c78c987b86540b9c6d494f7253b9b,t,21000,567051,,5000080,2018-01-30 14:01:56,26
0xb1cfc785b119dce097c28833578a1d8d1bac7865cb6618257ed1c66f2f3bdeac,t,21000,588051,,5000080,2018-01-30 14:01:56,27
0x8287f2889de2b07cb440d58dadfc6625d3310481eb43ff15f84b8082b8f1746c,t,21000,609051,,5000080,2018-01-30 14:01:56,28
0xa843db1f6be212e4c1779876dd84b5b511bf281398c0c5ff2f72f39ec64c40e7,t,21000,630051,,5000080,2018-01-30 14:01:56,29
0x587c782c4469652263a159f6f64af2894e0408c68a8a950b4e6a3f2f5d9aea01,t,21000,651051,,5000080,2018-01-30 14:01:56,30
0x2106a92289a1fa7a4e3ff4db8b263bc067d37f86569fcdbbc046f2ceeac213af,t,21000,672051,,5000080,2018-01-30 14:01:56,31
0x47f3f784149af3aee9082c2826c3f4530ac13385e50fdeeb89a4da3cde27983b,t,21000,693051,,5000080,2018-01-30 14:01:56,32
0x84c9f181e1ef3febeea5df7ade30e6736399b005a720e9acbf47e886fcff414a,t,21000,714051,,5000080,2018-01-30 14:01:56,33
0x6e0e8b56ccd7a8916de45a75a70c481005eff0664a4d3bdaed9087a2334ce902,t,21000,735051,,5000080,2018-01-30 14:01:56,34
0x3f7d2204af075a73e12adb20cdacb42b9e4d00aab05a131b45d7c9be89422cf4,t,21000,756051,,5000080,2018-01-30 14:01:56,35
0xba3b37b549af702e8fca100ab84f0187a1543e70a27265c18b5e28cbba8814dd,t,21000,777051,,5000080,2018-01-30 14:01:56,36
0x111a300044f60111c6e56854685944be22d39c0732307e5184ed3d2c856ab8ca,t,21000,798051,,5000080,2018-01-30 14:01:56,37
0xdaccc4f7fc4f3bc7becae618db6e424edeb592840ddd7a12236866478f15eb80,t,21000,819051,,5000080,2018-01-30 14:01:56,38
0xb19525f7a6e9d6623a9ec330167d2e0a2d617618ff481a6277194ca0abc1149b,t,21000,840051,,5000080,2018-01-30 14:01:56,39
0xf21a39fb618f0e011e0172ef5f86871a6f965972ac08b950d16d48e52b82de89,t,21000,861051,,5000080,2018-01-30 14:01:56,40
0x5f7b7f0e39828ed571fceaf52b33383018a0df6f679bc8bb312ddbac6acdd943,t,21000,882051,,5000080,2018-01-30 14:01:56,41
0x8ee42a214c43cb134c23500cf9d7e4a584df858078be889b99062dd2de844c0d,t,21000,903051,,5000080,2018-01-30 14:01:56,42
0xe02d855be80c96d4aab125b78d578bb53d1e6b603f758198e3fa5ea06dc6ff9f,t,21000,924051,,5000080,2018-01-30 14:01:56,43
0x9164a0141588ac4c2eb120a32affc345c0314654a968fa239eea12b29acf43e2,t,21000,945051,,5000080,2018-01-30 14:01:56,44
0x0c94ed909a7f554d00ee69fc09038196a623fdf1e409007dfcd6f48d07b31432,t,21000,966051,,5000080,2018-01-30 14:01:56,45
0x507dc7d2c7ac0f8c9bfe528eac0802b175536625af6ae6d14c07120be50e6de3,t,21000,987051,,5000080,2018-01-30 14:01:56,46
0x801bf7d9cb4b1ea89f5ec867e40aa02c9d70f413db307e0338ac1805b44bb5db,t,21000,1008051,,5000080,2018-01-30 14:01:56,47
0xeb7f03e3a83653781790ba8114c2548a87bcf33ad2d42b09b237c4d8d8697c13,t,21000,1029051,,5000080,2018-01-30 14:01:56,48
0x83954e93e5040438f627201d7b8f7ef80e611b8080365905bf8ca785374a44fb,t,21000,1050051,,5000080,2018-01-30 14:01:56,49
0x3a13b6b89c678cf12609b677969ec54333ccb3408f71fbae1a91a3e7891de827,t,21000,1071051,,5000080,2018-01-30 14:01:56,50
0xa98ed0f2d96f5c9d9164b1bf933191edb3ca3f3d1f9540731e4a0b90cc7ac67d,t,21000,1092051,,5000080,2018-01-30 14:01:56,51
0x932a9b2b446d3171da478bd66dc9827775eb45883cfff5cf25218f06b68d94b9,t,21000,1113051,,5000080,2018-01-30 14:01:56,52
0xcd46aab51d20369f342f42f66e081a1c879775192e37586f70278b948eba9ea5,t,21000,1134051,,5000080,2018-01-30 14:01:56,53
0x629a718c76a72559e2b4f4b6a07466c03c6f110ee29263940b33f5bf7f07db7e,t,21000,1155051,,5000080,2018-01-30 14:01:56,54
0x285aedf18b7af5d761d113cc9fdc9e164efc01cea3e32aef888ea52ccb983414,t,21000,1176051,,5000080,2018-01-30 14:01:56,55
0xf168561727de06e3535f3c7be3151e959732baaced5752419afacc2511167116,t,21000,1197051,,5000080,2018-01-30 14:01:56,56
0x07d7f4dd4339651171bc6fc44de87afa765bc1fdf3d3a688b1ccf82d0e88e2f0,t,21000,1218051,,5000080,2018-01-30 14:01:56,57
0xae061560e4fe039751c5a0c85df009d1e24a7e76e4d3592086a3edb96e4fb3b1,t,21000,1239051,,5000080,2018-01-30 14:01:56,58
0xfbe74a0a50d23b9a69409a89d1d6e6e915fe4c285ff10d70ceb4a6f903422f9d,t,21000,1260051,,5000080,2018-01-30 14:01:56,59
0xf7c028a6ba361878978622d2df54f6de15b5f27eb5a4821f36b11d5d40e3e788,t,21000,1281051,,5000080,2018-01-30 14:01:56,60
0x3567c936ca36f77aab14771127a1ed3aa734d263b092cf23b11d5ddf3b17c589,t,21000,1302051,,5000080,2018-01-30 14:01:56,61
0x3aa7eb9d8ff2e37cea169e8c86e76a51cdc8950b1721771dac1e2359e7e2dbcb,t,21000,1323051,,5000080,2018-01-30 14:01:56,62
0x62c9f35fc75d9a587d5006359366959360d9aba459ce6e9c75a2a6639a5704e1,t,21000,1344051,,5000080,2018-01-30 14:01:56,63
0x2e45805f2d4b830cb2ecc12e8f2495a6c70c7f927f2af88a65396ad5c7329188,t,21000,1365051,,5000080,2018-01-30 14:01:56,64
0x0f3159dfc6c7da8ce5aa6623289485e18f63eb1f9aa49315afdd0cb5c8379650,t,21000,1386051,,5000080,2018-01-30 14:01:56,65
0xf26268ef012fd6d8b076cd9b0618ceb0cc2eba71c971a5468b9eefe7f2bf5654,t,21000,1407051,,5000080,2018-01-30 14:01:56,66
0x8bed54219e1a2a763fd43a5be9d77283cc64ca22dbc118bee93f970b03271681,t,21000,1428051,,5000080,2018-01-30 14:01:56,67
0xa6a9f673426129e7e791a404045526bd563f942abcc648f50051896297fe4c39,t,21000,1449051,,5000080,2018-01-30 14:01:56,68
0x5c495dffa239d05bdbef795a8fe3db8b7d0452dad655d96fb7991032fc767a63,t,21000,1470051,,5000080,2018-01-30 14:01:56,69
0xc92ba7b43c7ebaed7b622713f4aa552a6e7af8c1a5d3a0fe12b25639a4f4700c,t,21000,1491051,,5000080,2018-01-30 14:01:56,70
0x1f3b8186bc96cefac1c5428a17aef4bbaf89d852724751c7f5fec16a97bcae52,t,21000,1512051,,5000080,2018-01-30 14:01:56,71
0x2aaa906c265cd3c2aa96990599544bba338e5deec89b09a1336623143c325e38,t,21000,1533051,,5000080,2018-01-30 14:01:56,72
0x4926352cd0bfd315267d3e99fd093c780e7b76a777729a2eb51dc2ce85e70c07,t,21000,1554051,,5000080,2018-01-30 14:01:56,73
0x2538fbb4d93357c3c6cab07c473791d23d04930c113280f57bf8355542f1f078,t,21000,1575051,,5000080,2018-01-30 14:01:56,74
0xd8be931ab56df3fde9dd5408c885b4fbc6b895b3324cf83b93fe3917c1f539df,t,21000,1596051,,5000080,2018-01-30 14:01:56,75
0xc7b41bc2dc5e9428feb7845c9b197d161a100cb4ea7f2627471e68b980cec3ba,t,55337,1651388,,5000080,2018-01-30 14:01:56,76
0xf5fb559ec0ecf197d03396a2a8f752a8e234073c3e5f0221d2c7a3afdc431200,t,21000,1672388,,5000080,2018-01-30 14:01:56,77
0xc373f22f8024ece9277ffaa66a6a4eb312e2bb45aec234e0f879fa45b041468d,t,21000,1693388,,5000080,2018-01-30 14:01:56,78
0x55f41a0ff55a5764f5506049d67877d2d615928ab4868c5a6279511277e3a544,t,21000,1714388,,5000080,2018-01-30 14:01:56,79
0x3f3617fa979f83970245a661c521dfb8e20247719cc1fa60bfc1b3818293d222,t,21000,1735388,,5000080,2018-01-30 14:01:56,80
0x074f82cc142ab0da8f3f632dcc1d94e7ff7ef0688920ddd502be70298eefd67a,t,21000,1756388,,5000080,2018-01-30 14:01:56,81
0x5334a1e92246fe42e558a2ec0083cca488d3583c021ac96a8b6ee9c95e410eee,t,21000,1777388,,5000080,2018-01-30 14:01:56,82
0xcda465866d8c047e2a888670e66fbbbb46c7ebb9d2b969461b7d755a5612c177,t,21000,1798388,,5000080,2018-01-30 14:01:56,83
0x2d8fd8563588d0ff63d13607600b53f9aae0ff06c761c4f20ac546243a3d5924,t,21051,1819439,,5000080,2018-01-30 14:01:56,84
0x705c2c94f38accaba26b3d2838f7065a16fd68225c0ead6ba87c136c0c014c04,t,21000,1840439,,5000080,2018-01-30 14:01:56,85
0x4e4450e2765565f7954d73ae2ebd16ae3ad7ea6506fdbc021797ed88376384b8,t,21000,1861439,,5000080,2018-01-30 14:01:56,86
0x67e40e987c20bad371cae660d408c91430b379e030c1acbc3c92dadce48b7f3c,t,21000,1882439,,5000080,2018-01-30 14:01:56,87
0xf2cc50ae1a6f1638481f21ef4210e45806c505b57bf353f8e95bc182572663f4,t,21000,1903439,,5000080,2018-01-30 14:01:56,88
0x1defc712619702e8349d7bbbc7089e654e8ff738403ce2e6d45806acbbda83a2,t,21000,1924439,,5000080,2018-01-30 14:01:56,89
0xd36e7891665836d92f0cbcc0cd983613c4c9ef05634588ab3b3fb21b7cc907aa,t,21000,1945439,,5000080,2018-01-30 14:01:56,90
0x756b58e0ef2b560c84228b53318cd53a958f836acf0cbb6be501ce497f787212,t,21000,1966439,,5000080,2018-01-30 14:01:56,91
0x63841a1583ff48dbe1619c77ec0e8780c6d44b4fd48bfab44d4523976943bb62,t,21000,1987439,,5000080,2018-01-30 14:01:56,92
0x3412d2bcf788d446fd7f7618b37d08ebec5d9872b8778b419989a6895dc26590,t,21000,2008439,,5000080,2018-01-30 14:01:56,93
0x59d19d0fac5a3201dbe5422cfe4167d87725bb89577acdd53c85d6e724385f7b,t,21000,2029439,,5000080,2018-01-30 14:01:56,94
0x8ba04cdc8fc84d9c08a5b53ec8ea4a560b943bc25b29fe38c61cf3bfc89bc286,t,21000,2050439,,5000080,2018-01-30 14:01:56,95
0xe51fce2af2639e3516f36d0b6af693ee3a91ec85ec697d079b5f0b6875e3b7c8,t,21000,2071439,,5000080,2018-01-30 14:01:56,96
0x5356afb54aa906d69d3a6c3bc14fd4c3db4b1b13e07d092b89e7ef62a6cc1330,t,21000,2092439,,5000080,2018-01-30 14:01:56,97
0x60855da402eeee5e51f69940b036549c6f29a3f80bfdcbff00c455e78f9cec6a,t,21000,2113439,,5000080,2018-01-30 14:01:56,98
0xa9f1b526264a9d4fdd06503fbb56b5eda1c676d26aeabd737927d1e04879d3aa,t,21000,2134439,,5000080,2018-01-30 14:01:56,99
0x553a1346d150cd64ac59a27916bd586be9787bac99312ff7dee5bf863c30c6d4,t,21000,2155439,,5000080,2018-01-30 14:01:56,100
0x54816e52f6c29042a03db40f41fa2031566521bc64d84db8ff441303d91539b1,t,21051,2176490,,5000080,2018-01-30 14:01:56,101
0x51cded0e82a5695404f6600cdf8a787a51de527736054f3954177cfa5343760c,t,21000,2197490,,5000080,2018-01-30 14:01:56,102
0x2deb6bfe42724b630fc35ce2b34707af0035f96ac655f1922a59ff134616f66b,t,21000,2218490,,5000080,2018-01-30 14:01:56,103
0xdaea96b217d3aadceb96e7f7268c5fd31333bcce7d7d07fffa7753adde54b826,t,21000,2239490,,5000080,2018-01-30 14:01:56,104
0xe1c517f87dca826e24849a44dcda827e44753b7689f76234c0e4428c062b0584,t,21000,2260490,,5000080,2018-01-30 14:01:56,105
0x28eb7a6f6b55f33631a381d5a0c698956ef1c440504cba6a989bfb5393a02e12,t,21000,2281490,,5000080,2018-01-30 14:01:56,106
0xc6416b66628ac1b24aef1bcc0c13335ed6938c308659f2402241dc28ba814f72,t,21000,2302490,,5000080,2018-01-30 14:01:56,107
0x35dd1c535c781baef84acb965ed6cd533442a18a84b79e6a78463bd4f79efb37,t,21000,2323490,,5000080,2018-01-30 14:01:56,108
0x1220fa106ab9c37fe931a640d1687ca9fac12459868ce401e6c9e2dad1e328a2,t,21000,2344490,,5000080,2018-01-30 14:01:56,109
0xea723ff50ec7da63f4401f03ca5f78b6360dc828a1a0ed0eadcb56406e9aad83,t,21000,2365490,,5000080,2018-01-30 14:01:56,110
0xdd3c3004022cd98fe23d39519df273608e1b22f4e24946cb0aaf3d3c1b051de8,t,21000,2386490,,5000080,2018-01-30 14:01:56,111
0xf3acad0a3e4aa946cb3e25a893eb59b6273cdb8ddabbf1fdaca3bc773c20b7d6,t,21000,2407490,,5000080,2018-01-30 14:01:56,112
0x99335dbaf4dcb95762c57c6ecf0544a07ec2be15afcc233994fcd56462892a15,t,21000,2428490,,5000080,2018-01-30 14:01:56,113
0x599ab48a1cb744e0eaf485ad1dc4bc9759abb548774b98f3b958b46f9d07108d,t,21000,2449490,,5000080,2018-01-30 14:01:56,114
0xc0dfe27e33dbe204b2ee71f39568bd6a7945684f0b2ff01063335dd6631618e7,t,21000,2470490,,5000080,2018-01-30 14:01:56,115
0xb8fcc3d76778c500ed580ca2136f0b5686545d06705f3c76b1f3798161d722fc,t,21000,2491490,,5000080,2018-01-30 14:01:56,116
0xc3678b227654a337d57758b9c9d1ae3c77e2f3c68242b32aac17a186365ee932,t,21000,2512490,,5000080,2018-01-30 14:01:56,117
0x081b46f0a8ee0fbb943d35de2191eed564a465288780d4b4719516b7e5c614fc,t,21000,2533490,,5000080,2018-01-30 14:01:56,118
0xfc0b40285a89ff2aa93ebe6b7bd40683a1e522e4e0e869360a5fa40efe1362b1,t,21000,2554490,,5000080,2018-01-30 14:01:56,119
0xa8ed2b3b462060e92966f348a2ceb4551db337d1accd5c8262143e72d73aab8f,t,21000,2575490,,5000080,2018-01-30 14:01:56,120
0x51add990eb8fa3d4e4b5ff44d7f42454b6132ab42836b6e09e0873bd317136fd,t,21000,2596490,,5000080,2018-01-30 14:01:56,121
0xaf60c15268f82867d91f47bc3677feb5abec12d401e92cee2c52c17a6264dafa,t,21000,2617490,,5000080,2018-01-30 14:01:56,122
0x0b430302eb38d185f54e71cafd12bab83538ee518ee34b40261e17de0291c696,t,21000,2638490,,5000080,2018-01-30 14:01:56,123
0xa0de5c078ba7bb71823c5317a9c85669f7fa3ffda402d122dd1ab6a037620516,t,21000,2659490,,5000080,2018-01-30 14:01:56,124
0x3d903ce361c169685dc5da9979a833c3a949a472f2b8b4cf51d2d959c466c654,t,21000,2680490,,5000080,2018-01-30 14:01:56,125
0x0c3eb9ebe273b5e36a79aeceddc5828ec11a4dcf6f3f56509202cc21764a5363,t,21000,2701490,,5000080,2018-01-30 14:01:56,126
0x2aca787aff5f88ec140bba2c6b1683258fab0b47161eb60637548d229d718418,t,21000,2722490,,5000080,2018-01-30 14:01:56,127
0x9d81e6add8b7c7d73b956ed1a7d15d207629162e141f0d4c9845b6de76cacda0,t,21000,2743490,,5000080,2018-01-30 14:01:56,128
0x5d96dc52c45d80f4dd932ff45bafbda9dafe443d95dfdf252b0b01d38a50b447,t,21000,2764490,,5000080,2018-01-30 14:01:56,129
0x7d0fb5440e01f229708f6a7a40360b725b7efc85e2046cc0825a749963762063,t,21000,2785490,,5000080,2018-01-30 14:01:56,130
0x03bb925acc47348becfd4786c6e17517203aeaa51c3b1a593d24c04161530a06,t,21000,2806490,,5000080,2018-01-30 14:01:56,131
0x162d1a6f393c734e22f0b3748a7570098547fa94c4cd8cac1fb5d77c6654e47a,t,21000,2827490,,5000080,2018-01-30 14:01:56,132
0x2ea88e08d05c4892274eabfe5791a3f5a6dae4e0b278b8205100ff44a9a9b7ae,t,21000,2848490,,5000080,2018-01-30 14:01:56,133
0x17d0fda9a967ecc1cbf18d210e0350fd1046da700548d4b77499bdc5bf068b70,t,21000,2869490,,5000080,2018-01-30 14:01:56,134
0xf59bf1c8ad99db7533a976c1f241b7dc9087542ede046f926ed3877b854431e9,t,21000,2890490,,5000080,2018-01-30 14:01:56,135
0x1c1443e01d73a6ed7504b8de2e3964a91a9c8964c4e475704a81a6d099a6f246,t,21000,2911490,,5000080,2018-01-30 14:01:56,136
0x800c285fd2e098f483cd02f980c1fdd5b5da6626d90cc0aee44c46165e04dbe0,t,21000,2932490,,5000080,2018-01-30 14:01:56,137
0x4cf9e62de5454ed6a443625bbafc67a8e3eee44970b6470df15d42ff4ea4e450,t,21000,2953490,,5000080,2018-01-30 14:01:56,138
0x632101826b88e35bc98005d062f3901899945f224d6693b6f06cda640255394e,t,21000,2974490,,5000080,2018-01-30 14:01:56,139
0x72855b64a312f234d0d1eb033902a853564cf80d2fe8b6006d9e424c7b15d437,t,21000,2995490,,5000080,2018-01-30 14:01:56,140
0xe716f85c0c90931f577a7c4e6e50a7b224637d737a56545506d6ccabd4992c58,t,21000,3016490,,5000080,2018-01-30 14:01:56,141
0xd4cf0dc2913ca79892710052da62f5dd40ed5fc80021bc31b7b113be8a3bf1e2,t,21000,3037490,,5000080,2018-01-30 14:01:56,142
0x3ae706ff012aec254f7f4a2f2c10b13a6d69f1db0344f50eca475b498a5a35e2,t,21000,3058490,,5000080,2018-01-30 14:01:56,143
0x69dba8d693df70970da42dfea7ec2339cfe552badd5fc1ebaccfb526371739c4,t,21000,3079490,,5000080,2018-01-30 14:01:56,144
0xfcd684c3d3c69420051f60e89422acbab95728b2c89b4e3901275ba2e56142f5,t,21000,3100490,,5000080,2018-01-30 14:01:56,145
0xf075d3343e3d1f7a3855813ff7a469ecd65d686b385144e0939bbddc6ee8ec90,t,21000,3121490,,5000080,2018-01-30 14:01:56,146
0x1fbb6cd40e39ff1d5e692274fa8bac3ab7777ee030fd24c7c287885ccf69de07,t,21000,3142490,,5000080,2018-01-30 14:01:56,147
0x66f6b8c946f954b49d1daebea2b3a5cf1de08bc387ab21f20d67ca7b569c7075,t,21000,3163490,,5000080,2018-01-30 14:01:56,148
0x2532efc7884b588588dafd9ca08cbc7b1dc29a78076b9f3dfa41613ab8d7f380,t,31005,3194495,,5000080,2018-01-30 14:01:56,149
0xe7e6c5d906fc68ce0b17f8311de8273593e6d28b3b56f1d023acd26f5ea520be,t,21000,3215495,,5000080,2018-01-30 14:01:56,150
0xddab8c1b57bc2a5c17cd4a7c74a0747db28c6a27034bed4b8f0190ec6c24736f,t,21000,3236495,,5000080,2018-01-30 14:01:56,151
0x8b8df1fda3ad89c61d573b187905ceed83fc75ab5d3a24d4687c8ea1755a067e,t,21000,3257495,,5000080,2018-01-30 14:01:56,152
0xbfc037a2122ff96d15135fa79d869241678fce8d786715f0244aaf0828a835b7,t,21000,3278495,,5000080,2018-01-30 14:01:56,153
0x7e2ccfe44cc55122e275bcc234acb039d4e8304443176dd6f408ff0e139bc646,t,52078,3330573,,5000080,2018-01-30 14:01:56,154
0x249bec1a3d274c6dd842c83488384fdc7d56ffbdc363efffa427580962efe24b,t,39835,3370408,,5000080,2018-01-30 14:01:56,155
0x2ef6f21a3410a9659bc93c5e5c34a9725c33a4cb80830dc8c0d7260f46d5ca16,t,21000,3391408,,5000080,2018-01-30 14:01:56,156
0x95c9d8f1bc1847405ee0d70ddcd7d943995df0164f430cfdbbca4ac736def774,t,21000,3412408,,5000080,2018-01-30 14:01:56,157
0xaf1eaf1e5256dada180de33c77c67a14c79a428df24d6583c1fa59c512e86699,t,21000,3433408,,5000080,2018-01-30 14:01:56,158
0xdf13537121a43789571472e087c5094820e60c48f975dab4a9c8de33b280cbf2,t,21000,3454408,,5000080,2018-01-30 14:01:56,159
0x230becc29b7d5e97f05e27e0e49aaeaa3b00797271835c35123ec13610f389e4,t,21000,3475408,,5000080,2018-01-30 14:01:56,160
0x5e54611cb73ef74f8b351ba06e2f965aa399936ebc2c02f9261fc776e1ba6c66,t,21000,3496408,,5000080,2018-01-30 14:01:56,161
0x847ec9949c772b8ccdf0be1a0c918be8b9e3beb9ada30dee5e45e4dbf809b7fc,t,21000,3517408,,5000080,2018-01-30 14:01:56,162
0x40049123c22c693dea8c856e6b77778ebdf49353fa1d04d54fe034ac4d376199,t,21000,3538408,,5000080,2018-01-30 14:01:56,163
0x9261d57e3957b2197fcc6d1b9cd0c94d7e710afdadcb2774b59f9142b49252b9,t,21000,3559408,,5000080,2018-01-30 14:01:56,164
0xe41b124526fe48a500964661e5cec621065fadcc126d8d8b1fad1650c7c39661,t,21000,3580408,,5000080,2018-01-30 14:01:56,165
0xeb78bf57c0ded0ca3ad3310ba00f8ca57343a82bfacc13a824a8581fa7a75ab0,t,21000,3601408,,5000080,2018-01-30 14:01:56,166
0xa56087f7c3f7a419b0f93b83548893b828edbd46f35c93cca34fb1bae6521cb6,t,21000,3622408,,5000080,2018-01-30 14:01:56,167
0x176fc35983ea5e95fcd0cdd2bd48f6941fe6b38399291c8ec3702800b38f5f5a,t,21000,3643408,,5000080,2018-01-30 14:01:56,168
0x1c79528443934092f11cf7f97e4c53279cbf40d8d3c044611e4e36e7d4836182,t,21000,3664408,,5000080,2018-01-30 14:01:56,169
0x88699aead513192cef57fd46aceff77f3025ac6a9342c1d768179c49920119d2,t,37884,3702292,,5000080,2018-01-30 14:01:56,170
0x26209a725062159d2fec41d22186c697cd4797ebbcf3c9ba7881403e240bff8d,t,21000,3723292,,5000080,2018-01-30 14:01:56,171
0x202bec05739e14af837818d7851504c10da6e9d2de120fa8f80b47a6394843b8,t,21000,3744292,,5000080,2018-01-30 14:01:56,172
0xed78fd0a66b818c120508ecb9dc6440a68251aa4c65eb91b939b7b60ede876c7,t,21000,3765292,,5000080,2018-01-30 14:01:56,173
0x34fa73cf5caa05debb1687c8a6c7a47c7d0db99724f61d1ffddee19563ea2101,t,21000,3786292,,5000080,2018-01-30 14:01:56,174
0x24289d104d64f6c2bcd07da8b56e6447efa7c67aad93389161af61d46cbc685c,t,21000,3807292,,5000080,2018-01-30 14:01:56,175
0x7689e534155ff228bb3f3f7bf6ce646714ea18f7dc30ae235b888e597a65fb28,t,21000,3828292,,5000080,2018-01-30 14:01:56,176
0x59b7852e884583da380bd19307044d4833a5d7080fe214aa7494a30e7e06ac6c,t,21000,3849292,,5000080,2018-01-30 14:01:56,177
0xcc40b94c871e55a1ff45823688e29be0525006626d0661a854bc420beef15b16,t,21000,3870292,,5000080,2018-01-30 14:01:56,178
0x8aa03d2306832ba71318040f3b11f99bfd31efa21a3df7855c97942d4252f30a,t,21000,3891292,,5000080,2018-01-30 14:01:56,179
0xf2a0f001121f78dd2130ddd7a389ef0fd8cf4971636ce79c0d94d4da07bd8e97,t,21000,3912292,,5000080,2018-01-30 14:01:56,180
0x4b17dd0d7107f349ef1f349e99b56bc125ce5e28eab8edb0d85da060faa13eb7,t,21000,3933292,,5000080,2018-01-30 14:01:56,181
0x999dd3d7739e02f34c52ccc368e20a627cfe5c3bc47844a5a609b7a3b23896d0,t,21000,3954292,,5000080,2018-01-30 14:01:56,182
0x1b163dcadd72ebf71d8e2ea81e7bda7d2ae0c51272cd714f5046b0bc3bc184f2,t,21000,3975292,,5000080,2018-01-30 14:01:56,183
0x7285d836d891ed7b066ae34199d751a8acabd88b4b6f8726c8bb23347409939f,t,21000,3996292,,5000080,2018-01-30 14:01:56,184
0x5603b12eec111598bdcfa72e19b7357b34cee38b9cf668a2da7207f8a7f40102,t,21000,4017292,,5000080,2018-01-30 14:01:56,185
0x59dce6bc1729825ca6de606b4bce161529ff4e672bda0494219941d4c6d1aa6d,t,21000,4038292,,5000080,2018-01-30 14:01:56,186
0x2b5b4e31e69fc55acc009b9df798c4f88aa2e4f929d52011bac6e13fbe47290b,t,21000,4059292,,5000080,2018-01-30 14:01:56,187
0x4f7c1d5b54ed240162699f25e593410708ac478faeed45afaf1d7cd09f66a5c1,t,21000,4080292,,5000080,2018-01-30 14:01:56,188
0x043d9e44696dabd9181beb96427a8d14079ef6ac9f3d8d585aa6517c559d17a5,t,21000,4101292,,5000080,2018-01-30 14:01:56,189
0xc416f061dd9802f38da7de840cdec31c1d4e83052d540fe8a69316da7d7758a8,t,21000,4122292,,5000080,2018-01-30 14:01:56,190
0x91de7918b57b27fb7c6f3b11691af129f1db4ec7ace7cf33bd548c6eef6d7b84,t,21000,4143292,,5000080,2018-01-30 14:01:56,191
0x0bd61e5bf3ecc84fb267beca6f5d8c31121d3bae058e32889034eb5793e640e3,t,21000,4164292,,5000080,2018-01-30 14:01:56,192
0x3ab17d42ae46e10d9d3007ecebdfe60452a9d16c87e15fafcff02e7dbdf05a74,t,21000,4185292,,5000080,2018-01-30 14:01:56,193
0x750d4415b470fc99948cdb80ac2b974ba0592a09dee8fc7b720d9ca58504dafd,t,21000,4206292,,5000080,2018-01-30 14:01:56,194
0xac68052388c3914012e5582a174bbecfc02e8cb38c1be614768a22b16503bf41,t,37400,4243692,,5000080,2018-01-30 14:01:56,195
0x15713d7bb5f104f1a609188259a5ed33327dcfd74b553991cea5b316983a7e26,t,21000,4264692,,5000080,2018-01-30 14:01:56,196
0x345ab26c8ad8c9e765184e4dacdead8bd768cd1aa3cfc7c6aaaf1a1ea6521b56,t,21000,4285692,,5000080,2018-01-30 14:01:56,197
0xe135c2e5bf5eee58da5a8a35654cbffa0e9b9cf7fb0e63fec36110b1bf8650ec,t,21000,4306692,,5000080,2018-01-30 14:01:56,198
0xbc8082dd9adad503744819f38252d937d056ee39a6747066dcd0bfae33a26ca2,t,21000,4327692,,5000080,2018-01-30 14:01:56,199
0x5e1003d3ea896ff66eaa9bc72ab6a088cbc2a8ce71ec76d743f429fc255cd7af,t,21000,4348692,,5000080,2018-01-30 14:01:56,200
0x1f06491acc5de2b1d972043d341f7c59f6209c5948534cf4891fbcb2251b904b,t,21000,4369692,,5000080,2018-01-30 14:01:56,201
0xa9eff4a6ef9439ef9056d68cced1ef548146bc1df7931c33f5141fa9347e6015,t,21000,4390692,,5000080,2018-01-30 14:01:56,202
0xb04b6d0f16f0b5dcbf0aa816b902bb3aaa2db1d848c15d5b53dd3a3720d6a867,t,24090,4414782,,5000080,2018-01-30 14:01:56,203
0x2b1dafe3268c28cfe22988c6c3918f605f205c27679904818603d385e30fbd50,t,24090,4438872,,5000080,2018-01-30 14:01:56,204
0x6153cce118370102b8768195dccb45a4439439180f6d072299d56e9e697851c7,t,21000,4459872,,5000080,2018-01-30 14:01:56,205
0x0f823b4a1002ce793d38af4f0246b1969a14f145aceff3df872e89630f7464a9,t,21000,4480872,,5000080,2018-01-30 14:01:56,206
0x543bba67292268eb895e8306d26f5c280675b07426ee0d97dcba411445555aee,t,33296,4514168,,5000080,2018-01-30 14:01:56,207
0x1364c96d8dbf73f0f30b9afb4a808cfc7d1abba82a556268816fc56d681fb814,t,21000,4535168,,5000080,2018-01-30 14:01:56,208
0xab7b43de39ac8214366b04eface7f6b4cb297757c8b2f58ffcd4ec221a7e592e,t,33296,4568464,,5000080,2018-01-30 14:01:56,209
0x135e6e527d297877bb40361df0333f916394df0849b66e6acedc13f1a37e3be2,t,33296,4601760,,5000080,2018-01-30 14:01:56,210
0x940bf47bc321c075be4d78f58bbcaeedad26e9b1f7b0968f94e2e07042aba517,t,33296,4635056,,5000080,2018-01-30 14:01:56,211
0x72c821f95df513c7499afe8cd6301fe92bccc36aa506549f3c3bdea817d738de,t,21000,4656056,,5000080,2018-01-30 14:01:56,212
0x6e93799bc59f75c669b230b9773ef61af1855b29c278dae6cbf075a8045edef1,t,37193,4693249,,5000080,2018-01-30 14:01:56,213
0xc99e53603a5864071f69ce2821e000123fb8da57ea35eda71e5e28828688dee9,t,140972,4834221,,5000080,2018-01-30 14:01:56,214
0x41d2171fc8deef2ad1ea3b5cb86601ac7c9e1350e9baa43832219314ec31de3b,t,33296,4867517,,5000080,2018-01-30 14:01:56,215
0xb37af240c1950022b2dbef32a31206d6772395efa47945cdecdef69c10de66ac,t,33296,4900813,,5000080,2018-01-30 14:01:56,216
0x26ff8c7c0cb045ee4212d5d15ce467fab26f81e30a6b9a17afc5b9a3fd1b15cb,t,33296,4934109,,5000080,2018-01-30 14:01:56,217
0x903961d5468b8c3058c2a15c53f363f36574a8b3cd6032ea9f979a5c9f577893,t,21000,4955109,,5000080,2018-01-30 14:01:56,218
0x264026d39386476754704b947389ba05a8494d24827dd1b210777e3c79b30f20,t,21000,4976109,,5000080,2018-01-30 14:01:56,219
0xb3e234a9ab1f127b114c215e2451e8648344f47aeb597290a67b062f90ab62cf,t,33296,5009405,,5000080,2018-01-30 14:01:56,220
0x07c06764e29798b2080edda48d3f835d7074aaa9e70cd84ff55b43f1cc994fa8,t,33296,5042701,,5000080,2018-01-30 14:01:56,221
0xf2c6e15fe0b7ad7d5d45901e1b6e11619a6228d4e3fd89db14ce823868405d2b,t,21000,5063701,,5000080,2018-01-30 14:01:56,222
0x733b34a315712d5f153e874d5a858a5398fe1a0a01e41442912cb70d142538fe,t,33296,5096997,,5000080,2018-01-30 14:01:56,223
0x6b024af2f8fd660b854c68512ab4e14a1759f931ded63d9031bbd7033db4c862,t,33296,5130293,,5000080,2018-01-30 14:01:56,224
0xc7a8de45d3796204c1762878929c581d33b3140fac49d863b58dcc8009a6938e,t,21000,5151293,,5000080,2018-01-30 14:01:56,225
0x9ccff2be5f6fc7fe38c803af8c3862e1b0bd22bfcfaec92933685f89771ec65e,t,33296,5184589,,5000080,2018-01-30 14:01:56,226
0xac89bc29271fe1b3cf7847606a98a32ca0b6cba5da047c1819524d00e2961d47,t,214974,5399563,,5000080,2018-01-30 14:01:56,227
0xf994648c58b121a8f52c8551346278e8bfd240049e9b5551f3f918398b0edb2f,t,33296,5432859,,5000080,2018-01-30 14:01:56,228
0xe90ce97da5205625a6e2e937d69aeb7970b18ed7e4146ed874c8fb9d8d5cdfea,t,33296,5466155,,5000080,2018-01-30 14:01:56,229
0xf75aeafbf053d440db4c3d0f72f096e9fb58325f21818590bb334197830eb489,t,21000,5487155,,5000080,2018-01-30 14:01:56,230
0xe8437432f3bd7624276a9229f7ddd401b53d8a80cf6fb2ac3fc0f14db2075914,t,21000,5508155,,5000080,2018-01-30 14:01:56,231
0x70a198082f057a76f911ff4fca582dc8da7a490f10035510f4fb27c6d8151180,t,33296,5541451,,5000080,2018-01-30 14:01:56,232
0x5489147cd10a5b968505dbc74c2b045edb3200cf946d54bd8c2252efe072ba16,t,33296,5574747,,5000080,2018-01-30 14:01:56,233
0x5008b6fe9dad6092844e970488b90e23f52d0677eda21ceffd1bd753f213eb5c,t,48235,5622982,,5000080,2018-01-30 14:01:56,234
0x46d32550ffe56cd38a62d89d06eadec7fbfcb9191a25144a8a83d201d0d93610,t,21000,5643982,,5000080,2018-01-30 14:01:56,235
0x9e3e83a9395cce67ec39aaa0ccbdeaa1dd3c5a5387db0e49065c801ae8ab21a6,t,52404,5696386,,5000080,2018-01-30 14:01:56,236
0x6e96c84e7c918ab4ff0938d8a17cfa53c13445db1cb4592f6af3e110d78895ca,t,21000,5717386,,5000080,2018-01-30 14:01:56,237
0x7d37b1a62cdab4a5b5c67e32a7368fc4a2adbdf69c32f33392c904a79e7b2633,t,21000,5738386,,5000080,2018-01-30 14:01:56,238
0x90d2a74391672209b6fb4356160c454d317b34c31487eb664bf42419aa9ccbd2,t,21000,5759386,,5000080,2018-01-30 14:01:56,239
0x9be2c3bb9a1423ab0ba181cbbe7f0360d35ee8219584d39044d56d05602de2e0,t,21000,5780386,,5000080,2018-01-30 14:01:56,240
0x2433d6f0d33d00ecace21ddcabc75ee704c628a90588e053e9adfaba66a86aaa,t,297444,6077830,0x2cFD0Cb43D93Ab1674DEef86D6FcacF80902eE42,5000080,2018-01-30 14:01:56,241
0xe2d879dded213b92fc3a2650097a94ec42041ea3ebd05a4d3d024fd581e9b841,t,21000,6098830,,5000080,2018-01-30 14:01:56,242
0x265f2e9d26d25e0f098901ac3daec0a59dad91ac3664a5d49c3c8584cfebd8cf,t,21000,6119830,,5000080,2018-01-30 14:01:56,243
0xd5d685a5532ec1b4d29afdf24c09d639a06bc9ec22e6d842c1093e3847866c76,t,21000,6140830,,5000080,2018-01-30 14:01:56,244
0x2eb689a0bba8909514e83003f0abca6192633101472f71a46c13766ef5875f0d,t,52327,6193157,,5000080,2018-01-30 14:01:56,245
0x1a53399390a6127d6a743e31971de4b563f06a7c4f39bf81848c0c139dff5ab4,t,21000,6214157,,5000080,2018-01-30 14:01:56,246
0x884b1bba6f86d80be9f6dc207587bb087ed1cc68f15b2331a0f92823b7c7d430,t,21000,6235157,,5000080,2018-01-30 14:01:56,247
0x882b8b3399113a63b1f3e778dcdd56b3434571d736d918555660a68a5de2aaf0,t,21000,6256157,,5000080,2018-01-30 14:01:56,248
0xb5fb88af48d09a34911b24b99da23af851bed0d0933921f997288b7309d000b1,t,21000,6277157,,5000080,2018-01-30 14:01:56,249
0x6632a2785b355bd2e6350d05ba98e22c7f34e6c2060d7910dcc64bdd1b73aca9,t,21000,6298157,,5000080,2018-01-30 14:01:56,250
0x2d65ef6d8f44a665bd0c17a189a11249c98275ce0bbe1a8a5b017c1385da6fa7,t,21000,6319157,,5000080,2018-01-30 14:01:56,251
0x632ddf2c604a14563d277f1df5c3293332047ec232fa72da8baa11991380c207,t,29493,6348650,,5000080,2018-01-30 14:01:56,252
0x1c359463b7f6dfe823f59ecb3a1930d5b1a0f37ce022973a100ef6cd862bdf7b,t,21000,6369650,,5000080,2018-01-30 14:01:56,253
0xd779ee47725d20ddf9f6288c20f6f8bca78d34afdbd99870c98b45ff5d4a1d37,t,21000,6390650,,5000080,2018-01-30 14:01:56,254
0xd2381f1fc93a9b85f6b7fdefc86bf4e89dc0fcd8fbfb47c7549f83d09895048b,t,21000,6411650,,5000080,2018-01-30 14:01:56,255
0xcd47354fd69f5ef3a0cd926a7e0b20030e04159e0218961b18268c0d4e13b4eb,t,21000,6432650,,5000080,2018-01-30 14:01:56,256
0x056872abc2ecb96b175613cb9fd4c6ad96134c6df4898b71a3c9c929cdae5316,t,21000,6453650,,5000080,2018-01-30 14:01:56,257
0xc51202611cee5c37f9f04a3c28d13a14be09cfcf5857410107f7c8e3f380d4e9,t,21000,6474650,,5000080,2018-01-30 14:01:56,258
0x5e00a19223ce66612524fdf1f51b2f4e4cec3c656a482ea9859099074e469b1a,t,21000,6495650,,5000080,2018-01-30 14:01:56,259
0x232e31cf4e658e2fafc996bd357a12f76e913b592c4596e04ea106f2f8fa9e72,t,21000,6516650,,5000080,2018-01-30 14:01:56,260
0x40ebabf903b6ac33604b24042e50b27e485cf2afb1a35ec08cda1b81daec4098,t,64725,6581375,,5000080,2018-01-30 14:01:56,261
0x5385da91a60a3706a168a567d1e00011dd224d3cd04ca0701ad44ff5cb7d71ed,t,21000,6602375,,5000080,2018-01-30 14:01:56,262
0x1f2377be50cdfb5e7dd27c6db19abfe214cd43037151584c89a8307d6f86fcd9,t,39075,6641450,,5000080,2018-01-30 14:01:56,263
0x512224de8cf6443bb5ec1c6cf3a95943dcb720f1f41995130e0d1febb64f570b,t,21000,6662450,,5000080,2018-01-30 14:01:56,264
0xc643a1386c0fd0eb0c1105cfddbf054bb437b60626bdd54a4cc6b3076a77f1c0,t,21000,6683450,,5000080,2018-01-30 14:01:56,265
0x25b07029091db36274eca5b40ea490dc9edc435b941f8ce614a7327fc1d13afc,t,21000,6704450,,5000080,2018-01-30 14:01:56,266
0xe69956da677123dab1b3604fbb3f594c82cf4e6f4b9c7e32126aafd04673d0ae,t,48122,6752572,,5000080,2018-01-30 14:01:56,267
0x86ac10a5d7684f54b450b295f64a70ea60264973f66e2b96773159e0021bcd0d,t,63122,6815694,,5000080,2018-01-30 14:01:56,268
0x616351499d1138307e648edee88a14ae7d7c1410c4983043b766c0363afed66b,t,48122,6863816,,5000080,2018-01-30 14:01:56,269
0x983de5cda76cfae0337efe95ecff300aa4613f3752fe5799868165d172d309f7,t,63122,6926938,,5000080,2018-01-30 14:01:56,270
0xc92f5ac1b0173c206066cbf7be69f75ae9b4447bfb7fbc6fa2e47f811a3449b4,t,63122,6990060,,5000080,2018-01-30 14:01:56,271
0x52b61379997ec6174f993a277168993f69d9c8ec5b05b1fde9abf17153f2c76d,t,63058,7053118,,5000080,2018-01-30 14:01:56,272
0x057e80ca4fd49fb08d3eb6d4dca4f1108ea600c9db1c896ae358558f235b4787,t,37084,7090202,,5000080,2018-01-30 14:01:56,273
0xb4887a788555a6d5ddf96456adfed9bfdfa62fa26793393aa2ccf7689d2338e1,t,21000,7111202,,5000080,2018-01-30 14:01:56,274
0x2b0bdc6258685bc67baa8c1c2cc374a4685abadbda94074fae648e65b0c726aa,t,30876,7142078,,5000080,2018-01-30 14:01:56,275
0xdb3f586d2f5d6cfaff51da797b3c00d8afa80ad895c72836b715a9cc702a9c37,t,21000,7163078,,5000080,2018-01-30 14:01:56,276
0xf648b9012fd9ddbb51fd23c76f0eb6f34a39c8636e0ebccd8dea158a65980a70,t,38318,7201396,,5000080,2018-01-30 14:01:56,277
0x60837bdcfeb12c3f0199591696b94d7ccfcac584708f657fe04df165f33786ee,t,21000,7222396,,5000080,2018-01-30 14:01:56,278
0x6a3fa1b632f8ef2e91e71876a9684052288f75491858f9121f65b5106fce7a96,t,38318,7260714,,5000080,2018-01-30 14:01:56,279
0x3dc7f716b0dec8374b63f0fa63b689aebb8d74bdc5035e3bb58c654934852372,t,21000,7281714,,5000080,2018-01-30 14:01:56,280
0x3f65bdeff037c2e50b52cc774f61eb4669d89858dce7e1c15e7dbbf755ba9527,t,38382,7320096,,5000080,2018-01-30 14:01:56,281
0x130e88b85bd31debfdf54b2a12c1ca21dc1da2e4bb4082c793e0142d89db3f26,t,21000,7341096,,5000080,2018-01-30 14:01:56,282
0x151bd95a1ffad6573c47ecfdffb0c399d0ae41f55830ebf7101ae9d9c03c791d,t,21000,7362096,,5000080,2018-01-30 14:01:56,283
0x62b361a22ff9532a8993de568a3deefa1f6882c81aee41ef6b132bea8ed3259e,t,21000,7383096,,5000080,2018-01-30 14:01:56,284
0x87806eb4b9c4da8d93cda6e5a59eb08d5f6c18ac5e2b6122bc78ba1e8eb23834,t,38318,7421414,,5000080,2018-01-30 14:01:56,285
0x6dde6075c05d080d26f0f0f6170a6229a53652314c5301c0e8ba36eb74e6cd72,t,21000,7442414,,5000080,2018-01-30 14:01:56,286
0x30eca9a5a371bf13dd3972cf8daf8942117248df97e6d7da5f0f7fece959e3ce,t,21000,7463414,,5000080,2018-01-30 14:01:56,287
0xe5fa663caa74317c6cb141da67e137a2236a31a883a07865783bc8ce51a35f88,t,21000,7484414,,5000080,2018-01-30 14:01:56,288
0xa4d6f05621261beae998e65a2cd8ad82c1a58c23172e62bcf64f61bc23c6de74,t,21000,7505414,,5000080,2018-01-30 14:01:56,289
0x40159146827266bee2cec2d2c4c06ed4c36901dbd581ff41d5b2f90ea0eb6007,t,21000,7526414,,5000080,2018-01-30 14:01:56,290
0x86018b02d5c5ec5b6ea9f3805a07fdbc63cd9815a5cde1230a6e0d5331e4648e,t,52391,7578805,,5000080,2018-01-30 14:01:56,291
0x8082037e999bd351fd2f6e11197dfa1179abffb2cdcccb0a4a951ffc4f095163,t,21000,7599805,,5000080,2018-01-30 14:01:56,292
0xbe8f7ec81736f1f4bc190a567e18e61c5547ba86192bcaf12e194131d5ea8805,t,38318,7638123,,5000080,2018-01-30 14:01:56,293
0x523baaaf9badc8dea155d584079fd174fdddaa8f04a9b2e6ef34823beb2c43e5,t,21000,7659123,,5000080,2018-01-30 14:01:56,294
0x312942516ba8dbe10951bc28f2e82f91b6a0d9744c3e3c85a882ee8870064c89,t,21000,7680123,,5000080,2018-01-30 14:01:56,295
0x1f9df79a2210452fd28d6c18f48c03193bc42965e1e351af755e2c3589dc63de,t,21000,7701123,,5000080,2018-01-30 14:01:56,296
0xbf070f33bce300954cd8b1126f9e83221a7378cb4f21667f9632d6fc4256a9f8,t,21000,7722123,,5000080,2018-01-30 14:01:56,297
0xac888f8a457fbf50efd3317e7481a63956adb188f824e82b69340d9ba8669acf,t,21000,7743123,,5000080,2018-01-30 14:01:56,298
0xf4c120004345fa77b96d9e19f9e012e49d156e672f9106eafb5d13f3cd163a3b,t,38318,7781441,,5000080,2018-01-30 14:01:56,299
0xfdb79f15a2305b0e98aced6ffcb516ec89517ba0a03eaccb99f04367f247e460,t,21004,7802445,,5000080,2018-01-30 14:01:56,300
0x32b9793ec5ab089d989261283dc6f5c594fe5506521948b585da76975509f922,t,21952,7824397,,5000080,2018-01-30 14:01:56,301
0x0042ca7f416bf1e6a03d5fbef5d4e2453a39c54b9a164a2ac499576f9efab4f2,t,46096,7870493,,5000080,2018-01-30 14:01:56,302
0xacafe6527ac28565adece306905354dbfae8178f240899829799660989edbfec,t,21000,7891493,,5000080,2018-01-30 14:01:56,303
0x3f2fa2b2d49d2462b1741fbf919031277465ddf5340ce9cb489e34f6c35fb538,t,29372,7920865,,5000080,2018-01-30 14:01:56,304
0x25614ebe771261549861d4269e4460ef1ac145d2d09831b0da32099ec4aca1f2,t,21000,7941865,,5000080,2018-01-30 14:01:56,305
0x4e3f29268e84a1c78590ecb3d795c568994e216f14a4b2677a622381f1a12ae4,t,21000,7962865,,5000080,2018-01-30 14:01:56,306
0x6683f928e7d09123f794f0b8d94f515031acbdd2af4fd66247b9ec0c6c6ac968,t,21000,7983865,,5000080,2018-01-30 14:01:56,307
0x257e4e233ba598f4da37146aeabf1abbd77cebaf8fbdd5c4cce26b69b07c5c63,t,143081,143081,,5000081,2018-01-30 14:02:02,0
0x996d7faa02e46e5cfe0db03154031c7101fbe5cf96790d4b64526f6062c2cfcc,t,21000,164081,,5000081,2018-01-30 14:02:02,1
0xc6246a36efd58c72aef6132a031b46907898bf6a1e9a24be50d0883793114f98,t,21000,185081,,5000081,2018-01-30 14:02:02,2
0xaa6cba57ba9a18357341feee360921301438bb9057d411641b8b281b3ce0ee96,t,21000,206081,,5000081,2018-01-30 14:02:02,3
0xa65c5c09fb40db30b08ec2f922c8c01bebbf366c6e3848c47d0a9d6318a60e2d,t,21000,227081,,5000081,2018-01-30 14:02:02,4
0x442ce2909f0789a59b8b116559faac3ec8fb9d931c039fea38cb0a1e77ce4ae6,t,21000,248081,,5000081,2018-01-30 14:02:02,5
0x8cc42c00521a670dcab884540bdd0ca8ef129cb8fcf678c9f865e606a46ca240,t,21000,269081,,5000081,2018-01-30 14:02:02,6
0x200eca804849050088c0f6083a3e14807030127326b83c511e53867ce3c8457e,t,21000,290081,,5000081,2018-01-30 14:02:02,7
0xf4bf87caf7a3f7264843e73f28828aec75f7c01d724743449080a921a3b19e9f,t,21000,311081,,5000081,2018-01-30 14:02:02,8
0x3f0db9bca7fe7cc2f191929b5849b640bd8d70c25781e001caff9a061bfe0c23,t,21000,332081,,5000081,2018-01-30 14:02:02,9
0xea5c2ecb29c059344488123f5847329edbde986ac39a30c4a5f644b8b709e127,t,33296,365377,,5000081,2018-01-30 14:02:02,10
0xebe01078b167e6a03e7eb64a80b6c56e09c5b52efce46bf06e2af96d8ddbd849,t,21000,386377,,5000081,2018-01-30 14:02:02,11
0x8a7a3deeaba077d04d955dac7b31cd445326d6c916b226e12d5b5001a9c71c77,t,21000,407377,,5000081,2018-01-30 14:02:02,12
0x3ecf3ad8abe7024640c758289f80cdf021121dadf95706eb793757f91dcd1c89,t,21000,428377,,5000081,2018-01-30 14:02:02,13
0x66cc0db0b3a1a20d9e2059175e112ff8ec51e970a1341480a5070774eb6c4fe3,t,21000,449377,,5000081,2018-01-30 14:02:02,14
0x676bd4e35d9429e2563834f092228080f0c71d580175dbfa0f01103153ec22e8,t,31257,480634,,5000081,2018-01-30 14:02:02,15
0x1c10672e8e13aefcd4f78e8e36d042e09d33e0f5d51802bcf3b2a4d60dd9ef85,t,21000,501634,,5000081,2018-01-30 14:02:02,16
0xd3473f8bf3827b01fd7637ed743a92cee51cd964fa9cf58ef8d4056433d68051,t,21000,522634,,5000081,2018-01-30 14:02:02,17
0xe7e8b77e14ce99387b46614e184231c6aa2fe48b86f118ebd3da2cb92c9ef809,t,21000,543634,,5000081,2018-01-30 14:02:02,18
0x530427329f068bcbf0bac20b2ae0d6f44945eef526a87d9a20e2c0991cce9785,t,21000,564634,,5000081,2018-01-30 14:02:02,19
0x5db89ef2c12bcb2edd61c39cb89ebeb1b8023250b2ed5b868dd842b6889b390f,t,21000,585634,,5000081,2018-01-30 14:02:02,20
0x6a344688e53a2cea3b806b26facb43ddb7da9c9232b0d798f2a999efc7477a43,t,21000,606634,,5000081,2018-01-30 14:02:02,21
0x3482d03e152a35997c562391b9db123c25e807e637de300bb42937bb2a1c59ad,t,21000,627634,,5000081,2018-01-30 14:02:02,22
0xf92e27154d7014cef7482b74a5f69737b230c126b1ec89bea1b159bfb61efdf6,t,21000,648634,,5000081,2018-01-30 14:02:02,23
0xc80a92ec1196eb78ca7d3fb41ffdc1d21bf7485c0e1dfb08195203a9336b1a35,t,52616,701250,,5000081,2018-01-30 14:02:02,24
0x27b78391e1852503e8e9559666abcada3ef02262d8dd68d596489e6b87b97023,t,102934,804184,,5000081,2018-01-30 14:02:02,25
0xb0ddc3cd5f9cb12e9d476306ffafe8ce17753362b900d9b173ce162bfbbcf839,t,21000,825184,,5000081,2018-01-30 14:02:02,26
0xd5d433bae982822d6a0835a38d11b1cb072e38f3aea082ef0d34d302c54e65ea,t,21000,846184,,5000081,2018-01-30 14:02:02,27
0x6c1ec2a926e6541e70f8ec0a24bd9961785ecaa2025f2057100aa6faeeb8b612,t,29180,875364,,5000081,2018-01-30 14:02:02,28
0xa99d74ec5561f134452b9b606b65c37f7e3643d9458d98526f8da1b5c86ac2da,t,65010,940374,,5000081,2018-01-30 14:02:02,29
0xecab3ac29b457c4ca07f4e4853a1c56e8c97d4ed4ae76d80515ba8174e04ae0c,t,22106,962480,,5000081,2018-01-30 14:02:02,30
0xf167ece26316a24c78709d0f1b0b63bd689326481045097171bc4ae6ae4f653d,t,37683,1000163,,5000081,2018-01-30 14:02:02,31
0xe4e8c3e11b4139baaad2e71440fc0bb57c4fc8835044deeb6c2ecc5982319003,t,91858,1092021,,5000081,2018-01-30 14:02:02,32
0x5a2499cbb4cf4c66d3aac1c0f855a8109361cf405c9810653f3d520d9a81c594,t,71137,1163158,,5000081,2018-01-30 14:02:02,33
0x1616c773052e3a60d3c44780b9c15193f18f502a3af3d045d483a5405a28af2e,t,71137,1234295,,5000081,2018-01-30 14:02:02,34
0xf19ec8a2e0b3a940949bf6b8e5e46c58ea5b89f615c4b1da8ae92aa1adffa5e1,t,37619,1271914,,5000081,2018-01-30 14:02:02,35
0x789cab575bfa881e1a8d5cc45daafb82caad1f356a402476816c1d5db84a170a,t,37683,1309597,,5000081,2018-01-30 14:02:02,36
0x47e1098287e46c8952ece7c6628d3ba720bbca37f2fc63e635a9729682e4bb99,t,71137,1380734,,5000081,2018-01-30 14:02:02,37
0xcc71b24743f3c747eea18b9bd18361727eff19b9fa8803cfce5db2c7b4e7527a,t,38233,1418967,,5000081,2018-01-30 14:02:02,38
0xc4017d4f96ae4ccbf53833c6f39000f2ae1ba056cbd90800c0ff70e75be3fe6f,t,38233,1457200,,5000081,2018-01-30 14:02:02,39
0xdae8330c42d23ac04a4be079c20e713fc8c9e8c69ad202be49e4c77aa29c47e7,t,21000,1478200,,5000081,2018-01-30 14:02:02,40
0x0ae16bff08da498d09fcc44d6fce40e852b726297507258cce3c9f2fe134a8a2,t,21000,1499200,,5000081,2018-01-30 14:02:02,41
0x8777b7d4802e41e2568985340bc1c2d773af567834742858dfbfb4a838fd8ebb,t,40843,1540043,,5000081,2018-01-30 14:02:02,42
0x19aba2ff94a596f124a56c6a34a1be02eaaa02ba3a9004704e32403bb995a800,t,21000,1561043,,5000081,2018-01-30 14:02:02,43
0x69e8b92fb3c7c640fa6473a50fa875cbb99af1db76c9487049738acee45278bf,t,21000,1582043,,5000081,2018-01-30 14:02:02,44
0x431ed5b744a06cf4d8d52c89f16be1c484cbb9b35f6ec415b7df632241f01a7f,t,21000,1603043,,5000081,2018-01-30 14:02:02,45
0x4c564d636cf8224c8aa14a12c07aad2fc22e9ae5306125f2dd7d6fc52ce13cca,t,21000,1624043,,5000081,2018-01-30 14:02:02,46
0x0ff9ddf2ba669726a4e10be439115429b08e87f44630ab622bb8de6c20ec5c39,t,21000,1645043,,5000081,2018-01-30 14:02:02,47
0xd6333abc0e3be97a019d29750f2773fe430b25c57b9512e8107cd36c767916a5,t,21000,1666043,,5000081,2018-01-30 14:02:02,48
0xee04d0d1e4f79bda678394e76708419cb52603c82199146584d49a39ee4c2b88,t,21000,1687043,,5000081,2018-01-30 14:02:02,49
0x85d56fb78aa69fce8935dbbd5b1196b55b0b44b0b560f3e0929268e750fc8161,t,54760,1741803,,5000081,2018-01-30 14:02:02,50
0xe1e7565cde5f41f64e15cf8516adc269d2dd0feb19e43d5efc3c43f0d7eb46b5,t,127836,1869639,,5000081,2018-01-30 14:02:02,51
0xa50f070a06fec7db5886d032f9bb5c9f58947c0c9a60cd1bbe40610d0f1e95ed,t,21000,1890639,,5000081,2018-01-30 14:02:02,52
0x3bb4f9ab6c1b3f4f7a1a19fcf841eb1550c2af3aa8b0704f9e96b99198ca86d6,t,87734,1978373,,5000081,2018-01-30 14:02:02,53
0x4d384b327bfab9d5c1176aa86fbc0ee6b77cdb12706b4bd664539134daaf9c92,t,21000,1999373,,5000081,2018-01-30 14:02:02,54
0x5e8fb6877f9d5e7fbc60cd7e646f387861413dfbebe4af4643f76476d9b72952,t,618872,2618245,,5000081,2018-01-30 14:02:02,55
0xd36c7bb89e13a7c9f276b13ab16cf2ea06fc3a3e4fefc983ed351999e59042cf,t,21000,2639245,,5000081,2018-01-30 14:02:02,56
0x4b6c65b07ee0d1ee0e33c3b1d4b004cb6afe0d6daefe42ec113e9b56a92024f6,t,66525,2705770,,5000081,2018-01-30 14:02:02,57
0x4f002de3a5027755fec73bbc8fcb3e56a6486c7a3a31eb7e7fbc7c18e2c83218,t,21000,2726770,,5000081,2018-01-30 14:02:02,58
0xfbc2aa1de7b58df1193d053a12edca5ca45ed0d809749d99970dc2d392d073ed,t,21000,2747770,,5000081,2018-01-30 14:02:02,59
0xf88731f71b6ecbe50fdeba15ac2b0e09861b419b5de027e99dda7a1bddcf0a61,t,23419,2771189,,5000081,2018-01-30 14:02:02,60
0x46a3dbaddd8f13c6f84eeeab11cb82cd605a77fb8ca3dc54389ea31709a3f86e,t,51545,2822734,,5000081,2018-01-30 14:02:02,61
0x66df42f0a11cae42e469024e09de8dece946fa1631826d0cf306ea6b69419def,t,21000,2843734,,5000081,2018-01-30 14:02:02,62
0x7e98888cf08c8740c9db9f365024d7a705f4b516e31e831104ab60ef29887c48,t,21000,2864734,,5000081,2018-01-30 14:02:02,63
0x0fff10ad2494763857845ab0bb05a7628072cf0676c5729e2c6ee42e7cf0204b,t,21000,2885734,,5000081,2018-01-30 14:02:02,64
0xf95f8df9139d3754e486138510d16f005ab2e0117580b130429a4e67837d3e1d,t,21000,2906734,,5000081,2018-01-30 14:02:02,65
0x38527922baf3e5f43107ab4f851126b3db9ae03d1a81511186b1ba24ebab7ef6,t,21000,2927734,,5000081,2018-01-30 14:02:02,66
0x389e963ee8c3864e4690b46b516f6bd2e159ad86262a88fe7191931307fffb34,t,21000,2948734,,5000081,2018-01-30 14:02:02,67
0xea6e7a26e965fce90f3d250d095960a3d2b9ac26c8973cbac518ab5dfdcf58f8,t,21000,2969734,,5000081,2018-01-30 14:02:02,68
0xe602d5c89a6cf5e32d35f67440a901ef07c5f5ab1004411387b0e96368c31443,t,36885,3006619,,5000081,2018-01-30 14:02:02,69
0x9ec4d3b7d8dab24f263cf2a99d8fc5324fb2b372b7d7bac2620de0bcd0b4cf3a,t,21000,3027619,,5000081,2018-01-30 14:02:02,70
0xd40710f4338aecd6ca04b1446c55cd3a8d208f823219ea8790a081cbba272588,t,52886,3080505,,5000081,2018-01-30 14:02:02,71
0xe31d33e06c7af62f6f2d290dd912f8259ac5a91a2d6c89741a60dab3626ba81d,t,52886,3133391,,5000081,2018-01-30 14:02:02,72
0xe93d183928e4b1e395610977943364a41cbb27e01d927868e5ff1c7cc82b1277,t,52886,3186277,,5000081,2018-01-30 14:02:02,73
0xa2e08f992ef2647620bbbd5782e0f0d1ee12392f04390224a778190c901e34b9,t,52886,3239163,,5000081,2018-01-30 14:02:02,74
0xb7cd5db0df13ff68f314e1ffe740c421b152f901da0040c93629220daf4e1370,t,52822,3291985,,5000081,2018-01-30 14:02:02,75
0xe8a5c74415272ed3a0d5d48ad017c436bba8cfaf2cd9192c3f2c4cd1e20242e0,t,52886,3344871,,5000081,2018-01-30 14:02:02,76
0x8448e46f79d7061df68f56f31f0af8bdc179923b4fce103b6325f69eec0f4581,t,52886,3397757,,5000081,2018-01-30 14:02:02,77
0xecd304953c3b7c78a1f14f8f989a22313b29c62eda9728c30bffcae1e712903d,t,52886,3450643,,5000081,2018-01-30 14:02:02,78
0xa0e23c7305fb400a89ec539110ed767e7c66f50fa6b522c96b3c2e6c8a0fad6f,t,52886,3503529,,5000081,2018-01-30 14:02:02,79
0x401ebb7e6ed4ce125f4df388b395c4e01ca5eea6fab81303ecbb5ec4344adf92,t,52886,3556415,,5000081,2018-01-30 14:02:02,80
0xdf03245f01e1dfb4cb8ee86dba801a935a904fa974d005c4e78dcf4eb96416c8,t,52886,3609301,,5000081,2018-01-30 14:02:02,81
0xddf8f06b60fd6576bb6da8ed2f37a4a3ff43dd18d5a14e5cb700992548cffd4f,t,52886,3662187,,5000081,2018-01-30 14:02:02,82
0x662c5d602666092608bc4c3342aa4f181962634a82e7ca984a5c86594ae43316,t,52886,3715073,,5000081,2018-01-30 14:02:02,83
0x6b23a340e64ebceeeda9837c01c323f3dc8233ec1ef559c539113fdba9bc0274,t,52886,3767959,,5000081,2018-01-30 14:02:02,84
0x8e2819fab251fdb06c124de08f5b49e7865ea67808230f0a63a0cea96f0feba8,t,52886,3820845,,5000081,2018-01-30 14:02:02,85
0xe8456d76fe93c714cb2b9d9f7a0fa3ecceb5c39dc3e03d8281802051331a25a5,t,52886,3873731,,5000081,2018-01-30 14:02:02,86
0xea1e0e517d07b6572ae66065e9b7dd2cfcfd5b8a801f5faf1129ce623b3e86a2,t,52886,3926617,,5000081,2018-01-30 14:02:02,87
0x3934b46db5b69f8a1b5d599cf67c4cc1cb23af8c7f0164aae8ce6ec45f02a6ee,t,52822,3979439,,5000081,2018-01-30 14:02:02,88
0xef276c27f4a23445b7084f3d7f118f05764f6d1a31e5c3ffd26ae841a69405d2,t,52886,4032325,,5000081,2018-01-30 14:02:02,89
0x29cabd1a81f1c80b201be6f28b7528128f98c9e5ca0488483cd676f48121a97b,t,52886,4085211,,5000081,2018-01-30 14:02:02,90
0xf63b4faefc82b7c69d4cae35b73f27d7e003c6a8a75f20a7d19253d8340a42aa,t,52822,4138033,,5000081,2018-01-30 14:02:02,91
0xa86bf3d29b90fc5bb6931274d2099c6a03a7819506d4e6e7a75a2f5d130bd1ee,t,52886,4190919,,5000081,2018-01-30 14:02:02,92
0x87e92d9ef273f1d5414f01009bc15af9c824836dcc9542c625f1243853a5799f,t,52886,4243805,,5000081,2018-01-30 14:02:02,93
0x02692e94a26017b5fb1a764c3188e01a7ba3d2acb4b44524b8cee2a1fcc6827d,t,52758,4296563,,5000081,2018-01-30 14:02:02,94
0x33a4843879b6e9b57d672ac1e0117012d822e91e297b43c70215b09e71860a23,t,52886,4349449,,5000081,2018-01-30 14:02:02,95
0xcd8d454423d13b5d42717db7d656ceb90aa4c2e09b8753ce4c41ca9329b345fc,t,52886,4402335,,5000081,2018-01-30 14:02:02,96
0x1b4a63e0f7adf343db139a9275b0dfa77e028b08b5cda173e985028c8ac43ff6,t,52886,4455221,,5000081,2018-01-30 14:02:02,97
0x117b263470933c9aae82790dd2e5e27271b9e1d8b199bc169667f52b79f77211,t,52886,4508107,,5000081,2018-01-30 14:02:02,98
0x605b2ddcf5644ff9e750b9825ecbc4476233246139e7bc9522a4bdba85b8a1cc,t,52886,4560993,,5000081,2018-01-30 14:02:02,99
0x24a208aa9b2c1a20bb6836c69e1ed37924766ecb0f572ecc31d5c7dbb2409c64,t,52886,4613879,,5000081,2018-01-30 14:02:02,100
0xd070cbf3a14eb232c43197c90d65104d4094dd89a33e99cba5afc58db7cd8113,t,52886,4666765,,5000081,2018-01-30 14:02:02,101
0x8f65bee0e91d740097988bd40696a46eaf335138d3d9d1f534937b890f87d39d,t,52886,4719651,,5000081,2018-01-30 14:02:02,102
0x89f723a04ed082741681d775bb66d3e85155746e4df679e3be0a888aaaca9378,t,52886,4772537,,5000081,2018-01-30 14:02:02,103
0x814762ffdedd6bb83fe2e64b2c0a83247b2f84bd9e4aeeb6d76717a351261076,t,52886,4825423,,5000081,2018-01-30 14:02:02,104
0x04f7c8ff0497a0f9aab4bff4e74977564f3c18dcaefebbd656218dc78d7fdb82,t,37886,4863309,,5000081,2018-01-30 14:02:02,105
0x3aacd1bd751ee837d573e9f62eb782ebfbaf6f03895594530f37a7dc191fe0d3,t,52886,4916195,,5000081,2018-01-30 14:02:02,106
0xf20e2fc5b483c8b492cb04f22785dbae0e09fe4b191b9eecc74514c11e096950,t,52886,4969081,,5000081,2018-01-30 14:02:02,107
0x091f51f674ab71d6c11cde221d89ae763ffd54a62f8f5fce3953887be4e196dc,t,52886,5021967,,5000081,2018-01-30 14:02:02,108
0xe71f4af84f0f21d0ae5ea4f363d590fc4dfaf2f58503b7c1dd84f822a14266ab,t,52886,5074853,,5000081,2018-01-30 14:02:02,109
0x7a064c54ece6ee7f50b741d3360f9384310edf40cd533ed1d4fd6188eb472321,t,52886,5127739,,5000081,2018-01-30 14:02:02,110
0x83bb9df593208cacdcf5f3c9648d923ae01df321b82bd4bbc733df3c55224636,t,52886,5180625,,5000081,2018-01-30 14:02:02,111
0x8f7c89d35da6c95e9ce3fd0998b930a4154877f60196cf5ad1e213766ec09b17,t,52886,5233511,,5000081,2018-01-30 14:02:02,112
0x7b67e04cb17e1093ae772adab621e47699bfd3e534feb910f08e499fcddb6fe3,t,52886,5286397,,5000081,2018-01-30 14:02:02,113
0x56b28cbec4087c312309a4d7f0721cf9c583f73e7ddf5933a6dd27aa9a50a7b9,t,52886,5339283,,5000081,2018-01-30 14:02:02,114
0xebcafe107ea7400400ef6af62bcf38041b0743543fed8de8000ade90f3e48611,t,52886,5392169,,5000081,2018-01-30 14:02:02,115
0xb4e7cfa1ff2828701e0cacfd638ebe6b46ad9d4927a9ca487141c7375379e151,t,52886,5445055,,5000081,2018-01-30 14:02:02,116
0x855166614eccf5cf3754e11089096853146660b2689928a1ff9684e34e8f8e55,t,52886,5497941,,5000081,2018-01-30 14:02:02,117
0x2ee4857eeeb2e21b1d4b55fbd365d75f7e273c573665746495a684d8d7445e42,t,52886,5550827,,5000081,2018-01-30 14:02:02,118
0x007402237b40035aff838c068e3aeb1e1a406c3e3acb047565975abeb145d127,t,52822,5603649,,5000081,2018-01-30 14:02:02,119
0xfa6b06b9fd061dd2eb456962cf9663e0d680de0f3fe1fdbc5d084a9b8717d2e3,t,52886,5656535,,5000081,2018-01-30 14:02:02,120
0x5a280309430e8441cd311b7fe9e0177f2d3b4815460c3957d98240cd1e26a739,t,52886,5709421,,5000081,2018-01-30 14:02:02,121
0xf2d613cfbb6d6396ad60e5acc6cba1c4a3cb88a401763b7b4d72b2816a592fba,t,52886,5762307,,5000081,2018-01-30 14:02:02,122
0xa082136a2becfc0632252f7be6d3db6608c097702b1641a042cdd00db1731db6,t,52886,5815193,,5000081,2018-01-30 14:02:02,123
0xdfb2911f99ac8c8c1d4e529fd3bbde06b37539e187a561bf9d8c7638c5b33cce,t,52886,5868079,,5000081,2018-01-30 14:02:02,124
0x37a7f666eafdfbb9dc80cd384a039a1764fc226e0d5bef94a907e624b90d43e8,t,52886,5920965,,5000081,2018-01-30 14:02:02,125
0xa650cc4675a56de79e6b9931609fdd3a653f2f191d49080e598a0e908fc86c8a,t,52886,5973851,,5000081,2018-01-30 14:02:02,126
0x108d0c1d63880eab3d3596c287afcebf5e63220dd1fda50923443da0faf56c59,t,52886,6026737,,5000081,2018-01-30 14:02:02,127
0xa67cd7ec7ca30b88ca4642496b397a7797dd740cebb8742487edeb065d024f2f,t,52886,6079623,,5000081,2018-01-30 14:02:02,128
0xe033672e134a20bd8875508f6b54bcd1832cb8adbc00dd5de068e367b99ffceb,t,52886,6132509,,5000081,2018-01-30 14:02:02,129
0x4b719dee29188b697c412cc9ebecbfd020e947e7b63bdfc2776095ec138474e8,t,52822,6185331,,5000081,2018-01-30 14:02:02,130
0x1eba88162159f14f4cc53694d9dc35d3baa5a0f93b6588a35e445f28669f34f5,t,52886,6238217,,5000081,2018-01-30 14:02:02,131
0xd67cb88d377b0f2ba5921eb3b4cb02996a1004355ac2aac30589e9cbe09d55e5,t,52822,6291039,,5000081,2018-01-30 14:02:02,132
0xb8614097bf7728859b95c8a949006f55feca3aba29e419dff495a1a4b0d3d3ec,t,52886,6343925,,5000081,2018-01-30 14:02:02,133
0xd31955093dd45366fbb92c99750bca6390a7ffcc5f50ab24eda07aa6b55c0a11,t,52886,6396811,,5000081,2018-01-30 14:02:02,134
0x24938e6ecf846ea2ae90833d3d37db906ad42971a0754e71af521c3f213764e6,t,52886,6449697,,5000081,2018-01-30 14:02:02,135
0xf9e57e5c734c3ac61ee79ed6810532acf3415825597976134dc966059888d565,t,52886,6502583,,5000081,2018-01-30 14:02:02,136
0x6f31dd4103ad214c935b32c56d6dea91265942bcf0745f0e2221dce932f0d5dd,t,52886,6555469,,5000081,2018-01-30 14:02:02,137
0xfdddcc05032954c01d63bbf3775fb2b072d52adc53f39f67ff455c9ecd28d334,t,52886,6608355,,5000081,2018-01-30 14:02:02,138
0x14aa1489beeb3d1a904e40f151eb09871250cfe26301984429a01a0b1903012b,t,52886,6661241,,5000081,2018-01-30 14:02:02,139
0xeb08db75aadbb74ce0f63a5e454fc1862f7bab37c177de0da72b30adb17a3ee7,t,52886,6714127,,5000081,2018-01-30 14:02:02,140
0x956e1f56a6750cee146cf078120f4b596fa8faef2441ab6e38a39508bceb770c,t,52886,6767013,,5000081,2018-01-30 14:02:02,141
0x9f89326ea0bb8455736db6ff683cc9f63f77351c6d1668c569f8bff8a1ac2b97,t,52886,6819899,,5000081,2018-01-30 14:02:02,142
0x08a0dd7fcf6ab9664071837a7d3a06fb0037f6c742825f0454d8c24120c1233b,t,52886,6872785,,5000081,2018-01-30 14:02:02,143
0xa92bced195d38ba13278426aa6bbf384017d440037bf6ae0b5184c6a37e1fc43,t,52822,6925607,,5000081,2018-01-30 14:02:02,144
0x44cc1839971e5cfddc84c717db0b004f79df00e598928cde7dbcc41e21ac80b5,t,52886,6978493,,5000081,2018-01-30 14:02:02,145
0x8e1f0fcac1955d79eaab95b7762539832112c9107c6b2a51f0d46d2c7e432035,t,52886,7031379,,5000081,2018-01-30 14:02:02,146
0xe746f8c9143eec8a1f04a384df85d7c68113515d3325a8d0694033e6876b27ff,t,52886,7084265,,5000081,2018-01-30 14:02:02,147
0x686e15690f2184d6aff93b9783ba582f821e06801fa63b16a9595c30989da9cb,t,52886,7137151,,5000081,2018-01-30 14:02:02,148
0x054c8749b63a1b8ca8ac563ce732a709e116457ec8d79b62f672a91fae2ca47e,t,52886,7190037,,5000081,2018-01-30 14:02:02,149
0x1a0cee8f159253e453a7100493a4fc4897df5a5ecb259943c4540f94525c3768,t,52886,7242923,,5000081,2018-01-30 14:02:02,150
0xd09f67f0af722804d884850a3d81d22ed23362a71d9a2054a2641d8d0335220b,t,52822,7295745,,5000081,2018-01-30 14:02:02,151
0x42f0e83cda081e1e12a3d335074443d6b257ceda90c6d534dc6225ea958c5592,t,52886,7348631,,5000081,2018-01-30 14:02:02,152
0x3e5761fbcef5da6936c18cbf00e2f83a0a5382bff98ddda3123f749db04bb05c,t,52886,7401517,,5000081,2018-01-30 14:02:02,153
0x1efd5430fa2dbb441f2be9612f7728f253af5bbcf36732e5cd3a4f39122c296c,t,52886,7454403,,5000081,2018-01-30 14:02:02,154
0xfc8e325c7b1ada8e0292f461993186ec74edb9488c40fc1d1ad16a63aadf335b,t,52886,7507289,,5000081,2018-01-30 14:02:02,155
0xd0d03d35077fc0d899f1767305bdd0d501af0d97ac8094dfe8d443f31f3a468b,t,52886,7560175,,5000081,2018-01-30 14:02:02,156
0x041aa4f1b65ced2a172fe2bd79ba987d0b749726d5e4a8780955a7fc37b050fd,t,52886,7613061,,5000081,2018-01-30 14:02:02,157
0x0e4e05ebec66f6ed139f879060a2558f2fbff1d33f725ce31929b57f0b13972c,t,52886,7665947,,5000081,2018-01-30 14:02:02,158
0x7614f7e0e14e4d0eb861cd557472069bde4f57b8515fe5fa7e9119ee9534f621,t,52886,7718833,,5000081,2018-01-30 14:02:02,159
0x80b2513288be70cc1a9a938ffe9cfde6f058326f4ef40ecdb1f694c2fef8bebb,t,52886,7771719,,5000081,2018-01-30 14:02:02,160
0xd6b8052a4b1d0773d721643249e8c81357f5feeb840247b792d884a3aeee8934,t,52822,7824541,,5000081,2018-01-30 14:02:02,161
0x20d2767ffbf87c8b90eae2f6ad32056a18b7b812bdbd9fac47195e0e5bad6a29,t,52886,7877427,,5000081,2018-01-30 14:02:02,162
0x1634bf05c22399eddd03ad3630ed4d0a2b10ccc29778770e4af2ac83f00bc07b,t,52886,7930313,,5000081,2018-01-30 14:02:02,163
0xb056865dce1ec0a883e4e10f34894ce3c1a88ec5050d0bf5f290b1a5ad57fa96,t,21000,7951313,,5000081,2018-01-30 14:02:02,164
0x40b276185244eba1a997393088de67dcfc40dc041d8dd6d88664bc93d895e869,f,21000,7972313,,5000081,2018-01-30 14:02:02,165
0x4b9b8dd12ad69a769f7313479975dd089651aa77d41f9803c3d3691dd32d291e,t,21000,7993313,,5000081,2018-01-30 14:02:02,166
0x63a8b0399b2c3cf39e9bcf59ed4afa6f2510dd0635ea6bf6eb058701b36390e0,t,21000,21000,,5000082,2018-01-30 14:02:08,0
0x4627aa4a11e468505b44422877b2e3d766c808710e14ce2c6c8885ce1b2f16a0,t,21000,42000,,5000082,2018-01-30 14:02:08,1
0x15e10d620734d7f417db2fcdee5c7061410a5f10dd2d444be20746f356afb8bf,t,21000,63000,,5000082,2018-01-30 14:02:08,2
0xc1c2445757d9055648e673fc70607b6454c1e5be8c8f5114007d7990d1192e6d,t,21000,84000,,5000082,2018-01-30 14:02:08,3
0x10849729f1adfd9afbcaf35141137837b1387f55fdd50cbd7116bd3f00674cf3,t,21000,105000,,5000082,2018-01-30 14:02:08,4
0xe9d8329e71081a133b0b6d40270aad0aa375aba63508ef7975eee9d29a3d246e,t,21000,126000,,5000082,2018-01-30 14:02:08,5
0x431d4aa3f1106b7c2a400d8bc5fbe00c71484cac88e81e9ce1a4cb7c6472732c,t,21000,147000,,5000082,2018-01-30 14:02:08,6
0xd27752b1f6f63bb79354fb5827e998acb5a0916475d3adc0fc24b4c14cd6088c,t,21000,168000,,5000082,2018-01-30 14:02:08,7
0xb5c5ed120f4177bc0c8086340695cc71d3ec3c0fd9019ff4e5201118af74534d,t,21000,189000,,5000082,2018-01-30 14:02:08,8
0xae53984cd8bd38fd75b8b5a99eedc9107a8c0728e52a477a1dd7c955ada81a1e,t,21000,210000,,5000082,2018-01-30 14:02:08,9
0x1fcbaa16dc0b3627742078ca4368bb042ba4419c4c44d7704afd5602a5d6b824,t,21000,231000,,5000082,2018-01-30 14:02:08,10
0xe409c9700a9e01b42727d4d4decae32c8f384c31a5b2edcb3e629e411970ffc1,t,21000,252000,,5000082,2018-01-30 14:02:08,11
0xed1dc0f84b7f634a44b64e644ea4e4bd9cce5941ddf7fddeb23f952190f4aac4,t,21000,273000,,5000082,2018-01-30 14:02:08,12
0x59774c85235f6798f738f52455936257f449272357f170fda1e4aef5f5f08a0e,t,51752,324752,,5000082,2018-01-30 14:02:08,13
0x07e41d7f54dd917c333bcbf6aa994c784a72d1a3b20d26e6bd36f36076c4e84a,t,21000,345752,,5000082,2018-01-30 14:02:08,14
0x56fc897c1bcbf6f2ac312b189b6ac291ee7d3eeeecd722780c2b91aad68dfad6,t,21000,366752,,5000082,2018-01-30 14:02:08,15
0x8bd990d822f81895c27c15c113d6b972bdf63dd40f7219a72fc8622c5ed8b19c,t,21000,387752,,5000082,2018-01-30 14:02:08,16
0x3e6e515717f72d16f0c6befe894a498c1336f6b47be61cb75507b44436a263a7,t,21000,408752,,5000082,2018-01-30 14:02:08,17
0x4e0ec16cced3f14d87f7db393e9b4bd82771cb2e8e63fddf7f5b49e208d75a36,t,21000,429752,,5000082,2018-01-30 14:02:08,18
0x02a0c6c33cecc59ed039b030b702dcf0e7d5d8a91f05a8144a914830f19ac927,t,21000,450752,,5000082,2018-01-30 14:02:08,19
0x76447a1d668a3099da4a38979101445b73e1765d8d8592ef00ab58e762e39e62,t,21000,471752,,5000082,2018-01-30 14:02:08,20
0xbe806624a3698b8c4dccf968ac6bb2ce402036af9a315de32918853a2361f8ec,t,21000,492752,,5000082,2018-01-30 14:02:08,21
0xd38b79ba04bdf826c3e20a64a77c9b7fcedd2822ec9c121be63629295202663c,t,98113,590865,,5000082,2018-01-30 14:02:08,22
0x1e0022741f9dd394aa573b9b75203c35a178d7efc1cffa481d333d966f857b66,t,21000,611865,,5000082,2018-01-30 14:02:08,23
0x212f8052e89b1c9c667cc8e6d3e533d4d7f47cea89f4caaeccfe2a05ae9b722e,t,21000,632865,,5000082,2018-01-30 14:02:08,24
0x65497a564db532fbdf0e3ce778822d33236d5b4763a1310d354c03d17c22e65d,t,91794,724659,,5000082,2018-01-30 14:02:08,25
0xc3ff7f795fb45f8ee998f4c100064aa487c63f9b76671992fbc73dd3d83034dd,t,21000,745659,,5000082,2018-01-30 14:02:08,26
0x0ef2940f04d235aae626733866ee7377176572778f7356af12ec242aa2b535eb,t,21000,766659,,5000082,2018-01-30 14:02:08,27
0xde50853456f116c09eec41e92fddab0af18e85e3f137ca6112bfb1c0afbc119e,t,312958,1079617,,5000082,2018-01-30 14:02:08,28
0x89c3f3b36fee437e1759bc642fc1af84cc29394324a8910f693a4762878ae8ca,t,44095,1123712,,5000082,2018-01-30 14:02:08,29
0xc8073127e69e8c88d92cb499530c7125189de70d233632a580678103b3e5d5a7,t,53167,1176879,,5000082,2018-01-30 14:02:08,30
0x8dcb21c47277152b8d6a561c97d095d53c848c46abf2c2d5e0209ae158537c3e,t,21000,1197879,,5000082,2018-01-30 14:02:08,31
0xd84669f291dda5a0c1ceb9f08c09bbea70aba6f12c2faf5daf363b4a8f33cc9b,t,40979,1238858,,5000082,2018-01-30 14:02:08,32
0x3c77155834813908b1d9c8f7f9fab5c8851d5d71b66e0ed0408aca00a533616d,t,21000,1259858,,5000082,2018-01-30 14:02:08,33
0x1676ae2bb3082c843384521bd56c4fe09ef7dd59860a21e0b8b09425a463188f,t,21000,1280858,,5000082,2018-01-30 14:02:08,34
0x6f9e6e45cf1dfbf40de9652146457ff2ba3166fee064fff882bffb15fb21460d,t,21000,1301858,,5000082,2018-01-30 14:02:08,35
0x148adcea11a258551b5d18c8739851f0fd928caf282466efa14379429c355573,t,31951,1333809,,5000082,2018-01-30 14:02:08,36
0x84c9417da89a33466aeb08e59ff7991446b006ca7343301a7bcec200766c7c43,t,21000,1354809,,5000082,2018-01-30 14:02:08,37
0x0ca5d5bf8a9bc1195206efb57ad7cf15c8236af21c7f79744cddddabf8b948bd,t,92613,1447422,,5000082,2018-01-30 14:02:08,38
0x7c89cf044262403cc14a2378a6105cdbacc77e308659ffd4e363f9dd9bc39ffb,t,36792,1484214,,5000082,2018-01-30 14:02:08,39
0xfa18e813ebd386d610fd9e1497a178c942ac214425385a7ba217e927cff3e03b,t,44198,1528412,,5000082,2018-01-30 14:02:08,40
0xccbe1997699b5de597fd76b6f97bbbcc72bd7a294d3c7b83edc2e35975af40ba,t,21000,1549412,,5000082,2018-01-30 14:02:08,41
0x4f3ed0e8d51f8cf56f6ec95d9c67450ae63c084a481a5572d9f1849f418b0cd6,t,21000,1570412,,5000082,2018-01-30 14:02:08,42
0x5ee6e0c6b5bf7ed66b565d796f2e380f7dd89b84bfadc6b148abeb04002e3e21,t,21000,1591412,,5000082,2018-01-30 14:02:08,43
0xd73e7bb6abac95de9aedd02c0b7a5052900dc88ca0773fb3ac26da60e47c8409,t,21000,1612412,,5000082,2018-01-30 14:02:08,44
0x9599412a43c93222ab303a6e7cf2ecc4c3be573fdd60871977692565771a6149,t,21000,1633412,,5000082,2018-01-30 14:02:08,45
0x4cb5a2026ad6cd54b38b2bcf3209ac27cda0f158b7fdc8d68571850699401449,t,52460,1685872,,5000082,2018-01-30 14:02:08,46
0xc47a0a0c5c0f4e114d037d7a3bf3ad1d81949d9735f376d56420b2699c043c3d,t,21000,1706872,,5000082,2018-01-30 14:02:08,47
0xf8faaf6fa577174a7c5b04d076ef8c312f85b20ec35a43f8d893d7c845cde841,t,21000,1727872,,5000082,2018-01-30 14:02:08,48
0x97113679d4fbf4aebdd679f7d0916177332a723576f8ca31bdb243ffdf14c71a,t,21000,1748872,,5000082,2018-01-30 14:02:08,49
0x8a95d3971d3f9c39bf6d8275982bddbfbe94a14faa02f597662e1ae522abc952,t,21000,1769872,,5000082,2018-01-30 14:02:08,50
0x95d0ba66fdd5f281214caed122dd9fc397943235cf7dfe215e442e958b160a04,t,21000,1790872,,5000082,2018-01-30 14:02:08,51
0x23d314c871cb4e6adeab0e17147c37c55d51be74bb69bd538484d659cdf146d8,t,21000,1811872,,5000082,2018-01-30 14:02:08,52
0x4f4acb3cacab32085defc32a792711d23df2691ce9f6d0530f15188a7028aaa8,t,21000,1832872,,5000082,2018-01-30 14:02:08,53
0xf89009be7cf83dea94b85f97324ba1db97a05dbf4176a021c6ccc058b1b4835a,t,21000,1853872,,5000082,2018-01-30 14:02:08,54
0x2f5b0a3c57c96c9e1e32ab860491ab3ddb2dc1a0967cd716b4b6df0e876afdc9,t,21000,1874872,,5000082,2018-01-30 14:02:08,55
0x473224a51c5880a367d0763582708b0aac6617dd6fddbb3097c260ee23e9edfa,t,21000,1895872,,5000082,2018-01-30 14:02:08,56
0x3f79425ae5103496e775c0c417572dc1f1c1320e0a0648e763e0a9d2ee8e3733,t,21000,1916872,,5000082,2018-01-30 14:02:08,57
0x6216cbee2ea720348044b10f2f770cbbe29954377bfcf0d4685660555d8d7c25,t,21000,1937872,,5000082,2018-01-30 14:02:08,58
0xecd511d6fa85f757334ec60f2f4415ab8a4f3108665852e8c6fd035327b764df,t,21000,1958872,,5000082,2018-01-30 14:02:08,59
0x3aa3dc56510b7a8066d765a81325f74d9b5202dbcae4e2349d7e4ca9816ab2cd,t,21000,1979872,,5000082,2018-01-30 14:02:08,60
0xe1aed1ecadcf067f1caf3000fde281a80c185c5b6059d9dd7c930f1d2cb68c0a,t,21000,2000872,,5000082,2018-01-30 14:02:08,61
0x6eb3bd7b71d4146ae3d311e06e5e6e2d1e51090dcee4b30614004c3f6f0665dc,t,21000,2021872,,5000082,2018-01-30 14:02:08,62
0xcfab6aab2608c75304b2af76a1a1f0ead2eb1553c9fff75fa8f01cdde7def435,t,21000,2042872,,5000082,2018-01-30 14:02:08,63
0x0d545c57d542a359f0259f041a809323bf7ad42cef07e05663046db2026e10f3,t,21000,2063872,,5000082,2018-01-30 14:02:08,64
0x104b8c8deb6f5e2673d7b1211962a83d605a33c82a7a30c2e74dd0931c607d6c,t,21000,2084872,,5000082,2018-01-30 14:02:08,65
0x5277c4db59933629c8d49b3fdb422855eb97b97f5ca4e911c48161da8f8bdc53,t,23252,2108124,,5000082,2018-01-30 14:02:08,66
0xf411637764b4ee4f10e00cee9661744d9cce6487cbfa839b3a85cbea60accba1,t,21000,2129124,,5000082,2018-01-30 14:02:08,67
0xf811159dfb8863dc50d2c45b8ecd07cfaabbb56a1ca807ecffe9cc10663808c5,t,21000,2150124,,5000082,2018-01-30 14:02:08,68
0xbfae1509024723dc8cd2c40bc07e56ad5a967049de4874ed16970982d9219f3a,t,52840,2202964,,5000082,2018-01-30 14:02:08,69
0x8277062e5e8cdb480b93841cca17245c2499978b8f7e2ca24f3cf14333cc6077,t,21000,2223964,,5000082,2018-01-30 14:02:08,70
0x16d4e5f515462c5cfabe58d240f53cdeace933ad5e176d5abc9125e3eea4e659,t,21000,2244964,,5000082,2018-01-30 14:02:08,71
0x87f9154b728f63b680e114929af459d8530d7514e5e442bf07fec41be35ae812,t,21000,2265964,,5000082,2018-01-30 14:02:08,72
0x12a97306623f5abae13c2d3df283234aa2e0485027ffb3d0f10668bdd331b540,t,21000,2286964,,5000082,2018-01-30 14:02:08,73
0xe1382510380500b316c863b305484b68c93c2d6dccb7be4519f959e722dd0e78,t,52308,2339272,,5000082,2018-01-30 14:02:08,74
0xaf6defdd310762d74860d9ae7dce47b697404906419b8db4915aeac79040b729,t,21000,2360272,,5000082,2018-01-30 14:02:08,75
0xd7250bf461eff7fb61c7c341b9e4de18b1c8c7091b9243e4b058966f940b115b,t,22222,2382494,,5000082,2018-01-30 14:02:08,76
0x337b1caad5bc126432ac68e89f667c0449f491cf1019f493f317771415319b65,t,36772,2419266,,5000082,2018-01-30 14:02:08,77
0xdd8fbcac1e064d783a8d1174047fa83d1ac5ce410d6ea37654cada4d0d263881,t,21000,2440266,,5000082,2018-01-30 14:02:08,78
0x54fee8e9ba564f8d711bc4c55dd6a70a60f7284bafdc95a980844b18e85843e4,t,21000,2461266,,5000082,2018-01-30 14:02:08,79
0x73e7c256b71262119d62aebdbec77dd4de0803d75aec6982b51b3f2bc5b4b65a,t,21000,2482266,,5000082,2018-01-30 14:02:08,80
0x3204333779bf346d22716826a92f4c37e090d5787ef0c860f46cb82ebc164a97,t,21000,2503266,,5000082,2018-01-30 14:02:08,81
0x645080b331461f728ecc54f6c52c97c9d6eba56412ec2f2b2380d2422d3ba75a,t,37245,2540511,,5000082,2018-01-30 14:02:08,82
0xb174448e85bd95f956e5aacab62e9e53a58227e71728630b888ab2d8d990167d,t,21000,2561511,,5000082,2018-01-30 14:02:08,83
0x75f245e1ea46d33c9ccbb08a54d50393418466cefab68d19e93eca51caa99552,t,37900,2599411,,5000082,2018-01-30 14:02:08,84
0x06ff409d14e1daf6987761ea529201ee5802f9f00f4cf16ab106cb59d112a908,t,25562,2624973,,5000082,2018-01-30 14:02:08,85
0x0daf0c1f234d4eb9deb99411240b9cb2f743d23363d0d3f93f19ab28c162804f,t,21000,2645973,,5000082,2018-01-30 14:02:08,86
0xe5779c95e55778883aa8897165f874dcdf77af054f1d57bcce2df6aec418c99c,t,21000,2666973,,5000082,2018-01-30 14:02:08,87
0x0f2b0738403a71fa47b06b483344e16ddfaf814f747aa98a3897149178a399d6,t,4664076,7331049,,5000082,2018-01-30 14:02:08,88
0x02860f909f9abd2ff245f8d064a8286c58356790787dee8a1b870766f305fea3,t,32668,7363717,,5000082,2018-01-30 14:02:08,89
0x0beb2d9e0da8a274ad563ce7fe67fa9ce2f1cabfad283b02770f89b6a0fe4619,t,49041,7412758,,5000082,2018-01-30 14:02:08,90
0xc19b98c0ca924673d39e5fd92e46b88656af8dd4005c2e2e20c12f2841c32c09,t,45508,7458266,,5000082,2018-01-30 14:02:08,91
0x62f6e6824305b6a6821b01bcb75389dc3857283a217543b12a9878e493e7e868,t,21000,7479266,,5000082,2018-01-30 14:02:08,92
0x87e539d827194082fcece56b225d14ec0ced1c4485033f5c15a98da4d4d2d213,t,108562,7587828,,5000082,2018-01-30 14:02:08,93
0x221e6da10f6ef9d998b5c08d8effbd00eb891d1f8c8108a73a2f3b33f37d0916,f,23970,7611798,,5000082,2018-01-30 14:02:08,94
0x348d6dd70d8d88d2bbe7410d3e9e24e9c6389d6885b9f5bbbc697590490f9864,t,23615,7635413,,5000082,2018-01-30 14:02:08,95
0x00a6fcf270bd0a84f9983f7c6b4a38582da90568fdaef361f6454c5371c1cd9d,t,52976,7688389,,5000082,2018-01-30 14:02:08,96
0x366d8403c1d23d8e6d66e8f34fd308b74f4c579dc3a9f1b264ead918d9c21887,t,21000,7709389,,5000082,2018-01-30 14:02:08,97
0x1df3e9edbcf65b7ba0eb07b7d8b3d958f3846b5eaaaf8f41ee9f03085a771ff4,t,21000,7730389,,5000082,2018-01-30 14:02:08,98
0x943d58bf61990b87c874ffa4b35b6fcc9f66253eb7dd21ed8ad45383f1ecc65e,t,21000,7751389,,5000082,2018-01-30 14:02:08,99
0xb284da9b3b914f41d96c0def99b08e08197df769ebbecd6d66623253cb72f0b9,t,29493,7780882,,5000082,2018-01-30 14:02:08,100
0xa0747ff67b637d0e61c0e619c8a3d104c4d5bd22b34b11f0329c6bbdb26989e7,t,21004,7801886,,5000082,2018-01-30 14:02:08,101
0x5bb47136a774da36672e9dbb996304eb01949640516c2a2bd9515eb68b4a0052,t,37173,7839059,,5000082,2018-01-30 14:02:08,102
0x8379e9984cb678ca5d796fffcd05f5ae27ac95c01845fc2a7de05e685ded38e7,t,22222,7861281,,5000082,2018-01-30 14:02:08,103
0x07017e4b988f9311ce14dcaa563872f2de4227ea3f766dcd0724d2d001521f87,t,21000,7882281,,5000082,2018-01-30 14:02:08,104
0x4840a7071e8c0ba7d062e5ce001f45dd741567542ea390350bf5d840b8c20bc2,t,21000,7903281,,5000082,2018-01-30 14:02:08,105
0x244ee537e0c0fb26ae31aacfaae955b2cb95034f0255b7c85675a26858589198,t,69568,7972849,,5000082,2018-01-30 14:02:08,106
0x4ede737ed820a8a7b0da95292804cf0f353d72f674d8b498b5e389bedb815264,t,21000,7993849,,5000082,2018-01-30 14:02:08,107
0xffefcdae0e52b157de408befd2f15ab5470ffd9d64e01bca00642e5b3755d79a,t,21000,21000,,5000083,2018-01-30 14:02:13,0
0xcc5d3840cab1c72232c0bd4df13068b5f4bf2e462ffffae5c3fd997a9a38d710,t,21000,42000,,5000083,2018-01-30 14:02:13,1
0x706a453d497086e60e066e0029d8efebaf8091245eef251ff70a2e9173616b9c,t,21000,63000,,5000083,2018-01-30 14:02:13,2
0x249b710b4606f1471278437411187c213361bb4ecf9436010b417b1d55231960,t,21000,84000,,5000083,2018-01-30 14:02:13,3
0x3657315b589eb93575328f477f965460c4fcc714c64138d01ef1743602f73388,t,21000,105000,,5000083,2018-01-30 14:02:13,4
0xf3422ab367f9751e156d5bd69338258f189a12db2a8c83b899533abe554f6fac,f,27563,132563,,5000083,2018-01-30 14:02:13,5
0xe9497af040c9c7257548c0dafd3058af4ce63a26d8fa63e987ff3a02ceed8ea2,t,21000,153563,,5000083,2018-01-30 14:02:13,6
0x69ac39b1322a027af72c41028449188ed1063aec69bac2886eab078c0b8a7fb7,t,21000,174563,,5000083,2018-01-30 14:02:13,7
0xf96418e91e21952ab07f29188912781ca8009217c898a8d65f2ee55717b0bc3f,t,21000,195563,,5000083,2018-01-30 14:02:13,8
0xc89bdeea8a5e9962e2d3f8c5930d3b147eb25bce3b8a0832a6d392427b644814,t,21000,216563,,5000083,2018-01-30 14:02:13,9
0x27392a32055dc91b610234f0242ddb1bc9bde75a02c6e16bf68d1a49c0c0bb1a,t,21000,237563,,5000083,2018-01-30 14:02:13,10
0x82b635af12d23ae67de68515567eef08eb48d969d6b7a94910cb4b7ef1ac3a6b,t,37964,275527,,5000083,2018-01-30 14:02:13,11
0x93bf13aa53ebbd2e24f418f738fb073ac978814ba637fb3c361a55eeae61b57b,t,21000,296527,,5000083,2018-01-30 14:02:13,12
0x4fc2abcde3ff9744d2e2959b2a4844f73cd98bab42097d69fa8b507afedcb3ca,t,52950,349477,,5000083,2018-01-30 14:02:13,13
0x1c4077259bed8c74cca21c1115083fb7614c1e8dd70db394b9623bba6e96954b,t,21000,370477,,5000083,2018-01-30 14:02:13,14
0xc554ae367a3b484306d4165a20ae264966fae39ea76aa7911701edbb934df3bb,t,21000,391477,,5000083,2018-01-30 14:02:13,15
0xc50aca95248370266b301b205b7f8661aa219ef54208f0bce6725383de9ccf0f,t,21000,412477,,5000083,2018-01-30 14:02:13,16
0x2631cfc09994b468a3078927a4001841271a3c22f35809e1303b13a87c43a290,t,21000,433477,,5000083,2018-01-30 14:02:13,17
0xa8389d355aac8e1a2af5b5b3ba0c021c708709948da3742a3fa07d5c6a72313f,t,21000,454477,,5000083,2018-01-30 14:02:13,18
0x40b564a71ae7330fa96a3264737ccb8027fa4ee519d78eb7e7f05b83d3f4b8a9,t,21000,475477,,5000083,2018-01-30 14:02:13,19
0x0576959f6fdf79c0685ef2aaca7deadeba0b75a982ac7336a3e0dd6d7cb0445d,t,21000,496477,,5000083,2018-01-30 14:02:13,20
0x768a9034023134a7789f979588400593e43d518b9a452bb992243963a1ceb73a,t,21000,517477,,5000083,2018-01-30 14:02:13,21
0x867c2139a6164b65a0968d931804d9f1feb95f014a37529ae68474a5f63f0b61,t,21000,538477,,5000083,2018-01-30 14:02:13,22
0x6c7ba66c4bfb67d49cce4985ec59c7d261694828139a0899855ac91dd350aaf4,t,33149,571626,,5000083,2018-01-30 14:02:13,23
0xbcca03add958bb6f0c9a836ce5623c1792dd0f23ad923c073dce32fec343259a,t,102934,674560,,5000083,2018-01-30 14:02:13,24
0x429de186284203b2b1f50262024d3451ea3a5265bfdfaec087dd5d3179b0f0e8,t,21000,695560,,5000083,2018-01-30 14:02:13,25
0xfee379aadc6b3ff3fdae16015535260cafb51123fef8f732fc74e46dc278170d,t,52852,748412,,5000083,2018-01-30 14:02:13,26
0x24752425cd1d90ccde840fd16e55e6b7770a32921dffdbf8384f96ffc0ae11f8,t,21000,769412,,5000083,2018-01-30 14:02:13,27
0x00080506cb04de7f1b61df2935c1c86ef509793c89b2a9ad5437e2d4677c2f2a,t,21000,790412,,5000083,2018-01-30 14:02:13,28
0xf7fd9a4b6cdd8b2753a5d59e9f5e307b24f3670af8b0c23caaf4ae691a7c28aa,t,21000,811412,,5000083,2018-01-30 14:02:13,29
0xbdf217b804680be0ffac13bb22923306cf7504f7dd8b8924dd8b3178b4ad727f,t,37292,848704,,5000083,2018-01-30 14:02:13,30
0xd465aaa2c0d14f8698c9adaeb3162abdd16af0be7677ce1317c97e6a55d796ca,t,36618,885322,,5000083,2018-01-30 14:02:13,31
0x83fb06588cc94acc939837d69e9e4160f7231d86e19d68eae987f108bccb1663,t,46203,931525,,5000083,2018-01-30 14:02:13,32
0xe9bf9d34334bf63e96faba210aa6b52ead99668c11ba16001a626a71c0db7e0d,t,38028,969553,,5000083,2018-01-30 14:02:13,33
0x6039503bfe3b1f9454e517f93f0fde873e6929b0062e0425b02dbe838abcf592,t,21000,990553,,5000083,2018-01-30 14:02:13,34
0xc72aa336f01f081f0d00d595576f94ea65ae65d6d0f4079b77cf704d7b59b9ac,t,142644,1133197,,5000083,2018-01-30 14:02:13,35
0x779669ee5d44a55d27151bb6cf4ca246eee959646b044a6ab8aa0c1789ae105e,t,21000,1154197,,5000083,2018-01-30 14:02:13,36
0xf96f8cf7badb5d80566a274fb2d066f23b28e2f3322cb17f77cd65ead128c9b9,t,93306,1247503,,5000083,2018-01-30 14:02:13,37
0x2f963bf0ce0abf34b830e81e8924fc7e6806bdba93f632cfde87c14bc137e272,t,36792,1284295,,5000083,2018-01-30 14:02:13,38
0x40bd33eaf8cff3b99c0a47f5b927cd08347cf52a4ae2f1ee63432e45e5f55c02,t,52886,1337181,,5000083,2018-01-30 14:02:13,39
0x86c4299be50e56b5842ab29b22bbe21dd7e53f5ae2edbb47c5fe91d5427fd9b0,t,21000,1358181,,5000083,2018-01-30 14:02:13,40
0xd38cf48cfa073232f860f0bef8658cd65a8d888152a16157ecaee11da0e15f9d,t,51590,1409771,,5000083,2018-01-30 14:02:13,41
0xe46dc14b7f9513623eac04c8d9d1573e7e1e4f16344f944eae2681ae67feb6b3,t,39512,1449283,,5000083,2018-01-30 14:02:13,42
0x8b705887bcb3c65664ed235b094a4ba1a553a953529294c5c5b9f1dd4054936f,t,253854,1703137,0x29500fdf9fea2E99F8aEe2855969F826F50a083e,5000083,2018-01-30 14:02:13,43
0x3adddf8aa859e7a9189e78e783df5d211b50ae2ef752ccb777ec187d0cf237c8,t,21000,1724137,,5000083,2018-01-30 14:02:13,44
0x8c4f38083b09396f7739a11a5c54130cbe80d3223eb7ccf7fca3a6dd3bb9c2f8,t,21000,1745137,,5000083,2018-01-30 14:02:13,45
0x82ba2b760c869bf2a461324860bb2bb818501d8083e5106f92e1088d11a8d077,t,21000,1766137,,5000083,2018-01-30 14:02:13,46
0x0e888cb3a494b7517186898bff871e82e2a7f17548e26f666d6bcb9f5b64ae8e,t,37075,1803212,,5000083,2018-01-30 14:02:13,47
0x62ee6d41a6d1c17740278a4efd87e59863b45ccfc534df6b7253a16b1fab4a9b,t,21000,1824212,,5000083,2018-01-30 14:02:13,48
0x0e1261b258911bb1344c7fdfc63a16c49c506de169465d9b1b9d52a2e10580f7,t,165532,1989744,,5000083,2018-01-30 14:02:13,49
0x751789cb2bf17acb294af7e2093f83921c01c2ad35223ebf47734af8e17dbdde,t,140340,2130084,,5000083,2018-01-30 14:02:13,50
0x0b93490bf2d5f99ea86a4a146abc86d4ae13b1aeb9edbb07507140e4cdf3d5e7,t,27200,2157284,,5000083,2018-01-30 14:02:13,51
0xd86e883e6491d9b0fc58d3fabf34956f8d5af58cf35edaa97b8ebc80711e9d15,f,23970,2181254,,5000083,2018-01-30 14:02:13,52
0xfb619ec85d5a013346fa67f4727a64f4f8f64840bc0cd5b77aef63d83aece3fc,t,36621,2217875,,5000083,2018-01-30 14:02:13,53
0xbfe7ee4a5c5fecfda0a45209ab6d3ce32f5513fffe5b617a174034dee45d05a8,t,59034,2276909,,5000083,2018-01-30 14:02:13,54
0xa2a9b8c24e48e362dc85c4a664ad46f649d766f6962dcc269256acd4d7b6b6f6,t,78306,2355215,,5000083,2018-01-30 14:02:13,55
0xdfdf58f96f15d9fbdd62491191e229fc93a2dbe38ab119e23a5c76d4057217a9,t,59098,2414313,,5000083,2018-01-30 14:02:13,56
0x1c99d04d2c0b91617dccf5997120d25cebd0eed0357d430d57ef275a68c8d14f,t,36973,2451286,,5000083,2018-01-30 14:02:13,57
0x4ab12800623d65e7120239a9d827d3f951f830e134789c8f552f333c6f4eba92,t,45591,2496877,,5000083,2018-01-30 14:02:13,58
0xa77f8b7a45a3852bc594c2838ae6cd2abca4fcb0f540ae3fa425b3cd407566d3,t,43346,2540223,,5000083,2018-01-30 14:02:13,59
0x3a850517d778765fd04797df082c89a66ecb3a2a2a3ae5d9170999894b92aa2f,t,59226,2599449,,5000083,2018-01-30 14:02:13,60
0xc693601fbf5ca19af4b7d911a84bc7cc897e23a984ee3d8ec23204eaed479435,t,53350,2652799,,5000083,2018-01-30 14:02:13,61
0xf3ea0de5e2cb22e02d0b6c42d2dba5e753de861f7cfe184b918b86d803400471,t,44290,2697089,,5000083,2018-01-30 14:02:13,62
0x7abc9d3ef3873ae17301b8c962397d25b31d47150734be78b8b2ca0c2d7659e2,t,52052,2749141,,5000083,2018-01-30 14:02:13,63
0xdf2c8c040b2b0230bf1709ed5fbbdd582dc20a9cb99e5b12bef2304cda324316,t,21000,2770141,,5000083,2018-01-30 14:02:13,64
0x46af59ffbf831002f203eaf70995c9ec27fd5cb56b7665b1ff3ace929d87f910,t,75092,2845233,,5000083,2018-01-30 14:02:13,65
0x1d319d0f3fcf2da4d347e78dcaf3e725024c0e73b54a94b9a79065603cbdff64,t,30417,2875650,,5000083,2018-01-30 14:02:13,66
0xc2a49b66608fe14f01560d7287771ca05087f8da198882f3268c25e48cec7846,t,66316,2941966,,5000083,2018-01-30 14:02:13,67
0x5ab99ae0961148abcd79b400198040e12dae0fef6262d09a4367e0242aa54661,t,36940,2978906,,5000083,2018-01-30 14:02:13,68
0xdc2069bb10bfcc20bc4697930d151cc33c7d9e1db4047e450a4088d86a999925,t,21000,2999906,,5000083,2018-01-30 14:02:13,69
0x33ba4cb376e7398688bb22aaba9ad2c8e7e2da7401b217655b734851fa6b4317,t,92666,3092572,,5000083,2018-01-30 14:02:13,70
0x3e136f09bc16d8fe12cb52a0d884daae4234f002488c3c6452d230b4785fd54b,t,21000,3113572,,5000083,2018-01-30 14:02:13,71
0x6d9cdd21df5827a3a08d7ac77561b4b1d276ce0b18e75cbe813194589fecc93d,t,21000,3134572,,5000083,2018-01-30 14:02:13,72
0x3199a6d26819046f0e9fa2a8b172c9e18cab48895891e5a14aae41323e271fcd,t,59098,3193670,,5000083,2018-01-30 14:02:13,73
0x405910a2f247f0f2eea58d6514b3cec9aa47014832068c9103812682fe984a58,t,21000,3214670,,5000083,2018-01-30 14:02:13,74
0xa4b828d35d964141c7699a53bc06eda8f3ef229be72ba2741cbb798b8ee7702c,t,92858,3307528,,5000083,2018-01-30 14:02:13,75
0xb13c7d83850a68d8f2403c33f320ec6825aceeceb85134b25dab04a738019e73,t,21000,3328528,,5000083,2018-01-30 14:02:13,76
0x7a36931731bc15c0ab89dceea2a0a596c471f152868d507e54b13dd45ce20175,t,93306,3421834,,5000083,2018-01-30 14:02:13,77
0xe03f492b906e5e409b4ecf2472b40f9992650dcabcbc1f9870a57cfd2cab7184,f,21000,3442834,,5000083,2018-01-30 14:02:13,78
0x29ecc27d63e04981565801257240659061680c1d26a437bf5d20d6e0d64ab1f1,t,21000,3463834,,5000083,2018-01-30 14:02:13,79
0x9e8e3630b2c37237f1592a5446f263091692fbecd5b54e68867058b8e7e08e05,t,37900,3501734,,5000083,2018-01-30 14:02:13,80
0x074da89b2e94dd3f4e71c9e562bfac132275ff0f89df9171286d26ef269c965f,t,1300709,4802443,0x265947e08088FaD82743c7a9041Bde2ab4B68D30,5000083,2018-01-30 14:02:13,81
0x2c97c679ff21f2834abf4f5175730670b3273d4ccbd6fdb9106e697f473bb8f2,t,37450,4839893,,5000083,2018-01-30 14:02:13,82
0x05918d596304f01e0aa4de550f53646fd845415f9f9aee4740ec5df4ea4b2124,t,107858,4947751,,5000083,2018-01-30 14:02:13,83
0x426560c05eacb922c90483b40f4aef0bde2ceb1f73443eebfeffa2b2b2d63fb3,t,108178,5055929,,5000083,2018-01-30 14:02:13,84
0x0234abb587d29a0db0cff96d6eabe43f4b05b9b43a40f5b5d9c6837eb0ebd0a1,t,21000,5076929,,5000083,2018-01-30 14:02:13,85
0x0bb62f8024e9b16e59a95ef94fcec217bdf42ab9c9685ca361410410ea81a2e0,t,84005,5160934,,5000083,2018-01-30 14:02:13,86
0xe9c3e5028ee8d8f9608b3285baac5a748009353fc26f3b0b60da181ee28a4e9d,t,21000,5181934,,5000083,2018-01-30 14:02:13,87
0xafdf73a601715911155498078ef84d792f22d47f3d39babbe391bddabe9cc728,t,21000,5202934,,5000083,2018-01-30 14:02:13,88
0xfa761ed794dea447a7dbbdbddf0835fc8e67904a31f7d6da266c99ef08263655,t,21000,5223934,,5000083,2018-01-30 14:02:13,89
0xa0eba43646ee5ae5a847f3f158c5e3eed3a751aa13764e33f1ea750ba82114db,t,21000,5244934,,5000083,2018-01-30 14:02:13,90
0x36fc44380e8b6bb6d7860f90faa0c4a1144bbe313c03e604a317a5bd31b76a3d,t,44354,5289288,,5000083,2018-01-30 14:02:13,91
0x18a167b68581d01c1957823994f0edd57a989a43a428788f5960a57b1e2e1e57,t,21000,5310288,,5000083,2018-01-30 14:02:13,92
0x79a6c261aba86ff05dd51ed8f181704980b25833dda552bf4a2d6ea507ac194c,t,59162,5369450,,5000083,2018-01-30 14:02:13,93
0xd35c5ac415ef314dfe7da49f2c26ba03a6f2a71c25e1747b739241dd6aabe381,t,92922,5462372,,5000083,2018-01-30 14:02:13,94
0x155db7550db380ac42527955967cad5acc218a9f49c96e66641aa993f43f43c9,t,59354,5521726,,5000083,2018-01-30 14:02:13,95
0xe4a7c3e128c013a47f8b6293048b9d4dca3ba26bf44cdc637680bd5e76c7cdaf,t,47623,5569349,,5000083,2018-01-30 14:02:13,96
0x09c9b279633f311b26d4a35531bb819042a27d778d9347a1a8deba7c9fb101ff,t,92986,5662335,,5000083,2018-01-30 14:02:13,97
0xf5a5cb7019db778b000fe1062b4822f0050e45ec84218e7c7447142d79ede3fb,t,123242,5785577,,5000083,2018-01-30 14:02:13,98
0xa009fa9986debce8aeb53559fc5c5155033dcde0c9aca2db55bd2977d9384c67,t,55779,5841356,,5000083,2018-01-30 14:02:13,99
0x1f76671be10d2fd3afaa93993caad3bb3907c83868978c13fee30598d23e51b5,t,44493,5885849,,5000083,2018-01-30 14:02:13,100
0x5c62059caa3726e25431469c83e1b0a68fc884591df1ba7d70a5a6f55aa29aeb,t,36841,5922690,,5000083,2018-01-30 14:02:13,101
0x8c5333dfddd7b036b2bcac7eae21ea6aec4760552d93a76aa4c9f9257cb71343,t,21000,5943690,,5000083,2018-01-30 14:02:13,102
0x51343d8a64f408eb858a7f541cc1d32bbf4ba70b013ea27022a06f0b0e4a5df8,t,21000,5964690,,5000083,2018-01-30 14:02:13,103
0x93108e8ba41f654fcd8a5219699ca98e832c053c5b3d20ac8deeecaa15c62fdc,t,51921,6016611,,5000083,2018-01-30 14:02:13,104
0x190b5312eda5dbc308bb7b3ae6ff5a8fae2361ab85704d20a7b639de7d89d732,t,174591,6191202,,5000083,2018-01-30 14:02:13,105
0x2fd1e197f13e751e930934c91a3b9973c9f0b70e3adaf5302cb1c3b1a4163e24,t,29493,6220695,,5000083,2018-01-30 14:02:13,106
0xe8acd2ba34f3bdc87e6d53e839b071e9638ae3d14ba6af06cc6e35c5bf0473cc,t,21000,6241695,,5000083,2018-01-30 14:02:13,107
0xd2ae7f72b14bd41be0aa4fd1393efb4b1852b9d6f9716dd4af5595085f530d85,t,49116,6290811,,5000083,2018-01-30 14:02:13,108
0xdce9dd957de839a4c37d0ae00fdc0e7089b83fa0790b63086bb441c1cae2725a,t,93242,6384053,,5000083,2018-01-30 14:02:13,109
0xf1c8015f54659be1ebfaa28c4d088673e80c5cf87fc52f25bccdfecc620a5d4f,t,123050,6507103,,5000083,2018-01-30 14:02:13,110
0xe5104f60bde9d2ad01c4286efd4eec317ede7858ec5f6c0f83cb9edbd502f889,t,21000,6528103,,5000083,2018-01-30 14:02:13,111
0x004980ee29982c193dc7e3ea3788c783baeacf8121e90a7eee2010ce9aed15a3,t,34207,6562310,,5000083,2018-01-30 14:02:13,112
0x117b28b8e096ee5800b421ccb7f63f5462edd999123a261a10583433f8a58e80,f,23220,6585530,,5000083,2018-01-30 14:02:13,113
0xae2d73c2b8f230ca4ad1373b902e15325aa64f9671324af4881378beeecf2c08,t,22900,6608430,,5000083,2018-01-30 14:02:13,114
0x07914dee649fc386f7f45285d5578b5038a35091aa1c38845baf79be8e2bbafa,t,44354,6652784,,5000083,2018-01-30 14:02:13,115
0x4bd41b7c51e5a5d7c693918d44485b08db5d0f4dd5cf174b47b4591c7e9ecefc,t,21000,6673784,,5000083,2018-01-30 14:02:13,116
0xb85f147a0b86af8902da8c337948c052c0ca360359ba59d1f614a4246e59c8f7,t,59354,6733138,,5000083,2018-01-30 14:02:13,117
0x794100e49e6ed3df1180fd96d04a4f24b4c4ab0a7eb64135d11cf5507cabca23,t,107666,6840804,,5000083,2018-01-30 14:02:13,118
0x4c478eb740a1e9ba877a2df0b109cc5ca2c361b98179e6cfdff38b66b8aab9b5,t,21000,6861804,,5000083,2018-01-30 14:02:13,119
0xe8dfda99568d97d4b5b567f99f38c287049011ba2a3f396ad1b2e0b6029beb7e,t,21000,6882804,,5000083,2018-01-30 14:02:13,120
0xc24ef6f3df910ecfc64582c3ee6939953a56175f5fec802df347d4e35ec433ef,t,21000,6903804,,5000083,2018-01-30 14:02:13,121
0x0f14c89f4e437df1f8f066429c8df30ea0a7e86a61803aa24ba4ad35793484b7,t,51560,6955364,,5000083,2018-01-30 14:02:13,122
0x10c51ecd5db19a714e4055a9ee1bc5efc079291f5d82079fbc0c1d859a89dac8,t,21000,6976364,,5000083,2018-01-30 14:02:13,123
0xf1b7472da2e38b2023b4e5bbf728a5da3eaf1c19453db120667e32c38914c197,t,84005,7060369,,5000083,2018-01-30 14:02:13,124
0x8d74b296b3e65ac865284993cd0d9b6fe5fe81262c717f6176ee9d9c00d4dea6,t,21000,7081369,,5000083,2018-01-30 14:02:13,125
0xf01b738ea757f27addb3e3e073f5f2492d3da4d44bea5d0b2c1b07111b3b8c9e,t,66357,7147726,,5000083,2018-01-30 14:02:13,126
0x5ede042c7840dcbb718f450b63584dc4aa7e8d1780e79f981163c4d072936f63,t,43523,7191249,,5000083,2018-01-30 14:02:13,127
0xb0bcda4a590ba6503bca3bfe312716961bf4bc6ae23f01aff36ea36f0ec95775,t,21000,7212249,,5000083,2018-01-30 14:02:13,128
0x677555eeb348ba748a97ce6a2362c6bafcbfdd4519e91359d6464668c839cbfb,t,21000,7233249,,5000083,2018-01-30 14:02:13,129
0x60fb313a09bd1f9f7ff816fb30b5d058ca4d4f5b56edb38be4a58c6766388574,t,21000,7254249,,5000083,2018-01-30 14:02:13,130
0x0bf6cda83f45e49f2f4513e5fc677bd3bdce68ff07edc678bd82cdebb4b3d71e,t,47836,7302085,,5000083,2018-01-30 14:02:13,131
0xb5be1be4278cbfe55de61766056babed090f65cb7a027d2920f7adc7d176dd06,t,21000,7323085,,5000083,2018-01-30 14:02:13,132
0x3bfe0df333ac058d5170867a9649e7a37ad3760145ff0677d04b1af00c7e10af,t,21000,7344085,,5000083,2018-01-30 14:02:13,133
0x27b6411637d2ef7b51c8a86f036aea17a21de29ee86ec66c88950b3d326fad33,t,45706,7389791,,5000083,2018-01-30 14:02:13,134
0xc925ffffbb9ca344c1cdfd599cc1cbab51ea69a212be7a7acf34ba2157ac0dfa,t,21000,7410791,,5000083,2018-01-30 14:02:13,135
0xe096fa99d86c7734efd3c87aac1fc17b4b7bd87e13730080bac7578a69b08f19,t,21000,7431791,,5000083,2018-01-30 14:02:13,136
0xe30448cceaba3c13c1f532fc442af410054905bc108d4f4da3c1f6ec2063d949,t,67941,7499732,,5000083,2018-01-30 14:02:13,137
0xf17fab838a65afd31ff1559c2f484ae95b00ec6f8992f97efe0b9f606bfab213,t,36792,7536524,,5000083,2018-01-30 14:02:13,138
0x803a36260355fe1484c411ef0f80077e48e8952ab4ca40fd5d62a98696137f15,t,52886,7589410,,5000083,2018-01-30 14:02:13,139
0x42b40190cc3e37c09f315a0d56a06cfbe90c2d86329f8aac988355cef48273d3,t,52187,7641597,,5000083,2018-01-30 14:02:13,140
0xf79eb21eff2d4d0109af8ff834e4bf35cffef5ca45d7a1bb3ab4e22332e96ee9,t,127772,7769369,,5000083,2018-01-30 14:02:13,141
0xa1a30ec0f8a7595e37bda129b74d1168bdf598d8706c17e2616dd43fc2ef8369,t,36792,7806161,,5000083,2018-01-30 14:02:13,142
0xa21bb22c32918e568f72194c94f1b59efcdaac7547d3d6e3b62b5a2c0d0c9da6,t,52886,7859047,,5000083,2018-01-30 14:02:13,143
0x4410c64bdecf41ac1c3f0848a7e6f12809a720251f17893ac8a85ac74f681b97,t,52886,7911933,,5000083,2018-01-30 14:02:13,144
0x0e4956cb3e040e9d8e83db05c004650ad5fc421e432648ab57d0cd15bc01d11a,t,21000,21000,,5000084,2018-01-30 14:02:51,0
0xe9a627f630ab072b156f8730bc77e2b389c1d7ca70a70dfacf34c210b888a539,t,21000,42000,,5000084,2018-01-30 14:02:51,1
0x418c6d85242b0d9e53a02b1c4e2b9358470c7e9eae4eaf6692fc59d7645259e7,t,21000,63000,,5000084,2018-01-30 14:02:51,2
0xd89c87cabaab68ea2cf503f849e96a8a6543334102ee4573635ed64664b889d6,t,21000,84000,,5000084,2018-01-30 14:02:51,3
0x093ed4ec8bde0ae30ade6720a58cfc14d1a715ffdf3da1ebfafc51b9d0fd4d62,t,21000,105000,,5000084,2018-01-30 14:02:51,4
0x95422606ecf6455237e541b46e06658a08d14fc4ee5a248f24b1d1929e32ecc4,t,21000,126000,,5000084,2018-01-30 14:02:51,5
0x1949da884b511b522b81d2f3cc2f9bc41910d55b1335d23c1cca1f8cdcca70a7,t,21000,147000,,5000084,2018-01-30 14:02:51,6
0xe1ecf3a12cf9235dd60a950af4e78104c602cfdedf9ddab53c0e8492551709ee,t,21000,168000,,5000084,2018-01-30 14:02:51,7
0x28b5f7acb79bb9d67efd96c1756702c9808d2f57385c6251ef8da9ff2f74fe21,t,21000,189000,,5000084,2018-01-30 14:02:51,8
0x4fd731d39b9a811177f43020d847c6c74d212509d27cf27fff6cc9917ab96d51,t,21000,210000,,5000084,2018-01-30 14:02:51,9
0x6936c6b14ad76de1481aabd947ae6b6e5bcb5c4af7de9555a27057f302f6eb9e,t,21000,231000,,5000084,2018-01-30 14:02:51,10
0x4172850c356bc615d93b80d0cc1bda4af7eafe9bb780d047b81df1abac17f351,t,21000,252000,,5000084,2018-01-30 14:02:51,11
0xf552712dca3b2d2f6892be45bcd17ad36b158561b5b3419af6ef3393d1a597f5,t,37400,289400,,5000084,2018-01-30 14:02:51,12
0x76f9c8c418935431799b675b39cf7c752e0398982c6224374e5a53c3a86388fe,t,21000,310400,,5000084,2018-01-30 14:02:51,13
0x6083db02f2f8981f83bbf57100a29e316b220f5a23f966900d7ff01ab30eb711,t,52611,363011,,5000084,2018-01-30 14:02:51,14
0xf2a8c86bce483719df302350113cd0f71d9320277913e6538e05005ec2a4425b,t,51394,414405,,5000084,2018-01-30 14:02:51,15
0xbeb04f1b52b2ed18f08379ea05b660f317889dcd3425375982c2468c2ad8a651,t,21000,435405,,5000084,2018-01-30 14:02:51,16
0xcb66109535aea89cf9e2318145688213becffb500ece8cc39eb16420461b7ede,t,54835,490240,,5000084,2018-01-30 14:02:51,17
0xa20adc5b9cce056462b4cbdac997875a41a0fd693f71d1ba4eb9f023caf913b8,t,21000,511240,,5000084,2018-01-30 14:02:51,18
0x5a9ccb3811843fde8c5491cb3677ea06a83ee2b45a5413a948a62019031b0afd,t,21000,532240,,5000084,2018-01-30 14:02:51,19
0xa9dfe001b38790082b8520284524284d9c01e4cbeaeeadc73d69f667a1430386,t,21000,553240,,5000084,2018-01-30 14:02:51,20
0xa8c67578ba79d62cf619a8f7c89de8fce26727a181368b6a68b9c4df5d598920,t,21000,574240,,5000084,2018-01-30 14:02:51,21
0x1e7b1fd581dd0344d7f485ca2ee91f3804379d3e776ff5cdde52c4f6172d3b0c,t,21000,595240,,5000084,2018-01-30 14:02:51,22
0x39356ad7071509fc9b46106f4a4c5a5d2355cdbbc337d595ea8b8105063bcd25,t,21000,616240,,5000084,2018-01-30 14:02:51,23
0xbfcd98f2d248bf2008cbf5e64ee2ef7f6dfbdbcaaf7e14876c2c7d3f099bfc6f,t,21000,637240,,5000084,2018-01-30 14:02:51,24
0xeb285ebf46c697fc5b5f53e7436ac459e1afab7eff51bc889c1a8d2afd9891d7,t,21000,658240,,5000084,2018-01-30 14:02:51,25
0x85ac7c7a470bfc0d52aff094217809c25116c329ce05008baeee4a6c3c3dd273,t,21000,679240,,5000084,2018-01-30 14:02:51,26
0xfac0314dee92221725ab1e8dd7dacb761ec3b36f3710b74e3f457a09f2b3bf63,t,21000,700240,,5000084,2018-01-30 14:02:51,27
0x877a1fdfa1bfbb5367ab46507a59866bcddec3abfe241341c0daf99ced000d71,t,21000,721240,,5000084,2018-01-30 14:02:51,28
0x00d7613806e19b8299c44a91382ccefccf7d2e261526ada9f0e3a9e966faa948,t,21000,742240,,5000084,2018-01-30 14:02:51,29
0x50a0bbe3a1abf82279bcdd230b55b0d5765ba5223f48951441c428e09c244e07,t,21000,763240,,5000084,2018-01-30 14:02:51,30
0xe221cc1388621b23faaf0bf8db5c26a0bf4c485764962cbc866de5bd861549a4,t,21000,784240,,5000084,2018-01-30 14:02:51,31
0xdf09664df251717dea942a62685023f64e16cd591b159a155eb944cf803e086e,t,21000,805240,,5000084,2018-01-30 14:02:51,32
0x1dfe94588d7467b0c98412e56f7d01198223a2c936cc66353355c3d3c47f0c41,t,21000,826240,,5000084,2018-01-30 14:02:51,33
0x63fcd92133f2acd34ea90d04b92ce09e05b8aaecd8dd1c251c182797c1d40886,t,21000,847240,,5000084,2018-01-30 14:02:51,34
0x60689e1790197162f98495ad993471994bba4c8957dc56fa4779a9e4b1e18fcb,t,21000,868240,,5000084,2018-01-30 14:02:51,35
0x827ac85c8a26e67333398aa1117088d2a0dbbedb78c2735cf4b45158edfcebe6,t,21000,889240,,5000084,2018-01-30 14:02:51,36
0x79a17aaa8f989afcbb3eb34e2ab8cff17b49fc200a9dbcce2402a1f314e54951,t,21000,910240,,5000084,2018-01-30 14:02:51,37
0xe89cfd3c693116a9a47c6c47a9cd924091850db310dab746017ea79d9ac611a0,t,21000,931240,,5000084,2018-01-30 14:02:51,38
0xd77e4120e2e5fa7ce1f350753732acb7652eb77d2b0feeba894af00d62d87f60,t,21000,952240,,5000084,2018-01-30 14:02:51,39
0x610a66b55ffe1da8d166cf13464623a182f018688913b37b4f48b2ff764819af,t,21000,973240,,5000084,2018-01-30 14:02:51,40
0xa877eeb3e32dc502326bfcf29bfc55671d3b00adfa076f865ecf9c437a0e88ba,t,21000,994240,,5000084,2018-01-30 14:02:51,41
0x81f55544c87fb34d800cd898373455728a0d80f26bcdc650a8e73a4e28c77e64,t,21000,1015240,,5000084,2018-01-30 14:02:51,42
0xd0b0ac14c1556802a6af5b2e81bc228b4740a2250b78d02fae01a40783e68d65,t,21000,1036240,,5000084,2018-01-30 14:02:51,43
0x80d6e08a932c7f53a5ba72ee6ea78a62c5194c3aed87e886f8009b4f873354d9,t,21000,1057240,,5000084,2018-01-30 14:02:51,44
0x5f8b57dcb2e6b40af24f70af484de7d1faf89f110df35c29f433b774b1097864,t,21000,1078240,,5000084,2018-01-30 14:02:51,45
0x3e835fcdb993e9f103a29893a2e6a4502b3d56c2e053fbd5f2e73e303c9c8143,t,21000,1099240,,5000084,2018-01-30 14:02:51,46
0xb65bf68bfcf1a9e438b262454e2407be8a3fee0bc73ca568f60c0f9171274f83,t,50057,1149297,,5000084,2018-01-30 14:02:51,47
0x4c5a864c1883d6d14e8e5a715593cab6b992c7b671ad7bc1820e204cd8ce98f4,t,34470,1183767,,5000084,2018-01-30 14:02:51,48
0x6d5fbee66ff4fc2f6011d0e9a23cc9daac997c1026410eb318975222c60c29d3,t,34470,1218237,,5000084,2018-01-30 14:02:51,49
0x8c8fe2f7c9a88d4edbde44dc974d4fd590dffb50b2dd376dc4b1c7c902ecfdd9,t,34470,1252707,,5000084,2018-01-30 14:02:51,50
0xfc5af8564d984cc14b2503c8783392a885ffe5f647dadc3faf3284bde015193e,t,34470,1287177,,5000084,2018-01-30 14:02:51,51
0x0437d45573154719a10ec4b78479118459c2a86cca5791ade7674c04f7c09145,t,34470,1321647,,5000084,2018-01-30 14:02:51,52
0x01159e28b6ec6665412685f7ee76ca60cab11bc387f324d29d0dd0b8b8391444,t,34470,1356117,,5000084,2018-01-30 14:02:51,53
0x91e0451d80f97b38c0218ff875607dd256cf6723ffc1414a031b2f2ee10de915,t,34470,1390587,,5000084,2018-01-30 14:02:51,54
0xec02243934765a56698e99163472fd75125e3150c16872859d20e62645caf651,t,34470,1425057,,5000084,2018-01-30 14:02:51,55
0x2741acfff7188f67e3c3f2d649dfd75a0db9cdc793edf600d44180130e72e1cd,t,34470,1459527,,5000084,2018-01-30 14:02:51,56
0x1ed38c24c4400e18c93650f31bfb91ae3801078e5f5f8d5146ad34c9be4bd12d,t,21000,1480527,,5000084,2018-01-30 14:02:51,57
0x4110609609b1641efbc7d50896db9cb91530ba9915fe789fb0b3f295e3688442,t,37449,1517976,,5000084,2018-01-30 14:02:51,58
0x93397dc770d00bfb1579813e68fef6db52887e5518a4e92d799bbc603d1f5cb8,t,21000,1538976,,5000084,2018-01-30 14:02:51,59
0x29f4b76378cd554a5ce82c7235dfe71145589a1a75724e1769ff63afd8852174,t,21000,1559976,,5000084,2018-01-30 14:02:51,60
0x8448a7341c1806529bc4050900f5a552da7da7eea9cd87c809e5cec393ef71fb,t,21000,1580976,,5000084,2018-01-30 14:02:51,61
0x756a85a10f7375f2bdae102ce409b19a580471cf96da122e5e3d353fb5d8c908,t,21000,1601976,,5000084,2018-01-30 14:02:51,62
0x1eef45d46e9091049e9b119ef4cd1a3e7153ac78db85f24594d167f51187b4e8,t,21000,1622976,,5000084,2018-01-30 14:02:51,63
0xa3b11ad587bf9f666633332c1cfefc488eefd91cbcdead42c432c5c8cf7f3daf,t,21000,1643976,,5000084,2018-01-30 14:02:51,64
0xee068799e69b7173c3457101473b08cab88276d6648e924c965c2c4361a157bc,t,21000,1664976,,5000084,2018-01-30 14:02:51,65
0xfbd973dcca5f72428150921f9f42c70f26cc58942b8c5d021b0aa537619cd296,t,21000,1685976,,5000084,2018-01-30 14:02:51,66
0x10c1a087c441d899ad789d8d7be1c18c25de8e41cc6b22e49d4fa42be78ff5f6,t,21000,1706976,,5000084,2018-01-30 14:02:51,67
0x7aaad21ecaffb6c3288804434390f8fd87bf12b8bab86e9bb46fd42a8c82f3ae,t,21000,1727976,,5000084,2018-01-30 14:02:51,68
0x6b2f6b638701c8fa8807581e5641980d16df5e7292bbfcf2e56a16632c910045,t,52404,1780380,,5000084,2018-01-30 14:02:51,69
0xf862ebdd0b1b7b3277db920bd7593ba96baa18a3a526f1f3e4f24dede508dade,t,21000,1801380,,5000084,2018-01-30 14:02:51,70
0x93e041ec7b22298eddb39cb3149aee07503d8d0b0b14459fafbf72c165914123,t,21000,1822380,,5000084,2018-01-30 14:02:51,71
0x3f3d84443bd90224c89f01918b47f22c58129cd399f161d6a8aed606e65ecf80,t,21000,1843380,,5000084,2018-01-30 14:02:51,72
0x65c71f1e0fb99499a0e5e1258c1d642520e51402476c166a5db3849360048684,t,21000,1864380,,5000084,2018-01-30 14:02:51,73
0x2298c114e97bfd8889de0c46bdaa1b7f1fabf566d1796903c15ca685817aa2d4,t,21000,1885380,,5000084,2018-01-30 14:02:51,74
0x40841fc280113af8f84065f30550d536183989667518c3a7ef009957e9e52dc4,t,40843,1926223,,5000084,2018-01-30 14:02:51,75
0x8e285154e647597664b1e953c99139f9c0f97ebf0a1dfdfa93b5a8073f6cd4fa,t,21000,1947223,,5000084,2018-01-30 14:02:51,76
0xf11056dc62b599c1acfa43fa3abf43c1c26bbdd886a208207a286570ec830a18,t,21000,1968223,,5000084,2018-01-30 14:02:51,77
0x4d684ece8120489668d39d8fc196bbb6cce396585a31d1623e5e138632a6bd4a,t,21000,1989223,,5000084,2018-01-30 14:02:51,78
0x2e855017c978ccc253b1d9c564d0a21621774c9e773a1f667222e647cc33247c,t,21000,2010223,,5000084,2018-01-30 14:02:51,79
0xe71896c37669054a164b7a005d323974d3505426126641b983d0fef334d02370,t,21000,2031223,,5000084,2018-01-30 14:02:51,80
0xd9190fa7379ef0c29541210c49f842e497075ecbbf7346d1274b4e22d909b7fe,t,52524,2083747,,5000084,2018-01-30 14:02:51,81
0xff4c9e1960f28f68b97caa9f13f950b3f82235b2f3a7b2adc64a01e7604b1e4c,t,21000,2104747,,5000084,2018-01-30 14:02:51,82
0xdf959111c5bb3f5b111d98deb9da969161204b3588f99c59b865bb81ee0d2f24,t,21000,2125747,,5000084,2018-01-30 14:02:51,83
0xd875a8e199e2a13153135ff3855db891213f1c068d2560c642d92c315c469dbc,t,21000,2146747,,5000084,2018-01-30 14:02:51,84
0xa41d07a48dfefd91ef33392bfe08c9f2ee06a15830882418ebcfd62d374c9eb0,t,21000,2167747,,5000084,2018-01-30 14:02:51,85
0x1ca18164121ea267fa4c80240b64a22fd97aad2ef074d7750dc35ccb07330e44,f,21000,2188747,,5000084,2018-01-30 14:02:51,86
0x3f72e43dc42d299ab291d3249b134305705e9c8fa7ef9486589a3ab2fd63c566,t,21000,2209747,,5000084,2018-01-30 14:02:51,87
0xc94988398f652b0f1e780678220622eb6a3ae658e77c9977b848a3c828e1a1d0,t,21000,2230747,,5000084,2018-01-30 14:02:51,88
0xa91bdf647ca42844bf0ea30cff00201d2dca3a9c26ef5d59d09838bf45b7e9f3,t,21000,2251747,,5000084,2018-01-30 14:02:51,89
0x9960be3047474129a754b4155c18e65240a04d660ed49cba705f356e5944bb3f,t,21000,2272747,,5000084,2018-01-30 14:02:51,90
0x482fc29b5b8c8c4591fd032a042d3ed7ce4e2aa1932028c1d8811f7d7c807f6c,t,21000,2293747,,5000084,2018-01-30 14:02:51,91
0x65ab069d66fc489b88cc1e667c04fe8aac02a4d3e1707b701133b1f22025e47f,t,52711,2346458,,5000084,2018-01-30 14:02:51,92
0xe910687ce2b65017e94ef74bf66a614069bbf75fdafb7f22e378eef7a7df09b5,t,21000,2367458,,5000084,2018-01-30 14:02:51,93
0xff756d7c04352d59fe5e674faa1217f69b862c8678b8a430149123808c38a978,t,21000,2388458,,5000084,2018-01-30 14:02:51,94
0xa7b3f22de0989b5b28836df13ae3331d52e6e76e5c78fc5c580a361bc4a42936,t,21000,2409458,,5000084,2018-01-30 14:02:51,95
0xe602de5241bfabafe720e8f1b4b7d2d083eaa67df10de8d2d4160d76f8e835f7,t,21000,2430458,,5000084,2018-01-30 14:02:51,96
0xc359f5d9a3e27ed6909b070beb50886f4425f612a11cb7de3c9647242aa58c55,t,140972,2571430,,5000084,2018-01-30 14:02:51,97
0xe3dc0503be302760ffcf091b4330768a9dd01ec4f188cf0c66e29219dac8d100,t,21000,2592430,,5000084,2018-01-30 14:02:51,98
0x9f9b8010ac903f783f43aa67c482c028307ac4bbe4f10c7f1c2be5372f3c1bd5,t,21000,2613430,,5000084,2018-01-30 14:02:51,99
0x5f6003da5f53be3b57e56281af4ad5ece360300bf81e36fd0f7645c1b52c0463,t,21000,2634430,,5000084,2018-01-30 14:02:51,100
0x3092238a3242b369c2d87ab82ce4407d5ff384fc0f434044f40d4dc1d59bfc6c,t,21000,2655430,,5000084,2018-01-30 14:02:51,101
0x16dd2823ff2d6ee895a22de21b065a118a065c673f9e0eae919882540546bda1,t,41043,2696473,,5000084,2018-01-30 14:02:51,102
0x9ac80f6b06451eed3a06582c39b6af8e201a8f5d7d0563397061f5c7b709d80e,t,21000,2717473,,5000084,2018-01-30 14:02:51,103
0x2ee40f2513e93c8c16383d3a7bd3bb6cc3c6ae0841bc2ec46c5e3ed8be87b1f9,t,21000,2738473,,5000084,2018-01-30 14:02:51,104
0x3e9f49d9afe859ef6386f19d98590f241425ecb19ba7b5e892f9e6f6c9b956f3,t,21000,2759473,,5000084,2018-01-30 14:02:51,105
0x11bb8d5a20c637224e1be72da9663d87e64a5fd85008bb59fddf34f4ee851881,t,21000,2780473,,5000084,2018-01-30 14:02:51,106
0x6c44c14049055c015b5e5568d27c3d5b04926252a9290b44f0714a27045464d6,t,21000,2801473,,5000084,2018-01-30 14:02:51,107
0xa5e4ae43c03627be122dd53fd1d1af6fb2f3cb40cce593082908528717d328fa,t,21000,2822473,,5000084,2018-01-30 14:02:51,108
0x0de41a84688b13be443fb14436d41a058baa6d141c26efe4e994bf050a0f8036,t,21000,2843473,,5000084,2018-01-30 14:02:51,109
0x1522722392e269eb10c81c91652adb9f04e1ff57f349a2ddc24bd193c02e94df,t,21000,2864473,,5000084,2018-01-30 14:02:51,110
0xd211b740e0ad5042dd0ac4f01054fe35961a89569462d2d8c6e3e5210101126c,t,21000,2885473,,5000084,2018-01-30 14:02:51,111
0x04e649f0ac929eeffc99c821faceabcbee6c313444078ed6bcc308cafa4d649d,t,21000,2906473,,5000084,2018-01-30 14:02:51,112
0x9895834f377a595fc8ad2ed12a95d04b569de2ed49346873e585e7628aad4d65,t,21000,2927473,,5000084,2018-01-30 14:02:51,113
0xe5d834f5da035e44d02e6e7f03ad537d799ba1c6e1135b5a37d9ac11c752514d,t,21000,2948473,,5000084,2018-01-30 14:02:51,114
0x0f2ed43f955faecd529082e838c0cabeea15cfaa2593c1538b140c56c8052f97,t,52907,3001380,,5000084,2018-01-30 14:02:51,115
0x5e7d787c3bf2b4d93121641d821a6e0877f5da0c0ec82daeb6710183c99bb82f,t,21000,3022380,,5000084,2018-01-30 14:02:51,116
0x2645d932040ab7b99a226d7b51e4c9bbf64fdb5707379e3c4b67657e5bb74b72,t,21000,3043380,,5000084,2018-01-30 14:02:51,117
0x70eba914c326e4f6a3d49fb947c399eb9df32f15bc94263ecab12953bce1d77f,t,44854,3088234,,5000084,2018-01-30 14:02:51,118
0x4f6abe1cd85e75a34d6ccb6e6e358373ee98c06c0b9d2982dc9b4a5f233ede71,t,21000,3109234,,5000084,2018-01-30 14:02:51,119
0x8437088357f6a9cc5fa5dc322b7c6b4b12c4da9fb3b36fc1b21f671bce616f4f,t,21000,3130234,,5000084,2018-01-30 14:02:51,120
0x176060a45c265afaf7072b44645a27e55333148effaef5565242cd7303c54327,t,21000,3151234,,5000084,2018-01-30 14:02:51,121
0x355f80e4d2927f65c18c4c8342a1ae53b13c4f3b84d58fc92af34c03804d2a02,t,21000,3172234,,5000084,2018-01-30 14:02:51,122
0x64d3c88794af24d7fed462d847230fd44314b5d0f1f1d410f5ecac2858ab32aa,t,36815,3209049,,5000084,2018-01-30 14:02:51,123
0x0062f2d2398367ce1c49d30213d58257b3ffa5dd701fe4e58d23dd4330a7f483,t,21000,3230049,,5000084,2018-01-30 14:02:51,124
0x10abf596abe8daaad579209d8b816879560d0a4bb64730fee0ad72a353c4d5d4,t,21000,3251049,,5000084,2018-01-30 14:02:51,125
0x10259de9a012470cc97107de37723dfdf19a464e41ebfb79b9d2efad8192eefe,t,21000,3272049,,5000084,2018-01-30 14:02:51,126
0xf260bc615abe100b2efaab78c6428d12aec7516e0b71a5fcd4caa302900e9ac3,t,21000,3293049,,5000084,2018-01-30 14:02:51,127
0x078bd3f348166c72756ace2055160a48c2b4b59d01f41ef4941c74cb1856b84c,t,21000,3314049,,5000084,2018-01-30 14:02:51,128
0xb7129295974fc505c1760ad03d2a69a89191eec28e6c8444810c9ec1256c2fd3,t,21000,3335049,,5000084,2018-01-30 14:02:51,129
0x43c46ef2fe6b42e033d746ddf3b837641ba9bd6cc993a842df858a9c4f2556ff,t,21000,3356049,,5000084,2018-01-30 14:02:51,130
0xdaffe901837f3c0ab33e6d77c57ed607d9c873286ae14187dd220b2d798fec41,t,102998,3459047,,5000084,2018-01-30 14:02:51,131
0x135931c749aa1815d9c0e61cf96a0685830a180108d309eaf9cc6d59d72de40d,t,21000,3480047,,5000084,2018-01-30 14:02:51,132
0x947767c5366a85f86dade53b332a81ffd09005d3279723cb1b0ba0b9f02c9d2d,t,21000,3501047,,5000084,2018-01-30 14:02:51,133
0x9e5c60a27bea9bc34830d48189ddad797b0f689d3f0b04aad73849b436a1f0df,t,21000,3522047,,5000084,2018-01-30 14:02:51,134
0xa5e8632cd1fdc7fd0153386bcf8c45394b6b40129cf338e44e28bc82d97c82e6,t,53361,3575408,,5000084,2018-01-30 14:02:51,135
0x19691ab7cce1ade11c662b7cee5a1b3e5a1438f906346d476d51d5ac934be399,t,21000,3596408,,5000084,2018-01-30 14:02:51,136
0x0ab3dc8ee86878fffcb2e52f5c50c0f65884bd99e2c1e0065069b40983c64ac3,t,21000,3617408,,5000084,2018-01-30 14:02:51,137
0x2da437f4d2162cd0c208a835baf28b94d202df3f7678f735e0d1666ac1a35568,t,21000,3638408,,5000084,2018-01-30 14:02:51,138
0x6542f0388f5537135b1218128035225527f45527d4f085b5eee1eddb88cd13f1,t,21000,3659408,,5000084,2018-01-30 14:02:51,139
0x4ae2b8165118674703605d3026ec0637fc13435588fb6a66127ed8b3649bd526,t,37255,3696663,,5000084,2018-01-30 14:02:51,140
0x7019a494d459f9c863f0f7a1a9f1e52ea73d41b59a9ce896429f72762cf01873,t,21000,3717663,,5000084,2018-01-30 14:02:51,141
0x517e3f2eeccec565bb66f2379f2cf422937535adca8fa476ce4831774b26d0e6,t,21000,3738663,,5000084,2018-01-30 14:02:51,142
0x6f0c8f258b1521f5c8204a104f3a54084f022489eb6eb89a6b730ea13cfa2130,t,21000,3759663,,5000084,2018-01-30 14:02:51,143
0xddf72e5b72d00c73d5677cfa169427bccce58d54602f6deef49b74de08f00b5d,t,21000,3780663,,5000084,2018-01-30 14:02:51,144
0xd6542b92993692a24ebc993f7accd58d5724229e57881d59c73120b66bdaf936,t,21000,3801663,,5000084,2018-01-30 14:02:51,145
0x4dddfd8d7bde88b67627349c65c3b84ab9ba911755ea92029ed106c54b8f26ff,t,21000,3822663,,5000084,2018-01-30 14:02:51,146
0x34bf12eb678bb09695b0b71d497a2ad0962aaa6635b6e62bf2a997fab88aa415,t,21000,3843663,,5000084,2018-01-30 14:02:51,147
0x5f59ebdac9a58a1b2214e20af84caae4c54f7ee37274460872b4140f53d01a41,t,21000,3864663,,5000084,2018-01-30 14:02:51,148
0x466c13c2f48be4f050470403fd597e0e11443c579184160df5adcddee3d692cd,t,21000,3885663,,5000084,2018-01-30 14:02:51,149
0xbb065f6996d04cc4da7d2c4ccd2aedc9ed1031960d5e60feb3d2d0acca625141,t,21000,3906663,,5000084,2018-01-30 14:02:51,150
0x8b120c38c49906eda1fea89887226972066fbab842353f1c8e79e35453ed81de,t,21000,3927663,,5000084,2018-01-30 14:02:51,151
0xf7080e23ca59efed69a2271ff79c66648f9a1a874b5e57018ab6d6a98f733eb3,t,21000,3948663,,5000084,2018-01-30 14:02:51,152
0xc3516577b573db249c4fe7f301993ac0b625f123d3ae5bae4d250c1ab65d9e11,t,21000,3969663,,5000084,2018-01-30 14:02:51,153
0x07158110fa7e2e38836dbee839d768355c81fa6a5909c583ac62f72119e61c1e,t,22142,3991805,,5000084,2018-01-30 14:02:51,154
0x34f65c4904119dcd752d41a21880322c3469710efa81bfc5ad6a2574d5b4d3b3,t,21000,4012805,,5000084,2018-01-30 14:02:51,155
0x57423a68600966f90f606948e2dabd8e2db959ab1ad666c9a910b8684af8b2eb,t,98791,4111596,,5000084,2018-01-30 14:02:51,156
0x1c7bb7558549b45b4cdec5f5bc3d854c282cebc0f89a6274c9f751cf7fec6d10,t,21000,4132596,,5000084,2018-01-30 14:02:51,157
0x2e5b3230a4c87d0a2119fbc090c57bce826dbcb0b3d578f148590b6fb6f54cf9,t,21000,4153596,,5000084,2018-01-30 14:02:51,158
0xcb72876cd36884d288b20d93079e03bad3dbf4410873e4dd73a1eda8a1a13852,t,21000,4174596,,5000084,2018-01-30 14:02:51,159
0x91b579c9f23a7f71714828e0792401a4226eb8a4d0564882b6e285d65a574b4f,t,21000,4195596,,5000084,2018-01-30 14:02:51,160
0xd43f2f3f1c2a482f0b1321d667d50cc3f33cf03c7f8e9943c58f6b628175af92,t,21857,4217453,,5000084,2018-01-30 14:02:51,161
0x044deb78de8020281a0b465154a6d8e09f8e0b7d46b8c2f235c537652f6ec442,t,21000,4238453,,5000084,2018-01-30 14:02:51,162
0x68f7d6c2f51ab811b4a4989be8b37f322d1902475e8d78eb3c1241f3d3ae5e23,t,21000,4259453,,5000084,2018-01-30 14:02:51,163
0x8cd23bd049a41e66fa5ad48dc40c45a1d5c575989a0f3547d2f4f121328c1f0f,t,21000,4280453,,5000084,2018-01-30 14:02:51,164
0x74b67788a36dd6e9820ea38a8045f3f1650929d8abfb3e49faae2b3800c32a3d,t,21000,4301453,,5000084,2018-01-30 14:02:51,165
0x36c6fd9aab72842afc8dc421df0188225bc8a839d14adc2b7ec42499196449a1,t,21000,4322453,,5000084,2018-01-30 14:02:51,166
0xbf696e562b3e689b257b45b40e4279bf9df1955028cc486eae39cfabf51cbd38,t,21000,4343453,,5000084,2018-01-30 14:02:51,167
0x1053cc782bcee6f313d6fd78cebd8fcac00660a49564f25322aded330f91b7f8,t,52884,4396337,,5000084,2018-01-30 14:02:51,168
0xab877181b28bd392db309ce999dd40633a8429a2af328dee1a5e65be1bad0b43,t,21000,4417337,,5000084,2018-01-30 14:02:51,169
0xc28f160511b5a9b02e7b961211be59feab837fad1a2165def4bbd6ddf4337cba,t,22031,4439368,,5000084,2018-01-30 14:02:51,170
0xddb085b13083a34cc75f2593943d4384b48bb5079593b89204dbbff80a0d8fb6,t,36852,4476220,,5000084,2018-01-30 14:02:51,171
0x5e2bebc43aa17c510518a9546b1aa8b553bb1b1ace7189fe4ce0d27996dd43a2,t,64725,4540945,,5000084,2018-01-30 14:02:51,172
0xd9a748d03f24fc8d9ac8fa871a6173d888375f913765dd79e324c1f73d9eb7e0,t,21000,4561945,,5000084,2018-01-30 14:02:51,173
0x256de0ac0206b1255e542a9bee0c87e807084dccdc974898f77a511c444dfd10,t,21000,4582945,,5000084,2018-01-30 14:02:51,174
0x729c5e925b37d35b694195cfedf35cbf0181ea74eb226052bb67c2a0ce9c5ac3,t,21000,4603945,,5000084,2018-01-30 14:02:51,175
0xa19a505dadd06075a298b79f92c37652fa625392410a508409999fb27f4c816c,t,21000,4624945,,5000084,2018-01-30 14:02:51,176
0xdc8c87e47bdf813b6f06b6771d7d2f93b4064c561d9f397ddbe31decadcf42a6,f,67349,4692294,,5000084,2018-01-30 14:02:51,177
0x7f005010d9374ce2ee1b4563a23c2f072ed99249ec702766eaf44ed8a74b99f4,t,36452,4728746,,5000084,2018-01-30 14:02:51,178
0x638c470968e5168e33aa0291e7fec742ea3bf6f6954e19eebbad19ed727899b6,t,21000,4749746,,5000084,2018-01-30 14:02:51,179
0xcade1d13456d80f4fdd98d7f2c0f51bb16ff6ee1e6a02a55a9dc116bc413899f,t,21000,4770746,,5000084,2018-01-30 14:02:51,180
0xdd179c71c33d5a3a556a518b793a53da9806b25575ae75e3f884f32a7f17b798,t,37259,4808005,,5000084,2018-01-30 14:02:51,181
0x335a950d60cc920319f021bee3e910f840b5aa30c5d775fd2db71df74645862a,t,21000,4829005,,5000084,2018-01-30 14:02:51,182
0x668d74fd08483d7b78bb384172b51de176a0205299797bd1b3ae33a0a669aac3,t,21000,4850005,,5000084,2018-01-30 14:02:51,183
0xa9364146db9840b4ae9f9636e394254afd705b2b416573581a369adbc55f4c83,t,21000,4871005,,5000084,2018-01-30 14:02:51,184
0x9171886a37789f1e6dc01c02ca6efc64551b4505dc872cd20405fed2cf479e6e,t,21000,4892005,,5000084,2018-01-30 14:02:51,185
0xe9fe4880f44828938eb1e933caf9597e763ac33074ad830a29303cf78f123677,t,21000,4913005,,5000084,2018-01-30 14:02:51,186
0x59e72817fb5be81b1c2ca3132913e88b39c3470a6d7678f9367fcdd2ba1a4129,t,37460,4950465,,5000084,2018-01-30 14:02:51,187
0x1e162ce6a6cb2f3ee13ce8128e581aa08fb578ca35a74b8a4e2a62cab66a0999,f,50735,5001200,,5000084,2018-01-30 14:02:51,188
0xdabee1cf00c6b950ef208d2ea3ed1079caf9e00871a25ce523c38df777841a44,t,37746,5038946,,5000084,2018-01-30 14:02:51,189
0x0b91366bf3312b1729a380af9cd52a94763ba4f415e7f45c8cedc57c630d8ca9,t,21000,5059946,,5000084,2018-01-30 14:02:51,190
0x8869de79faf2d86adabfbd9d59a4e47955ac14b94ea5443a9a9aa0bd52f93b68,t,21000,5080946,,5000084,2018-01-30 14:02:51,191
0x5ec6f019a4060365a492283f833e7adb9fb623cd8537f6996882f7b53bc8b042,t,37148,5118094,,5000084,2018-01-30 14:02:51,192
0xd365da2c5c58a5d5bff6f257f5b82a8ed72ab274313e3b75d9004ca5450bf22b,t,21000,5139094,,5000084,2018-01-30 14:02:51,193
0xb49df07ee848c22e5f9a0407dc263cd9e526195bd03eb32471cb327e37eaa9f3,f,31000,5170094,,5000084,2018-01-30 14:02:51,194
0x882b5a164b7166f973da6a08b267fea567810ae7eda899de84e935bddf41463d,t,21000,5191094,,5000084,2018-01-30 14:02:51,195
0x48bd7767ade263390d33d13177370bc94846a201da3b40db545e9ce146a90595,t,21000,5212094,,5000084,2018-01-30 14:02:51,196
0x7ca9325e68311341882e8ee0ec369ddae9086de49521cb7a44d41cc443f692c0,t,21000,5233094,,5000084,2018-01-30 14:02:51,197
0x0c677242637db4457c45c40eaf1d5512a7d0601eacdce44a66bd140653a88eac,t,21000,5254094,,5000084,2018-01-30 14:02:51,198
0xc444ebe9649ec3e9b60cae834dc06f603f030583fdca73afaa6542ea08481dc0,t,52643,5306737,,5000084,2018-01-30 14:02:51,199
0x4aaca1666382feee2863ef0d2b053714112226e095237ab2ee6b4b47b112c448,t,21000,5327737,,5000084,2018-01-30 14:02:51,200
0x0603af4662f3c1288dd0f761012b5e3df5f6095cf7b1b5669e7e4acf0954cde6,t,22094,5349831,,5000084,2018-01-30 14:02:51,201
0xb4a147fc92b46e01a795903b31ef9b6fa5a3c8161478ab1cd73780b76b1cd26e,t,21119,5370950,,5000084,2018-01-30 14:02:51,202
0xf58d13922e5c86460bc1d19377541105bb2c1f07d6f3991e4e1a13e11107e25e,t,21000,5391950,,5000084,2018-01-30 14:02:51,203
0xae8e458fbd72bca1138599262f01456174c0430649d35a360f8c8562bbf6bc80,t,22094,5414044,,5000084,2018-01-30 14:02:51,204
0x85fd77d74d669a0f843063b18ac29c9918a47c0619ec70e58ad8f2988fad0c8d,t,64725,5478769,,5000084,2018-01-30 14:02:51,205
0x82afb170b167a0286479e056263d3c6cb81f1f984657262a133da66d6d34e193,t,21000,5499769,,5000084,2018-01-30 14:02:51,206
0x6b2b4e42d75aa0bb8c27432f5ab1a5a4f5f7b8092f8bfc68d4f70aadc8d33352,t,29694,5529463,,5000084,2018-01-30 14:02:51,207
0x78b6afe8d4ae091c45da5d4e4fe14662e26f15322a8c490f534c9e03441453af,t,22030,5551493,,5000084,2018-01-30 14:02:51,208
0xea9c10fa0c6b5e75c7b981b2f65db14ce68adc7b249d2fec652da3bdf479a957,t,21000,5572493,,5000084,2018-01-30 14:02:51,209
0x03613826ecc19bb831568a2f876c64ffc4cdab0cc6ef2c5cc38f6528e89bb9df,t,21004,5593497,,5000084,2018-01-30 14:02:51,210
0x086138553860b051f4c33a48421a2de0efa4474eb766e312c00affcdc2d38756,t,37524,5631021,,5000084,2018-01-30 14:02:51,211
0xfcaf19f94b75d8008e24cf6ae3ae16b633f9faf08690cb075da62a82a8ec47be,t,36746,5667767,,5000084,2018-01-30 14:02:51,212
0xf367e66cfa53e384c8f4ed3b659b240913ed3c2dbe49fd25d084353827a98f6d,t,36746,5704513,,5000084,2018-01-30 14:02:51,213
0xd70d6eef7fca49627f1f440bf781cbb8cbc4374af214fb39c03789b96865d3e3,t,36682,5741195,,5000084,2018-01-30 14:02:51,214
0xbaa47a3351a8bc87c3df02c31f1633364aa9eb1c05a162534c2d33d7907bbd37,t,36746,5777941,,5000084,2018-01-30 14:02:51,215
0xfaa4118d51a3bfa392172c1ff9ad67bce97f625256f3c1e30e5f4299cda7c7a8,t,36682,5814623,,5000084,2018-01-30 14:02:51,216
0x6be9d438f95a00a5606f06308d170f68427e56e2884aaea70b97d289a9c23611,t,36746,5851369,,5000084,2018-01-30 14:02:51,217
0xc80065b3f5fe7a133c727505cd69baab0249338c7d340361f41c9a0913c93af4,t,36746,5888115,,5000084,2018-01-30 14:02:51,218
0x761e41e8e1e44dd1b3b0865e3cb68e381185602012f1eec801dac9d0b2fcdb8e,t,36618,5924733,,5000084,2018-01-30 14:02:51,219
0xcd7dc6b5fc1ffb30b28109b3c13b4bab48b21108a8b25c20aab91dcda7bfd7e7,t,40915,5965648,,5000084,2018-01-30 14:02:51,220
0xa7af5f53625a149a64cfd853ce1437d2e2a857364a335ad9561ce5b2569ae29f,t,40979,6006627,,5000084,2018-01-30 14:02:51,221
0x585987c4cec1f453c2fdb9303b2df612c612afd0a8e862ebce4a3530d5d03671,f,250000,6256627,,5000084,2018-01-30 14:02:51,222
0x3e8c7b2736c78c08309df0da33b36512364304d46fdc9e8e02d0615ceddc60a2,t,21000,6277627,,5000084,2018-01-30 14:02:51,223
0x59966e05282c9899be4cb57f45591249427862b452f2dee19ed1a7037ee64083,t,101614,6379241,,5000084,2018-01-30 14:02:51,224
0xf69cafd6b03910ad17285299588084b102136469d67cfd1bbd06f733acb7c808,t,53233,6432474,,5000084,2018-01-30 14:02:51,225
0x49974e3cc732650ad34f342be06d4369e8de0d895db63b9cda6b3b8bab71baad,t,21000,6453474,,5000084,2018-01-30 14:02:51,226
0x2417a531b3abee1d3b65a1de772cd9a90f60bc3e90783238364e1b615a9c7997,t,21000,6474474,,5000084,2018-01-30 14:02:51,227
0x573caafab33b3cc9c92a4b7ebde16903e10be204d4ed292eab2e7d958ae59819,t,21000,6495474,,5000084,2018-01-30 14:02:51,228
0xef399b631ea56cd92966ba8c996e20509ff0ad722c14a82a0ef133d3438385ab,t,53391,6548865,,5000084,2018-01-30 14:02:51,229
0x99525961d1be0bc32c4b819239090cdf46587fde63e3022a3f89d025c731f7ae,t,68696,6617561,,5000084,2018-01-30 14:02:51,230
0x44d637049c8a435b0d0b3e699836fa816bddb2f48be4aa5d6f0d0acdc2d9b842,t,26712,6644273,,5000084,2018-01-30 14:02:51,231
0xde60eea9c6209d7ef60fa144410bf599a41d0855db645130d89412bd9b414c5c,t,52316,6696589,,5000084,2018-01-30 14:02:51,232
0xf61231151eb142195dc2785750d6913cdac3189a920b8d6acd50144e90af7f95,t,21000,6717589,,5000084,2018-01-30 14:02:51,233
0x8706a9ad8b7785f758f9bb27b2f2c6216cefbe6204ed9451c364068167419883,t,21000,6738589,,5000084,2018-01-30 14:02:51,234
0xe38ac6ad11a28e691a866e24eb1c9c7f1ebf880e3c6a7c13fcbfb0c3819dffc1,t,21000,6759589,,5000084,2018-01-30 14:02:51,235
0x7a067d44c33972a84f921a75924a18b8f834d0b8bf1a51e2c63c8b4a52429f00,t,21000,6780589,,5000084,2018-01-30 14:02:51,236
0xdbdeacd8f65053288f6fba3460b24a114bb76fd2b9d2e8c58fc9a0e5e20a9717,t,21000,6801589,,5000084,2018-01-30 14:02:51,237
0x7ab9c253d4d9971356a3567878bb6574cb70838b551128d160a6d3c3355d025a,t,21000,6822589,,5000084,2018-01-30 14:02:51,238
0x1bd129df0bdf4cac0809170e286817883f9183f74192a8b89ae5149de34b982c,t,21000,6843589,,5000084,2018-01-30 14:02:51,239
0x1aaaff228c39267ff39120e4edf090fe9aba67f40535027eb1c50306a86ac074,t,21000,6864589,,5000084,2018-01-30 14:02:51,240
0x9b971b7a9ac1cda1a817749a5605be1aecc979266641fbefdb43c86462b4b425,t,51937,6916526,,5000084,2018-01-30 14:02:51,241
0x54a335536e51d2f2dfbf483087ecd574209eb4240b0982b217c28b8d3ecff7f5,t,30981,6947507,,5000084,2018-01-30 14:02:51,242
0xeff60b81e2eef8b24d717331d7b774309d2e03829da0c71f45ed6cd2b68868bd,t,30981,6978488,,5000084,2018-01-30 14:02:51,243
0xcf93ccea5eb871c93df9378a9fec2146adee3f8be200f32d2d011834133f9f25,t,30981,7009469,,5000084,2018-01-30 14:02:51,244
0xfc832be3388d0a936105f5b96022b8d31866d1484148bddfa46843cb3b44abbf,t,30981,7040450,,5000084,2018-01-30 14:02:51,245
0x4556d723a50894081193261ad93a40c7f79dd3adfac63064a8f0c57e07a5d5fb,t,30981,7071431,,5000084,2018-01-30 14:02:51,246
0xdf15800d5a188f1cc18faed843170dac2cf12136e5f0be90ddc731f85e658e7f,t,30981,7102412,,5000084,2018-01-30 14:02:51,247
0x7d4ac2883b3f12f561ef4c2fd60626f3876d77b55574071f7ee679c031b16357,t,30981,7133393,,5000084,2018-01-30 14:02:51,248
0x3fdf6916b3c51d332c98a776e6eb960724aa4021a8953dbdc13b4d4d9429a4a5,t,30981,7164374,,5000084,2018-01-30 14:02:51,249
0x4049741b30b31057b1532ba5d494ccdb312ed9c310202593d127972ec5dec421,t,30981,7195355,,5000084,2018-01-30 14:02:51,250
0x9ad113e1a483962bc31aea8a163bc547523835ac1b12903316ac64f4198fbf97,t,30981,7226336,,5000084,2018-01-30 14:02:51,251
0x04470e35e422ea2a9a8b4cd44a22bdfb9fff8f5dcafd70a352bfc4a7bb669544,t,30981,7257317,,5000084,2018-01-30 14:02:51,252
0x9c8c1d42525593b263c5fb262ed3d6ebc9c27e982dc413f3d5c4b7c49f498d63,t,30981,7288298,,5000084,2018-01-30 14:02:51,253
0xb48b82a2f829d99627b4a8e60b7d15b461392c24f528b639a6434579722e0218,t,30981,7319279,,5000084,2018-01-30 14:02:51,254
0x5f1bf1678c1865e33ac877ddddae488b3b98d74e97a64cf56251fb8bf110b642,t,21000,7340279,,5000084,2018-01-30 14:02:51,255
0xf7e4db181c5d4c763727972fe9b7ed98ef7dcca5bc91caf341b4d03679b11116,t,214974,7555253,,5000084,2018-01-30 14:02:51,256
0xce50ec45e25719cda98e604559856023d57595ee6b97372a22764589e14ef7c9,t,21000,7576253,,5000084,2018-01-30 14:02:51,257
0xf44f4898432125101c199cf97207749ab82a195cb040d67c8202eb7937597f91,t,21000,7597253,,5000084,2018-01-30 14:02:51,258
0x560d452363ff049023ea118ce933f0de8359134276e61ea8d7e0519cd2cbe2a3,t,21000,7618253,,5000084,2018-01-30 14:02:51,259
0x3d2a3f296b2b16f734a82c2f9d2a5c5e2b425e169b6935c9c4340363c4eed4c9,t,21000,7639253,,5000084,2018-01-30 14:02:51,260
0x6a3ed89f59dc08942eea94b6c92e57880276f4dc8b4e430e632e1df0a02f687f,t,21000,7660253,,5000084,2018-01-30 14:02:51,261
0x883c1d6b1ae2d5641f5c015e6caafe2abc1131d4a7f5e442a0e7a64d6358a10d,t,21000,7681253,,5000084,2018-01-30 14:02:51,262
0x3d962fe0f997f35c24c553cf63d3885367b4aa774349ca321d2c2dd89da6263a,t,21000,7702253,,5000084,2018-01-30 14:02:51,263
0x80bd0e2797f51b014c59a611506e30187596837ce3130d094f787cdb1519c46f,t,53419,7755672,,5000084,2018-01-30 14:02:51,264
0xd7c670f41758e2dc0c57f4e93fa94058f78415ad410a739af5f2b7808ff7a59a,t,36851,7792523,,5000084,2018-01-30 14:02:51,265
0x4d7d2f127f723060e9b1af95895b3cda68028e3dc488d97f32fce00084ca9061,t,37313,7829836,,5000084,2018-01-30 14:02:51,266
0x70cac2b74dcce16d25ae350cf855f375023a9f852b80f3bbaba058ca5deb2acb,t,21000,7850836,,5000084,2018-01-30 14:02:51,267
0x50c70789b79131cbde1a323a3cfc92c34796feacd35c5334a742fc6d754e5c1a,t,21000,7871836,,5000084,2018-01-30 14:02:51,268
0x4fa7e5e755f9b89a3d2313e8ccc08bd3f7f0c063025a2317c886d794fa0d37b2,t,21000,7892836,,5000084,2018-01-30 14:02:51,269
0xb7bd3f6a49d8b6e230546e9682da392dc27720fd4b0f699c2701ba16cc3a470a,t,21000,7913836,,5000084,2018-01-30 14:02:51,270
0xcd05793d3f19554404dc6c548a410afafa2705bf31d168158874226c3c62e3f2,t,21000,7934836,,5000084,2018-01-30 14:02:51,271
0x41acfde64a111336c099a3ec67ca4e9ed41e9e69b5d93830cb760b9b8458338e,t,21000,7955836,,5000084,2018-01-30 14:02:51,272
0x643a8067a352da55914dabb53907d1f7129f43d59de4e23fdb8393416c236847,t,21000,7976836,,5000084,2018-01-30 14:02:51,273
0xdf277ee73d8db402f4b8d9f25d02632b1480e067ab0dbb50c31bca1d8ca46aaa,t,21000,7997836,,5000084,2018-01-30 14:02:51,274
0x2a03d961bdaa78a3d2e72f26625140a051bebaa330c4733fc7382104931173e0,t,21000,21000,,5000085,2018-01-30 14:03:01,0
0x54b35e329e840085b5f874d44a3dbc49fe1ccb02c2b89f246e53ad00ec146a72,t,21000,42000,,5000085,2018-01-30 14:03:01,1
0x73cef701c9deb2feee4942013cd5556299e3cbdc69f782e0a3bd43360b5e8545,t,21000,63000,,5000085,2018-01-30 14:03:01,2
0x5044ee2bb760a76b03828e5eba8581cb920e41f8394b6e6addce1f0b86dc9c8e,t,21000,84000,,5000085,2018-01-30 14:03:01,3
0xf062f462ffe61d596740489af73b02240f527d9cd49dfa063ea6a4122a53c6e1,t,39707,123707,,5000085,2018-01-30 14:03:01,4
0x42d3cf5c156777e3b02c6f296cdd637d809f082b4228efc32ef801e7996c8bae,t,39771,163478,,5000085,2018-01-30 14:03:01,5
0x086f22f2024bd2a2d1524ae4122a70de5de273f23204438cba3e4bb8d8a5c1a9,t,52912,216390,,5000085,2018-01-30 14:03:01,6
0x3dd639a5226e0cb4371cdcf7147d9073ccd5978ff9ee01434142405bc14d0cb1,t,21000,237390,,5000085,2018-01-30 14:03:01,7
0x513bd8fad5ddcb7cd6867b3fcc06ad5d47afbce581d3c27abb95c731dbf96556,t,21000,258390,,5000085,2018-01-30 14:03:01,8
0xe867f74a79d86a757ccb45d7468955d3036395edb68077094fbc35540e0694a6,t,21000,279390,,5000085,2018-01-30 14:03:01,9
0x46bb1173d9d9465fc7dd1279896083fd6a57f56f48f318ee1a417b23836e2ea7,t,21000,300390,,5000085,2018-01-30 14:03:01,10
0xc5857fa22b10d3ff7e054691f1563f13ebb6752f64b9a150ef4c54e10e414fe2,t,21000,321390,,5000085,2018-01-30 14:03:01,11
0xd62e0c0a76c7620e041b6545bb65615870d54fbedf18204304a30c57da458ec0,t,21000,342390,,5000085,2018-01-30 14:03:01,12
0x883e9c8c81fc6391dca45121a76ac020c2d1b38138ef66b29062a9e81a01e351,t,21000,363390,,5000085,2018-01-30 14:03:01,13
0x9281512f6f1f615dc46f3f9e2b9e1bb58669888bb957145dcff041251b8144c1,t,21000,384390,,5000085,2018-01-30 14:03:01,14
0x4151377846758cddac95ac1d0a0d700c7f42e491592af0d6c7bfe61d36457947,t,49993,434383,,5000085,2018-01-30 14:03:01,15
0xcf52d61541ee2d58ee9a261a23fdcfb3ee8012f602c70f18e9893b02b932c7d4,t,21000,455383,,5000085,2018-01-30 14:03:01,16
0xde3b0ca65a6221ee39943e870b5aaa2c16e3a32dbac31277cc7a4361aeef15ae,t,21000,476383,,5000085,2018-01-30 14:03:01,17
0xcd1974bfddf0d91c426ed3068925d348e437dc7855db9e834c019de302c3c256,t,37859,514242,,5000085,2018-01-30 14:03:01,18
0x7270c5d9d3965214c4cd5c934d5a06270aa08aea2e115df9fad7ab79a32e37c3,t,21000,535242,,5000085,2018-01-30 14:03:01,19
0xfbd6164d947bc71ebc601dfc8a9881db17dce32b7805b13aaf72dc601b4725b8,t,21000,556242,,5000085,2018-01-30 14:03:01,20
0xf739414eb39c0a716e0dbbb5df0ab209ce51c40ba95da04e0c8a1625ee249a66,t,21000,577242,,5000085,2018-01-30 14:03:01,21
0xf35008fd74088df3afe65b9a7c946887791126c97320a953b94034edf2e8ab2e,t,21000,598242,,5000085,2018-01-30 14:03:01,22
0x191e542a042b658a2c6b6fe964191b75a48f28f59b1a1b05d1264a762ba30879,t,21000,619242,,5000085,2018-01-30 14:03:01,23
0x97c45c9c49fce063399b5ddcb8ff2b9ccb29aa8e4b83c51e99c3fbae7f2d32e5,t,21000,640242,,5000085,2018-01-30 14:03:01,24
0xcc09e1c643898ce05b20885dace0d1baa9190f12279d3636dc5fb5feb8a5f5b9,t,21000,661242,,5000085,2018-01-30 14:03:01,25
0xbbcc89cdd5cbc2c343bebc799b8b0d19c9dc64de8d932d71f8b4c85dd2a9c639,t,21000,682242,,5000085,2018-01-30 14:03:01,26
0x0cba8197facfb29c8daa8d67f21a42133d6fa9df04f9e07a65aba1eb11079082,t,21000,703242,,5000085,2018-01-30 14:03:01,27
0xa9256b5c90da579a06cde3b692d321af67399cdfe82d93954950598ba82bec42,t,21000,724242,,5000085,2018-01-30 14:03:01,28
0x9e788ee9a2e3bf6962517a026f8e59834a8044d8ba3fe958e25a2520f8fe2cea,t,21080,745322,,5000085,2018-01-30 14:03:01,29
0xe4c08852b7bd57aa24f5545a2e4b5b3c980d60b12d430efa18f8f87d4cf05d70,t,55779,801101,,5000085,2018-01-30 14:03:01,30
0x60e564b2787df47ddac14c00d751533db8a46db1c4f817bdc0273d2265c3d9f3,t,21000,822101,,5000085,2018-01-30 14:03:01,31
0xe344037bcc3f87e9d8f13073ea0712385e64c8b2931e658ea04a2bc1942d426d,t,21000,843101,,5000085,2018-01-30 14:03:01,32
0xea915e3b8093ef6324d67327ddfe959190bd8e4831c0f862f595986faa9de412,t,53361,896462,,5000085,2018-01-30 14:03:01,33
0x9c34df109f37c69fe8d5de536061f5bf4eaf0db4309a7e3883018c138caa0421,t,21000,917462,,5000085,2018-01-30 14:03:01,34
0xfe8104660b9d09330e138919ca4b0ea8359665ccba7c46b98b52839d7fe6c390,t,21000,938462,,5000085,2018-01-30 14:03:01,35
0xa239ed0821b4bfd537e524ac0fab373dde473a76c5b20eb6e693d426e53e4d35,t,21000,959462,,5000085,2018-01-30 14:03:01,36
0x5d9f8d784bba3f1cc1c6f2dfd9e01624410a2ab83cf4c7b62aecdbdbe3987291,t,21000,980462,,5000085,2018-01-30 14:03:01,37
0x6b547c2bd7622621c2994904800542dd71bb512d0ec3a70e9fda9720a3c564b6,t,21000,1001462,,5000085,2018-01-30 14:03:01,38
0xf98e53f78a1367c074fa5ad7c125d1e02218b7bbf1ba79287e45f7f293dfd01a,f,21000,1022462,,5000085,2018-01-30 14:03:01,39
0x41393a59b86454bc7faef6233cd933c7e6c82965390833b92b7d83ed1c4a3c4b,t,21000,1043462,,5000085,2018-01-30 14:03:01,40
0xf4d2e73dd1b983f2042ed7e1c1576c7178d2fd2dfa9f7cb301a91859b5ff78fe,t,21000,1064462,,5000085,2018-01-30 14:03:01,41
0xdc48008e2479b4f207ef9244c64c9be8de8951416964dd888fd649bff2435c3c,t,22249,1086711,,5000085,2018-01-30 14:03:01,42
0xa5dd74ab471024982b70ea927bec315e6e3460cdc65cbf10efe4a4b9ad9582ff,t,21000,1107711,,5000085,2018-01-30 14:03:01,43
0x4d7c41204e2a220e3db41bade2412f69022fdf86df6fa584af5247468a39aa9a,f,50000,1157711,,5000085,2018-01-30 14:03:01,44
0xa3d09933be2612175c8308c04ea711c66367da7cb9b6be3eb0edc854a2cf3253,t,21000,1178711,,5000085,2018-01-30 14:03:01,45
0x22808cc5f7ea606afad7ab5a2ee4134c596cf38dc511c608e4e9ff3e2496498d,t,21000,1199711,,5000085,2018-01-30 14:03:01,46
0xaef341a6bacc4cf0383e90c32993064c4cd7135905b95d54ea75eda0b0b29b27,t,29308,1229019,,5000085,2018-01-30 14:03:01,47
0xa974adb3105bba9f51ea979b6b7056072343b426afb7e50abfeae1629b58cae5,t,21004,1250023,,5000085,2018-01-30 14:03:01,48
0x536c81bbb3a705f56961703188a03e382b7fcd02f84a47b9bb5f08b8f6e93f4e,t,21004,1271027,,5000085,2018-01-30 14:03:01,49
0xb85379e8345cb000784d6f59637062849f0000d8d26dd5b8ab57d3f30ed53836,t,21848,1292875,,5000085,2018-01-30 14:03:01,50
0xfb5abdf60b71dbd4a151b9811b258ec5ae8170607d902ea09db5eddb6a983ff9,t,37455,1330330,,5000085,2018-01-30 14:03:01,51
0x259988a81b3d5ff3d4f6de0e8cd8921c0aa4b4e8df91f5d5392cf1b48f835ba1,t,37455,1367785,,5000085,2018-01-30 14:03:01,52
0xe189b582051c98b3ac81cf13a353c5b462b63addfa7123a1256194cce0ec0494,t,37391,1405176,,5000085,2018-01-30 14:03:01,53
0x0a06b80b2c09a0324474f7d9b853443ebe44e232146a4d3280fc05f5fdb296f3,t,37455,1442631,,5000085,2018-01-30 14:03:01,54
0x1d3e9ad4aa828cc39b9ace464a9109c264ee49882f204b07d494b14531fa6412,t,57825,1500456,,5000085,2018-01-30 14:03:01,55
0xab980f3b959d950bc514dde2e28b52d21e6bc6331bee517017990abbd99afbca,t,21000,1521456,,5000085,2018-01-30 14:03:01,56
0x08998a2145b0f0ceac9c43bced2b23f9689d0df0824f42b93956861663cf889b,t,30981,1552437,,5000085,2018-01-30 14:03:01,57
0xdccac4d03bc925c6ec87eabd1d1ce0d426ef2203b60e9034e63e11e4af91640c,t,30981,1583418,,5000085,2018-01-30 14:03:01,58
0x1665a2c82bb9c904d6fe5f7791b24b2fca04343c9bf96b7abed311512e197646,t,244829,1828247,,5000085,2018-01-30 14:03:01,59
0x43dc97c326c064b7b49b34f899d6bd1e6c46846f28e1436af06943d0bde7443c,t,253854,2082101,0xf9C8bD77Ee4EC337340A3750adCf9c9644D67913,5000085,2018-01-30 14:03:01,60
0xe3bd135eae0a9b94067214a120ea4e9fc11a7fd1ab2e04ff06d3c15f75b336ac,t,21000,2103101,,5000085,2018-01-30 14:03:01,61
0x2d914b65164e38fe24eb4d663a3b6dc775348153ba389fc71251b17745c76b5c,t,21000,2124101,,5000085,2018-01-30 14:03:01,62
0x97652f1898448558696a0f8330f625097aa57c8edba26b31a36ba6352c04b49c,t,21000,2145101,,5000085,2018-01-30 14:03:01,63
0x3812d1c39507b7cfbeaf9a57eb37d921602c35c3974e5bc4b809f8b2650745cb,t,21000,2166101,,5000085,2018-01-30 14:03:01,64
0xafb42266cb7575ffcaf2889b90d7300e399d98cb1a3361907c8fd89a3fd0c175,t,21000,2187101,,5000085,2018-01-30 14:03:01,65
0x1f72de2cfde63776822cbdd588d6a955019ad2749f191321fa67e08738ddfa67,t,21000,2208101,,5000085,2018-01-30 14:03:01,66
0x6fd0bf72981e8eecbc68786fdd252e99e175232f0a1efa48d552bdb19fa6c7d4,t,21000,2229101,,5000085,2018-01-30 14:03:01,67
0x465f09b84a4602f2dfe1dae035bfa78004ce46b0279dff269ee1bdec2cd7684a,t,36756,2265857,,5000085,2018-01-30 14:03:01,68
0x2fb85d02a6bc7b282c41fa1c76594ef459b1ef379fcd600a09aad37622061ee5,t,21000,2286857,,5000085,2018-01-30 14:03:01,69
0x41934f4d07b5445fc456efca0628808579faf4ba4970f168e5f2d17b7a0efab4,t,21000,2307857,,5000085,2018-01-30 14:03:01,70
0xd990cb73af808daeb902e48aed3abf471e5cf7d6f05c7a019a989cd1d5482bfc,t,45576,2353433,,5000085,2018-01-30 14:03:01,71
0x043a43999b8fb281e1b8cac9afe089173dcd6b44c385b9e2348d98f66a08b85f,t,21000,2374433,,5000085,2018-01-30 14:03:01,72
0xc69e7c8c8e9ce062760eabfbd4de955c22e8e09b6435f31ce695fbe3f3fbe75f,t,21000,2395433,,5000085,2018-01-30 14:03:01,73
0x63e43fb0262a08e143ad1f03fe95a62805d0e8a317416f68ec7f068067539d96,t,21000,2416433,,5000085,2018-01-30 14:03:01,74
0x4339600281b7c5cd5729ebce562f5bbf924c2e56a9fe36ee61ee8e0fd9a1df1f,t,21000,2437433,,5000085,2018-01-30 14:03:01,75
0xec218b056a0fbfbbfadd762b624924b0fd14346bb363f7ea0063628b5638d76b,t,21000,2458433,,5000085,2018-01-30 14:03:01,76
0x1a919cd8dd1fd5cd19ab7e619e5aa0a341b91267f17f4157be16e814556a185a,t,21000,2479433,,5000085,2018-01-30 14:03:01,77
0xf1baca75b588a1567ffdbe890d3f0ed2a18f8e3056a7a84db9a0133c04b47857,t,21000,2500433,,5000085,2018-01-30 14:03:01,78
0x08a7b2f6718cd8a62df1df1776747967e28f5736f5d25429e9843eb110a873c4,t,21000,2521433,,5000085,2018-01-30 14:03:01,79
0x87352ddf98d0228e2967d967b7e08f5498ddbd6082fd5eded41de1f27b4a1726,t,21000,2542433,,5000085,2018-01-30 14:03:01,80
0xc70e41d897daef4b599c32321ee961b6a4044beffb932fbc32fd13dbe33f987e,t,21000,2563433,,5000085,2018-01-30 14:03:01,81
0x62916f0757657184fabf6510badbfb5edd9ecac09c3feb406e8dce1381842d9c,t,39512,2602945,,5000085,2018-01-30 14:03:01,82
0x4968174c24ef8af1c987fe7993cc8dff958c2719298220ac3f9e6532c133642f,t,21000,2623945,,5000085,2018-01-30 14:03:01,83
0xab1d72e12703b9e1b0c0d10671afdc894a6861220e9fcb75bcb466aff4cdbc90,t,21000,2644945,,5000085,2018-01-30 14:03:01,84
0xbad59c32ccfcba83ebb5ea909ab981932bd8a8ab6ea1f4f32f026e968c6aa353,t,21000,2665945,,5000085,2018-01-30 14:03:01,85
0x87c7fe03a798970b75cfa52284754eabc3ccff05dbb12b2710a69fdce2178e9b,t,81357,2747302,,5000085,2018-01-30 14:03:01,86
0xb9aecb66e8ef924f14cf0b7a3cd74166fd83e1cea755bac1bc9312f5bed0f7a1,t,40779,2788081,,5000085,2018-01-30 14:03:01,87
0x3d45ffd354154c7dea02f0c22b51d372f2b5999c0ca6e8c258edc761c493e251,t,21000,2809081,,5000085,2018-01-30 14:03:01,88
0xa9ef2b398b72c6fdd983460f03b3e897627e7537ee78c0b23b8e4b6338afa28c,t,21000,2830081,,5000085,2018-01-30 14:03:01,89
0xf8c5934b8f1fc6b8bc7012fa98b287a04a822bbb3f91ba798bf35ab04d267b5c,t,21000,2851081,,5000085,2018-01-30 14:03:01,90
0x4a44d144413196f28f643af04adffe9769e0e93bff407db5c573573c89d66b5b,t,21000,2872081,,5000085,2018-01-30 14:03:01,91
0xd05f870ff474653bbabfc14100520f88857c38f71f7da3b10118ed265dd0d79f,t,21000,2893081,,5000085,2018-01-30 14:03:01,92
0x07b69dbf0120a5006704fd11d8ec7baf0444eb858a0237ac8c260da1edd16a95,t,66253,2959334,,5000085,2018-01-30 14:03:01,93
0xfbeeeab4ac30b478109ac3a1db34be6cd775de35f473eeea2933fc5717d38dfc,t,21000,2980334,,5000085,2018-01-30 14:03:01,94
0x419d8e53ebe1ca424b87112230395f355622d12444863b8f6b2d0e2b1d48dfd0,t,21000,3001334,,5000085,2018-01-30 14:03:01,95
0xa977f64c3d54f46ae0b5c9722959623a5b5c9269d23b3bd4d5c20b6da27c2c4d,t,21000,3022334,,5000085,2018-01-30 14:03:01,96
0x14026565bed5ae5d7a5db3d1045149876b659123a109e9815efd241120160c86,t,21000,3043334,,5000085,2018-01-30 14:03:01,97
0x34651cc78cb47d0370d212374c23b382f8d81029894437705bb445bb8294844e,t,21000,3064334,,5000085,2018-01-30 14:03:01,98
0x993622025ac9d9f39a90b85d4b4365b77f78225fab5345af7e01f880ea0488f7,t,21000,3085334,,5000085,2018-01-30 14:03:01,99
0x75e6f24a509f2dbe9144fb03928ae2828f6173fcae29352ce1cca04a31d63df5,t,36792,3122126,,5000085,2018-01-30 14:03:01,100
0x865605edba67b235d5b5d914fb67cb43f27396ddf9f4a8a7bc98de329b4a42de,t,21000,3143126,,5000085,2018-01-30 14:03:01,101
0xb4504ce3d2ea14c80ca22f991cd89c2c27a4bc9bf66701556ea2e47f47655e13,t,36912,3180038,,5000085,2018-01-30 14:03:01,102
0xc5372a7654a63b6b65b3a6adb0322ec28be0c5f6bdd2638963d45aa19b0e4de8,t,76734,3256772,,5000085,2018-01-30 14:03:01,103
0xd0cb3126c6c48b67d6c104fb729231df0ff85f99e161b562d4aaa784d363b134,t,21000,3277772,,5000085,2018-01-30 14:03:01,104
0xcea00c2d4c5ffc2d859764620cf9661418d905071e500fb9ef5bfe824e3de101,t,52886,3330658,,5000085,2018-01-30 14:03:01,105
0x55d275526de27e32e8c44e6073865485b6d45dd1465bb33d10e83d4a0ab2f43e,t,21000,3351658,,5000085,2018-01-30 14:03:01,106
0x61e5243ec211526f225b09ca91af1dfded16b51c3c916fda2a1c7ce632320c31,t,21000,3372658,,5000085,2018-01-30 14:03:01,107
0x8f93fa9b5555f210fae6123ee1e5863677879e23b8fa9fbc8b02855fbfb91bb2,t,21000,3393658,,5000085,2018-01-30 14:03:01,108
0xe2fcf50e2b1f0e4110e5547cfe568e93c41f36911d9de686539e0107c61e9eb7,t,21000,3414658,,5000085,2018-01-30 14:03:01,109
0xb40c93fbff7c498704cfa30190eb38cb19b3600032701bcfadd6520b57afbbbf,t,21000,3435658,,5000085,2018-01-30 14:03:01,110
0xdf3b72424a5f4207c2774c536776ea3558f259f8caef10b9954eb8367c816b67,t,21000,3456658,,5000085,2018-01-30 14:03:01,111
0x21389df059cbcc7069e7c99822e021b956eb3ada1c93bcc5936cab0cedf48ebc,t,37320,3493978,,5000085,2018-01-30 14:03:01,112
0xc344de82f20e5a19668daeb0b6d6144f1ea295e590d6257059c20eceb8860d9f,t,21000,3514978,,5000085,2018-01-30 14:03:01,113
0x1ddb66888309b0fb9d75d02942bf027e31fafc5cc212d75564a5223ee21f69d7,t,21000,3535978,,5000085,2018-01-30 14:03:01,114
0x8639fda4fd230e9c7c999ab5c86c876fdae2971f7df7f74c78005bbda7e689e1,t,21000,3556978,,5000085,2018-01-30 14:03:01,115
0x54f0da7c6ece09850ea51e6fa2d17c903995467696fe1a8677a46ca777260ad5,t,52084,3609062,,5000085,2018-01-30 14:03:01,116
0xe76d1388cb926be4541c8c3c7fb41d39e67a729bb654694b010eedac6fa62bf3,t,21000,3630062,,5000085,2018-01-30 14:03:01,117
0xc8388a90b9f0af18a8b48423b809e0bbbabfbffd280bd9960bcac39d4142176b,t,21000,3651062,,5000085,2018-01-30 14:03:01,118
0x8cc734a92f155ba80cfad1f114fa0466ec100432aac94a5ee76dbf8e06ed411d,t,21000,3672062,,5000085,2018-01-30 14:03:01,119
0x15b7365e32a4ab01f407a99a96316885a810a5820684e1acd409345c2f4a12fe,t,21000,3693062,,5000085,2018-01-30 14:03:01,120
0x9da0c375eae135d01ac2542a84902ddb765d8460dfbeee8d932dcd6f0dd13cf6,t,21000,3714062,,5000085,2018-01-30 14:03:01,121
0x0982794921a921429b0b5125922812214b3877b312e3f3055ba97b06e8c433a1,t,21000,3735062,,5000085,2018-01-30 14:03:01,122
0xd97017e20052d68a6fa77d28b1605dec775cf1186f2f815150fe42497239fa60,t,52948,3788010,,5000085,2018-01-30 14:03:01,123
0xabd988bc9f8edf1ef989de7a2744e01a4bd1a404bab13b1a584534abc3d76490,t,21000,3809010,,5000085,2018-01-30 14:03:01,124
0xd2a5b444ac2b1f18e3ea16ea37b103afae8ee6f2e4a715da1f547536e2aea6d4,t,21000,3830010,,5000085,2018-01-30 14:03:01,125
0xef510c6a075f8c009f9f3e4ed9bd926ee503df513afe5925bc21828c8450cb81,t,21000,3851010,,5000085,2018-01-30 14:03:01,126
0x82352e21e88c7302d2bd229fee2d648033f9a8110ffef7c1feea9f3695afb913,t,21000,3872010,,5000085,2018-01-30 14:03:01,127
0xa9dc63d9271ada53d3214a213e8327ca86f4d93a63d47c10f8d96c6ac4fc7b53,t,21000,3893010,,5000085,2018-01-30 14:03:01,128
0x6f15519e9196526a19f439174144044ccefaa8d6b4e167f4d71ad15492f8a0b9,t,21000,3914010,,5000085,2018-01-30 14:03:01,129
0x49838e34ec1ac3f3d7aa846b58df5a1ea845afb97f8391e25a1bf5f2d13ec67e,t,21000,3935010,,5000085,2018-01-30 14:03:01,130
0x1d5c45ed3861a9f39d3560fc9edd5b7ebb09ab746d31a52734fde38f957c4884,t,21000,3956010,,5000085,2018-01-30 14:03:01,131
0x535ae13f482c55a96f3dd376ec2bdf47264fa3ed8cb2b2e9aee0779ee20f2599,t,21000,3977010,,5000085,2018-01-30 14:03:01,132
0xf19efea304b682e0c69d8dd861c59304c18e28670faf2c75783646a54f4fed01,t,21000,3998010,,5000085,2018-01-30 14:03:01,133
0x12dcf3e76212a2dad5740f075cb0c04bd5ff1334e8b9f971676719f5344438c5,t,21000,4019010,,5000085,2018-01-30 14:03:01,134
0x050217863cf99c8be02dac65c6f6f65820481dec54b5adfb66c057b1360895ec,t,21000,4040010,,5000085,2018-01-30 14:03:01,135
0x328dba23c65cf318fd3d48a1ee521b9be993177134cb52e9c7aed76f45f73475,t,21000,4061010,,5000085,2018-01-30 14:03:01,136
0x70ad3c56c0ec484e48c5d41973e8cbf69e369cee903ed259f06a2ea7ada99b53,t,164716,4225726,,5000085,2018-01-30 14:03:01,137
0xb08ccace599e6d0abf9f105f53b105bb1ea08d9049f49454f354537ac3ea0371,t,21000,4246726,,5000085,2018-01-30 14:03:01,138
0xb858ed9036e2b409b796ac001b94f6ba8163c5170c700bc6e6f4635fc8922863,t,21000,4267726,,5000085,2018-01-30 14:03:01,139
0xd3246fbf33f908b9149ff7c808fa359347a9fe3797a7a97f3840855070161788,t,21000,4288726,,5000085,2018-01-30 14:03:01,140
0x5dd8bde617e9c8be71028d9e23744f2efd36d38605a2fb2af246b244d790f01b,t,23722,4312448,,5000085,2018-01-30 14:03:01,141
0xfc56de7ed895e9f1c1539b8f6466dc3e2baf685b6a0b1159d4b81eff0702bb3f,t,37654,4350102,,5000085,2018-01-30 14:03:01,142
0x85e8430ee2ae774fd7f16fc2423a8cedfb3f0dd485231dc95a9e5ad860354393,t,21000,4371102,,5000085,2018-01-30 14:03:01,143
0x192c4c141004cc77f44c2c83732309f6d6193e31a3052f9253ee1fff8090016e,t,77627,4448729,,5000085,2018-01-30 14:03:01,144
0x6b6ce8f59727446861c35d835f6438b6f957d199e59a523b0d4286a84d782777,t,21000,4469729,,5000085,2018-01-30 14:03:01,145
0x487d35d90feda9309ec82b4facdba93385a56399aeec0229c3a0a7f6931ed2b5,t,22193,4491922,,5000085,2018-01-30 14:03:01,146
0x69d1c7c80be9ea3d71569f3901e6e13cf5f5b350b0cb7f80539ee410eb9488b6,t,22148,4514070,,5000085,2018-01-30 14:03:01,147
0xe2d959834684afd61f952f408a4641ffb77ced2c27b4bc86f173b31ddecd79f8,t,22408,4536478,,5000085,2018-01-30 14:03:01,148
0x94ea064d1b15cf910e441a82159e89bd40cb38476bea5370bbbe734ddfdc32cd,t,21000,4557478,,5000085,2018-01-30 14:03:01,149
0xd86fd0a40148cc7d844318ed1e5dfeafa3fbdf89e5ea3469191484ea700d4c72,t,21000,4578478,,5000085,2018-01-30 14:03:01,150
0xe9f56a2d7cf76b6005bb2c3d9230d719d088e4f3af62e9d64d75de243d4fa121,t,21000,4599478,,5000085,2018-01-30 14:03:01,151
0xc7767a8fe6eb9379f66f110f0ed930f0ff4086b48088a428f1d90d306d7dc4d0,t,21000,4620478,,5000085,2018-01-30 14:03:01,152
0xf53fc6b8cce16d54f9ec3087a83e5554a656f60bc79a271701664857dd84ed60,t,23519,4643997,,5000085,2018-01-30 14:03:01,153
0x846e0b325dfc829e748391785242a7302f33909f015b9d5895d9dd2a6dca2bb8,t,22094,4666091,,5000085,2018-01-30 14:03:01,154
0xde1de4234ab87f796c5f5e177a3d9ccaffcd34d76bfc6cb0224ec35eb14ad0af,t,22524,4688615,,5000085,2018-01-30 14:03:01,155
0x3884b54eadac8d2950fd34f4f655c9917196f85004b645b261d1fcc3f52725c5,t,22460,4711075,,5000085,2018-01-30 14:03:01,156
0xc1e94b170cb782f81de29ac4c0c4c0e1e533f3d1420373bf3687a88ca826f6dd,t,22158,4733233,,5000085,2018-01-30 14:03:01,157
0xa716ecb0193ff111b8b3a26e755a2307f6725d0fabfdcae8591b28a95e086f46,t,59162,4792395,,5000085,2018-01-30 14:03:01,158
0x224d97e53c25586ee21b60fa69d3444441947dffdb27c24cf4f4d5f0d42d40fe,t,21000,4813395,,5000085,2018-01-30 14:03:01,159
0x83a5687ce2b5abea460f3e08da360e2dff7817c3643d31905a364ae238e037b7,t,21000,4834395,,5000085,2018-01-30 14:03:01,160
0x42088389d30d1ab485861ad2e9d7b62a77a06aa193cadc4c9413deb8a429de92,t,51988,4886383,,5000085,2018-01-30 14:03:01,161
0xfe30011c392b4a207be613251c82f021744b86c6264bc0af72cedbb23f11d51f,t,21000,4907383,,5000085,2018-01-30 14:03:01,162
0xeb01f0a5e67ed12df03eec98f0171cca9df9f0eab7483e05fd4b2b296b634085,t,59290,4966673,,5000085,2018-01-30 14:03:01,163
0xc084e785bd21e465d4c72234c71a403211d708b9c64a71fba2ab966eabbfe2ce,t,41337,5008010,,5000085,2018-01-30 14:03:01,164
0xf7a0a58281c848b5a6d9bd4282cea23d23269e769b8707c194eac82585472dec,t,37347,5045357,,5000085,2018-01-30 14:03:01,165
0x2e6575e7717b67615f5151cec739fbd6eadfbb8dfad56f792b5b73d4c69bc273,t,121706,5167063,,5000085,2018-01-30 14:03:01,166
0xa00b56c7feaf3b8dd55a2b8a6a6158d8e81e2875c70a59ea45af871a882658a6,t,66316,5233379,,5000085,2018-01-30 14:03:01,167
0x2ef00968862e424b5e8d0e92b9b62483165da96f65a467f9465b2c086d4a4e72,t,56384,5289763,,5000085,2018-01-30 14:03:01,168
0x41aa95708940dac5069a9da76bfa84bf70fbf8d08b5d6286fb864add95ab1f2e,t,107986,5397749,,5000085,2018-01-30 14:03:01,169
0x00bb4b41fd5f859631b9a82394d702276de6fdc99634003d6b57d8f1ed90c807,t,77602,5475351,,5000085,2018-01-30 14:03:01,170
0x60aabe7248a5eaf1307f7cecd47fc5bff6979d5c321091d3a2387897b19a9845,t,1154996,6630347,0x531d89649690F570347aEa8EBA1461B640c1346E,5000085,2018-01-30 14:03:01,171
0xda5b15ab2c12f9e2bf1e881a60194250814d8f6d873aebfb4381b90a5a17cb18,t,500754,7131101,,5000085,2018-01-30 14:03:01,172
0x1a824d62d961e37309e2a5c9c61a31509e137ff6425f05589ac5fee2dda05e3e,t,21000,7152101,,5000085,2018-01-30 14:03:01,173
0xa8a0ac41563f0ecb6879c84c68c0a063fbc3498fb66e9fe0d8843038e29a7289,t,38337,7190438,,5000085,2018-01-30 14:03:01,174
0x33c220843f96ebe1706dd53abe7a1afb9aa3103d894500fa1c7e38bdffa702d5,t,58791,7249229,,5000085,2018-01-30 14:03:01,175
0x92b120a8992c3b2c284f9c0c69203e00d8a9f7f9e3937cfa106a7cb9b3f7154f,t,21000,7270229,,5000085,2018-01-30 14:03:01,176
0xb08fa8c3fb1e52a4911efbb3a65eb0701dd82d28ac5c4f78879ff54362849677,t,77922,7348151,,5000085,2018-01-30 14:03:01,177
0x088353bada83cf3c8013e08bcbb3e7420b482e79dca463c576e7101db780ba30,t,32654,7380805,,5000085,2018-01-30 14:03:01,178
0x277a34041be950c18b2b1aa2912dc9f59bb18ef793f72a0f2d5801f2bf571235,t,59162,7439967,,5000085,2018-01-30 14:03:01,179
0xfacf1a0b064ffe004ae7e1231353208abd7865372dba54572705e2d898e74683,t,37900,7477867,,5000085,2018-01-30 14:03:01,180
0x4ca309179f03796c4ea3d64fc5ee1bea4dda510d31556947f8712324e17865a7,t,21000,7498867,,5000085,2018-01-30 14:03:01,181
0xa05b68eafe54f3dcd6f1cbdeac79ddd7f5924a854a25b8631b03386358108064,t,21000,7519867,,5000085,2018-01-30 14:03:01,182
0xb4c6a864885302daefca8b2329649c2d3db83205a0d44b944d50a6cc1b44cb3d,t,21000,7540867,,5000085,2018-01-30 14:03:01,183
0x31c33eab41e4d650bbf97c9025bad4d2c6eaa6927975b50a888b7550d76099c9,t,34647,7575514,,5000085,2018-01-30 14:03:01,184
0xed2aa4ee170d79c9c9cc1278a23f55efd3ffb4c630084a76b6bc9851fae682fc,t,21000,7596514,,5000085,2018-01-30 14:03:01,185
0x4abf858859da08d054f491c73a7ff975ad1704a8bb291e863998a5ba97a45709,t,21000,7617514,,5000085,2018-01-30 14:03:01,186
0xc3ce9fd10bb3150607bd2bad57a8369bfa93f7b4726c8d26195dd3185b26a966,t,21000,7638514,,5000085,2018-01-30 14:03:01,187
0x86f127c1ea04597d744894357f2dac4e777710c74035fda784c88e52a1f0f41b,t,44493,7683007,,5000085,2018-01-30 14:03:01,188
0x0ba3b574f823ea515f1547c2ec3b0bccb249a67eaf8f9f51539b24489b020f1b,t,93562,7776569,,5000085,2018-01-30 14:03:01,189
0x81f0083fffc7b4f545faaa0c79ffea159a06e73261140b1dacd3c1bda03580a1,t,21000,7797569,,5000085,2018-01-30 14:03:01,190
0x2ceffb37f0c056399a2b2dc0e8a86c3c80885c3f1858ef278357ae213cfd5b28,t,55907,7853476,,5000085,2018-01-30 14:03:01,191
0x5ac3f650e7c10ea0be0650e278a8071eee15471b93e4f6fb0df5245ad6b1fc3c,t,21000,21000,,5000086,2018-01-30 14:03:16,0
0xf8e3e2f9c2a09f56328bac67e5d8a1d92bc7807c42f1748f64a5d89bf22a15e2,t,21000,42000,,5000086,2018-01-30 14:03:16,1
0x4ecac9e6dc45fed4932e44674ea62095c640a32990fed15d53dc462a050d3608,t,21000,63000,,5000086,2018-01-30 14:03:16,2
0x1ccb0034cde7b5b0419b5229c2942dd5b0fcde8690b7897de432d1922e818273,t,21000,84000,,5000086,2018-01-30 14:03:16,3
0x5db16015a4c13fcf6d05c51f8472e444d056aed9673ccc53c12fcc4266a57099,t,21000,105000,,5000086,2018-01-30 14:03:16,4
0x37c97257d8e677c1eeaaf46b715297e46bd17207d9ff1e39e1cf4db54de4c973,t,21051,126051,,5000086,2018-01-30 14:03:16,5
0x29459f932d55c54bda30b4de3c766e27e94e227ef77d9c44dd4a6b13e51f0bde,t,21000,147051,,5000086,2018-01-30 14:03:16,6
0x27b1b2604e4df4ccfd9371db1528d010b1ccac7ca891b4049d7b07916b44f7b3,t,21000,168051,,5000086,2018-01-30 14:03:16,7
0xa5095dfe98e08034f97ae558e2c0a50c90766aa8184ae8a3cf6860991c128651,t,21000,189051,,5000086,2018-01-30 14:03:16,8
0x1562ecb3c0a5226a13552a891e7af718efd0dfd6f2cd28bfd26832cc0736684d,t,21000,210051,,5000086,2018-01-30 14:03:16,9
0xb3b01700fd89fb456ed05cdf8693cdbb220f13a8816942cca36aac040338f8b3,t,21000,231051,,5000086,2018-01-30 14:03:16,10
0x10fcaab37294e0ad94ad2f97df066f5e9330f4f3744dab17de5b598477fd2c5e,t,21000,252051,,5000086,2018-01-30 14:03:16,11
0xf55d7446dab28e7623dde3838690f5d1e6238809c10bf20ba9728216e32d7995,t,21000,273051,,5000086,2018-01-30 14:03:16,12
0x77aba893802621284327431ad1a3de2ad963b3693185e03b03309cba00bfd1f3,t,21000,294051,,5000086,2018-01-30 14:03:16,13
0xe1f291982fc76e79989b0acf74c94cccd0bd7cf7785a5bba3c732798ee312d26,t,21000,315051,,5000086,2018-01-30 14:03:16,14
0x9fd1f60cf2f6e9d9ba5731711e0d7aa94c1abe080f78ba68e03413f7af5b322a,t,21000,336051,,5000086,2018-01-30 14:03:16,15
0x000be66616dafa148464ab16a68d47693a7b0aafc8a0cda6f22a539a0ad11fb7,t,21000,357051,,5000086,2018-01-30 14:03:16,16
0x93ffac1b67c2f34703e05ccc537ee44995467621e0cdfde5bb077b3378f23d7f,t,21000,378051,,5000086,2018-01-30 14:03:16,17
0xf22fb00397e02650d7afbd6f54e36de8f591bd2a8f338ec1143e586af9853f5b,t,21000,399051,,5000086,2018-01-30 14:03:16,18
0x62d6f7bd2376d6ef714daf73bcfc5d3647718c8cd2e40ca8b11ddd3348f5b4cd,t,21000,420051,,5000086,2018-01-30 14:03:16,19
0x1e86c694b67a0381f083a7d0aed9870fc98bc8a94485adec6335125f07c68fc4,t,21000,441051,,5000086,2018-01-30 14:03:16,20
0xb180804da6889f24ce07d39fc7eca8556f93bc4e00bf339c46da4ba80f0bb89f,t,21000,462051,,5000086,2018-01-30 14:03:16,21
0x4809498e3ec6c8591d831feaa690b12134de221e9d3fec3626520d9e657df7c1,t,39512,501563,,5000086,2018-01-30 14:03:16,22
0x8ccb99462cc8982aeedb27ae711ec8737ac17c43ef3d45340454dfc8362afed0,t,21000,522563,,5000086,2018-01-30 14:03:16,23
0xace2584a954d00a5b04418e304b5ce8cd518afd9b2d732a9f6c4853341b112fd,t,21000,543563,,5000086,2018-01-30 14:03:16,24
0x5af920521084de1b3a144ab8a8ce21397812b292edbad72b25a778cab0eb3a7e,t,21000,564563,,5000086,2018-01-30 14:03:16,25
0x8226528d6826f0225413ab5b998e6e9f3345d24da044ec8765927b8f628c5205,t,21000,585563,,5000086,2018-01-30 14:03:16,26
0x535a1158723c758b740492f5b0b7760cbb6dd249dbadf28826578b6277f866d6,t,21000,606563,,5000086,2018-01-30 14:03:16,27
0x399e67f74f87dd3d77dbc3f4a58fc4c1b2393d747d742e43b400d38043710af6,t,21000,627563,,5000086,2018-01-30 14:03:16,28
0x2967a67b401db8790a3a94453323cb83bba2558ee6ba8c9b4c4770a2c11fecea,t,39512,667075,,5000086,2018-01-30 14:03:16,29
0x03c7e9d5827df17c1dbe196fbc794ebd164357dfa5014cd948426dfc0aafa44d,t,21000,688075,,5000086,2018-01-30 14:03:16,30
0x104e240173ffcdc2c7db761abf0cd45ee14fb97a300920c4bb1a0ae9a35f1fe0,t,21000,709075,,5000086,2018-01-30 14:03:16,31
0x6f9dd390ba6ff7ac7098cde42356f9de926df8b9465d9123be7b3e518771223b,t,21000,730075,,5000086,2018-01-30 14:03:16,32
0x572c7ec54a89a9a93234e8b9b4ae597b4a80dd3a73b3620b10949b30b6a8079e,t,21000,751075,,5000086,2018-01-30 14:03:16,33
0x765645539f9c56117a6a858c7d5b30ff63bdd790a6c97a3b8a7e595843931e28,t,21000,772075,,5000086,2018-01-30 14:03:16,34
0x98eedde22ad9cd6db7895fac5f0512f195f4482f9b976d7c05fd97552e4e26e9,t,21000,793075,,5000086,2018-01-30 14:03:16,35
0x4a0769ad4173e20929130f568f5be20b38fe7dba7e40b920b5e8cb4131da6a8e,t,21000,814075,,5000086,2018-01-30 14:03:16,36
0x522efacfce3a19c52b6d5d75b2684c86691f4127f0060b1f9c79f5c6d0a9532c,t,21000,835075,,5000086,2018-01-30 14:03:16,37
0xc697aedc9210bc190a22fb7c3e8ace6bd2f1fd77ad64a0df2728af4ff93055cc,t,21000,856075,,5000086,2018-01-30 14:03:16,38
0xa20e334ee32dd72f6fec5070c796bfe1ae10ac0191900656b911402ebea432e5,t,21000,877075,,5000086,2018-01-30 14:03:16,39
0xa9f2110f640a45bc81c93adfffffc98f67755e23551b7f622dfeef202f1ef682,t,21000,898075,,5000086,2018-01-30 14:03:16,40
0x1cd712765414e96a7821f7643554c7cfee5a1e60b02fa5d7aecac79cccdbcdad,t,21000,919075,,5000086,2018-01-30 14:03:16,41
0x88c5615249c2ee63c307a52269594f3961dc033f2bca9193f2207da05f27e6fe,t,21000,940075,,5000086,2018-01-30 14:03:16,42
0x895b94acf0319b4e1c24e51bb48648985bde21858aacd1c876eefd01ea06872b,t,21000,961075,,5000086,2018-01-30 14:03:16,43
0xcf031652fdeb5022649273226e490aa19509940da49faf420d6cc1497a3545e8,t,21000,982075,,5000086,2018-01-30 14:03:16,44
0xa39d1acb4f39d9f92e99b0e725e5a340aef8a8c3d97825c200fc12d932dceca4,t,21000,1003075,,5000086,2018-01-30 14:03:16,45
0xc56b35d6f078235a1c5332d1f8c1e6dfc2ade1b78830b459b2d1591ac44b781a,t,21000,1024075,,5000086,2018-01-30 14:03:16,46
0x6154ace821eb38c7be1c7db58e85c56b7c432e047d718b5f7ea6b72aa5cc14df,t,21000,1045075,,5000086,2018-01-30 14:03:16,47
0xd13c591e4753838a30ed7517d40639e54ea7374860e4dde0570e05e94463d461,t,21051,1066126,,5000086,2018-01-30 14:03:16,48
0x51efcb70037791c71394c58c31f45d746af0c684f84f7182d39e37bed65c9522,t,21000,1087126,,5000086,2018-01-30 14:03:16,49
0xed6af7e10d26a73994a6d9876e2b34dce10b1ee9eeb2cd4da605fd78782f6329,t,21000,1108126,,5000086,2018-01-30 14:03:16,50
0xc260c6df088103aad6b410bc7db841c64ab88f44908689a223fafca8b027d7ad,t,21000,1129126,,5000086,2018-01-30 14:03:16,51
0x7107e38cdd138b2f3d5fcb63b6aea3e678cff6573b5e550374d9563e9ab73b73,t,21000,1150126,,5000086,2018-01-30 14:03:16,52
0x279bbde0a47f351ca978b9afd4941f43b6d9316097b686ea0de3b8961af0d7cc,t,21000,1171126,,5000086,2018-01-30 14:03:16,53
0x6a617d9138c6f30e3af441f8c69eb6f96a3c2a99d0e922018d733e7fd2b16294,t,33705,1204831,,5000086,2018-01-30 14:03:16,54
0xd08208ec8a26f9b15c6dda0695b876c02516f057c5c8f778160792438f7eb801,t,21000,1225831,,5000086,2018-01-30 14:03:16,55
0x8f559c399a4e72719fe1baf7242466a57df4e43cee1990d3a2573929aeed6dd4,t,21000,1246831,,5000086,2018-01-30 14:03:16,56
0x9fee756b85592143050eb87f5c09f50c777768729091fdc34a402748a5629b61,t,39512,1286343,,5000086,2018-01-30 14:03:16,57
0x05e81e9eb0c80d119f5b0290115e9b38f651f4a9c2dfe9719f3b0ab047e3102f,t,21000,1307343,,5000086,2018-01-30 14:03:16,58
0xb570969e8795d50cef23df37f6b9444d2259106f2331b1e88909574a50805198,t,21000,1328343,,5000086,2018-01-30 14:03:16,59
0xce51d4db0f38bc1e3717f79006238d0f667c16baf9a42b93ce8d4e868b321f81,t,21000,1349343,,5000086,2018-01-30 14:03:16,60
0x60a6ba40eaad4ce0edacb320c162c261ff36d5b22ab5307ea1538f9b0ff4cef1,t,21000,1370343,,5000086,2018-01-30 14:03:16,61
0x605b9dc741edc93c899293ff38d052042c77daeaa05e4df47cae464797907f17,t,21000,1391343,,5000086,2018-01-30 14:03:16,62
0x672ec90d89ba5a5b291005576d5a06b3c3a26634fa2288ffb47020b71c7cd029,t,21000,1412343,,5000086,2018-01-30 14:03:16,63
0xbc67e46169dea79a5ad01a90e6aa013e74b4644bf4da86030f9d6ce10159d7d9,t,21000,1433343,,5000086,2018-01-30 14:03:16,64
0xfb4c2dfc4e2df289ee5062e9e9ae01c65b88ab6c25c52b0d27816b730660cf39,t,21000,1454343,,5000086,2018-01-30 14:03:16,65
0x4f9b8b4ca47908b9dfea6c15c9ff1ddebc2077c89d5c8ffb0c83f3a8893fe5a3,t,21000,1475343,,5000086,2018-01-30 14:03:16,66
0xa0024be257c93617da6c2907e9f90069cbab97de0bb1d6f5bd0d414bc7808732,t,21000,1496343,,5000086,2018-01-30 14:03:16,67
0xc2e1e728047fce8c92e7c95645a51e20f736672810c49d2d9d7122435e16921d,t,21000,1517343,,5000086,2018-01-30 14:03:16,68
0x26e35af07fa8dddfa471c0887a9213a71d399c705b47622134ed5acbfb7eb883,t,21000,1538343,,5000086,2018-01-30 14:03:16,69
0x9fcded67ba4d1944261e0595e0e40aa0ccd9b34ea1870e4caf6c5e12255ba544,t,39512,1577855,,5000086,2018-01-30 14:03:16,70
0xa22113e1d5820d8cfddc2c71f7da155b8cd0c34430b9abcfef090bf23c5cb635,t,21000,1598855,,5000086,2018-01-30 14:03:16,71
0x598b2ced183e650b97227c41f6dc87d939f541248e27f0f101a960f3481e7da7,t,21000,1619855,,5000086,2018-01-30 14:03:16,72
0xb2938f4813eeac6805123e440827357d763ce248bdca8206ddada541cb4a1934,t,21000,1640855,,5000086,2018-01-30 14:03:16,73
0x79922129d2565fdde081471f30c96be3c698aa84592f9032a7c82e07a1c59491,t,21000,1661855,,5000086,2018-01-30 14:03:16,74
0x4a6cd063e9b08a728695c3e6cdeaca8028fda0392f2c4c26dc6ffbe08a4fa7c7,t,39512,1701367,,5000086,2018-01-30 14:03:16,75
0xc418d68aff8c576afb1269591f43deed4ecf066ec2367b6c7f7c00787d76b9bf,t,21000,1722367,,5000086,2018-01-30 14:03:16,76
0xcff15d7cd91afb249e809349d52786452a39d8300d9d854f07fe4c9c541adba4,t,21000,1743367,,5000086,2018-01-30 14:03:16,77
0xae432eae1dbe15326b52f4106ba8c780f39fe16a67ac3448a6c69eaf76419e91,t,21000,1764367,,5000086,2018-01-30 14:03:16,78
0x124b044d40ca9325f29f507d7f07c02a67a43cbe55120cce7564a4af466ed3dd,t,21000,1785367,,5000086,2018-01-30 14:03:16,79
0x3e8ce3a769ef29ce2a530f6eb99d94c70eebc4a7eaf84243d0aebed64636f22e,t,21000,1806367,,5000086,2018-01-30 14:03:16,80
0x781d715c8c83cecb8148d8f7b3a1d525aaa56db100c2dacc1ff2ebf710a77b89,t,21000,1827367,,5000086,2018-01-30 14:03:16,81
0xba731297ff3f8977bb0a01efb8bc38f8ccdbdaf59042f52e6933fd6a5b842622,t,21000,1848367,,5000086,2018-01-30 14:03:16,82
0xfc518204718e3d41477fbf1d255f78e8bbc70d802d557a4401f41f86343fcfa8,t,21000,1869367,,5000086,2018-01-30 14:03:16,83
0x0b876376de7978c6156a19c15512aea47f98152c1536aafbeb6cec08967df364,t,21000,1890367,,5000086,2018-01-30 14:03:16,84
0xe088557a320afff84f100f9b8c666460c70456dffe9bac2537dc3103179c7715,t,21000,1911367,,5000086,2018-01-30 14:03:16,85
0x740fe32e98ff9c04f39ad8264a33b9cfe07fcff1f64edff53580dca7b0ef9292,t,21000,1932367,,5000086,2018-01-30 14:03:16,86
0x704371bb3f82168ab14af0fa24a6bd50609d1ca90370cf8fb9511795166eb3d3,t,21000,1953367,,5000086,2018-01-30 14:03:16,87
0x99bc97255c093cffcb438beaa5f1531e77da180565948b11a0d004b4826a0635,t,21000,1974367,,5000086,2018-01-30 14:03:16,88
0x9531c354e8636839425674d0250c5fdc21d54bb6dc29206f9edda7695ef382f4,t,21000,1995367,,5000086,2018-01-30 14:03:16,89
0x9ca78322a7272c22375337a7d6bb00846b9b792df75014e1b7699c626ac6f276,t,21000,2016367,,5000086,2018-01-30 14:03:16,90
0x80226cf1d5de8410cdb44067c96be66a53057a852206b67ed6f763d5a70f89e0,t,21051,2037418,,5000086,2018-01-30 14:03:16,91
0xe4c6aa3af44ab9ccee82e9b165054d7e8867ec40f9a04218c01efcf03f50b2f8,t,21000,2058418,,5000086,2018-01-30 14:03:16,92
0xf4f0d03e8fdc1eb5bb1284fa236714e2654bb394cf4d45a9a2650676b344f7be,t,21000,2079418,,5000086,2018-01-30 14:03:16,93
0x2991fd6ef2601ffb8160fe5587a447b42713306d11287648775385f311661e6a,t,21000,2100418,,5000086,2018-01-30 14:03:16,94
0x8b912d32632925488179cc29fba4b836f155ee137ed1a5526a5e239c08b4620b,t,21000,2121418,,5000086,2018-01-30 14:03:16,95
0xdc76d63faf446f0011f1bb8ee3c74a52044fc8e6c47e59f153b06e5c0ad77d86,t,21000,2142418,,5000086,2018-01-30 14:03:16,96
0x82301e51a87e69424c41c0e3b4afe568c6efb3420af121c549db2104fa8d77f6,t,21000,2163418,,5000086,2018-01-30 14:03:16,97
0xe2342107933667780d480ba73f54235d418327ff74821d4eeabb3414cb395b66,t,21000,2184418,,5000086,2018-01-30 14:03:16,98
0xb69936e69ce724c253565a8db2f1b66f034ddd19f97f1984f85d19cc0a3e4c13,t,21000,2205418,,5000086,2018-01-30 14:03:16,99
0x16a6e93590130335f872d66408f19cc4afc29999ab72f439aa9da6e85a3d1574,t,21000,2226418,,5000086,2018-01-30 14:03:16,100
0x9b78ee6412e19e258db2c253de640fbe78cdfbd8ece1a75923e2583c35b0f526,t,21000,2247418,,5000086,2018-01-30 14:03:16,101
0x61221dacae9caa22da55ba500d3c2240979e7c9f4edb8e6214c51754cfbf83c9,t,21000,2268418,,5000086,2018-01-30 14:03:16,102
0x019c42f7b8f727827eda0401c2027eee2c7f7f9dde9c07b07a80e9deeba413f3,t,21000,2289418,,5000086,2018-01-30 14:03:16,103
0x4b6f935b6e2b2340eb0bf34347893b5d72ea331332bd3ce7cf753b1b04d11da3,t,21000,2310418,,5000086,2018-01-30 14:03:16,104
0xb35abc933dd9a9b97edc4b840a9ddd2cd99bec78d5b84f1ee251ae4cfd365878,t,21000,2331418,,5000086,2018-01-30 14:03:16,105
0x725134a0acc4d93868a7946f6850caa457ff5726ec25e354a140965c1b40bf46,t,21000,2352418,,5000086,2018-01-30 14:03:16,106
0x785d76feb4df897021aa40c93e33f9232f448199f9a74023bc1d708010820803,t,21000,2373418,,5000086,2018-01-30 14:03:16,107
0x3b4078a7b390eb6cab4c03e286c0f3117f9bbf386acdc180c06f66ba175f0898,t,21000,2394418,,5000086,2018-01-30 14:03:16,108
0xc6382fac4278379f6352d60f82addf74f39f7d5d86fce76385a888b418525542,t,21000,2415418,,5000086,2018-01-30 14:03:16,109
0x43a51fe1f75f89fd46fc4b04d9026d5c4ca359b9bb671e1320787bf6357c858c,t,21000,2436418,,5000086,2018-01-30 14:03:16,110
0x64819f3fb6700cf5d30a6a948563ddd10436c1a3a8e72a67f0411858b9df8bde,t,21000,2457418,,5000086,2018-01-30 14:03:16,111
0x892d93e096eb1a1c5f38a53a663e002c63c9cc9a35e371faf9ba208e61cd9174,t,21000,2478418,,5000086,2018-01-30 14:03:16,112
0x2275cabcf480845d60dfe09436bdc8de9892e2539bf72f50f52d34716c4f9ae4,t,21000,2499418,,5000086,2018-01-30 14:03:16,113
0xdadcb11210773ce43e88d8642baa0374f2b648fd5c49b79c9c37054b81c19b13,t,21000,2520418,,5000086,2018-01-30 14:03:16,114
0x7eb73d0d93875f50d0da1dab1d3fcbed938ce58ec441bbea03a90d09d9daebf4,t,21000,2541418,,5000086,2018-01-30 14:03:16,115
0xeb52d59c34b7b36c8b195b10ea1eb7152392408d1b54b3ba81c0feb6d8dd4d43,t,21000,2562418,,5000086,2018-01-30 14:03:16,116
0xe9bb408220434a46fc1d1e978e9e85a6d61034e7edd1ac21ef2828f39e495e22,t,21000,2583418,,5000086,2018-01-30 14:03:16,117
0x945da27c78bbb92f68de2486a17315f481c6ddb727e7963be8de5d2d59784bae,t,21000,2604418,,5000086,2018-01-30 14:03:16,118
0xf683153708a9d2a3648b532c92705e09884b2f21778f077d92a9cdbd6cfbb4fd,t,21000,2625418,,5000086,2018-01-30 14:03:16,119
0xf577228f1191d9a6c9db768f5aa854a8d05979f444f10f92ae5d06805a902e76,t,21000,2646418,,5000086,2018-01-30 14:03:16,120
0x0a7ed9f0286ff505ccb70a641cc1956afd0fb409c4b5d92e9535dd03a07a704d,t,21000,2667418,,5000086,2018-01-30 14:03:16,121
0x6a88ff9420a3df05333951713a0c5a27e7946bc11ae62aa5fb7cdae5d3bc7892,t,21000,2688418,,5000086,2018-01-30 14:03:16,122
0x7503e6ae839753631b326b6ac0c91cc033d9d0a5dac3232122a1cf71d6dd46fc,t,21000,2709418,,5000086,2018-01-30 14:03:16,123
0xe79fc86983f6c12ee9b0475198894a29b27992fb6dc6935be8726df41c8a6a6f,t,39512,2748930,,5000086,2018-01-30 14:03:16,124
0xc6947bb433dd3382766b8f7c24a74ec8a117231a4470ef1e462649c70f3b5e55,t,39512,2788442,,5000086,2018-01-30 14:03:16,125
0xfb089076dd060c14a76340f21e8b74f32d3965f077b1201e272dfeefb80905b0,t,21000,2809442,,5000086,2018-01-30 14:03:16,126
0x902cad9bd3b73abbe372532d0572aee4cba827bcd1314ca5912d2618de6251a1,t,21000,2830442,,5000086,2018-01-30 14:03:16,127
0xaf47ef2fc388de8b72faf6db7df90cd169a2782a091b44663e1b3535693f8904,t,21000,2851442,,5000086,2018-01-30 14:03:16,128
0x6ce6b9292357bc80566584b71ac2c232ac2e3981b105870019bece5de47f07d0,t,21000,2872442,,5000086,2018-01-30 14:03:16,129
0x827dd8369bbfa4dfa907ab86704b27a6bb2e4e8474025215ec99aa8d8a552d1c,t,21000,2893442,,5000086,2018-01-30 14:03:16,130
0xcb5b827b27b4b0e55fe2a8b7020d5d0d8ba8d0938f9ba1e264028736b2c01d41,t,21000,2914442,,5000086,2018-01-30 14:03:16,131
0x85edc0a54e6f91a8c96217b45d7042217b8376b35538b4a129a199e9ce5bcc86,t,21000,2935442,,5000086,2018-01-30 14:03:16,132
0x51dda962bbedfe6b35efcb98269b85a46a60bab878d4145a5cc213c1126cceb5,t,21051,2956493,,5000086,2018-01-30 14:03:16,133
0x7d524cc49e9866598e4b18cc5bbb243e7e3111dca739ff4f35949789974a095f,t,21000,2977493,,5000086,2018-01-30 14:03:16,134
0x1bf85dd72d058e9aee7c6e5ea6c4f08ff69610e204752e721a33de3e5a52a147,t,21000,2998493,,5000086,2018-01-30 14:03:16,135
0x021eac0bd67c129365764194d211251f717da08dc1fed2ce6d79cd6002ddb2de,t,21000,3019493,,5000086,2018-01-30 14:03:16,136
0x0bbcb0c1d20c3933ad0c730742fc2f0c3d26d01a9753682c315994186ca66871,t,21000,3040493,,5000086,2018-01-30 14:03:16,137
0xf71cd4e14eb34fe40daa38bd3c08910289d1f5d0cd425a94d308530a13a224ca,t,21000,3061493,,5000086,2018-01-30 14:03:16,138
0x77d94f858b69875410eb8823281feecffcd9e28f869a78f0d32f52693d10c231,t,21000,3082493,,5000086,2018-01-30 14:03:16,139
0x2ae5fc328cc879723739df3144d4c8dc443ff60b0729ca8730d27d93aa76f01c,t,21000,3103493,,5000086,2018-01-30 14:03:16,140
0x534d96e7268f4bd634815ca7b7cc067d7ba055442988f0aec8ef6a0ae7b9e4ad,t,143081,3246574,,5000086,2018-01-30 14:03:16,141
0xac32c20f968c295f72d6e9dcbdbabfb3a3de70e563fa488a735a7a202e4495fe,t,21000,3267574,,5000086,2018-01-30 14:03:16,142
0xd8c94452869328d4f25a582e876bbf232fc92cbea3888d99a34977994a9bbd54,t,21000,3288574,,5000086,2018-01-30 14:03:16,143
0x5ffccca434e9411a8eb8beef68d772467587a99613b591b23123d19ede4d4070,t,21000,3309574,,5000086,2018-01-30 14:03:16,144
0x267e66132bfe6ed11f08611ffd1da9f01650e8db171f64f6709e44169b469d63,t,21000,3330574,,5000086,2018-01-30 14:03:16,145
0x16689050992cee0940c0f21af71e68f5449d8c5f423170ab8b9cdee6ef7c7b27,t,21000,3351574,,5000086,2018-01-30 14:03:16,146
0xe56c83374421841ea5b62093cb35b7399c29e60dcea5273291014d509680f372,t,37091,3388665,,5000086,2018-01-30 14:03:16,147
0x5df4887e3e25cebdca863d038c48c591e99876c15348d7450aa52d7642477332,t,21000,3409665,,5000086,2018-01-30 14:03:16,148
0x55e4f4ebfd82174a8eecb8f2b05bc0dd0d0491a90ba330c96dcd6608f1dea2d3,t,21000,3430665,,5000086,2018-01-30 14:03:16,149
0x0b074862897e3a91cbb962bc9bdff8950a66712109ad33ce6630f8f983174c37,t,21000,3451665,,5000086,2018-01-30 14:03:16,150
0x953405c1a19ec0874b580b143e9c2191e7c830a35fb96ea4cdf376602a6b01af,t,21000,3472665,,5000086,2018-01-30 14:03:16,151
0x7fbfad64a79efa2508ef4b38490d8d3e318423210aa331a8db391fb79bcdad53,t,21000,3493665,,5000086,2018-01-30 14:03:16,152
0xd2878276a9b55f7299094899bfafbf803fe895946365bcf52c921f82310ffbac,t,21000,3514665,,5000086,2018-01-30 14:03:16,153
0x15ff5ff8ac80e9c0c0a86e6538693bcc97de219748a24061a2e09bea7b4377e2,t,21000,3535665,,5000086,2018-01-30 14:03:16,154
0x01af2033ca43bc1be89411afe6eb22a75373d0dadcee0d75a7f470d8540ddb25,t,49993,3585658,,5000086,2018-01-30 14:03:16,155
0x5598b1f5dc0aa6a739e5c318924fac3780471c7383a7d57495dc8bef26992f22,t,21000,3606658,,5000086,2018-01-30 14:03:16,156
0x4b2eb839515bbce76449fbbc2e06859eefe04f714fce3220390bde8aa0e5ae0e,t,21000,3627658,,5000086,2018-01-30 14:03:16,157
0xbdf443895d37bd4023e91dfed74c831f0a48e9db9429ae52af52ca0c60643e5e,t,21000,3648658,,5000086,2018-01-30 14:03:16,158
0xe43f7d8a6316862031624e9497d6885417aff86229860b4542c999c4fac973a6,t,21000,3669658,,5000086,2018-01-30 14:03:16,159
0xf9bccf1208b03fade277f5d55aca943e88c279aa4855ea0703e2c5458debfdbe,t,21000,3690658,,5000086,2018-01-30 14:03:16,160
0xde194b498678fcf0d10a736561b9656fa1977afd35bec9d0a2aec38b872c30d9,t,21000,3711658,,5000086,2018-01-30 14:03:16,161
0x489f62d30c6df89c59391a13fd6fbd8d632bc7a8f45562246557fb711a23fc90,t,21000,3732658,,5000086,2018-01-30 14:03:16,162
0xb28928dc6d2dffb04ef8fb48c4853dc811d70031f349832caf643581c31f5f57,t,21000,3753658,,5000086,2018-01-30 14:03:16,163
0x24d31296c19ee01c93997beb66615eca5eaafd369c9dc06f7329c38af7ddcd6c,t,21000,3774658,,5000086,2018-01-30 14:03:16,164
0xf48846fb37c7a9868be726090f45efc6d294555118daa5afd2cf52091ab8bb9b,t,21000,3795658,,5000086,2018-01-30 14:03:16,165
0x3e562bd446315e6cc8d5cc03c07058653b87c2d40740370ab458f44a51939a02,t,21000,3816658,,5000086,2018-01-30 14:03:16,166
0xd3eb5df0531ccd69be0b50e53cc2ee353464cc798e28a110618193d23acaab3f,t,21000,3837658,,5000086,2018-01-30 14:03:16,167
0x16e13fdadcc9fa6ad9e7692d495fa986b12962e2f6b0d851cd7620e12ba0221d,t,21000,3858658,,5000086,2018-01-30 14:03:16,168
0x0ab97ac1d5b6b22b569895c2e3f84d52f585bd97affb29eda7b95e2659139792,t,21000,3879658,,5000086,2018-01-30 14:03:16,169
0x2944c164e989541e3a4a39de6b1c2ae8d055218635e293033a13b66ddfa54e20,t,21000,3900658,,5000086,2018-01-30 14:03:16,170
0x1425fb56715d333b386f8813391d3c551a126317d36fa783aee336cde0a048f0,t,21000,3921658,,5000086,2018-01-30 14:03:16,171
0xc040cf01193d0b21f8afeb4f56a29b6c55aec8d67b52316c9c8b7854f8bf4414,t,21000,3942658,,5000086,2018-01-30 14:03:16,172
0xa84a8d0c4061a3b01357f1ff3091e1730d6a13d54548b350c23d049b24d09f51,t,21272,3963930,,5000086,2018-01-30 14:03:16,173
0x81f2be777e0cd9e940162a87b2ce6087d1000b1a3749be1ebad05eaa96b29378,t,43061,4006991,,5000086,2018-01-30 14:03:16,174
0x1a8d50efac15e37de74babb345427a4a505e0a64f68274e870a14fab0ded7a87,t,21000,4027991,,5000086,2018-01-30 14:03:16,175
0x70ad4bd581cf2c7ef7dc37454a075963b0e71f27ff04145c18d6337cfb9d0bc3,t,21000,4048991,,5000086,2018-01-30 14:03:16,176
0x7233b219708c3970d8cc9723ba21ad02f70a6ffe04f2ecabb8d9c36dc53215b9,t,21000,4069991,,5000086,2018-01-30 14:03:16,177
0xc6b9ed2d4a9e35c05c07c6428da73cfbf9e527087cd294b84465aa5ae70b93d6,t,34725,4104716,,5000086,2018-01-30 14:03:16,178
0x2620ee2c02f33c328af553de8a9f4bc6940f67847b7deeac108577a7ca694d53,t,21000,4125716,,5000086,2018-01-30 14:03:16,179
0x98bd58bb28758f1ece333e9a34990292ed894882fcdac69b59c64e92a6d720c3,t,21000,4146716,,5000086,2018-01-30 14:03:16,180
0x329329193659aeb818664efea9653d76b93212824c00894bf42137a537ac8c17,t,21000,4167716,,5000086,2018-01-30 14:03:16,181
0x42026c0d6a3d18125345879ac01d6c6ecd6487070877896c73146e22ead8df2e,t,21000,4188716,,5000086,2018-01-30 14:03:16,182
0xab0ec4b0de8d663162d1a61e322d0b0e50e066afbff4068e011510b0e8def171,t,21000,4209716,,5000086,2018-01-30 14:03:16,183
0x91a01be8c4247cc01226700c3f435f330c351498d25446bf5711a9cbf344a182,t,21000,4230716,,5000086,2018-01-30 14:03:16,184
0xf1490b94a9c2368f5034151bd501abf4a28c837f04a8cb4841ea290d5792d69f,t,21000,4251716,,5000086,2018-01-30 14:03:16,185
0xfd3cf34a2e7ba39fee8e67ce179b6b0004151670bc7e8b77317fceb719329fe2,t,37983,4289699,,5000086,2018-01-30 14:03:16,186
0x27bba81a7518f41e0f2ff7d772b374ca78997b125af951e8f03b11205a841958,t,21000,4310699,,5000086,2018-01-30 14:03:16,187
0x16d72edcf935bff6390e6c2da5890674eb20910aefa7958f26b728cb825deb34,t,21000,4331699,,5000086,2018-01-30 14:03:16,188
0xa6e11de398ce8c56ae43e2bd33c3f6351a4549d6eddddc3f43db5d9855f17399,t,21000,4352699,,5000086,2018-01-30 14:03:16,189
0x91c57468b5dec63bb678fa076db61feb2e583e9555ff0628b653844a816e2170,t,37775,4390474,,5000086,2018-01-30 14:03:16,190
0x6e61e311aafe21fa959ffd1c819a40f550085a0fe419eacd08405c40082811ef,t,21000,4411474,,5000086,2018-01-30 14:03:16,191
0xa321db1f828dcc35b764b83e2119fa543a1daed81b4e5502d509f4cf3a7405e6,t,21000,4432474,,5000086,2018-01-30 14:03:16,192
0x5622d3cd1929d87c437ea5153ed75ce2cc465d1842848856045655afe7e9527b,t,37746,4470220,,5000086,2018-01-30 14:03:16,193
0xc965a61bfef375ab0e21f582f69e06ac1805f867648180b7454ac735df52f8f1,t,21000,4491220,,5000086,2018-01-30 14:03:16,194
0x79459b1a236f7143054dd67e4cbba203d3f9a57dadacd04a6bccd7191b9aab2c,t,21000,4512220,,5000086,2018-01-30 14:03:16,195
0xd2788489d6eb901c5055ab6ce6957760cfa5c4a3368ebdb3097bf03859cc50a1,t,21000,4533220,,5000086,2018-01-30 14:03:16,196
0xc10dc3bb5874be19f89d43dff93c120357c4b3616c286100c101c4a40982a085,t,103563,4636783,,5000086,2018-01-30 14:03:16,197
0xdb34035a110cfcaa92936df7625054a0541fba393b6c7b3ebb2e7dc0951a9b5e,t,21000,4657783,,5000086,2018-01-30 14:03:16,198
0xa726b7e78485bacc3c714355e67fbbafc71669f9fa19dd557a692760e2bd5d3d,t,21000,4678783,,5000086,2018-01-30 14:03:16,199
0x7ccb5856137732400635ebda67242ea9afbecdc96a165cf6ccfdf5d3d7db9a16,t,29493,4708276,,5000086,2018-01-30 14:03:16,200
0x5a533bac5722c95aa54087d306c3e28d2ce382d1dd097385e39ef38fc9af6b5b,t,21654,4729930,,5000086,2018-01-30 14:03:16,201
0x7d5ef98a3bdeb235023922a0f824c1c25ccb0d31720e448e665e3d07225062eb,t,33705,4763635,,5000086,2018-01-30 14:03:16,202
0x0c2a6b6ecdf2f964ec3d1b084ad85ce43cddc65c94f8effc8043f62266c9b848,t,21654,4785289,,5000086,2018-01-30 14:03:16,203
0xc1e6ff761af766e81b5fed80d19a87f2c7a4952f28dfe7747f4b00c90b4b5f86,t,21000,4806289,,5000086,2018-01-30 14:03:16,204
0xe3b895c8a5925cca975fbe810bcc73c1a620c6678bf42dd8c8cb2959a59599b3,t,21000,4827289,,5000086,2018-01-30 14:03:16,205
0x2e54cdd8142df331e04011bb23ba167f214e8b37579403bab0c783734a080f6f,t,21000,4848289,,5000086,2018-01-30 14:03:16,206
0xc95997531e8388a84023f5cc711984ecd259b85964171b243f1b3b97718633ec,t,21000,4869289,,5000086,2018-01-30 14:03:16,207
0x188065d9b96fca36dab464b735f428f61d7de165a46ff5a6bd13ac15ffe76777,t,21000,4890289,,5000086,2018-01-30 14:03:16,208
0xcf7766f62e40f8f5c4654f2413dc616dff3308b0162ffb7cee2424ebb2394249,t,51606,4941895,,5000086,2018-01-30 14:03:16,209
0x1fca8669ea9615627faa213164d6e3c0d56ffc1570235b629782e8649891fe8f,t,21000,4962895,,5000086,2018-01-30 14:03:16,210
0xf78a8c74352036b746fa778b19ee276fb03cd23c5ce7212d39abdf82859e5d68,t,21000,4983895,,5000086,2018-01-30 14:03:16,211
0x64d07fe6ac36abb7b7c36034775a6142407a97f41cdbc2c74d581b8f9981ac4f,t,108050,5091945,,5000086,2018-01-30 14:03:16,212
0x1246adedbc60acee88752a02f0a36a58408c8c208e22827bc13aeacdce6b09ef,t,21000,5112945,,5000086,2018-01-30 14:03:16,213
0xb69c7887eb95a23c4e86bd735f52b5c158ed9a466443c653dedf7bd8310fae8e,t,21000,5133945,,5000086,2018-01-30 14:03:16,214
0xb9acf17ac691d7a14a17601f84fb6df4377cf4ce0e5855c3dd3dc931e5a17902,t,21000,5154945,,5000086,2018-01-30 14:03:16,215
0x74664c5445c77537b03a78fa5422107b448dbd98de8ae1d1cee3bbda396abf45,t,21000,5175945,,5000086,2018-01-30 14:03:16,216
0x28fe0d88bd647c3fbf524e180aa099213bf792acc7e8d1799bb35e18f83ad28d,t,29886,5205831,,5000086,2018-01-30 14:03:16,217
0x0e153f5ea5bbde13915bd3939bda11efaa29a949c7b47078faad188225643ea9,t,104678,5310509,,5000086,2018-01-30 14:03:16,218
0x901efe8dd112e6dee4a17ca8331d2a69f11bdb0b60a0ed23a96e78c32e116182,t,21000,5331509,,5000086,2018-01-30 14:03:16,219
0xd19eec5a10474f6e954bab8b107308ad59a8879dfbd76dafd7acd69cf27653cd,t,37391,5368900,,5000086,2018-01-30 14:03:16,220
0x54fdd20fc20b0169d1b11b87f623dbde038410affe40e26eb91c61da26468059,t,36718,5405618,,5000086,2018-01-30 14:03:16,221
0x66dde0b31ca88ad1b711e049d08a38cc25c26e6380295d1c71b9c4ca24be7f82,t,37455,5443073,,5000086,2018-01-30 14:03:16,222
0x8ffef432691c3d4c8abb522cde9b4405721237b888f3df2463a550a3db68fec1,f,24783,5467856,,5000086,2018-01-30 14:03:16,223
0x828e3b80f585cd84d5eb2fd9d2527efb8f7e9e9904b255c52e8406d034f00bd6,t,21000,5488856,,5000086,2018-01-30 14:03:16,224
0x3336ebe2c333999753478971804dad6e9bc1ad26278fc7f429bec7b41201361d,t,21000,5509856,,5000086,2018-01-30 14:03:16,225
0x7761892651be44da90c3e87e2cf2d388d9e7fd754d36b454f47598b544757093,t,21000,5530856,,5000086,2018-01-30 14:03:16,226
0xa1320f0c4840befe4a85e21ca03d239d849b12db485d5e54225cfacaebb81544,t,21000,5551856,,5000086,2018-01-30 14:03:16,227
0x86f5f01e0c49859dca35b5b14f738a3ddc30466c9137ae9e3d60a6fef114a903,t,21000,5572856,,5000086,2018-01-30 14:03:16,228
0xa82f07f56c1a7ad168c9606375fa0c3a60d1be468b6f9c641d77c9c982374c1c,t,38679,5611535,,5000086,2018-01-30 14:03:16,229
0x2960b2825fd61cbcee25ed0175855e8cbe9ddca5892b3f5083f9171864135ab7,t,46031,5657566,,5000086,2018-01-30 14:03:16,230
0xe458b85799710cdd469a67097ad734f23091bbc69af0932af2e5d7f0e55b2e16,t,58999,5716565,,5000086,2018-01-30 14:03:16,231
0x84834bb03d708fb78da63d7b008f2962b0d5fab7172d0714a6d298d40dd9d78c,t,21000,5737565,,5000086,2018-01-30 14:03:16,232
0x7c2bb54898a90d31514e405b506a3b62fa8266d5f4c5568227f6423737cd80c8,t,30310,5767875,,5000086,2018-01-30 14:03:16,233
0xd5d4f51996d75fec3bd99b92c37281676b51a7db27fe4477300482394a6345d5,t,55263,5823138,,5000086,2018-01-30 14:03:16,234
0xd447a78a932d63c0458751534f80d7fe5f81d468fcd64b76a043af528094514b,t,56197,5879335,,5000086,2018-01-30 14:03:16,235
0xf9154d3664f8b93b086f573747184c497b43c47234b0e081ba3a83639ed894bb,t,142836,6022171,,5000086,2018-01-30 14:03:16,236
0x5406ca7ee827de8d03e804805c92501749be08eb8889d10b8dedf87fa39e8498,t,21000,6043171,,5000086,2018-01-30 14:03:16,237
0x1e1ea25b4b54587beaca9906e27820206194d232b69977dd926d6580e653a251,t,39835,6083006,,5000086,2018-01-30 14:03:16,238
0xe0786447363b9588e8d5a26d84c24de8ac89c4dfd4f4b91d3cf566eaa057576c,t,37071,6120077,,5000086,2018-01-30 14:03:16,239
0x1878b729704ec0a226fba28447fd1305f213ccbbbdec7d2357b07d5c5c41a67b,t,30981,6151058,,5000086,2018-01-30 14:03:16,240
0x1f823d515e34810d3330fff98545b4ac50bd83dbbc6bc993fd466c02231ce707,t,30981,6182039,,5000086,2018-01-30 14:03:16,241
0xcb7bbb4aa483b0be78028bade61bc074dfc8e77b268dbff2a05adb479a679421,t,30981,6213020,,5000086,2018-01-30 14:03:16,242
0x09a8fc87141a38d76e71c3351ae2e6428685100c36dc3562f30f54e0e92b9215,t,30981,6244001,,5000086,2018-01-30 14:03:16,243
0xb5700c93443eb71edca17a437faaa52a4e7e9cbaf7f769351934d03202445c4a,t,30981,6274982,,5000086,2018-01-30 14:03:16,244
0x17e95ac7cfb5552f57677fb43bd18879c9e5cb99e1f5c3412704cc425d05cfd2,t,30981,6305963,,5000086,2018-01-30 14:03:16,245
0x478ad0687d5e5d940fe00da9895528de6753dcf5f8d356fb001d8145df5f78a4,t,30981,6336944,,5000086,2018-01-30 14:03:16,246
0xf7ca5900806cc435de36ec7372aad0e984bf87da4eec0067bba3779cfa24a0c8,t,30981,6367925,,5000086,2018-01-30 14:03:16,247
0x1c3989268e8406bcc8c705f26f6c7b0d60214c04f84a9dd25dd36ba63d6303ad,t,30981,6398906,,5000086,2018-01-30 14:03:16,248
0x22d61c077fc631e6a0e69e7920e832ea0a9f5d3f9d107f7ebb9498093bf0a11a,t,21711,6420617,,5000086,2018-01-30 14:03:16,249
0xfe7e65dbc51d6418f5502a066b8b29b5b922f7e0ef11101ff14cdffe350e6298,t,21000,6441617,,5000086,2018-01-30 14:03:16,250
0x5f7cdfdf67e2d8b7b7ce4d26516354eb06355c0f977ed28393cbdc756386db07,t,21000,6462617,,5000086,2018-01-30 14:03:16,251
0x9201d14c8f9acc34c8c08d71829160ba645b5d376f2f1064ddb89dc817c5e558,t,21000,6483617,,5000086,2018-01-30 14:03:16,252
0x4889aacdb088e12bf3436bb341df3b4283e700fe14eaeb921d934ad0baf6b6ec,t,21000,6504617,,5000086,2018-01-30 14:03:16,253
0x35ed950d55c5efc48dbe924f3a3ff0a4fcee5f17ab4798e6ab86bd48f92ec678,t,21000,6525617,,5000086,2018-01-30 14:03:16,254
0xa9c51abbc3657fe8daf17df65eea0e42e74722eb5f59de0bd061a2f61f4b1271,t,21000,6546617,,5000086,2018-01-30 14:03:16,255
0xbbb1711d3a2d9642aa480f1a27c82ff0a5fdf65b0149b1fcf99be13489bbf34e,t,21000,6567617,,5000086,2018-01-30 14:03:16,256
0xd0ba89728f6bfa789655d19726e4f642c7c37386a2435afe354463349b9b7b9c,t,21000,6588617,,5000086,2018-01-30 14:03:16,257
0xd9a2dc80fcd85e8bdbe2afa258c77860eb48dc828da0b86a8b796d10c119ff46,t,21000,6609617,,5000086,2018-01-30 14:03:16,258
0x3b6922f9b570174b838c1e4b40b8198a3eb11e3944a6ba46c3b06cd9168ae201,t,21000,6630617,,5000086,2018-01-30 14:03:16,259
0x240397115d7943531b96b38d3d393091451aca935dbe5ead31ae2d7d3a35b05d,t,21000,6651617,,5000086,2018-01-30 14:03:16,260
0xf4f5c5df19d89c736653c39011e55258c604a62216aa2cc3cd024009462d2aec,t,21000,6672617,,5000086,2018-01-30 14:03:16,261
0x1e4f0b9bca1928ac4fa936742f69b08eef317d7db053887e489558a20daf2712,t,21000,6693617,,5000086,2018-01-30 14:03:16,262
0x7ae0e935be4c69b925bfd11a3485edd1d41a0fd53e40e566acb05237f99439b3,t,21000,6714617,,5000086,2018-01-30 14:03:16,263
0x1cc55324ff8178228ba6e0f94d400e3ad498f691e664976fc69233a2e8049500,t,21000,6735617,,5000086,2018-01-30 14:03:16,264
0x7cf72197fae5dcc99edc3a84ce4a6042b90b7a804964b7605f6db4584b49da9d,t,21000,6756617,,5000086,2018-01-30 14:03:16,265
0x1438034076585ce7339c0510d50b43c457640788207bf5a5d7db76033d460113,t,21000,6777617,,5000086,2018-01-30 14:03:16,266
0x42d39e39ed427e22af7d3dcc28badaec01c84d768b6127f1ce598bbbad602b81,t,21000,6798617,,5000086,2018-01-30 14:03:16,267
0xec3d7e77a166560886bf14084dbef99146893035f46f9efee0e9ddf373bae563,t,21000,6819617,,5000086,2018-01-30 14:03:16,268
0x3008b0d8b15e3e72cdc2d2b32773322ec5bcf0a9367dc9b76f43af0e00258bfe,t,21000,6840617,,5000086,2018-01-30 14:03:16,269
0x8b27b85297e26167ddede885eda3a93a6dc4a6fd892590ec870576745c368dba,t,21000,6861617,,5000086,2018-01-30 14:03:16,270
0x96e40433a9db823642c14b805ff2d9412dfd5a8fabcdb73aea9fbcef8c0d783e,t,21000,6882617,,5000086,2018-01-30 14:03:16,271
0xfcd4db7e712dd4cf9f7a0f7ca3a54a1af1b673e5f57c0928c20bbd16fc4be827,t,21000,6903617,,5000086,2018-01-30 14:03:16,272
0x31ec1e3862383023a7c6f6b389daeec1b78157323be7897d5eaec0e97986b688,t,21000,6924617,,5000086,2018-01-30 14:03:16,273
0x9d4c22514e9b0490cc2bc46360b699828a93188b8f7258d7733109ff44f2be7c,t,21000,6945617,,5000086,2018-01-30 14:03:16,274
0xe9216e92c43c3d9725eb18df692d378135908802bbe9d8f3c5dcb90e1b2dfb44,t,21000,6966617,,5000086,2018-01-30 14:03:16,275
0x7e4cf3d7e44b2444c9d621050b33d69e30fc6a86370dcc730641481eb4d2bdf9,t,21000,6987617,,5000086,2018-01-30 14:03:16,276
0x91e190bc7e826c9b2897e8d832162a68feee80d4d4b87f97b692b49ad4c60a3c,t,21000,7008617,,5000086,2018-01-30 14:03:16,277
0x7d088f5756a136c5cc0e404403d17285474d346e1919da4df4f396a65477a466,t,21000,7029617,,5000086,2018-01-30 14:03:16,278
0x0314c95c7e356cc37e8be5cfc4315574b55d2ca23c8f201a2fde98fc241ed1c6,t,21000,7050617,,5000086,2018-01-30 14:03:16,279
0x5ac96e3c64fa133b512b787a6b8d426990d47b9c9d7339326774258305ae6a8c,t,21000,7071617,,5000086,2018-01-30 14:03:16,280
0x26826e605df6bd8abd0e43687efbb4009367b5f27f62c00fcf7faf5f374eb2ac,t,21000,7092617,,5000086,2018-01-30 14:03:16,281
0x38f16df55196ee2cb2f6c1362a1e2236554130917f87cdc46508f90b8de7d9b5,t,21000,7113617,,5000086,2018-01-30 14:03:16,282
0x7f5e3ab28738ea00b864958f68a0a934764015b6b96684dfa52867e5066efe59,t,21000,7134617,,5000086,2018-01-30 14:03:16,283
0xcb7d7801db917e6751fab6cea0ff0e39e9ff6964c8595f98d27da9dac57bd0d6,t,21000,7155617,,5000086,2018-01-30 14:03:16,284
0x40e367f7eb62b96b3f64a0e7aae70e84b17a16322667c3f639bf9f5b68900fe2,t,21000,7176617,,5000086,2018-01-30 14:03:16,285
0xcaaff098b803aa3c6d26a7518280ddc4f72c13ff3f006e174349d6e5f3a19707,t,21000,7197617,,5000086,2018-01-30 14:03:16,286
0xef7ff5467a484003b99db0a01e2f418447fa3a15dcd3fbe4a5ea8ee3bc20423f,t,21000,7218617,,5000086,2018-01-30 14:03:16,287
0x7dc50840c1d18708c2c8c0b12382273c8b22c12edab6ae24bdfd3aa0417db211,t,21000,7239617,,5000086,2018-01-30 14:03:16,288
0x56773c6d2720406802f3c3893254d4eb336e6c6526af9d9226b198ed87c243b5,t,21000,7260617,,5000086,2018-01-30 14:03:16,289
0x06ccf0b2433e3eff0e888b683bc54b5fd74fe85602afa6fed54736aae534f4f9,t,21000,7281617,,5000086,2018-01-30 14:03:16,290
0xd1c0f7e23199863f1c4fd1a4e0fb84d5725af6492a0ca1fcf91ae93a844f76f4,t,21000,7302617,,5000086,2018-01-30 14:03:16,291
0xbe5473f99cbd0aa0d2cfeba189051ca248478e4b5967300b641373ac087c0742,t,21000,7323617,,5000086,2018-01-30 14:03:16,292
0xbda19e5e1cea6c84e933a392c4458f689cb3035c9e62e97a11457f057780f6ec,t,21000,7344617,,5000086,2018-01-30 14:03:16,293
0xbfed2c8cd4704c35f7a945d395e53c978559e3731e2af860d97728c27aa64e88,t,21000,7365617,,5000086,2018-01-30 14:03:16,294
0x3ed6a0876be2f532cd3bc5985c27af7e640f0ef7c19018da868fd521237da4ec,t,21000,7386617,,5000086,2018-01-30 14:03:16,295
0x6690b11009575a31e69a9757c560a60a57ab490b512328ba3a2538159ecc8bfb,t,21000,7407617,,5000086,2018-01-30 14:03:16,296
0x6f5b29ad9e0bb9236579b4cbaf7745040a5ab83399ccba942c77b6ba3c52ab87,t,21000,7428617,,5000086,2018-01-30 14:03:16,297
0xeae633b4e61fea41cbee3d1fcdea0d939da539edb43b415e73f411726da33974,t,21000,7449617,,5000086,2018-01-30 14:03:16,298
0xcea9d1f6b8fe409104a8b7d81c567a5aa2bc057c04868e3dbae44a1b966fe561,t,21000,7470617,,5000086,2018-01-30 14:03:16,299
0x51bef00674864eec58212ebfea1e34515a9b5dcc9dd51b192dd49db8e08d5d4d,t,33705,7504322,,5000086,2018-01-30 14:03:16,300
0x65da19fef7bc226fde6bba8441295c42373b828c58d16167889e4b3b50e6d3d4,t,21000,7525322,,5000086,2018-01-30 14:03:16,301
0x684e3247f3adf15e43f2b066d6ee5054c9bac83100b77ffba98bb306c1810711,t,21000,7546322,,5000086,2018-01-30 14:03:16,302
0x5a3233bbe983fa98083a459d236c05573ef3e30fa828dff781f15b34a7a73698,t,21000,7567322,,5000086,2018-01-30 14:03:16,303
0xa41d7456dfb13ec877d3175fbec672a256f258b9b1f29fded8d8cc6e2c7e3d8d,t,21000,7588322,,5000086,2018-01-30 14:03:16,304
0xdeb3c9cfaa15404202039b26097d9a77c058ad425f9335592481c40b8116ae80,t,21000,7609322,,5000086,2018-01-30 14:03:16,305
0x9f63f4c5c80f874597f5d9422ef97fd89b0426d9a0c190dbf761a44368019e1e,t,21000,7630322,,5000086,2018-01-30 14:03:16,306
0x9fc9dd569fe17d9cc77c9e2db3f7f0d4f560ce5f43487cb2dc6bc5219e7b48c5,t,21000,7651322,,5000086,2018-01-30 14:03:16,307
0xc5341d3dac5405de0f75476769fde8f117d3841c00ae54df21f73d4cbd2d7f0f,t,21000,7672322,,5000086,2018-01-30 14:03:16,308
0xddf3af4d5836a03c363e0efb109a89828bb9bfdb74ec5f9f022d9fb25b48453b,t,21000,7693322,,5000086,2018-01-30 14:03:16,309
0x259cd30e467e04e71a39e6f7ca790e11203debd62e9c8aa7dcfc447c374684af,t,21000,7714322,,5000086,2018-01-30 14:03:16,310
0x71318c9cb10f9821db9b2ee0588481c40d4ec4f5d9a1b59ca4bf654dd2dedc21,t,21000,7735322,,5000086,2018-01-30 14:03:16,311
0x7a7f1621bcc3e9c0dcd01c5309e3b41b187e05e0cf7fcda03188673edd611cbe,t,21000,7756322,,5000086,2018-01-30 14:03:16,312
0xb78043b79337aa389f49baae5a0825e72e1b72ba5b8797b8487c57dd7fe60146,t,21000,7777322,,5000086,2018-01-30 14:03:16,313
0xd09f3d687156e0cb058b629c2c3ebe9fbd75f3484da6f386c25332c180eaa9ce,t,21000,7798322,,5000086,2018-01-30 14:03:16,314
0x290cfba0022f31437a1fa8be9f956d6b7897ae62025a04b81792f32809e97e19,t,21000,7819322,,5000086,2018-01-30 14:03:16,315
0x58be386861c41a30ce09cfe19bd38950fda1927032d43e31a9e02ffbc4194236,t,21000,7840322,,5000086,2018-01-30 14:03:16,316
0xa31964bfbac9d756d540aabd5785658e29e0afccde495df864490e4ee2bd1138,t,21000,7861322,,5000086,2018-01-30 14:03:16,317
0x8cfa941ccce914733db8e0d0091d4ba635b25dc91baedcfea0d4b241f1859eb5,t,21000,7882322,,5000086,2018-01-30 14:03:16,318
0x7e3927759762eb3dd49bc8993ca5787e29516d31ef4c5d552d2e95a859b42af6,t,21000,7903322,,5000086,2018-01-30 14:03:16,319
0xa7f02513c5d1e72dfa68ea2df392922a50788c69d14d22732511772f88590fd8,t,21000,7924322,,5000086,2018-01-30 14:03:16,320
0xc362defa7dfbb318d83501d7cb1b1731f9325287aae5e525fe8fe37aed52f892,t,21000,7945322,,5000086,2018-01-30 14:03:16,321
0x7a8a8f454db4aa80a5eaa31fa965ea839c4e2616241eb1c69550e3daf0905dd0,t,21000,7966322,,5000086,2018-01-30 14:03:16,322
0x945d2530e746177b22478c3739b9b0ba7f05de52258c97e6135880ee3455d4e6,t,21000,7987322,,5000086,2018-01-30 14:03:16,323
0x0e0f28fc02e03af3b6888d85df3a212b47576a3ea8415e35e501a0cd872fe048,t,21000,21000,,5000087,2018-01-30 14:03:22,0
0x6b2411a57659fee67373cc3ed996fbadc2b789055814497e98f68bcce6b6ea87,t,21000,42000,,5000087,2018-01-30 14:03:22,1
0x658cf0a8f8927b7ec404859ed0a8063df38661c2e477a348ba7389a4fa49961f,t,52091,94091,,5000087,2018-01-30 14:03:22,2
0x03ee2b76bdf8bab21ab865d3378a371ca633c533daad3cde1486be356257e97a,t,21000,115091,,5000087,2018-01-30 14:03:22,3
0xa1b4c6a1e3f232ddba274753f4e9f2b12ee777ad468cb0c61ccf7ee222f54b0b,t,21000,136091,,5000087,2018-01-30 14:03:22,4
0xeb9389fdc68f8c9432469c23b3c992bc5671d2c1011360b383711d145ed239c5,t,37272,173363,,5000087,2018-01-30 14:03:22,5
0x16c821a37dc67517b427ad0b8505e40df8b39df0abadea47d400626634d53f17,t,21000,194363,,5000087,2018-01-30 14:03:22,6
0x0f002544dd45687ebd8c877b5f2e3b25bdd14716a0253f3d55b741be7cd12a35,t,21000,215363,,5000087,2018-01-30 14:03:22,7
0x398d33f56a3cf359c4e0cca65205b32c09cbcdddfbc4697ee840478f07bff57c,t,50057,265420,,5000087,2018-01-30 14:03:22,8
0xe4e84ab04c75e2a1874fff8939d1ce160251abe71acdc79203294a35202f6129,t,21000,286420,,5000087,2018-01-30 14:03:22,9
0x693c7bb45c47cdfc89061e6ea1893f59d77e38da460134c8575012d3654a724d,t,21000,307420,,5000087,2018-01-30 14:03:22,10
0x3a02bfdf052bc19a78c93f4725bda1d6b2c64d8228b26a01609e98910bfcac0f,t,21000,328420,,5000087,2018-01-30 14:03:22,11
0xdfba241755886294da845d1595fc7b4027c7555f5d546b98c7a98c898ec28d2f,t,21000,349420,,5000087,2018-01-30 14:03:22,12
0x9074d718271cbd635b4f6fab6862e4ef37eb21b367e388b265f17ae59def4338,t,52886,402306,,5000087,2018-01-30 14:03:22,13
0x446c1649e5f36760ed275bd53cc3f8a89016cd0e89cd593610b4c5e6d4e6b0f4,t,21000,423306,,5000087,2018-01-30 14:03:22,14
0x934d4a57251c54d81e5681d123a342f4e5d5adc4940144e1c8acac06647d3904,t,22305,445611,,5000087,2018-01-30 14:03:22,15
0xccf2b7a44a8b6601007320c35869a0e6dbf1feb3051775eb82ffdc672836614b,t,21000,466611,,5000087,2018-01-30 14:03:22,16
0x6b2ea35cfd5cae1fbf826c4a8f94a2efc47f5169998335f3d2a6022e15731293,t,21000,487611,,5000087,2018-01-30 14:03:22,17
0x76b76a0686a3bde190b2d9333605d73cda0214016a361e45cfcd420249edd217,t,21000,508611,,5000087,2018-01-30 14:03:22,18
0x0df3631f206704cf65f96c9d81cf9bef0fcf0f8f8a9f7f8b20d308c2a05bd978,t,21000,529611,,5000087,2018-01-30 14:03:22,19
0xcae6b1e2250d857c29a53f7ca5ee67850e2a2742c9c26b513b472b62865ebbfb,t,21000,550611,,5000087,2018-01-30 14:03:22,20
0xb3a401b22422dd924ae49674ed66882fac2ada441f44b826e38250ac203dcc5c,t,21004,571615,,5000087,2018-01-30 14:03:22,21
0x52c62d2b9ad0d7160805ef1f3e881b6144814ecfc1389aa60aa80723318c5861,t,21000,592615,,5000087,2018-01-30 14:03:22,22
0x7dc5dcb857a66ad469a45cd48e591e216ced3a68ae74430aa750f56163e908f3,t,74063,666678,,5000087,2018-01-30 14:03:22,23
0x0ed4d65d1a32b499ec36be3f9c20e7c41680bb4b6d7f9b82e3cbfee29e43a90c,t,21000,687678,,5000087,2018-01-30 14:03:22,24
0x6e3d40d0a5eb5be3dd7fbeab78ecd92e545df8705865c761864930ecaf1f480a,t,36821,724499,,5000087,2018-01-30 14:03:22,25
0xca015d567f3fb5c65721e73e3f9e4d2cf185d8a46f867c8f9e9a69b4fe3a579a,t,39512,764011,,5000087,2018-01-30 14:03:22,26
0x3dfdd22b580a295bb3b3f24f4fc41df33789b63866ddbbe35f973628e2d20a97,t,21000,785011,,5000087,2018-01-30 14:03:22,27
0x9ba904c8483e9954f2299419c79bed6464a23d34c561505f50d11ee07e7e80f6,t,44812,829823,,5000087,2018-01-30 14:03:22,28
0xc0610ae366fb051f782e0ee67ddb12c261a9cbc4792365bdc29155b1634fd0af,t,157580,987403,,5000087,2018-01-30 14:03:22,29
0xeb30b93e829b3d09f32e1dbe5b2ac60c9e3cf153a912755bd5293e551f22e375,t,52886,1040289,,5000087,2018-01-30 14:03:22,30
0x7c1c824f837cbd6dafcdb249e6ee80d2f47fcfca9a9c388bdf7598bb03fca327,t,244829,1285118,,5000087,2018-01-30 14:03:22,31
0xeff4c77b41d09aca32d505066f17c13dab89a72e1206f9deb819b840b3bfd90c,t,253854,1538972,0xdaD75D31b891F317fD22076e506f17E805183124,5000087,2018-01-30 14:03:22,32
0xae361c5323ce29f1229322b3e906d20985a0e358fb813869e42f4c0309d18a14,t,21000,1559972,,5000087,2018-01-30 14:03:22,33
0xb6d93ba79a5c9f0e80ac795382f2496b8e54caa26d7e3cd84ca91c86be2c1ea8,t,21000,1580972,,5000087,2018-01-30 14:03:22,34
0x765c453499863b05bbc088da1093e0a9959bda00f37bc88d29e0147c4a248a87,t,21000,1601972,,5000087,2018-01-30 14:03:22,35
0x01c2795c84761c00b218691ec47f7de6c661440e34bbe5c543ca0def547a99de,t,21000,1622972,,5000087,2018-01-30 14:03:22,36
0x1668fe5afb88737c4b5353a2c84df925184d9738024a271e477464ecd8e22bef,t,21000,1643972,,5000087,2018-01-30 14:03:22,37
0xfbbc45ba83c33e0b8bfd9af1c9b40f3adfe5ae2d50fa4a4ed9861bb7b7b88510,t,21000,1664972,,5000087,2018-01-30 14:03:22,38
0xff886ff1b1a6c1f6e74baeb0dd16eabcd1836f8758f6dacec5402656f54fe956,t,21000,1685972,,5000087,2018-01-30 14:03:22,39
0x2dc95ba88766adc15b472788eab7fa527666d877927dc3e24aee347a5daa987f,t,21000,1706972,,5000087,2018-01-30 14:03:22,40
0x70127ca668f1804eb0cec5df21025b55d1423e8c9cc5db89910061c53421a388,t,21000,1727972,,5000087,2018-01-30 14:03:22,41
0x5f70452c326ed9d5f5f832e8cca81ed0ced040de2ad03b612f3fd6066a1f053f,t,21000,1748972,,5000087,2018-01-30 14:03:22,42
0x113f236cfea09875ee3bf9dfb20ea039b996f215380d87231d8291e5e35e8dd7,t,21000,1769972,,5000087,2018-01-30 14:03:22,43
0xe603bbf3f2a5d3c521c12e7718d268d26befa788018eb4c0c521dacddf70cfa3,t,21000,1790972,,5000087,2018-01-30 14:03:22,44
0x6bcf119def7be11445d20bb3b983f5ee7337c551de1949d37fbf9742f82f89f9,t,21000,1811972,,5000087,2018-01-30 14:03:22,45
0x63f1170470a4360779b773c6d3e0b5e98f3e8c65e956411fdbc3e0de5ac98159,t,21000,1832972,,5000087,2018-01-30 14:03:22,46
0x9886f0e905a23ac4c11c8de2f842cefd86797dcd1b111067f5fc9b57f688594f,t,21000,1853972,,5000087,2018-01-30 14:03:22,47
0xd8240fbdc1f5363f94125b257c9950af87cc123574f708540e1e9d90593d5476,t,21000,1874972,,5000087,2018-01-30 14:03:22,48
0x5964d2c1d1bb308fefadc3a8036c5a2cd52444052366e35a25d1dab993233740,t,21000,1895972,,5000087,2018-01-30 14:03:22,49
0xf0b84ee47e09684fc4eeea03582d9dee0b2a699c3749a9b815ceb2e82a30b21f,t,21000,1916972,,5000087,2018-01-30 14:03:22,50
0xd1c968a70a984ddf37e1a85c1f432a5c4d898a2d9bba0f0ad4c2d64d430ef441,t,21000,1937972,,5000087,2018-01-30 14:03:22,51
0x6a59d1d04edef8785ea45b95b0781363003ef5562fb004e8551abfded6d42cd2,t,68812,2006784,,5000087,2018-01-30 14:03:22,52
0xe0cccb68e7be4475b1f6fa46efe82d3358e77df972b89c046a4cc89181335329,t,21000,2027784,,5000087,2018-01-30 14:03:22,53
0x86d56fa462b6ed79ff0638a16d34d18d0a7c35548f64602d747b7118883a3d61,t,21000,2048784,,5000087,2018-01-30 14:03:22,54
0xf1069ac70ea08d10d02b9b8bd16801c6f086dd3a9d132f1dc0591554c2f0ffb1,t,21000,2069784,,5000087,2018-01-30 14:03:22,55
0x09b08312da2d5a08012c40ca667abe231eb8681c608f28eb153dd3943c164488,t,21000,2090784,,5000087,2018-01-30 14:03:22,56
0xfc2a7b7ff23942e29892034efab4aec3f042b7667021216dd5c01056503e4cab,t,21000,2111784,,5000087,2018-01-30 14:03:22,57
0x8b22400158b1702a68d450d7dc87a4fb7be11aebdd725900dcfa78de7f5c1fbe,t,21000,2132784,,5000087,2018-01-30 14:03:22,58
0x268a890358b391f413e0281e5cb1b8f1dce646a734a7ec6d61b401bba1140161,t,21000,2153784,,5000087,2018-01-30 14:03:22,59
0x85065df658dcb3f5d8098f7280ac1418644fa9b1678a53cf89dbccef924cc076,t,21000,2174784,,5000087,2018-01-30 14:03:22,60
0x2f6d0f4dab073427ca18d7b1cf8e1a72aab6c0a13fe89f1608dea249d12e7e1a,t,21000,2195784,,5000087,2018-01-30 14:03:22,61
0x049f1ff5a2c0a95ac335a8eb51d596f74ec4e7435b9c5dd7620aa511f4bca523,t,21000,2216784,,5000087,2018-01-30 14:03:22,62
0x133ee328a2f70ce5cad5f188cbd08474949eb77a671b1381df2ee74c4954e976,t,21000,2237784,,5000087,2018-01-30 14:03:22,63
0x9060e94ea4d0ba703423079b16a5b6e91883ddf1f9d915bfd32c2c1ed76b0061,t,21000,2258784,,5000087,2018-01-30 14:03:22,64
0xd0059af0c9643a7fb39c122d6fe2154c601f8f42c6a5d4f3804deea7f505534f,t,21000,2279784,,5000087,2018-01-30 14:03:22,65
0x3ac3ecce04d2f8b1ffb098f00b347cb4985dc1b7bc0df869667fdf91b6388a3c,t,21000,2300784,,5000087,2018-01-30 14:03:22,66
0xde326618f8bf85b9aa7d170a05b952af3f7201c65e6a9b480c9983ad1cddc12c,t,21000,2321784,,5000087,2018-01-30 14:03:22,67
0xf5537ece77091572418d162641ff5971fd9ae9daf2c09fe6c0fb9bc4d9e1196e,t,21000,2342784,,5000087,2018-01-30 14:03:22,68
0x92fb2729c7786a8846b8ec3ec0629cb7a8246a7659e50d93c5c199e2aedfd3ef,t,21000,2363784,,5000087,2018-01-30 14:03:22,69
0xc55be6a54b26c68f7c7ae287d1b3d38466567d4be3058dd4191b2f9009ecb36e,t,21000,2384784,,5000087,2018-01-30 14:03:22,70
0xc7b3e1c20b4b769a630ce7a526cd2d5b1181d0584fc2fada15bdbf3089d08d3e,t,21000,2405784,,5000087,2018-01-30 14:03:22,71
0x6614a0cf69def485d9db9fd2b5f4070d072ad5a0e63ea39671b4660ad2ac4f22,t,21000,2426784,,5000087,2018-01-30 14:03:22,72
0xea413aa1d9e1b9254961b4b9fe6728bdc29335034fccb383dffa38590f6859ee,t,21000,2447784,,5000087,2018-01-30 14:03:22,73
0x4be858a9466d2b895d89c6d79fcb4f8b412a3c20d62d4ab3674b8dfa4c9f2f35,t,21000,2468784,,5000087,2018-01-30 14:03:22,74
0xd965152fe3016b774895724d065cf1b4afa5c4b4b0833fdad7234d5dfff3fa51,t,21000,2489784,,5000087,2018-01-30 14:03:22,75
0xaec34f6dcc6b569491625f703b3c7a6180010f86b1c980445c4b0e07750937c0,t,21004,2510788,,5000087,2018-01-30 14:03:22,76
0xc462d9f2335910a441ce30ab2d03dc5bf1905fc36955077cd67f22ffee238b53,t,21000,2531788,,5000087,2018-01-30 14:03:22,77
0xbc0796b6711df54ad1c135d076484081f8d146ed0c9275751b8600ec1ff62d5c,t,21000,2552788,,5000087,2018-01-30 14:03:22,78
0xb6dfce657437061944042815b54a23dda4a351cf85fc3b4c28c663ac5b3d34e5,t,21000,2573788,,5000087,2018-01-30 14:03:22,79
0xe12b2e4db430cde72f10c90180349a4376e41336b746d62e5448292e6a3cd49b,t,21000,2594788,,5000087,2018-01-30 14:03:22,80
0x47d127c1023d3dcd9e504e73b632b5ec7fb70d54519dc4c3326797638ef093e1,t,21000,2615788,,5000087,2018-01-30 14:03:22,81
0xec229ea9dd3cf3c23ee83cd1345b16e859d3ad46b9ad80e440228f4810b7c715,t,21000,2636788,,5000087,2018-01-30 14:03:22,82
0xeadd95394bbca24412e176f5cf4128479314c185d6f62d146114c96e09949ad1,t,21000,2657788,,5000087,2018-01-30 14:03:22,83
0xe77e19aa3e780f20023236ffc35b5c0d778e0b0bec4a4d7ac554ad9f77c7264e,t,21000,2678788,,5000087,2018-01-30 14:03:22,84
0xa0a81e578e82fd841e5f39e0b5c7ea6670c5d7257b78e136795e063d89c3299b,t,21000,2699788,,5000087,2018-01-30 14:03:22,85
0x1368b1f76d01189de1ba7f9dbfd6f6f2d2d77fa139e1812623c07b17f5775b7b,t,21000,2720788,,5000087,2018-01-30 14:03:22,86
0x53c72572e46bbb8a60713983affde7d5e1a54b71dc5a31892ea4e9749f723a1a,t,52460,2773248,,5000087,2018-01-30 14:03:22,87
0x891552a9eb5afc495a9c4ac89ba10870f64d9879f970fc55a2f50e34651b94e4,t,21000,2794248,,5000087,2018-01-30 14:03:22,88
0xe8c8b8f83d2d86906f714351dfc5456679b0dcf83c2a034fe855c411f31589c7,t,21000,2815248,,5000087,2018-01-30 14:03:22,89
0x30a56ce7be3b8a25d0a088d4f7c306743507634b5497d8c98d11b06f192b7913,t,21000,2836248,,5000087,2018-01-30 14:03:22,90
0xf0deefcf381315ed847673a9971b561e697c404d8dd727af9238477d411b5f8d,t,21000,2857248,,5000087,2018-01-30 14:03:22,91
0x9d8308ad178a1d65dc1eac926f8203fdf54b0c68b71c95d3c250279a73b5c4fe,t,21000,2878248,,5000087,2018-01-30 14:03:22,92
0x82d1830f33569435df5a0cdaf579a9d4a5658c4665deb78a6c3d949140b73824,t,21000,2899248,,5000087,2018-01-30 14:03:22,93
0x6b84ade46c775f5b41b979b5fd097634cb808ca6bba606c61d0b7b619b31b231,t,21000,2920248,,5000087,2018-01-30 14:03:22,94
0xb83c4250cbdc02a75b9ed2736292f253f8d4a14ea564b60e3eb67abd23580841,t,37524,2957772,,5000087,2018-01-30 14:03:22,95
0xabf5c5bfa7f05d7cedac2169bb6dcb79f3d4907684b2fc2795a9b6d5a3c36193,t,21000,2978772,,5000087,2018-01-30 14:03:22,96
0xce997fbd7f7607fe49f4e7d1a86bb13522f70adea24fb5fb9bbb7b75b9e85c3d,t,21000,2999772,,5000087,2018-01-30 14:03:22,97
0xc4a25c26c0c912adb5b341f752837f0ad0e04d510996d35345ea3ce7999dedb0,t,21000,3020772,,5000087,2018-01-30 14:03:22,98
0x267e97c3715dcb836ad10d4cbff818d97a2a4fb23633fe3f9a304fc53e7493ec,t,21000,3041772,,5000087,2018-01-30 14:03:22,99
0x3efffe39ba4a881b634453c8d5c86003a6024ffec1899ff7ba7e71c727abd382,t,21000,3062772,,5000087,2018-01-30 14:03:22,100
0x0ebd6d11b4b5355313eb16cc2a2b1f9aeca539ea6342b7fa8c4c8a1ce56f72e1,t,21000,3083772,,5000087,2018-01-30 14:03:22,101
0xafe6f348f5b907ef393625a948ba246c31f74cfef5564841757129b6d0ee616c,f,98863,3182635,,5000087,2018-01-30 14:03:22,102
0x7949c23ac279ba6e403f80b1cbf7150ff97764fd5e151391f933a613a3f44a18,t,25222,3207857,,5000087,2018-01-30 14:03:22,103
0x148507651373efb46d7126bed48c9ed0c77d1bac3d47667c3507c4ed9caa4826,t,29493,3237350,,5000087,2018-01-30 14:03:22,104
0xe13640800cc8febf2e10c01fcb9b5816b95a2ac3eab08a9d5ca9531388a69319,t,37976,3275326,,5000087,2018-01-30 14:03:22,105
0x34c31899dee99a3651072ae6d237757b1351108cf83a553fa7f52487072ba2ac,t,59290,3334616,,5000087,2018-01-30 14:03:22,106
0x4a5f54a54ed625e100f8e761fe02beba8f1500fb878782d1ce77c669641a5f51,t,21878,3356494,,5000087,2018-01-30 14:03:22,107
0x05f6ed3db7e22c9ed2103b0a8ce78f1a58c0e656e75bc1f414b561ff40567512,t,42220,3398714,,5000087,2018-01-30 14:03:22,108
0x728367d883fc8e3bb36b6e6e7262c179faf60d00bc5ef30bcf248d896edfaa4d,t,44418,3443132,,5000087,2018-01-30 14:03:22,109
0xfc28b81a36e0b064d71ffa1dae5d5d37c1532e8124396653e2004e4c91ef4917,t,37660,3480792,,5000087,2018-01-30 14:03:22,110
0x408cc25498e8848d9a1e70c2f7b76c5eaaa02f8f28b9404a2c0b48f601954b9c,t,21000,3501792,,5000087,2018-01-30 14:03:22,111
0x0b7887a55a5ecc6526458c31a982342470e2afbcb989c1009bd76f086504272d,t,38026,3539818,,5000087,2018-01-30 14:03:22,112
0xa53f0f0cec11122fc3a4e8c66976f72ee353add581397e08a6a87387d16f463e,t,22143,3561961,,5000087,2018-01-30 14:03:22,113
0x97e7f42b957bfc68a90c25f83f9da76f22c26e382c938c5577d0a7658bef9d65,t,45591,3607552,,5000087,2018-01-30 14:03:22,114
0xf798f53526c4c637d460cefd60eddb1c9069433145277164c02006007110f242,t,21000,3628552,,5000087,2018-01-30 14:03:22,115
0x1ce06aee56644d5ff562a72a5e10ed77a2485121ea34406d8d1268068852cd02,t,45479,3674031,,5000087,2018-01-30 14:03:22,116
0xc8634b6fd00af57073bc030a2d736a14616f5a57e7cea3964831c659270a7893,t,69376,3743407,,5000087,2018-01-30 14:03:22,117
0x7a8a8a386c925b84b6cd89b10572215b4624838114153ed97df9db5711d11c8d,t,52052,3795459,,5000087,2018-01-30 14:03:22,118
0x59d0c431f2e391caab6dde16d0acd4c7d18d5feccfa206c3b63eba316549ff69,t,107602,3903061,,5000087,2018-01-30 14:03:22,119
0x4754e36d6cbbeab6ae9e115f8fb536b7cc3829fc36249f8e65ba9c80f6768f6a,t,21000,3924061,,5000087,2018-01-30 14:03:22,120
0xfaff9ab18be59e0b65af0bd1d4d47b0a80850a03bebf4b5e5d536b3d32477e78,t,21000,3945061,,5000087,2018-01-30 14:03:22,121
0x73c3872108885e96001e39567d8b1cc39ce94f592eaa9b333a0d891c41620b73,t,66252,4011313,,5000087,2018-01-30 14:03:22,122
0xed42f0c1fa4403de8cccc056a9c20a543c376c523d77c15df41bd3294f94d249,t,51496,4062809,,5000087,2018-01-30 14:03:22,123
0x51e9dd4167a32d6de7fae87ec2d56791ce2f66b1a17585899d114f780104e7b2,f,250000,4312809,,5000087,2018-01-30 14:03:22,124
0x2ac8d310e42b6b13c1bbf075635bbd716a6460fc29ce11e11052714fe0703e11,t,93114,4405923,,5000087,2018-01-30 14:03:22,125
0x85659fc3dda2a462dd2cfd49ae1649c3364e044df9081b4744c0a1d2f3ea19dd,t,44354,4450277,,5000087,2018-01-30 14:03:22,126
0xf1a6177fdeaf4d70e6421778502f3187a188dea20ed017cc6f7a41da0f43a5f1,t,44162,4494439,,5000087,2018-01-30 14:03:22,127
0xfb3fb47803020fee4acbcfbc184e04589e81bd238b3314e249d8221cd7d0fc96,f,250000,4744439,,5000087,2018-01-30 14:03:22,128
0xe87703710e27970fade2b288689766074ddc49b026e6eb2180e5fade7eea0342,t,26734,4771173,,5000087,2018-01-30 14:03:22,129
0xabc23474b042649808ca1b0e3d7f28b58b08607dc016fd924f805ac5a474d5cb,f,250000,5021173,,5000087,2018-01-30 14:03:22,130
0xccb6a80ffccee98d788205fc9946b4ea9487feee57598533d9301416b60b6ddc,t,107602,5128775,,5000087,2018-01-30 14:03:22,131
0x68d641135588b6bb145635a58d5be0d057bf6caf53f610432173fb0ec9f3c191,t,45598,5174373,,5000087,2018-01-30 14:03:22,132
0xc970715134c2e680b5675228c2f8aa480dcf0e3e55ff0da8c0540788235dd0c8,t,86630,5261003,,5000087,2018-01-30 14:03:22,133
0xc9e7b3631aeeff5820a2bf847a93ff23dc9b01c7b35cbc6e4c1f63063c2209ad,t,21000,5282003,,5000087,2018-01-30 14:03:22,134
0x586e048807c50f7dc82672ef9f6cba6a95042d05727b3e7c910f025ae6aa7ce7,t,64725,5346728,,5000087,2018-01-30 14:03:22,135
0x25da5c1cd15593152762f3c84848b4b20a31f7b09da6109c342b77564a44f6f1,f,250000,5596728,,5000087,2018-01-30 14:03:22,136
0xebc430c91c6a0d9bed9a390dcb0b28f0cd4b7c0ea5c0f7d0b88de92e73112862,t,174591,5771319,,5000087,2018-01-30 14:03:22,137
0xcaffb697250c9c409daa17138059bae4f25b3af82b201d97d5bdf64da2d33504,t,21000,5792319,,5000087,2018-01-30 14:03:22,138
0xd7537b6ac6d4e6f565c72b0d48a2f14daa0d3508599a63fb52ca1171336430ef,t,78178,5870497,,5000087,2018-01-30 14:03:22,139
0x25b0cd71e2baa5a20d95c9d6ff0b92b1d43d1232d09113039614c1fa1b589bcf,t,84005,5954502,,5000087,2018-01-30 14:03:22,140
0x753ee0d5db8d1e00853d397593e18fc1766bd5525e7389a07cc2332c16253f67,t,54195,6008697,,5000087,2018-01-30 14:03:22,141
0xf8addbd20c396d25ebb149b2a9d3d2aaa0c4216619ed970e1d3faab52b2dd872,t,21000,6029697,,5000087,2018-01-30 14:03:22,142
0xcc8197812c1a0dfbe2e6da9bf3f57aa806e8dc2924283d76e9d85555c2d60b47,t,59162,6088859,,5000087,2018-01-30 14:03:22,143
0x76d51fa4c22ff9cc2cec09ef492101694846c3eb0162a45dea319b9023a604f9,t,59354,6148213,,5000087,2018-01-30 14:03:22,144
0x0c7ca6fa3bb05f1cdf5ce85d918d6060e8bb87df4848ad4c9b33f0715d6aa70a,t,21000,6169213,,5000087,2018-01-30 14:03:22,145
0x06fb36e1afcd238b8a22ef81173e33bd7656c1ca52fc8add4cf39a13f8775fef,t,37964,6207177,,5000087,2018-01-30 14:03:22,146
0xecfabe0399b1a70341e5881ac46f15e76d21398a8e4904abf649827ca6738bfb,t,21000,6228177,,5000087,2018-01-30 14:03:22,147
0x5f9fb5ae5ae5f46c630b849bed63a3c4a851dcee82abb816579789f6d24ed882,t,22484,6250661,,5000087,2018-01-30 14:03:22,148
0x363a4325c579a5796bc25bcd87a3eabad334be3e8b0dce46926e51af7bce001e,t,44290,6294951,,5000087,2018-01-30 14:03:22,149
0xef6c0c1bc8e39900907f9b024f684a77c41ff75dfd79a74e6e62d848de7869d9,t,34624,6329575,,5000087,2018-01-30 14:03:22,150
0xe662a7735a508996fc6d4a076b239bfe48790bff7fc7fbae810d88cbc50b04a7,t,84005,6413580,,5000087,2018-01-30 14:03:22,151
0x5024a2c29059d0e2601a71eeb2e5ea64258471fd4c1770b7359df6c683e4faa5,f,250000,6663580,,5000087,2018-01-30 14:03:22,152
0x8e49f1ca4484ddfb89ba8b8c2fe333424c68e6cf858bb045bdcd22a58c3424a4,t,78050,6741630,,5000087,2018-01-30 14:03:22,153
0xb846e39987f73f0f7b069c7d7129455c18d206aaebe465ecec556948dad61e2a,t,59226,6800856,,5000087,2018-01-30 14:03:22,154
0x5a1b109cc70db9f90c1f09a9764ac4dcdd10f522d5f1dcecf17ec457b2c89410,t,98113,6898969,,5000087,2018-01-30 14:03:22,155
0xb892cd57d983167b60c23bdb8fdd23cdee05ba9b4ad4658fd4bc0f2c0f8942a4,t,21000,6919969,,5000087,2018-01-30 14:03:22,156
0x33c71120f8c3ac07c59a6ae9475e2033ce4cbd8dbacfd467eeea79f7a0a27543,t,141985,7061954,,5000087,2018-01-30 14:03:22,157
0xff1dbb7e50e24bc5d057bdb9e2142a8af07877dcf86d5525ef5678c7849e3ca5,t,21000,7082954,,5000087,2018-01-30 14:03:22,158
0x103ef5523a8d89534134582c32b40cf44c9a93e2778240902a706986363ce8ba,t,79885,7162839,,5000087,2018-01-30 14:03:22,159
0x3b661cc99d4154dee72e4e41b8a9a9f380ba801174bbfa34b458eb7687f3d795,t,21000,7183839,,5000087,2018-01-30 14:03:22,160
0x7182738b0c920e2b6578e75ee4561059eb796547bc077875691e55b59ee15049,t,90729,7274568,,5000087,2018-01-30 14:03:22,161
0x42c193aaed6bda0e97683275bea4a823c09326d5e62d2bd75829babe75d623a1,t,90117,7364685,,5000087,2018-01-30 14:03:22,162
0x4f348870ae4aeab8568657b91ebc22e2567f6e854a92b6f15de8d885dd476e96,t,48734,7413419,,5000087,2018-01-30 14:03:22,163
0x15a14b7f9259eac23cb9ae51c4ee1afe08e0d07eaa4fdf7baa4654f5f1c23ec1,t,43952,7457371,,5000087,2018-01-30 14:03:22,164
0x89991e1fc62171e417f790c6228fe66a25b50500a3bebad52cd1b9111133e2dc,t,21136,7478507,,5000087,2018-01-30 14:03:22,165
0xf908e0f9908cb8f80d0041eafa43d0090efc7ab4e15241f367ca3eb94cea2b89,t,21000,7499507,,5000087,2018-01-30 14:03:22,166
0x24ad5ef908bda7c5f0b417e5369be662f36c8ff2f592bf7bae3e8ac8e24ea015,t,37564,7537071,,5000087,2018-01-30 14:03:22,167
0x3f35419a06e6aa1cc92016f62c7a30b08db1db03d19d09c52a2ef02d383d2682,f,24090,7561161,,5000087,2018-01-30 14:03:22,168
0xec99d5253222afc606ea4af0afd98f47f9eb941710479b66de588049574acd31,t,40806,7601967,,5000087,2018-01-30 14:03:22,169
0x6e794f523a40310850f8b59d7b026e1b05ec73a1705aef5c014dcac18340571c,t,21000,7622967,,5000087,2018-01-30 14:03:22,170
0x55edf9da2414b266fd995a8fc6d15e7275bf86d4de01375f312fdfd97b791664,t,44155,7667122,,5000087,2018-01-30 14:03:22,171
0xa4dde8cbdd265e97d460ccd85c894213f86deecb5ccb1a1377ae189a9c0ee564,f,67541,7734663,,5000087,2018-01-30 14:03:22,172
0xc8c96d9262ada62a4b98a909734562f23db5843051cdd5427df1f75ffa1e87d9,t,71363,7806026,,5000087,2018-01-30 14:03:22,173
0x711fbca9210571fa9a9e4d833fc31abb15f6c534dafd4b22e9c3266c3d4c7918,t,21560,7827586,,5000087,2018-01-30 14:03:22,174
0xa5fd79549521ae4c1c2880128ec761daab49bbd9c7cdb0d0f9cb7d7763566f21,t,21000,7848586,,5000087,2018-01-30 14:03:22,175
0x7506b96f57346ce96d784413094f9b4e3dc1c1433247a4bbfe03e64046c4d259,t,21000,7869586,,5000087,2018-01-30 14:03:22,176
0x78a4c72be646f5cb510fa2b408ab16728171bfb1c4bc07eea88fc69e1ba26e64,f,37169,7906755,,5000087,2018-01-30 14:03:22,177
0xe45f651265f2a96b0a4d4659df402d0fc146a68a3a99363ed5723763cc06fec4,t,21560,7928315,,5000087,2018-01-30 14:03:22,178
0xef6f263a2cbc3e4db35eabbcfcefcd56c8af8e6f213926a5150b718e57e5ad2f,t,21560,7949875,,5000087,2018-01-30 14:03:22,179
0x78bf64efcefc469075d056033221473a53a9885bb4893bb165a316919afc3ae5,t,21560,7971435,,5000087,2018-01-30 14:03:22,180
0x54ce17faca9460b1aa7dc29cdf90836f3f7865c3ee9249cb35d6a1b9a004b3fc,t,43972,43972,,5000088,2018-01-30 14:03:28,0
0xa35fa495a8925e05fc0ff0cafbeabfc247dc8e4a339596d64e1fe008ab9770ef,t,21000,64972,,5000088,2018-01-30 14:03:28,1
0xddaa4b20fa4ef6b4bf9aa3e4d7b1b41d1d57f3999b5fd94c470f26c6be5dac8b,t,21000,85972,,5000088,2018-01-30 14:03:28,2
0x4848cc788b68e3afedee0061f3249716dd5360902a118851706cb892cc91b74c,t,21000,106972,,5000088,2018-01-30 14:03:28,3
0x209efe2cfe08a4e3a8834340821418ea2f888a822d8e0cfb12a780e0e4efc8fb,t,21000,127972,,5000088,2018-01-30 14:03:28,4
0x0f9b5b038c88f6f38ba798545b6d13fc85c7d236f8af33273945f84d9b0e9e15,t,21000,148972,,5000088,2018-01-30 14:03:28,5
0xe7f47234fff3f950b56639e034e1491fc481fd047e3741d5af777519da510a0e,t,21000,169972,,5000088,2018-01-30 14:03:28,6
0x6e1147062b8783e22362c22ad8e60b7a3df265347c953b854df3687b54636e92,t,52524,222496,,5000088,2018-01-30 14:03:28,7
0x5207fc35061cb6b6b6bf03af9d906f2436037e01e21c39be8b6225f6464cb907,t,21000,243496,,5000088,2018-01-30 14:03:28,8
0x9099b5ec9460603e39cb457ed7f6b6b2c5b22bdae2f585dd70e3ef3a4f67c70e,t,21000,264496,,5000088,2018-01-30 14:03:28,9
0x7f900bda04346ecee3e6eee3defd82043e51c2e28bcf05a952dded4136d4c188,t,21000,285496,,5000088,2018-01-30 14:03:28,10
0x2225a9a33a51a6409ce4b1d07dce9d6d7d1d9a9e0c8e004d3e0d5ac8c08ed871,t,21000,306496,,5000088,2018-01-30 14:03:28,11
0xaf64edcd08ae87c37f1348a8ce7c1396f8ad548fc5514ae86f3c4d30d75ae0df,t,21000,327496,,5000088,2018-01-30 14:03:28,12
0xef38ef456a2bfc36b768ccf2cc357e444ccd321118bfd2529fda3ec5338f611e,t,21000,348496,,5000088,2018-01-30 14:03:28,13
0x011c48a059be4874faf59ded34ec7d49281791ae2b1c2e6402d90119d29ce87b,t,50057,398553,,5000088,2018-01-30 14:03:28,14
0x4beed007c0db327c4bda897b8068edf84a85d12282ce65ea869b6803f521db17,t,21000,419553,,5000088,2018-01-30 14:03:28,15
0xe9e065d8141f95bdc20f5e53d57996acba524b9d07fd12074843ed3277db47d2,t,117637,537190,,5000088,2018-01-30 14:03:28,16
0x21236ff3fffcd7d282a5e096d646f6a75133a8a854c68a1ffc4a2870eea5b9e6,t,21000,558190,,5000088,2018-01-30 14:03:28,17
0x2e507b57f0a0be9bac10ed39edb860ebf622e19dac5e0d188e2f0c02e1bbb4bf,t,21000,579190,,5000088,2018-01-30 14:03:28,18
0x233b6270eedeb4c4a2886c114d43d78dbc52b7a2907599770d0e9df2b296a74a,t,21000,600190,,5000088,2018-01-30 14:03:28,19
0x6a11af9d43a6b7b8aadc9257041326e64753a57d7d133e811c03b53404cb78e3,t,21000,621190,,5000088,2018-01-30 14:03:28,20
0x820182809029a45721084192dcb1e6f867c1f1e4fdf0e4f77351bdee9a0e9318,t,21000,642190,,5000088,2018-01-30 14:03:28,21
0x483cbc99d45ef9a27405b84ee7827b63289266710d727ca1f172dd05f25b6a56,t,21000,663190,,5000088,2018-01-30 14:03:28,22
0x1dcc34dbe06c5bb21f601d2903f6f690f715e67502bd5f30f991bcf6d6a52733,t,21000,684190,,5000088,2018-01-30 14:03:28,23
0x511c08c19ae849dda3e738cbf3f160d2af3dc17ff7591f69a851c256c4b95b44,t,53377,737567,,5000088,2018-01-30 14:03:28,24
0xb14e49d2c1c18ea69dc594d0f1a77310775d99b8f1dfde301bd32e4f0e5a354a,t,21000,758567,,5000088,2018-01-30 14:03:28,25
0xf1ea35a47d308dda33968d8d69e5fca2281bf133e5c7d5d4a9636b8402d93ebc,t,37507,796074,,5000088,2018-01-30 14:03:28,26
0xcfcd2e4777b35d3bc4d0e4e25e56fe8ffd3473743729e9995aaf7a3a96aeff5b,t,21000,817074,,5000088,2018-01-30 14:03:28,27
0x8ce837bc5b45bcd979c5079c1974cb8f231356e3af562d68693926d5ea6cdba6,t,21000,838074,,5000088,2018-01-30 14:03:28,28
0x6cd05b74ae99606ea61ef429415f663debfb390a1f7ef7a679bca477544ea8fd,t,36457,874531,,5000088,2018-01-30 14:03:28,29
0x3814a7f4e4a29fb37baf3f59dafab23ce4da04056eecc5e60cd4c552d1fa40f9,t,51776,926307,,5000088,2018-01-30 14:03:28,30
0x8040f46e851da0fdfabaff695771961e661710056cf3d5b02ed464c91c08bbb9,t,37900,964207,,5000088,2018-01-30 14:03:28,31
0x22a73d16c7c05fabd1b3e7c512c4307bcd7ebb8448c42ba8732fc1e4d8a8ce77,t,21000,985207,,5000088,2018-01-30 14:03:28,32
0xac6d18115d08a6275d56e2185adb0cdf3b397f73c9cedb0fd9cbdc59a48f0910,t,21000,1006207,,5000088,2018-01-30 14:03:28,33
0xd4d24eef4d6a4201d76dd96b652c53b5eb9b5c98775888616eaacca9fcd67216,t,21000,1027207,,5000088,2018-01-30 14:03:28,34
0x2d44b87d09cf9360a16a38a12526e38e76e4e985bfcbddb54b1dd387c63f912e,f,23000,1050207,,5000088,2018-01-30 14:03:28,35
0x525b870b5a13c2655c46a5e04187f1ee07b8fd9088c877a09a7bc4db0633477a,t,22510,1072717,,5000088,2018-01-30 14:03:28,36
0xa7072411961d0769297f9fdefa1684fc9c6cbc588279b36556a0c132c125e06f,t,21000,1093717,,5000088,2018-01-30 14:03:28,37
0x5564ec0a4f106b39daa0d27e3066e6626a1e9db363f6adf717b989da19dfd9b4,t,21000,1114717,,5000088,2018-01-30 14:03:28,38
0x9285334eb876e5bb44efd08a4b50b040b83b336c01fe7fd33004b5b0ae0c500c,t,21000,1135717,,5000088,2018-01-30 14:03:28,39
0xc6b043c7f17f4349392fe3ed3dfef27f344835c0ae3c0a9300447d28bd22a082,t,52377,1188094,,5000088,2018-01-30 14:03:28,40
0x4f8741bd882190a3abfd39548d8b838b09376a9471fa2a394b939d32141379a5,t,36883,1224977,,5000088,2018-01-30 14:03:28,41
0x8fd778f9760e75dfe2d8b1d385d58b15dafae97a065c1e5b40d0f3e768c49e96,t,21000,1245977,,5000088,2018-01-30 14:03:28,42
0x81c91953f14e9db1450ad3ec8698e87d287882d033c5efe43a07c92239ec84da,t,34725,1280702,,5000088,2018-01-30 14:03:28,43
0x52ce0108790088eef5c12ebb24a678a48bc9a7837cc84b806fd16bdfcb2c57b4,t,21000,1301702,,5000088,2018-01-30 14:03:28,44
0x305a982e81ec67c59f64e71ff8a4ec82ae1a32409d91caa02b188c0fc07f3bd3,t,22408,1324110,,5000088,2018-01-30 14:03:28,45
0x1f7e611dfb6c15ba300901cf49ec3ad683e63e70ca40527b7d940bd41e793fdc,t,21000,1345110,,5000088,2018-01-30 14:03:28,46
0x4703811dc0bf82295f2813aa4f2d2bafa6e6239bca7a91065304cc774fe7ea96,t,21000,1366110,,5000088,2018-01-30 14:03:28,47
0xd3ec23ab129555d98f3ddc75e1e2292ce6e577fd91b1debd6c721d05a3580b04,t,21000,1387110,,5000088,2018-01-30 14:03:28,48
0x88a76a2c51c470b5a7c43a088eb133bb2834bf9f8b633526d72e66abbb451086,t,21000,1408110,,5000088,2018-01-30 14:03:28,49
0xb698a981e333dbbeabf3890c8dfbd4fda500ebb827b3823b405d54e51eb897a1,t,21000,1429110,,5000088,2018-01-30 14:03:28,50
0x4aa6a7d83c30f7a4e61d61084146708f4e33246ed33a9790563e184d569aa453,t,52084,1481194,,5000088,2018-01-30 14:03:28,51
0x44849d1c5e00b3a5f22b266bec7aa41f0e838766a5b7a3ba0ed50089a24166dd,t,21000,1502194,,5000088,2018-01-30 14:03:28,52
0x3f47d5324bdee87a529f4f46b5429a472dda94a38eae1c01f15093fb14e652a3,t,21000,1523194,,5000088,2018-01-30 14:03:28,53
0x2408d82f9f05e864d943b5f18ebc7d1f7648a75ed65ba7599ffaf8770695c229,t,21000,1544194,,5000088,2018-01-30 14:03:28,54
0x9a1992b99eea46ff76d4ed4da76daca4fe2b372b485dc5bd4a708fd0313432fd,t,52372,1596566,,5000088,2018-01-30 14:03:28,55
0x184a830cd962337a42af32afe83735afb8ae0f3c7e3d13ea44815a92d66212c2,t,21000,1617566,,5000088,2018-01-30 14:03:28,56
0x52f9bd56b6c8e59f83c407040c934123f766874d65c2adc5185e13382b79ebf7,t,21004,1638570,,5000088,2018-01-30 14:03:28,57
0xe21261c99ebc353307c724d36d101f94538b2428427e984bf0011b1d6b096da3,t,21000,1659570,,5000088,2018-01-30 14:03:28,58
0x1d381548c1e928d6c5c9f72d2d97d1bdbdb039a709268aab4e9dffe31b5852c2,t,21000,1680570,,5000088,2018-01-30 14:03:28,59
0x505616865f42eb74920145cbe08bc69e878b6d0c70eae0051a1ec15560f35566,t,21000,1701570,,5000088,2018-01-30 14:03:28,60
0x43998af8440412174e89ae3fb594592aa6d7dc1751ba94a1c529ab60127cb592,t,36718,1738288,,5000088,2018-01-30 14:03:28,61
0x35fd4c4a1f2cbd35d473a3852536532c8ea8b6ecf534db81a3baf6d9a1041102,t,21000,1759288,,5000088,2018-01-30 14:03:28,62
0x1580b5bc9b37a77ce965b6f4da572f6f541bfdae5e11af63b96cfb38fcdc4bc9,t,21000,1780288,,5000088,2018-01-30 14:03:28,63
0xa35bd597709c84b19654fae6b41900d74c6366931426cbba2669ac4171754d5c,t,21000,1801288,,5000088,2018-01-30 14:03:28,64
0x8edbcff03e2c5464f5d780c570a48a1bc4bb0d2cb16645e5ae84b07eb9749f94,t,51584,1852872,,5000088,2018-01-30 14:03:28,65
0xfbcfb53b37aa79ae58ec1dd7a2a8d0e093d9d807489baa61f159ec0ab2e6a21e,t,21000,1873872,,5000088,2018-01-30 14:03:28,66
0xe9adeb23994b357f3ef54c0e98b022e19371c9ddb32dc5edab7e4d9a8a9678bd,t,157580,2031452,,5000088,2018-01-30 14:03:28,67
0x638648994597afe6784858c8ee922ddce251bce4b61a799d2dc830d91cd19ba8,t,21000,2052452,,5000088,2018-01-30 14:03:28,68
0x049acefddf568a489d85f073cd14d1d87526f5e2202cf84e58a8b52b136f9791,t,21000,2073452,,5000088,2018-01-30 14:03:28,69
0x667333391a516dca31b205c0ba4e9fda52f8851365ce9312d96fdca55020b137,t,31984,2105436,,5000088,2018-01-30 14:03:28,70
0x11b21e151fe10fe03cf3c0649244a32038e7ef30249951c979c21de17e7eb5ed,t,21000,2126436,,5000088,2018-01-30 14:03:28,71
0xaad0595189b997810bf99875a4f9b0a30dc6596e7153472097391a401450dacb,t,30981,2157417,,5000088,2018-01-30 14:03:28,72
0xfd9faf37adfea1e0f57ee98d29f83ad649696283a71e4d3f4d06f501db9d0c77,t,30981,2188398,,5000088,2018-01-30 14:03:28,73
0x0536727dfeb0956e66c2905d96c569d54dd3e20c9d2c84e0b61136b06f3b94e2,t,30981,2219379,,5000088,2018-01-30 14:03:28,74
0xd17f3f3cc271214564e08e4b0e24d654981e17de9d23b27fefcc6ffe8bf517ef,t,30981,2250360,,5000088,2018-01-30 14:03:28,75
0x7d353d713c7a83cc12246762b955685a26b21c4c3a6d962457619295ca7c74fd,t,21000,2271360,,5000088,2018-01-30 14:03:28,76
0xd79d44f457b9d9ab59abda8698ab9a03e3011b1354a3c5c2ed550557bc235217,t,21000,2292360,,5000088,2018-01-30 14:03:28,77
0xb296dd8bf447afb14aa9f8e42a6369c7f4f29ba87a5ef5df9104c9a288412120,t,21000,2313360,,5000088,2018-01-30 14:03:28,78
0xdf71c8098b9ef18115a193fac663c8447e9c67990665f9f2370eeb3c931259cf,t,21000,2334360,,5000088,2018-01-30 14:03:28,79
0xe164734057f712a08409c04abcd770444d8adf221abc0a03a9979939d00e1cd8,t,21000,2355360,,5000088,2018-01-30 14:03:28,80
0xf59835f89355070b3b5412bf5539e0e11b66901ca220ccaf6923da2c08d513ef,t,21000,2376360,,5000088,2018-01-30 14:03:28,81
0xccd81494c0f99a31788429bc731dac73b8432fce9bfc6e83886eaea677c6c45c,t,21000,2397360,,5000088,2018-01-30 14:03:28,82
0xa9657f95b2c4dcdd074b608165a8b712a1cc347437a9ab6e4f60dc775528f5bd,t,21000,2418360,,5000088,2018-01-30 14:03:28,83
0x0261e365fb5f96847f1ffa1e01a65082f5a11fa745e66611a7c07a921f35738c,t,21000,2439360,,5000088,2018-01-30 14:03:28,84
0xe02d6f565f75eba3726f2625d74eca6c34cd2bc916d6a968626dfb5c41681dc5,t,21000,2460360,,5000088,2018-01-30 14:03:28,85
0x43bc59ac58d149df93f0231e72a7a5590d5d44e9118af6cda3e7d6fd31e92280,t,21000,2481360,,5000088,2018-01-30 14:03:28,86
0xd36952ff5c2224fe474dae118ce130453650de65cc078305d2f72a1d3e83022e,t,21000,2502360,,5000088,2018-01-30 14:03:28,87
0x7d79c2d4d108c2de48ef8fd6ccca3fe5eb7b3e776f9146bc72ce67b60110ab9c,t,21000,2523360,,5000088,2018-01-30 14:03:28,88
0x8961e6107a3432173208b83ad6ac09c561a4221937fab55f873194303bed8372,t,21000,2544360,,5000088,2018-01-30 14:03:28,89
0x98c0fda529b57331889e8570bd7855138e27a9f40b502470ba0ce7ddb2f3aa29,t,21000,2565360,,5000088,2018-01-30 14:03:28,90
0xb85d5d60105ee2b98292a152d9c6cd252520cf4148b96d4976b226154e03a84d,t,21000,2586360,,5000088,2018-01-30 14:03:28,91
0x99927a217e05b20eaff1315aa3c358aefadf45bf2ace4865138b95cc7e0cc626,t,21000,2607360,,5000088,2018-01-30 14:03:28,92
0x49c985d346f5b4865d1ec743d38ebf48ae388af0a50d00134fd5025a7bf783eb,t,21000,2628360,,5000088,2018-01-30 14:03:28,93
0xe52f74c7df30ee666eebac808d33557202e3da42e9267a69131fc5e15a25e058,t,21000,2649360,,5000088,2018-01-30 14:03:28,94
0x148a6ae7624a18a0a48efd516576713d319cfaacc818ea6510b25d0ef4b5d333,t,21000,2670360,,5000088,2018-01-30 14:03:28,95
0xcf51af450d70a1067a69974445986d9fae6c4ee35cfed26e483ce1f3df90be1f,t,21000,2691360,,5000088,2018-01-30 14:03:28,96
0x283e1d3a3b15a15da0e4ad899dad8fce2e31231535520ae4cebb2c01109ab5b5,t,21000,2712360,,5000088,2018-01-30 14:03:28,97
0x748d0ee0d97ffad166e66f7eb5d9fd451e037e75676b6a15f39bdd9ab2f7ca44,t,21000,2733360,,5000088,2018-01-30 14:03:28,98
0x36d3c27b5644e9f5dec2e0d2838268bb706d056f3d9180c7573578102b11f45f,t,253854,2987214,0xEFE6dDcc1541F8D4Ca340C090c10D37f9D5daEE7,5000088,2018-01-30 14:03:28,99
0x279a2a23ede808425405c9db73c53b8621fef46eea6b87dd57e4c951b1a8a486,t,21000,3008214,,5000088,2018-01-30 14:03:28,100
0xd6977b3b6a7b1d671de3f67e09a874d21d7ebf05f10733b7b34b1fdd1e18cd52,t,21000,3029214,,5000088,2018-01-30 14:03:28,101
0x70a41cf215027d091a5baa3db6e6dfb41625b319643826fb37aba4aff8e3fd24,t,21000,3050214,,5000088,2018-01-30 14:03:28,102
0x3266ff55ef951b8fcf22c1f12dad4915af14515833e1d2a46350f530bb975e74,t,21000,3071214,,5000088,2018-01-30 14:03:28,103
0x391b6fe421b998861ef16bce97c4956545adf3a2ded6ce0ea57d656dac2e2de2,t,21000,3092214,,5000088,2018-01-30 14:03:28,104
0x90dc979012fe949f26722791a4982be6f7daf025a3c0a4bf2d16991010e9dcf8,t,21000,3113214,,5000088,2018-01-30 14:03:28,105
0xe13225b50df886c6f71de071b8a9058826150632e216cef6c0243a890ec01714,t,21000,3134214,,5000088,2018-01-30 14:03:28,106
0x62f9d6ba650aecde512def97786d6496f282c154cdf8c44a695ce871c200cd36,t,21000,3155214,,5000088,2018-01-30 14:03:28,107
0xfeb34d0604409a9914f54d2a8c52d019ffdd74fdfdc6ce3b22a5bcca4fd925e9,t,21000,3176214,,5000088,2018-01-30 14:03:28,108
0xa3f45367c498fbd1073c8dc185fcd1341cee37ac0224df62e464048b9a3ff358,t,21000,3197214,,5000088,2018-01-30 14:03:28,109
0x7c6a42541f774bade3f55ded72006fd02d41a9722bbd5adfb589d72646cb5987,t,21000,3218214,,5000088,2018-01-30 14:03:28,110
0x3ac2f01e12757afc1713be328308bb628fd749974004311b883579493d1ce7d2,t,21000,3239214,,5000088,2018-01-30 14:03:28,111
0xba222d3a0f1d1bc05fcb86c035305527116e2f780aa2c05dbb4dec23821f7192,t,21000,3260214,,5000088,2018-01-30 14:03:28,112
0x19087073f0050fec51c226b6b72873ab3a6061ff761b1118d22200d1974c2f75,t,21000,3281214,,5000088,2018-01-30 14:03:28,113
0x879ee3dd1f5f3c3b3fb620f96caeb4dd7e0c9ef8be775ae6cce51235f2cba902,t,21000,3302214,,5000088,2018-01-30 14:03:28,114
0xbbea19001d5a800f5020e4d44c6b5a734d255c495e3def5f0023fc01f47c292b,t,21000,3323214,,5000088,2018-01-30 14:03:28,115
0xb8ea51b8cfddf770b69ca5de0dbe2b0bd90afda829a09b340d40f0f689202362,t,21000,3344214,,5000088,2018-01-30 14:03:28,116
0x305924d90bbd5ee28d34d2b45ace383b223077c4ddae9ef09d3bae7294c50c2b,t,21000,3365214,,5000088,2018-01-30 14:03:28,117
0xa7eb5fedf30f2e7104746d58636cac63a560b9db0a651f143448776a27144ec1,t,21000,3386214,,5000088,2018-01-30 14:03:28,118
0x1fe9a02adc087731e0d9b54cc9a1662933a6cf0e8892c20bdde1aab6f3a7448e,t,21000,3407214,,5000088,2018-01-30 14:03:28,119
0xf58d151f1e1a8cfaea7f4e695e4dd98997830a21dafb51ff38dfd7e8dd73a8da,t,21000,3428214,,5000088,2018-01-30 14:03:28,120
0x45b2102bc4bf0c0e810b0a9cf5832a60dcbed285d8832c6b46e737658bafabeb,t,21000,3449214,,5000088,2018-01-30 14:03:28,121
0xcb8280a92db9aac1b5329f5a5f80b2a59e1b19be3852aaaf8914d5fd34bc4e36,t,21000,3470214,,5000088,2018-01-30 14:03:28,122
0xff7a267f206e83a091a05b7e1baf517c4980696e1514e9bb6e4a0c734db00670,t,21000,3491214,,5000088,2018-01-30 14:03:28,123
0x51a0cb3f49042af23321995e84ef04e899981a6676482b3a8d2cd90b0ac732d4,t,21000,3512214,,5000088,2018-01-30 14:03:28,124
0x0fa7301bb7f183200261f2141d2c059a663fb3069e53c2d7962227c1b1c50f16,t,21000,3533214,,5000088,2018-01-30 14:03:28,125
0x45b0d9a216e206c9447266f4325ca06c490c565afea7dc66d05b84803dad593f,t,21000,3554214,,5000088,2018-01-30 14:03:28,126
0x5ffe6432a2e26e88b3cba3503b2021830f9018702dfef6728761570cf180e0dc,t,21000,3575214,,5000088,2018-01-30 14:03:28,127
0xc70eaf1313fbdc0733e6f9b89f00462123930b547780d2048d821417da43919c,t,52460,3627674,,5000088,2018-01-30 14:03:28,128
0xcea0ec30ea3b356f7477b509d840c81f5c83f67cfe647b7006af75fe2e80db29,t,21000,3648674,,5000088,2018-01-30 14:03:28,129
0xe5bb908dac54d1f1e278c44ac8bc1728610546f7af6e5d644bb51a7f64063dcb,t,21000,3669674,,5000088,2018-01-30 14:03:28,130
0x28b155bacb57f224ca7dc1d4e714e3247b075a4dcfbdd54c849f9e433a7bd3d1,t,21000,3690674,,5000088,2018-01-30 14:03:28,131
0xc9d7d1fd85a11be3a7962557e07c8b336486590660fe4b693f2c610a830decda,t,21000,3711674,,5000088,2018-01-30 14:03:28,132
0x767454588269f0f540daba5afdc3dda52bd738df09dbe806ee18518676f74c93,t,52886,3764560,,5000088,2018-01-30 14:03:28,133
0x5a9b162c485c34dd984d141e1e0fa4eddf3a836720944211baa848b21cdfe872,t,51955,3816515,,5000088,2018-01-30 14:03:28,134
0x86092ad7371e7da90ec9ab8928e3f1d7995e5e647b1ffc36a5ca0c3260b1277f,t,37886,3854401,,5000088,2018-01-30 14:03:28,135
0xc21d0ec864933000356cb4a9b65118a1fe8c0e9c40405db9ea015e5f9cfe69f3,t,21000,3875401,,5000088,2018-01-30 14:03:28,136
0xd4a08e2e9595ca9cb1439a7049bd36e68429a9b0a2a32a393df70bb07323be95,t,21000,3896401,,5000088,2018-01-30 14:03:28,137
0x3611725bb73adbb1261d804197bc8d22b3322d1df65b7f53bde841dbedb99472,t,21000,3917401,,5000088,2018-01-30 14:03:28,138
0x44752b70baac931ed8ae265b54c6edfa71eb721496142c3824496d288c08a2a7,t,21000,3938401,,5000088,2018-01-30 14:03:28,139
0x412094e06b38e647f4e1fb5f3351da8ce2ddfa99ec83d5b28560316ca4f54d2f,t,21000,3959401,,5000088,2018-01-30 14:03:28,140
0xd1257ec9dc0e43a070f68bbd89b6cc5f819518becfc3726b0d40a15df4a24b54,t,21000,3980401,,5000088,2018-01-30 14:03:28,141
0xbb19b309deebc6b1943c2e620a1801ccbce5c42cb62170d990ab76b024967437,t,21000,4001401,,5000088,2018-01-30 14:03:28,142
0xa94b53bd34452d47832efba8010999c3b5d7b4cb33589569d4212ed90da5bc6b,t,21000,4022401,,5000088,2018-01-30 14:03:28,143
0x6c66ab185a6a13434bc11f55fae4e76bd7f609c72e760e09b82f459315fb28cc,t,21000,4043401,,5000088,2018-01-30 14:03:28,144
0xf0a5b9a2939fb1d295771b9a4993c76da7e381db60673f700ec1b18a9adb5efc,t,53027,4096428,,5000088,2018-01-30 14:03:28,145
0x803b5ab14dd8beda78b54ed53ac8c7dfe3a4fa73e6a1b2620e189028203a26a9,t,21000,4117428,,5000088,2018-01-30 14:03:28,146
0x180c38e7fc9dc9f7c28ffee2b7abf2a8181f052e0a45afe0a1c12f2252fe5895,t,21000,4138428,,5000088,2018-01-30 14:03:28,147
0xfb9aa9a1e2064c64b626125f2e2d55f0cd68bc9a31a0005daac84764dce047f5,t,21000,4159428,,5000088,2018-01-30 14:03:28,148
0xfc37fc3da052340f6a956d30e357858b24247c21bbfba5c93924ae0a0e74eaf0,t,21000,4180428,,5000088,2018-01-30 14:03:28,149
0x2fe35750747e94285278e338870a77933d9f93538093d2236fe64e8ad0a177e1,t,21000,4201428,,5000088,2018-01-30 14:03:28,150
0x4c5d45bce98db7fad5ef596b7572273fe926ba766b0b91c0ae01f83774b3d33e,t,21000,4222428,,5000088,2018-01-30 14:03:28,151
0xbf78e26c95a346baa1222e0537a527364a43a2d00757514bed26fd1dca2051fa,t,21000,4243428,,5000088,2018-01-30 14:03:28,152
0xb413eb3f0060452ca465a59d8da4732a6249e95d4dfd2e8a7f2c22b739990327,t,21000,4264428,,5000088,2018-01-30 14:03:28,153
0xb7ae6a3ca94d63b6dbde9376c5ea3403265047830a6d62c97db2c18d183759c2,t,144053,4408481,,5000088,2018-01-30 14:03:28,154
0xe3911a25c75cb39767631bfc17fbe07dc049062ba3a1532d94745e48d03a4835,t,21000,4429481,,5000088,2018-01-30 14:03:28,155
0x683c4102f249fc03ace14b5ce19cf8945c8587c2e380624a18ed9d8f7532fdba,t,21000,4450481,,5000088,2018-01-30 14:03:28,156
0xbeb028c0c705352fc3eb37c60bfffa74f67749064ea8eb5b9679d3bc1399f885,t,36672,4487153,,5000088,2018-01-30 14:03:28,157
0x2c3c326ffd76f165cd43705812b3a7ac5b4e5c8f6e83f608c7efc62b8c4032f6,t,21000,4508153,,5000088,2018-01-30 14:03:28,158
0x61bdf2b019490fd6a7bb3692094afa212088cd0a03caf15c709023210a9fb165,t,51606,4559759,,5000088,2018-01-30 14:03:28,159
0xc739270e2cd9d847d82c31d1e7caf04c2cb055fe196742a7dae496276718ef2b,t,21000,4580759,,5000088,2018-01-30 14:03:28,160
0xecc6d9f99402691160b54d6704e4e1ec94b458c507ae4f4daf71f97113a556b6,t,21000,4601759,,5000088,2018-01-30 14:03:28,161
0x5ae8922b4d48967ff367b99fa3e269db74b1338d00601a625cde51b5703e49e1,t,21000,4622759,,5000088,2018-01-30 14:03:28,162
0x0fed3f3c73191e2d19f499ea7ab3c064ea9533269dfc9491e7e4862b8f06f89a,t,21000,4643759,,5000088,2018-01-30 14:03:28,163
0x6fe2fc6a5527f619abe01cfac658fb755525af53d3028a827a705576ef12459a,t,21000,4664759,,5000088,2018-01-30 14:03:28,164
0x5fa59afad885340d82b8ed9de81d8d9657b416c9b324d9fed08dc15f7c78d737,t,21000,4685759,,5000088,2018-01-30 14:03:28,165
0x0a5d762d072f3b3ee820b7fb09eeaedc15b4499d9da3962f42ab54e46d4500ce,t,53318,4739077,,5000088,2018-01-30 14:03:28,166
0xfec66b2b58509af47b349b1b6a7f7acddd524aba8e7a84dd4043afbcdc772628,t,36815,4775892,,5000088,2018-01-30 14:03:28,167
0xfe57980a343fecd9df2f672ae36575560954fd374081484b2f215d4824b65a7b,t,52524,4828416,,5000088,2018-01-30 14:03:28,168
0x03a18922799814560a2f2bfc4f02062a4cef85380623fdbcd683f979a7950ae2,t,168970,4997386,,5000088,2018-01-30 14:03:28,169
0x09b8b1d4dc726f3fb020213bd4d8bf4b4b0358351ffd2f8cfbe2600ff0b9152a,t,26937,5024323,,5000088,2018-01-30 14:03:28,170
0x26d871836a797976e41a3bb8063dfab61abe8fa3fbb8f3b2ee7de3e5c6552cd7,t,33665,5057988,,5000088,2018-01-30 14:03:28,171
0xefc8abf935a2bd8954e705bb3dda5f60d9f13d9294b0688da6423f6cdaf2abb5,t,39139,5097127,,5000088,2018-01-30 14:03:28,172
0x5861876d526995e2ef0b58c9a2329def61015436bf2deeeedcd9168a387801fe,t,21000,5118127,,5000088,2018-01-30 14:03:28,173
0xa8dd959a191e753eeaf060dae0eb255d8c2b28d3630622476e51aa01e8a73d4f,t,52691,5170818,,5000088,2018-01-30 14:03:28,174
0x7cda9104f691f3e9bed232f7a7a4f62227b1356a71f5de1ab36c17668bd0f780,t,37886,5208704,,5000088,2018-01-30 14:03:28,175
0x0e88f55b390e1845528dbd9100948f3909854001589ecce0a52fd03392a5071c,t,37948,5246652,,5000088,2018-01-30 14:03:28,176
0x226adaedfc4b2f41974f93de109f11926efb93f7a5672e42f52bb71c7ee6afee,t,21000,5267652,,5000088,2018-01-30 14:03:28,177
0x31fe984c51ae161d8de7103e163105d9e1bcacd0966ef2c47732940a50703bf5,t,44418,5312070,,5000088,2018-01-30 14:03:28,178
0xfd97e09beb475ba9f2fb9540d9fb36e014b858d89701e40146526424f37af966,t,37660,5349730,,5000088,2018-01-30 14:03:28,179
0xf3e3f030bfd3de5bc0938dc3d0a2b334812378c6ecfb97b536e62c7954f7609f,t,21000,5370730,,5000088,2018-01-30 14:03:28,180
0xc0dca449539aa516537f871c23f3c3aa9f418f6b9cf29e50faaff093d7123fe5,t,45591,5416321,,5000088,2018-01-30 14:03:28,181
0x27705aacf0ec146d6aec8c15f85e6dd287ebe36c1df1352173eab9d6367d59a7,t,21000,5437321,,5000088,2018-01-30 14:03:28,182
0xc08a31f6891b1b07ca8d556fbc902cd2b7585e3eb3566eb5581ab636bbd59b97,t,21000,5458321,,5000088,2018-01-30 14:03:28,183
0x419cddb0b07d196d2d4e411a42b292ffd650efbbf62946a65f3895065591e2a2,t,59354,5517675,,5000088,2018-01-30 14:03:28,184
0x124512e3a7e28f943db6eb2a2dc712e6367b3b6ba3faa6819feafd8d4a5777ae,t,37111,5554786,,5000088,2018-01-30 14:03:28,185
0xc5aa02bfb939a309233460938c00a82f41973b54a62c25fe2dcc239a941cfb25,t,21000,5575786,,5000088,2018-01-30 14:03:28,186
0x3e02b2510ce1f787ae2de2712795529432a200a12b324a1a603348cd610a65a8,t,29552,5605338,,5000088,2018-01-30 14:03:28,187
0x029796c5c0c7438bca20b69341f4c4ae5862fe473f0b9e343af7b8f61fc91bbd,t,37900,5643238,,5000088,2018-01-30 14:03:28,188
0x023b3c14d11d6f400a5c1dc9f6f94af741c6c7e7c89e222851ae4a85954b3eb4,t,51988,5695226,,5000088,2018-01-30 14:03:28,189
0x5f524bd7f80da8a92b42a5acab3ff80d7553ce77dfbb6eea5ca757590936c7af,t,29493,5724719,,5000088,2018-01-30 14:03:28,190
0xa300504e6ee41d465aaa83354ec881740a4e966ec560b8c558585ce38803283c,t,66316,5791035,,5000088,2018-01-30 14:03:28,191
0xae72940aec977b00a1cce886620cb3964a994c114f792450e6a2bf2bd63472f5,t,51560,5842595,,5000088,2018-01-30 14:03:28,192
0x2c5df36d0db919015c221f34f502bc81a13bff7f5f04feaf4f2f29b8973f8fd7,t,93306,5935901,,5000088,2018-01-30 14:03:28,193
0xb50acd2f8edd0d1bc7a897af6863754c9f8aea166ff76829b0c8d5f74ac7cd74,t,59290,5995191,,5000088,2018-01-30 14:03:28,194
0xd2253edb624232a7d653beda55812eb8e942ecd74a0e847876ad16caa96c928d,t,77410,6072601,,5000088,2018-01-30 14:03:28,195
0x379a9eea697e938de5a7b79ff825a5128d3f418624dfa1ed2bb53fe1ca658e30,t,59226,6131827,,5000088,2018-01-30 14:03:28,196
0xdc5af349df445b66da338b9cdbb9a6049b6f2fea87c53d1bf00bfba864e9f38e,t,43346,6175173,,5000088,2018-01-30 14:03:28,197
0x6cad4ebcde7eee3a4b12f3f22437a84cb03c1ab7ecbb43eae1929e3239b7512e,t,52239,6227412,,5000088,2018-01-30 14:03:28,198
0x10be7e31201c256a86951203a367551d010a5130132823e2bc277a0f7ab9d655,t,107730,6335142,,5000088,2018-01-30 14:03:28,199
0xd3fbb355efd8f49c0034b7be1b29feca84c32787cbb18810c7e176b592d9bf8f,t,21000,6356142,,5000088,2018-01-30 14:03:28,200
0x59ecb686602b724c0d23ea526734a3084b5d76083947169bc48c112c41d28c14,t,21000,6377142,,5000088,2018-01-30 14:03:28,201
0x6224ac2d14ce4fef2150f7fcffcebe394779416497e7e8980caaed6823ea4c21,t,21000,6398142,,5000088,2018-01-30 14:03:28,202
0x3a6b4b0ac609d019635763686fdb45503ea9d39ca87e900b5e4f2f32e5b4d54e,t,46184,6444326,,5000088,2018-01-30 14:03:28,203
0x06ecf363c2ebaea6c8ef87606d21440341b9f68ac804f4eceff6b0721dfefdbe,f,250000,6694326,,5000088,2018-01-30 14:03:28,204
0xe36c01c13308b706c81e4b4e28e7ae2ee63be1189503ee53f99aa90e6a9b29fa,t,44162,6738488,,5000088,2018-01-30 14:03:28,205
0x4ea08706c41de5b3975cf48afb4642302f4c683db57cefd2d27345e3eddb7aab,t,21000,6759488,,5000088,2018-01-30 14:03:28,206
0xcb0eb72d225e484779ae58c686a58ce5cea4cae34f46fa5f7f35c1dd6f2fe83e,t,21000,6780488,,5000088,2018-01-30 14:03:28,207
0xce549b420d358ca7e283acf2883745f15d34a4af275ee85fa8a472cc66dcbb22,t,21000,6801488,,5000088,2018-01-30 14:03:28,208
0x4cf26dd9484009124677ea3bf24654d20185fa28298a7381849d58af3a4c526a,t,21000,6822488,,5000088,2018-01-30 14:03:28,209
0x87976621d281ec7df21e69e248d278925d5f518d880083f30772c561289efca9,t,21000,6843488,,5000088,2018-01-30 14:03:28,210
0xf806dc0d466596995e222bdf83122e1d13ab1ed97e6d8cfa946f672cca959da5,t,21000,6864488,,5000088,2018-01-30 14:03:28,211
0xad57e9027b0cb8c0565de628581094d715ad18b357ee2a7bac5eff5ab2c50f97,t,37029,6901517,,5000088,2018-01-30 14:03:28,212
0xfc0afd4423f8bdc6c5521c81dd2963f29fcaf43e385d1794c3ce9e465ea4a261,t,21000,6922517,,5000088,2018-01-30 14:03:28,213
0x98dda48f9354cdb6b2cedf7c3b14e9aba67d50b53036166b91a57de4a1a1c3ba,t,157516,7080033,,5000088,2018-01-30 14:03:28,214
0x57067850be8546dbd1996f61de63486be9dc10689c153b085e5af8b3e6cd6d19,t,22510,7102543,,5000088,2018-01-30 14:03:28,215
0x48beaeda418982194a6622695632707c98621c8c1f1a7c904b314cb67bb0efc5,t,21000,7123543,,5000088,2018-01-30 14:03:28,216
0x775da50081dd3b3f89e9e796a3c960fcdc7e0baf4393c2451805d5b89a257a84,t,21000,7144543,,5000088,2018-01-30 14:03:28,217
0xa5ca9e88defded0c11e2842446fa7c5f34794020b07eae1ff808a3922242e386,t,21000,7165543,,5000088,2018-01-30 14:03:28,218
0x333f7ce143f1b4a6ed0a6deb9b6bee12e4ca8f9298cac687a5b3f45a5abe0c7b,t,21000,7186543,,5000088,2018-01-30 14:03:28,219
0x22d8c512542b49cbf8c34f96553a25e50dbc9094b54110603914098ae48c40f0,t,21000,7207543,,5000088,2018-01-30 14:03:28,220
0x9ab4470c48f441412dad5804c240579643c48017d6d6df63f02a6128646a509c,t,21000,7228543,,5000088,2018-01-30 14:03:28,221
0x05afa652417f040adbc9f4d90f0ce4ae348005ec3fa25dd0bb540c379c3ea823,t,21000,7249543,,5000088,2018-01-30 14:03:28,222
0xf16615a497d36c63a65cd6b8b2c2bb3044d9986697fa847c2f0950287f40c197,t,21000,7270543,,5000088,2018-01-30 14:03:28,223
0xd88f6a7b04003fcaf6217385cb6251ac9426f5c71e103f8b4666da5813a13dd8,t,21000,7291543,,5000088,2018-01-30 14:03:28,224
0x9e178da86293e1f044278e90188e467d6cac08b75b530194d193fa9e582ad922,t,21000,7312543,,5000088,2018-01-30 14:03:28,225
0xb034cfc871487f18a13e558b82e83f3758039ecbaacb71d36e230510d6ba7f40,t,21000,7333543,,5000088,2018-01-30 14:03:28,226
0x278ce93e85f85de63d6e4f09f0563790ce9eb7a487b79b7e7f49edd70dd47976,t,21000,7354543,,5000088,2018-01-30 14:03:28,227
0x91fa5f552792964c45f646e644db0c84d1030632f1b6901abf2ab500a186cfa7,t,21000,7375543,,5000088,2018-01-30 14:03:28,228
0x4ab6cecab4d06af7b270adcbc25bf063f86fccbf88feff289ae834fbe377272c,t,21000,7396543,,5000088,2018-01-30 14:03:28,229
0x3ef211bd42f95dd45d9ac655cabf1b6482c2803282a3931d22deaf78f3736485,t,21000,7417543,,5000088,2018-01-30 14:03:28,230
0x26824bb783a5845c53db3b49075310f8ddcb032458e4d4be7a57a123fb5d0d79,t,21000,7438543,,5000088,2018-01-30 14:03:28,231
0xb3e3998cec1b53fb20c12f98a2d5b6ef10d81ddc6ce71ed51ac8bdae2045b948,t,21000,7459543,,5000088,2018-01-30 14:03:28,232
0xb8884ca7383bfc8b78e3ca98e041ff13af82a7cbb93106c7ace9e3566a0d937c,t,38027,7497570,,5000088,2018-01-30 14:03:28,233
0x3e7913a27e02189a3d517ee2f054c75c13f1a4cc1bbeb9c087e142b65e2160e0,t,21000,7518570,,5000088,2018-01-30 14:03:28,234
0x00f5e09b593804bdcadc9da3d76189c4fc55d66c9e01ba9456b9771918164931,t,21000,7539570,,5000088,2018-01-30 14:03:28,235
0x6e96113788eeabff4e21294e055122c2bfdf4da32834ad371a41f180385a728a,t,21000,7560570,,5000088,2018-01-30 14:03:28,236
0x93f57e085db0fbfceae0454f3e51bc66d54ca7cce3893baec78cf8fa055457be,t,21000,7581570,,5000088,2018-01-30 14:03:28,237
0x5388363a4a6a979c2584b751bbbcf08a84a7b3b9de31f116bd2557a1b15a6a96,t,21000,7602570,,5000088,2018-01-30 14:03:28,238
0x3afa64d71f463ba388c7313e08dfb48bc8bbbacbd83a362a6a56e26c8ee072f1,t,21000,7623570,,5000088,2018-01-30 14:03:28,239
0x5f80dc88dc0e58703c5ca485d8ca6bcdc6ac1f5c946f6b0a093e88a6ce4b0e64,t,52052,7675622,,5000088,2018-01-30 14:03:28,240
0x6d6357d1adfe6560d2c453f9c1e0d4ef7c5d9d844bf24f3b08a5384670f221bd,t,51560,7727182,,5000088,2018-01-30 14:03:28,241
0xbeab189d2eb9e73eeea151e12f0235f16ced4f3e2cd567386b0283b514db395c,t,29493,7756675,,5000088,2018-01-30 14:03:28,242
0xdae238312c1112ec7a9ff10b4e93c50a2cb33bc9a9d8162ecbd812075c02b4ac,t,21000,7777675,,5000088,2018-01-30 14:03:28,243
0x495ba15878abfdc458c0d3e2676d964254ddefa761eec69e4e816df0b8e41199,t,21000,7798675,,5000088,2018-01-30 14:03:28,244
0x765867d885fc7291becfda5640cc488e332fe1e4ff9842bf1d2026845897316a,t,21000,7819675,,5000088,2018-01-30 14:03:28,245
0x8c32b235250403eac699e53a5a01f09fb9446fb22d0c6c613a88f4ee656afbd3,t,21000,7840675,,5000088,2018-01-30 14:03:28,246
0x63081b35ed3a71e107c784cdf38f3e99d2a8bb9f8390b5daadf13c70fbd32fe4,t,21000,7861675,,5000088,2018-01-30 14:03:28,247
0x99e805f5c952dccebe740206ef4e04efc4d268c3771d0f82f6d8c157d4b8bf2b,t,52963,7914638,,5000088,2018-01-30 14:03:28,248
0x66b6427c24e2138ead49ec6ead3dfdf2c62d529d832a73c93cc3694bd21a122b,t,22510,7937148,,5000088,2018-01-30 14:03:28,249
0x03ce68513595859b621c043649bed80c6201cdc9fbe5a570619d1645930c730d,t,21000,7958148,,5000088,2018-01-30 14:03:28,250
0x881cdd8e6d97d70d313e6cd9a548e7327fec21ce2f5c176d179e48373b410635,t,21000,7979148,,5000088,2018-01-30 14:03:28,251
0x685b7fbfe7dfe134c8f29457259c82d7f3d14583e9f9d0099df60e796ecf4825,t,21000,21000,,5000089,2018-01-30 14:03:36,0
0x2b7decdcda934eb072a036d6fa47ce8d1fafd43accd1be79d310875f2969a2a2,t,21000,42000,,5000089,2018-01-30 14:03:36,1
0x50bfbdf0eea311632fb5f237c9d49ed27627676f1c9a005d322fc1d3003aa013,t,31005,73005,,5000089,2018-01-30 14:03:36,2
0xb394184dcb9d943d3d1578b6732d89e7a1611812e5cf88e8a63d8521d138de34,t,21000,94005,,5000089,2018-01-30 14:03:36,3
0xa9dcdf0d263d1aac91f5029e0a245fab5292d24fa5679d99318690001644a90b,t,21000,115005,,5000089,2018-01-30 14:03:36,4
0x063a446aa29c518aaacdd8942987b5214b427d5e40931d6b23a1c6c9eb4122b3,t,50057,165062,,5000089,2018-01-30 14:03:36,5
0x25ae8c582c33beef0feb2ec0b8d883b2d5af363349c76e6b4144e626ad852c80,t,21000,186062,,5000089,2018-01-30 14:03:36,6
0x1096173418a3b45273e0fa31828974435deb30887bc86389e63531de61625a0d,t,21000,207062,,5000089,2018-01-30 14:03:36,7
0x12ddd3d9e292aabffbc1c4c038406f6c4e000f12c2ccc5363edcbfe49a9cdab5,t,21000,228062,,5000089,2018-01-30 14:03:36,8
0x155583f77ccca51fe8faf3c77813de67e994aff4516a15432e8ebc5fe4abaf20,t,21000,249062,,5000089,2018-01-30 14:03:36,9
0x248a7e51ccc58d1021c466a261c08935fe379ee79b6c8b20f5010fa4d754c70b,t,21000,270062,,5000089,2018-01-30 14:03:36,10
0x029e974599280ed663789a1afe178795cf5c05b51558f4d04f4277a0ee29d18e,t,21000,291062,,5000089,2018-01-30 14:03:36,11
0x546069bfde9f2da5ae41f3d810146c4a6fc2602c8275ff293b24bea60eb108dd,t,21000,312062,,5000089,2018-01-30 14:03:36,12
0xa3066c93c44b253b60eebd263fc03de668d1c3224cd91c7ab33529e2935e4f1b,t,28355,340417,,5000089,2018-01-30 14:03:36,13
0x5c2f97730f4877d9f8485ac5ba4af690239674cf8f11148f46d7a3891aaad1d3,t,21000,361417,,5000089,2018-01-30 14:03:36,14
0x12d1f622704c7aafa6f0a2289af6e60a1b8c118e44af9dac60ff076595dd65f2,t,22305,383722,,5000089,2018-01-30 14:03:36,15
0xe9032b9b7bfd21e16b20654202e6c00c0f7390da2b9c53f0867496ac580dbfac,t,167836,551558,,5000089,2018-01-30 14:03:36,16
0xc69da170aefac8a69db940d030f0853f8627f57af0e90beb675e3b04e10eba62,t,34213,585771,,5000089,2018-01-30 14:03:36,17
0x7ba616316cdbf9c6b89ab1c1ac44d8a4f1352685f00c52ba6f82a9e0d8bdb566,t,21000,606771,,5000089,2018-01-30 14:03:36,18
0xf395c1a736aca56eb0755895d5194e59b403d50c9f5e7fb64abd2c45420761f7,t,26937,633708,,5000089,2018-01-30 14:03:36,19
0xdf10ce877f815a71a4f0c710dfc0806312c37729da4e9437d4800afe565875a9,t,21000,654708,,5000089,2018-01-30 14:03:36,20
0x7c6aebb3c3e3bb4dea05795878e5df9946f796604a18187d78d526abdf3523ff,t,21000,675708,,5000089,2018-01-30 14:03:36,21
0xa36b3aea3873383071a1951780856406f7568b7aadae291368b723af70d1560e,t,21000,696708,,5000089,2018-01-30 14:03:36,22
0x24ca58b94cf64dd066834d35266a13f7d6677e5b766d9612a9dc960c99b80bb0,t,21000,717708,,5000089,2018-01-30 14:03:36,23
0x6859f3fea934dd67c140e481c785d8b3aa2dc5e6b53f8699a98c823dca53166c,t,21000,738708,,5000089,2018-01-30 14:03:36,24
0xdf308392a3254bc1dc8e7942c0fa9db64c0ba1b68afc1415e246a3437cf9cb10,t,21000,759708,,5000089,2018-01-30 14:03:36,25
0xee6701eb82d5f6307e3c9198badb497b879c4db717d63bdcc0e1bd6b185e4116,t,21051,780759,,5000089,2018-01-30 14:03:36,26
0xd51d836fac25aff45849b6e5ef83b6ad006fce6f23876b3647cc7f6f26e93cbd,t,21000,801759,,5000089,2018-01-30 14:03:36,27
0x7261f61de103ffd5026151a4afccd834021b6f634023368d9bd1a4085db223e6,t,21000,822759,,5000089,2018-01-30 14:03:36,28
0xaa39fda8f10ff4a04da6929c3f521555655b0fd63d1335561f9c4e372fd6134d,t,21000,843759,,5000089,2018-01-30 14:03:36,29
0x7bf4ddc64cadac98334af39d662ff835d9bbc375340a6efd5a2af0208e425b2a,t,21000,864759,,5000089,2018-01-30 14:03:36,30
0xa89f79b635c097d52329cd26e4eced772b03f6ab59f9d2c83c61014c9f467473,t,46184,910943,,5000089,2018-01-30 14:03:36,31
0x4eac9e4ae99da1cdfb6abf3dd428af26bc5f518e03b98e81b8f545f1c96f12f2,t,46109,957052,,5000089,2018-01-30 14:03:36,32
0x0400fc3fb9b88548231b14ce4ceb838aae64277706805bb9499a7edbe735ef07,t,21000,978052,,5000089,2018-01-30 14:03:36,33
0x435081ca36df6b2002a2b6ee5f1efbc59f5c31244887bcc2969f2bf3432264ec,t,21000,999052,,5000089,2018-01-30 14:03:36,34
0xa7021957bb2a6e00b2ac4053766bb38ee487cc235dbd0b70313b5e15a6191850,t,38318,1037370,,5000089,2018-01-30 14:03:36,35
0x6fc810702af2f6dc7088d5b1070cbe25faf6b3d007f7e06231f171a8532a0d4f,t,40797,1078167,,5000089,2018-01-30 14:03:36,36
0x6b84bc975e2ffb0a5037c97354e37573232270d1b776b16dd069316f26f77bcb,t,40797,1118964,,5000089,2018-01-30 14:03:36,37
0xc271e1e31c497205e2c33a4d6499d7f724188b781ea85bfdc4090cb0aedbe4a6,t,37211,1156175,,5000089,2018-01-30 14:03:36,38
0x4790a9e39120a5e74b26404c0d51a49e227038ca847c78d27958f5a549c2001f,t,21000,1177175,,5000089,2018-01-30 14:03:36,39
0xf6f8ff8a5951d9291d0c9b7d0b9e80d393e637e5ee8c960099604d9b849f7852,t,21000,1198175,,5000089,2018-01-30 14:03:36,40
0xa9976a337006fe40013eb250a45ed23e3c19ee931b490110e35e61b74db7db55,t,21000,1219175,,5000089,2018-01-30 14:03:36,41
0x76f58ce5c450d6fb9188843a490ddf4938f0e054023032d64b681199ea98d41c,t,21000,1240175,,5000089,2018-01-30 14:03:36,42
0xc56cda441d74245c47e8a424a47c9b2dfdc893f8a6543542fc98542098f4aa86,t,21000,1261175,,5000089,2018-01-30 14:03:36,43
0x5ebc9e13a439db35bb07116b8dbf1076d1a85b91ce640dda83e78462044dd506,t,21000,1282175,,5000089,2018-01-30 14:03:36,44
0x86169fa5cfcb55cbb9326eb5ed3dde2cc5c5df7174350613aaa6ee8cd3956051,t,21000,1303175,,5000089,2018-01-30 14:03:36,45
0x1c02f1291528b317f7e57e90ca3e8ea8bd31892429ab643b53a6466d76f7cf4a,t,30981,1334156,,5000089,2018-01-30 14:03:36,46
0x20ed4f1b566dbbf7f12e67fe74aa750517b79643fb601f8ba8702b06f0c77c23,t,30981,1365137,,5000089,2018-01-30 14:03:36,47
0x90f48a8d3782e2df226aa4365bea076203640f420e477e63af7ead4afe06dba8,t,21000,1386137,,5000089,2018-01-30 14:03:36,48
0x4c7d458219f3e8abed5928be305deaad3e87bfe91eeb9503b85abf3e369a10bb,t,33571,1419708,,5000089,2018-01-30 14:03:36,49
0x1fa38aca586fd53bf4207bee1ea1224f842e28981c878174f074f3d3065e1ed6,t,21000,1440708,,5000089,2018-01-30 14:03:36,50
0xfd0fc74c5490c075ed2653230dbacff67e466f2ce103d970e29740edc113be97,t,52963,1493671,,5000089,2018-01-30 14:03:36,51
0x98c2b7c3b523c0a7c2266b0612a77f197d148cd73105f28b1e7ae0ca44ac2693,t,21000,1514671,,5000089,2018-01-30 14:03:36,52
0xe637b6448c0f91693e8af41d3b59d20cc9fbdbf9af0159be2a9d5c04f4886b15,t,21000,1535671,,5000089,2018-01-30 14:03:36,53
0xac1b97a4a3d0bd757851dc628cc38e241a60b1bcdee632ae9be47b3f114ededc,t,21000,1556671,,5000089,2018-01-30 14:03:36,54
0x9e6eb83b8a6add2cba79792496bc078975f789c752f82389bd266e3973a169bf,t,21000,1577671,,5000089,2018-01-30 14:03:36,55
0x6d81993768823583cd883c5162f53e88673a5b906921b0ea4f7726e040476c75,t,21000,1598671,,5000089,2018-01-30 14:03:36,56
0x6f3f294115bb8b6532edbeb7eb4887f2a75e39c433258ad9ab2549d2671ef55b,t,21000,1619671,,5000089,2018-01-30 14:03:36,57
0xcd5e24a6f19e4d4b682a261316a8128157f64f7409adc2316fd5d4b2765036d0,t,244829,1864500,,5000089,2018-01-30 14:03:36,58
0x444690ed14355e94748a6cc2f0b796c428eed954b8de6fec462b4bd68579d986,t,253854,2118354,0xB129D6BB08a39a9e92522d2FEa8d0b75D7878063,5000089,2018-01-30 14:03:36,59
0x0c4f5568dbbc6b289f875d0f818756f31ffd1ae879b0cebf0f1e7b9754e7ed57,t,21000,2139354,,5000089,2018-01-30 14:03:36,60
0xf30d3d0688a583e773ffc587d54237737a937df544cae8229feddc2f5fe55e57,t,21000,2160354,,5000089,2018-01-30 14:03:36,61
0x12a3b545f06eb0e701c13a1609db92653a75d63a09b66ab1178a15c9edc2f773,t,37460,2197814,,5000089,2018-01-30 14:03:36,62
0x17f88147c1794e0523a149ec4759d09153c83881d4bebf7670d549517405a849,t,26122,2223936,,5000089,2018-01-30 14:03:36,63
0x2dc155d150fc16d2b93f43e7db6db023d3307f5c5462fd408ed5fbd2517e6c3b,t,37547,2261483,,5000089,2018-01-30 14:03:36,64
0x73deb82f8ca58c4f0fbfe5f5936af82b3d4195c74ec69e2035b424e4753500a5,t,21000,2282483,,5000089,2018-01-30 14:03:36,65
0x4eb9639111bc0c16133ab22a24391d48da9d94b2671c80ceb05d5200514dbc79,t,21000,2303483,,5000089,2018-01-30 14:03:36,66
0x89dbdcade0526adffb0a1422b80fee8f514bf77977a8d3e552fb052a341ad183,t,24219,2327702,,5000089,2018-01-30 14:03:36,67
0x68fbda57d7b9055f1f926329052e1ee6b048e8361ab85f64da0b435499aa34ed,t,21000,2348702,,5000089,2018-01-30 14:03:36,68
0x0667ce385bfb384d3802e8b27eb910b64a725e5d9c8186ff7982af3022a64bcf,t,21000,2369702,,5000089,2018-01-30 14:03:36,69
0x70a2a49db247754a5295c3e215e6145b2172ee089fba16e099a9e24473363e27,t,21000,2390702,,5000089,2018-01-30 14:03:36,70
0x9d79ba0882c127bc931b23783a78a0d1f5d6e89548fdd08887850c9538c2258a,t,21000,2411702,,5000089,2018-01-30 14:03:36,71
0x8cc49c82107a3c0cbe95e4bc91d807a09701df77c6df01a4621d0b700fb5cc9a,t,21000,2432702,,5000089,2018-01-30 14:03:36,72
0x0135b03398e241ba276886bfe4d23455e5f5bdf632f9bf7141ebf2fa410f6575,t,37251,2469953,,5000089,2018-01-30 14:03:36,73
0xf1fb852d885d83004841a54c02c941fdd0f491306a1ab2257c71f8aa0406de4b,t,21000,2490953,,5000089,2018-01-30 14:03:36,74
0x5de21ff15b9f1444bb36e05807c5a86a7ae0c05b2b6637a49f85d89b4a7c814b,t,21000,2511953,,5000089,2018-01-30 14:03:36,75
0xb8b975a9af7e2a76e94ed9822a8e41e401949780d08a827ea15c1497d2f97d18,t,21000,2532953,,5000089,2018-01-30 14:03:36,76
0x0c5382141af0fefe0a0e20a4f8442c32b1f6129faf0e3828f667ed79b0a60ba4,t,21000,2553953,,5000089,2018-01-30 14:03:36,77
0x33f769a8f39e85a21bc1f9f0d87e3a5f1a50677cbb890bd393b64de0b3969775,t,36762,2590715,,5000089,2018-01-30 14:03:36,78
0x2a10a356dbacf0a1523ff6d212cb7f5020b1b6fd559c24fa9341ad1c371619e6,t,21000,2611715,,5000089,2018-01-30 14:03:36,79
0x475a7bd980036fbda2cd48fcdebc0ab34a60c2540a435615e4e000dd69450a2e,t,21000,2632715,,5000089,2018-01-30 14:03:36,80
0x990bff2c7e51593831d80ff40d31fe5007865b724f6762dcd0d6f15ee01c1b2c,t,21000,2653715,,5000089,2018-01-30 14:03:36,81
0x2669305af6169fb225ed9f631829590f4232f08c0572c7176fc00dab6c91dc64,t,21000,2674715,,5000089,2018-01-30 14:03:36,82
0x2c6c9200052d34b6904efb661e4d3df50831b1d5be0e7f3cfb3dc358c4faea91,t,21000,2695715,,5000089,2018-01-30 14:03:36,83
0x1232cf44e11d4e941a04174d0cc492cbaabaabaed8583d5b9d8bd47720a729ec,t,21000,2716715,,5000089,2018-01-30 14:03:36,84
0xf59c4ec9d23100c57834b74a4d4d021cc6dd605b3410a0b6a3b879371c5a0e3e,t,21000,2737715,,5000089,2018-01-30 14:03:36,85
0x0aa033d5b753ae53bb1b94a59d88c45be310d7416926fccd9638ba1e39c9e7bf,t,21000,2758715,,5000089,2018-01-30 14:03:36,86
0x6988cf99530bc86460116ec8399d8371df92378b2c41e956a9dccdf853e02440,t,21000,2779715,,5000089,2018-01-30 14:03:36,87
0x2ce9d96afb1513f85f96c89a097db353f3699ba93392d4e9e50e2b7a6172adda,t,21000,2800715,,5000089,2018-01-30 14:03:36,88
0x6a507b2b767dded9cb892357d3d4fd3d9e2e0b430783c7d502caa174a3d9c037,t,21000,2821715,,5000089,2018-01-30 14:03:36,89
0xbefbbc314910db9e9dd2d33cde4fb7af85d1dc73481d99b334572ee6596de7d6,t,21000,2842715,,5000089,2018-01-30 14:03:36,90
0x48a15b3534303fe5a9d3554cdf0f9d0ba6492c1f77c845bd12aeaa2c46725922,t,55669,2898384,,5000089,2018-01-30 14:03:36,91
0x99bcea0a3a549a4f00f774832c98837221571c3bae74cb99f410452c4389cf20,t,52886,2951270,,5000089,2018-01-30 14:03:36,92
0x8dcde3e4b46cdc16a458467e790692182ec3774a09432dc7196f6504b700ead5,t,21000,2972270,,5000089,2018-01-30 14:03:36,93
0xf999550dd98bca1cb773dbb7acaff14af6d07450b9a4be97502ac0af5c8383aa,t,21000,2993270,,5000089,2018-01-30 14:03:36,94
0x7597835559a8172bc2734c8c6baa37f7802e676da2c3a1d45480cf2b2a6b45d9,t,54720,3047990,,5000089,2018-01-30 14:03:36,95
0xf6144081a857f07d95298c755eae33337bb6fb093a0060fa39704e55312ff37e,t,21000,3068990,,5000089,2018-01-30 14:03:36,96
0x5935258d93d45916e19a8e792250de6d6aadafb149853b34a973ca6cae162fb4,t,21000,3089990,,5000089,2018-01-30 14:03:36,97
0x8f98f0f94e74603b89e54ccacb59d6efdd9df7516c347b3610a8d266e86e2e9f,t,21000,3110990,,5000089,2018-01-30 14:03:36,98
0x2dd6ff4790a0f95e840c143cde1d105bcf86440ea0f659c8f81085c140efd6b6,t,21000,3131990,,5000089,2018-01-30 14:03:36,99
0xe50ad5e73ed2aa6a679149ed8261d95177819c68d76e197140522e3189b7ce69,t,51289,3183279,,5000089,2018-01-30 14:03:36,100
0x584c929ae010064c28a61d6cf538a650384205600a6e3696bfde17c467ae4b22,t,52524,3235803,,5000089,2018-01-30 14:03:36,101
0x4f6b39a448a962f3275eb294a1ee04dc1d424da760d302f2eb18ae13dea1c292,t,21000,3256803,,5000089,2018-01-30 14:03:36,102
0x51d01b3df1895d20425e12db26d39523e1b5ac425bb6a23619a031f8c94917e7,t,21000,3277803,,5000089,2018-01-30 14:03:36,103
0xd968611366e7cc507cc60e84fe02305c8a5dcb1e27ca1f53bb7baeacb4f63746,t,36606,3314409,,5000089,2018-01-30 14:03:36,104
0x5cac03b8af06e1035a0b4b5d76fb21756e2399e121429a7f72921d332f187288,t,21000,3335409,,5000089,2018-01-30 14:03:36,105
0xda8be95269204eed7c0a1f16ef7eef0fa13436ae8a334240282fd129183d03cf,t,36989,3372398,,5000089,2018-01-30 14:03:36,106
0x23f630745bfe980bdf419ab72221d464445775437d27a4b54c96ccf1602b5943,t,37320,3409718,,5000089,2018-01-30 14:03:36,107
0x7339ee0d65a6e4fd472b90fe05b0ca9844cfcd6470abf3f8e375b72983152bc9,t,44310,3454028,,5000089,2018-01-30 14:03:36,108
0x2991355e586183d51b50d7c864673cdf36715d773b3026da53477d0a4cbd981a,t,37660,3491688,,5000089,2018-01-30 14:03:36,109
0x51143b663879d62b5b7ce51bc8dbb7168c2e30ff855dd3e500f3f120dbef919b,t,21000,3512688,,5000089,2018-01-30 14:03:36,110
0x7d46cfdd95c10ac89008e774207bab4ed3e49e3a52bdaffd2925e858ea9edf2e,t,77922,3590610,,5000089,2018-01-30 14:03:36,111
0x0541f7a522e7f0876e85c0da17fff25f298357079b34308d2e04ab484b3744ae,t,93050,3683660,,5000089,2018-01-30 14:03:36,112
0x7e059706427b882fc023cd8c645ddceb17ca48ee9a96fb3bf03ec25372d36a3e,t,21000,3704660,,5000089,2018-01-30 14:03:36,113
0xe75e30b29134995c3f676aa39c66eef279f5e3f4cdd3439eaf4f75cbef5bde66,t,36787,3741447,,5000089,2018-01-30 14:03:36,114
0xc66a3c35be4603656c58e52935e30bcb8a71ef5288d9f7ae23826b3b529b007a,t,21000,3762447,,5000089,2018-01-30 14:03:36,115
0xaebf970efe9839f9173f918fdaab5a5a66937543de7fa944b98a08b89796041c,t,45527,3807974,,5000089,2018-01-30 14:03:36,116
0x09edaf0470345b06c8777f75bf6c129eee0a2f3a70f2d8f20d36f69412435707,t,21000,3828974,,5000089,2018-01-30 14:03:36,117
0x2be7504d7419d56e721297dcbb81c95993a14879bb45e6d1603cfdcf5f562cf1,t,51560,3880534,,5000089,2018-01-30 14:03:36,118
0x3961b1add1e4ee9c2527733e0c3225130c0188e45df4435d6d67d67e429ee562,f,250000,4130534,,5000089,2018-01-30 14:03:36,119
0xae9165ecd58c307acdfb356d4bd368d76dbf36b65181909579b06c2c76a13e2a,t,55907,4186441,,5000089,2018-01-30 14:03:36,120
0xe7952f1504854d0721611f032919631e29a2ef9b253bc014fef2fe625ed11ef0,t,40806,4227247,,5000089,2018-01-30 14:03:36,121
0x9298f853806930a3170d3d6c06d62430fd717515aec0ba27a33a955eb1362037,t,44290,4271537,,5000089,2018-01-30 14:03:36,122
0x311ac068ba01114f21481b6bf1d3b065cbe289c5f35efefc30bfed23f101666d,t,21000,4292537,,5000089,2018-01-30 14:03:36,123
0x80caa28ca13052b103ed08c4ab6de53787543975cc4d08b283a4ce9917c92b8d,t,92922,4385459,,5000089,2018-01-30 14:03:36,124
0x546d7579cc322a8e0c69871444c2956c8b8b6ae2f121eb4ed1c3ef7d2bd69989,t,34144,4419603,,5000089,2018-01-30 14:03:36,125
0xc1c967d60c7e2e35e5b9545a82ee50db4341f272b148d246fc991cb845bc23ff,f,250000,4669603,,5000089,2018-01-30 14:03:36,126
0x6979abe472c1ca7bb945945c91397d27e4d31f877b391180fae3258c27aaa099,t,51921,4721524,,5000089,2018-01-30 14:03:36,127
0xf3f5398dce25795ba88fa649ea3e5674c61c60610a7b1f90ed4df8e42d2c21bd,t,44226,4765750,,5000089,2018-01-30 14:03:36,128
0x6c82b6a836edc2e2e3f5b1903714e33232a369e209373019c4ec80075a7c26ab,t,21000,4786750,,5000089,2018-01-30 14:03:36,129
0x8e77adc81167185eef31e85949057d70ade39749299f58d712eefc4d998bfabd,t,174591,4961341,,5000089,2018-01-30 14:03:36,130
0x2238629bbe3de5f1c46d9c60847297cd1a2844dd7aa0f78744597f2c8f519551,t,21000,4982341,,5000089,2018-01-30 14:03:36,131
0x7b9d270af266c2a27588f14fa64cf31204c1f2601149b8aaee17dd3f5353a939,t,21000,5003341,,5000089,2018-01-30 14:03:36,132
0x4d795587f65a9e52cb5afa14899a62417d7ca07449cb66df98cd86fc8e6307be,t,21000,5024341,,5000089,2018-01-30 14:03:36,133
0x216163e30361c1037b50cf0c081313e7e57f32a107b43383712170c44148330b,t,21000,5045341,,5000089,2018-01-30 14:03:36,134
0xe03ef647e7a4376016c9a054b5689c06dd7a03aad14dca852618bddfcf2f222e,t,50057,5095398,,5000089,2018-01-30 14:03:36,135
0x93d3aa5bc03783c986bc3fa6882a43dfe53452d75b5bdec3982b90d5e8257a7f,t,38318,5133716,,5000089,2018-01-30 14:03:36,136
0xf0f6ba965d06c6d0b156dc4ffc7e592d01371dcbfe023ad7e0cbe9bb8c571668,t,21000,5154716,,5000089,2018-01-30 14:03:36,137
0xa35bdd20de0db267cde792b317c642e6d8915f184c80a75f37d310ce806096ab,t,52336,5207052,,5000089,2018-01-30 14:03:36,138
0x0a01aae51bbbc014063a788b85d9c665fde4cbafa8bca4b2c438711e503f1a9c,t,21000,5228052,,5000089,2018-01-30 14:03:36,139
0x30193a9d979a34fabb1cd1b7a4d62d2a46d0a3a2a96cd0f81b4ad3803d4ed592,t,53027,5281079,,5000089,2018-01-30 14:03:36,140
0xc66ffe31cf6040f7fe100162eb3103a53a038f105a064be5d66d8cc7b98875f8,t,21000,5302079,,5000089,2018-01-30 14:03:36,141
0xc07bc5b5307d2f4f024aa77a5e519670e78352e54b9b888973862c35b277eb24,t,21000,5323079,,5000089,2018-01-30 14:03:36,142
0xd0a50891a9f889f0b356672db1755a9c02bd69308a8efc661162b40075f660fc,t,21000,5344079,,5000089,2018-01-30 14:03:36,143
0xda16b56f97f57661e75828f8cf80bd0743bd5565e962b3d39e51b9636b4c95d5,t,21000,5365079,,5000089,2018-01-30 14:03:36,144
0x8e887642e9af698a5772514b44bd55cc75c5c18a40815e73ae68418382643105,t,21000,5386079,,5000089,2018-01-30 14:03:36,145
0x941d1959df0726f4d4b328ed3906b62aeaac5f97e298b15d938232fe6befb853,t,21000,5407079,,5000089,2018-01-30 14:03:36,146
0xba307822f36ead430b9e0a30ae117583a18bcc648943118d1604c18e2a7260a9,t,21000,5428079,,5000089,2018-01-30 14:03:36,147
0x1fe64435cc2c03fd27a2e108a96c1b59c615c05a9fe34c59d69ad620629f86b9,t,21000,5449079,,5000089,2018-01-30 14:03:36,148
0x4f368dcc3f7b2fb54e4eba38fdbbdf2122d81d2006f0875f961a4da1289c1b8c,t,21000,5470079,,5000089,2018-01-30 14:03:36,149
0xcc69454ad765b5f1236574761c6df756ba16c92bda988134a6665b8cf764d524,t,21000,5491079,,5000089,2018-01-30 14:03:36,150
0xb4eecb9adaf59591fa485c43451d38ae01c0ad090011bb976e0655149fd58342,t,21000,5512079,,5000089,2018-01-30 14:03:36,151
0xe062a4ee2b521be45e3de7df75f54feaa32fd7be742f8511dba575571bcb7a11,t,21000,5533079,,5000089,2018-01-30 14:03:36,152
0x108e63a53be486153cf534ae9e328861e30f6d5bf44093524448b5f18379282b,t,21000,5554079,,5000089,2018-01-30 14:03:36,153
0x0950fa365da74d8d2d8889196f759a0b76c17a2cdcfa9246ad17a5a3f47f9521,t,21000,5575079,,5000089,2018-01-30 14:03:36,154
0x2020b6c5d3448ed4218a455e80162ee6844272294d32870b6eed4c9c39cb74a6,t,21000,5596079,,5000089,2018-01-30 14:03:36,155
0x3ac1acd8eef512069b6309876639dd70cd1bdaa43730e7919174f119ff33be21,t,244829,5840908,,5000089,2018-01-30 14:03:36,156
0xca5640878682fe01cd640b49558df2a26f545d37fbb8c213f440420b99cfbee6,t,21000,5861908,,5000089,2018-01-30 14:03:36,157
0x9923c8916ef1b73f1a395e04327e0f4034490c2ecac0f31b564859d558c140ab,t,52822,5914730,,5000089,2018-01-30 14:03:36,158
0x93e86d5c1fd439749a39fcfb4758eb6bc84b9fa8e608cd64db3b8da95608786f,t,21000,5935730,,5000089,2018-01-30 14:03:36,159
0x6b0889350b2fa443cbcdd18c75db130f14eec6c78ffd7f14cd486f5cffc8c51d,t,21000,5956730,,5000089,2018-01-30 14:03:36,160
0x546504ca9a38d3c3cc74d033794b5eef4ab75b00bbd8cb39961c87848da404c6,t,21000,5977730,,5000089,2018-01-30 14:03:36,161
0xc75f4cf409bb5f9754bf79e402b234f53d42af40f5523605fff2392f4f471928,t,37724,6015454,,5000089,2018-01-30 14:03:36,162
0x06fda77c8a5186d611d9b4a34772945216e13b9794e7dee9e810a14d60d3425d,t,21000,6036454,,5000089,2018-01-30 14:03:36,163
0x83bc99aa630b25c6ca991c46fe86b0c863b4e3a8abcc28dd834206c154cab0d1,t,21000,6057454,,5000089,2018-01-30 14:03:36,164
0xec532c471f3ac9a0f7a122f6a3da67c0f79e977215ad827cc9cba3ee3f5103ad,t,21000,6078454,,5000089,2018-01-30 14:03:36,165
0x9521cb9c0b41803283f57968729046d9f016396d3f4e0d0cc7ece585a5bdd233,t,21000,6099454,,5000089,2018-01-30 14:03:36,166
0xa5f9b9544d43ed5a28f6d9ced4e808fad404fe4831d8bd83269d969e581f568c,t,38382,6137836,,5000089,2018-01-30 14:03:36,167
0x3b6a66f5ecb6ddb16cdc5658a961169b5d7b295561da4cfd9cc0da6be92bfde9,t,53027,6190863,,5000089,2018-01-30 14:03:36,168
0x4b353b2f813c6a23911a4e5322d486a79bb4fee2283a650f9d80d3f475911ac1,t,52886,6243749,,5000089,2018-01-30 14:03:36,169
0x64a4e08b83b942d509e61d30cbe367ca34caa5a6c9b9cfcce8975d1d3920715d,t,37660,6281409,,5000089,2018-01-30 14:03:36,170
0xf15589ce3c919f0aea8d6c2982d263299622b0cd9a8d05de4cc787902da59e0d,t,21000,6302409,,5000089,2018-01-30 14:03:36,171
0xba72e4f36f6bc23eb51c2f2a96b1dbd98706d42f48cb9e045e96f0c538affa8d,t,21000,6323409,,5000089,2018-01-30 14:03:36,172
0x2e1e169e63614f55223152b02bfb40397a501abd385f1627fe9c34e181dc1f46,t,52963,6376372,,5000089,2018-01-30 14:03:36,173
0xe811699a9cf0e70dd4aad17524a6e000ec1a035273d59b52ab975d4d9375b09d,t,21000,6397372,,5000089,2018-01-30 14:03:36,174
0x56e6ee22e57163416d5582d7fa64a536d6c477caf944e271e3768ac207e0feed,t,52963,6450335,,5000089,2018-01-30 14:03:36,175
0xe2cb9e9f3e47b13c527f634b0f04bcf4fdd8f4597fc4d56554a39eae173732d5,t,21000,6471335,,5000089,2018-01-30 14:03:36,176
0x878918805d2a9714a8b74dfe40ddc0428a24068c29b91243857d44fe5904d6bd,t,52963,6524298,,5000089,2018-01-30 14:03:36,177
0xa5da21b0451b158f8e4c9f1a90e7ad7404ded5579e4f76cb57718c321408852d,t,21000,6545298,,5000089,2018-01-30 14:03:36,178
0x22d72cf821899f9a1ae512d2fa26408c05bfa5694be4b5e5e465bd4685a6ecc8,t,37963,6583261,,5000089,2018-01-30 14:03:36,179
0xa794f64aa44beb5f9730a6d21100f5d0f15b68263640935df1e4efd6563aa3a3,t,21000,6604261,,5000089,2018-01-30 14:03:36,180
0x737241661078d4f59d346bf96f7eae863b7b0c8d49a98101c8f7567cfabaf0ee,t,52963,6657224,,5000089,2018-01-30 14:03:36,181
0x979cc8c9208b2d03d76638331591277ba3ba62c86bff75aff62888dc9bfc2065,t,21000,6678224,,5000089,2018-01-30 14:03:36,182
0x2b6ef0c4a3bab3d2959e372b7d4371ae0681e3932b5808960adf560ca686ea66,t,52963,6731187,,5000089,2018-01-30 14:03:36,183
0x05d1965ac6c43c32a9bf7ea460e34824b1504c690cf418c15cfa7558962db7c4,t,21000,6752187,,5000089,2018-01-30 14:03:36,184
0x69c86f8ee2698f6681fd88b1beb729e7d85af0b594746b09b7b4ca24e6c1437b,t,52963,6805150,,5000089,2018-01-30 14:03:36,185
0xf4e86eeb2fc8354965f347e55367fc2cecad0fa2a5b15ca99539074c9a8c1122,t,21000,6826150,,5000089,2018-01-30 14:03:36,186
0xdb3b79c83a2d53ac84a968eb0bf537b643438f6fee84eef53247670c23aedc32,t,37899,6864049,,5000089,2018-01-30 14:03:36,187
0x7cf1f31ef32b235d1bcd5dca9336e7200c9514c1bcadd4be3bacfd91fd3703e0,t,21000,6885049,,5000089,2018-01-30 14:03:36,188
0x1e62698844eb04cf13b7936df01f1fd1e7ec602b749eccf61fd9b7415c83a95e,t,53027,6938076,,5000089,2018-01-30 14:03:36,189
0x8b10e7b7e312d833a0ff1c0294b3de239b57e25c4ee6cac254b8206795f12367,t,21000,6959076,,5000089,2018-01-30 14:03:36,190
0xc0672c876779fb0fbad6ecd7ce492d7bd5d0d90bad1a23136ba8133b761e57dc,t,53027,7012103,,5000089,2018-01-30 14:03:36,191
0x154fbecb656ca0d4b1068273810c508c02332c541cd7608438e02405b5227250,t,21000,7033103,,5000089,2018-01-30 14:03:36,192
0x736fb1e399a1420b9cd47f12d464114384387cc0cf55467ee4d816fc0487b9f9,t,52963,7086066,,5000089,2018-01-30 14:03:36,193
0x4d8388689a207035c7ace11f58830c554bdc1f19760f12ddc6a36d41a0b3a830,t,52236,7138302,,5000089,2018-01-30 14:03:36,194
0xb9b84ab3f77f561a3817f05a2ce5df7f136e60b481244c748fd19313e7d45dbc,t,91372,7229674,,5000089,2018-01-30 14:03:36,195
0x40f0311426d8a4b4aec2380fefedbe0e995961a6f0777717faeafca867c6a3e7,t,52476,7282150,,5000089,2018-01-30 14:03:36,196
0x184989a84f41164569e0fb65115d3352989e742cce15389a53c9ef11f91d9c53,t,39771,7321921,,5000089,2018-01-30 14:03:36,197
0x86e06142a488aea86c704bd043b2eb5b271c174caf8710175c86e1928b94595a,t,55843,7377764,,5000089,2018-01-30 14:03:36,198
0x5d74bbddce7bec2158c4f492e93eb6fcdb669b3954516774b335e11d7b3adc90,t,70716,7448480,,5000089,2018-01-30 14:03:36,199
0x6085700724a560ced0fbc1a11c96487714a05728dc43b143e01ce1144e0f2d30,t,21000,7469480,,5000089,2018-01-30 14:03:36,200
0x7d21304ad18d5390872ea47b381bc27d1a58edff4589de8e896e3a663055b6fb,t,21000,7490480,,5000089,2018-01-30 14:03:36,201
0xe915659e556ef37fc1ad349630515cadc80250eaf9572acd5da18fb550593fe5,t,21000,7511480,,5000089,2018-01-30 14:03:36,202
0x2b7269f513cb288bb099e9086013ae5687a5e2e4f94e7be391fbf374979aac5a,t,36762,7548242,,5000089,2018-01-30 14:03:36,203
0x9e87ee153873667519190fcd10fcdb522cbbfb932f86b7e28a15a1202c222075,t,21000,7569242,,5000089,2018-01-30 14:03:36,204
0x484df2811a65caefc9067427bd8ff8d56628477e98eff2e8ee4976fb97ffaf9c,t,21000,7590242,,5000089,2018-01-30 14:03:36,205
0xb0574bd6d595654b35ab677af6ebd7248029e96f5d5d68a18500649d3b26ee8f,t,21000,7611242,,5000089,2018-01-30 14:03:36,206
0xb3e1a3d72d9b29199937b56c98331fa2688b1d95b133abf97cc4af18b6b932f9,t,21000,7632242,,5000089,2018-01-30 14:03:36,207
0x9bb591551ecf270e8f3c8519061d4694e1fce468887cf1d40f377cee81b50f22,t,21000,7653242,,5000089,2018-01-30 14:03:36,208
0xe08b794d3dd3dd4b8cf094114985fb1bcd5ba7214c2abac3d56e5c907d538863,t,21000,7674242,,5000089,2018-01-30 14:03:36,209
0x291ddf1e05385d757711deef55f7de3fdadfa02a6cb67bf695af4a68a1519c0c,t,21000,7695242,,5000089,2018-01-30 14:03:36,210
0x050e4de55a42d98b7f1adc68f97950bc10970d7f5c12314dbae4f6de9e109e27,t,22948,7718190,,5000089,2018-01-30 14:03:36,211
0xfe2ab8b9933559444403dddbc5f3053e1e1a1a40e246590ed566670c17777b65,t,21000,7739190,,5000089,2018-01-30 14:03:36,212
0x0667ac72ff24a6a81a3dd841c57e2a4386c5e01f2576f4272018eb05d2341630,t,37524,7776714,,5000089,2018-01-30 14:03:36,213
0xba7f3e165da6d11e9a3b88dde1d300bf5ead6ca9d29d4336632a18891ac5917f,t,21000,7797714,,5000089,2018-01-30 14:03:36,214
0xb9ee717d6ea794871a9d51633ef1f8246c2372da762f2aee28b5da03930f688e,t,37148,7834862,,5000089,2018-01-30 14:03:36,215
0x9b677688457438c97c3846dcb9354fb92d9a18c256435e49c97a79b07b64ad33,t,21004,7855866,,5000089,2018-01-30 14:03:36,216
0xeec5afdc3f36ece6cd0fa48719ceba3e934c19e001d00d65b672c0d5a1921dbb,t,21000,7876866,,5000089,2018-01-30 14:03:36,217
0x5c55d7d4e9ee0074300337a323951de309ce14ee523ba8b9729074f59a219bd5,t,30981,7907847,,5000089,2018-01-30 14:03:36,218
0x172537f92e56433c6ba40b82c6c4af2d7144a05450a7ce125acc88bca4903ea5,t,30981,7938828,,5000089,2018-01-30 14:03:36,219
0x4db5fcc03f929b897d30f888edba130424d4313a547ef5949532b655a4750017,t,30981,7969809,,5000089,2018-01-30 14:03:36,220
0xb1f4a0371d965d43dc9fb0386ed0e4869d42a35c437d1db3bc73dd0ec7276980,t,21000,7990809,,5000089,2018-01-30 14:03:36,221
0xb8670b271d3741562014331e836560a5d4a5088d7b4e9e211cb5161f7d506eff,t,21000,21000,,5000090,2018-01-30 14:03:43,0
0xd875e6593255e5ee4aed7ada952c8dfe6669fc9e9a5d611271cadff267951b2c,t,21000,42000,,5000090,2018-01-30 14:03:43,1
0xb450d52619e16e3bc597f7e230a5730608d4eed86f79d2c5f5ad404646d8931a,t,21000,63000,,5000090,2018-01-30 14:03:43,2
0x6620021e0043c7220c3ca853948d4c65a6378eeb22fff7a7ae7bd4fa38943cf9,t,21000,84000,,5000090,2018-01-30 14:03:43,3
0xe9abdc9c831a6c462a4ee209b9c96e45bba7e0e785107bc04286bc6d830fc0db,t,21000,105000,,5000090,2018-01-30 14:03:43,4
0x0a0e4f2c79e396a64c643f522d4e81532b24ea4b9d0575a881d860a15ba84824,t,21000,126000,,5000090,2018-01-30 14:03:43,5
0xe4984347a5e4d1b85b1c0c6984525b819c67bd4e46d5def55e83f88bdaaaf234,t,21000,147000,,5000090,2018-01-30 14:03:43,6
0x6dde5cd969127fec999832951d8a774bdfc3bb2072528990325b98a768393135,t,21000,168000,,5000090,2018-01-30 14:03:43,7
0xa6e5a79b968a1b6f34af0d5ac2e6811ad4ffd42431c4a608add4084084554d72,t,21000,189000,,5000090,2018-01-30 14:03:43,8
0xf0408b03ba7477bc071cd1b7f42de36f0d3181aaafc2b6adedfb3276b3be5526,t,21000,210000,,5000090,2018-01-30 14:03:43,9
0x090783341d3e3f6d5e44247b86fa5b9f2860598d6d54d8d5b6664667e431949e,t,49993,259993,,5000090,2018-01-30 14:03:43,10
0xf377f82cfc38e3fae2ce04ccf1809ce75ad149d919a12a213c040796b8b61b2e,t,21000,280993,,5000090,2018-01-30 14:03:43,11
0xc2923f946eaf826ea13e98be2616cda4db01b90ff2d8060a2c577aa4649e9c34,t,21000,301993,,5000090,2018-01-30 14:03:43,12
0x022118d859e25b7a1ea311ae3a296d85251805b0653772159f4e7be37e0c434a,t,21000,322993,,5000090,2018-01-30 14:03:43,13
0xe884223a3b2eaf3e6662f6a6df704757530c76769c32a7d4e581637f2dbaad69,t,21000,343993,,5000090,2018-01-30 14:03:43,14
0x8f8db7aa301579220b9fb76f3854403588334f1660eee9253655168ceb75031a,t,21000,364993,,5000090,2018-01-30 14:03:43,15
0x03a7fd7d0fc88184ef58318d15c1a50df53b15876f093ad577b1a077f0d01dad,t,21000,385993,,5000090,2018-01-30 14:03:43,16
0x6758009c0581e4f99f924e20607a3327693ad823a6f78a236700e690587950d9,t,21000,406993,,5000090,2018-01-30 14:03:43,17
0x1717cb2ef7b338d37507a13083d3921ea884a81832e0f5822a210ec1c24df6b4,t,21000,427993,,5000090,2018-01-30 14:03:43,18
0x1b3dbdeb9d377a911a177a1dfffb743b8dbff8d5123d90e0c40efe135da2c8e2,f,60000,487993,,5000090,2018-01-30 14:03:43,19
0xf0d45f8a18fa905af472f109037e944f62c11ce1e70b4a9c38f9c9ef06b6e191,f,67349,555342,,5000090,2018-01-30 14:03:43,20
0xe4439455d2a39cc8791e0ac44cb0a8ce399afb98d7d685182ff923f04e289a47,t,21000,576342,,5000090,2018-01-30 14:03:43,21
0x3fd60365887e209f77ef164b29308103e15404703ab28bc0b6a4fee9b36a4d7b,t,21000,597342,,5000090,2018-01-30 14:03:43,22
0xa36bb4bf379685ecd788b67e72cdd482480fa558cdd1204b50572268353faa33,t,58862,656204,,5000090,2018-01-30 14:03:43,23
0x4fd90a0cd527655d71735907b1ae3221a322b4289ebd6a08f9bdde38ee876a1a,t,21004,677208,,5000090,2018-01-30 14:03:43,24
0x27bcc45b854739bd360edb97342284cc24c0db7f4e45e0b467418011091d15dd,t,21000,698208,,5000090,2018-01-30 14:03:43,25
0xda7092c3fa5f83c83443f5857c141061ea82b8fd85af3d3e1578105225d50f75,t,46045,744253,,5000090,2018-01-30 14:03:43,26
0xbe64365914983ad7c6a412c379ac8c4d03e7c6df3967b1e007d9205c1d62bd71,t,21000,765253,,5000090,2018-01-30 14:03:43,27
0x3904a41baa933c060bffb2283af93439b8f0c3b3b3054cc637a2920df2ee0368,t,21000,786253,,5000090,2018-01-30 14:03:43,28
0xaec492a27a89b84d0a1684838a3669c537203f7e66282149ef269e017fceec94,t,40797,827050,,5000090,2018-01-30 14:03:43,29
0xa67f89752f7b8dfea28f5a3a0bab58cf65d98dbd5f19cf5a5c833d4664f4214b,t,21000,848050,,5000090,2018-01-30 14:03:43,30
0x7c4d9eca133219b2f7fa12b6b6e99a297e68466efbbc25605fe88adcdf859d48,t,21000,869050,,5000090,2018-01-30 14:03:43,31
0x0932de8b16d8640f93d89d07fb7a90893ebf4dc6c0a6eff8406b772e084f35a8,t,127516,996566,,5000090,2018-01-30 14:03:43,32
0x47088e11a8a6ae1b548eec471a4b17e86d3534a2a98f1409b865eb725eb4f1e4,t,62759,1059325,,5000090,2018-01-30 14:03:43,33
0xeb5928a0880d8d85d0b6c59332d556e6422275fe4786e4fc60f3f0a7ca4e212d,t,39835,1099160,,5000090,2018-01-30 14:03:43,34
0xecba66b29c843152294b170d098e3993f612254570470510778a12e621efeed0,f,21000,1120160,,5000090,2018-01-30 14:03:43,35
0xe853d74aedfc71b7cb1b312fa22fedb2ebaeaa30023ce8000f6302f73d09e673,t,21000,1141160,,5000090,2018-01-30 14:03:43,36
0xfba1772e23d2f43a542b8baa9138f30c3f0d1d94be788a41af5ef4f567bc1875,t,52963,1194123,,5000090,2018-01-30 14:03:43,37
0xe050c5cc61dd48c8d8dbbdbb7362f54d20d1fea27c33cfc1270f2fc825c96131,t,21000,1215123,,5000090,2018-01-30 14:03:43,38
0xc620789cba3eacf5fcb5dadddae1e4c82639f725c6a6c8002bd4b146e29a4c86,t,21000,1236123,,5000090,2018-01-30 14:03:43,39
0x93ec57e4faf85b1b2de28f975c9fc7929beba314acd783d2215ea562cea0c91f,t,21000,1257123,,5000090,2018-01-30 14:03:43,40
0xa115d09470589c334909fc60ac6de1e1f7a7e6e84e1c1636aa4d55502a282f4a,t,21000,1278123,,5000090,2018-01-30 14:03:43,41
0x5de2fcd53220785a38c1f5150ec4d0d6e466ecee1ac79b8807a9de920e2514a4,t,52460,1330583,,5000090,2018-01-30 14:03:43,42
0xdf7631598713a8a12de74d563288bba8b22f0efe15c4b195ea33ec5b17703003,t,21000,1351583,,5000090,2018-01-30 14:03:43,43
0xb4dde85c89527452dcd2e4c7cdadff2800bd97ae637a4ebcedc52e9e11b95aae,t,21000,1372583,,5000090,2018-01-30 14:03:43,44
0x2c1a1a78b13235c8ed1eaaa16c327d5e25d2c9f552cea9af2018dbf70392dda6,t,21000,1393583,,5000090,2018-01-30 14:03:43,45
0xdd447f6309bf9b57107088aecaf3ea9de4ce133abd2dfa86a56b90fb5600c257,t,21000,1414583,,5000090,2018-01-30 14:03:43,46
0x841496629d248526f12642544b18eb8b34717ecf514b8bedf476d74dfdf3e6c7,t,21000,1435583,,5000090,2018-01-30 14:03:43,47
0x18df7760503b8441f27bf9ab047d39b2b31b70b5965be4e9d1ba3969bb36d61c,t,21000,1456583,,5000090,2018-01-30 14:03:43,48
0x99e93935e0b6f3ea14c5a133edfa2db7fda1eb93e73daa6bfbdb94d4b54a1b2d,t,36792,1493375,,5000090,2018-01-30 14:03:43,49
0xa667dbf338475c3541bf34ec75c8ff41071bbb58f1bd20b265e6e7cf580742a2,t,21000,1514375,,5000090,2018-01-30 14:03:43,50
0x4fa0749253e9a4242796c49857b8e371f30a254a1b2b852dfddca4b6028943a4,t,21000,1535375,,5000090,2018-01-30 14:03:43,51
0xa8f33c3587386e3f870f11ed113859b4c1d3e026b75f7d9c3ca43fea667c39b0,t,52886,1588261,,5000090,2018-01-30 14:03:43,52
0x7651f191c5ef634c9f4237d3bf891a442b20f08e91fd8d363acef439f6a2db11,t,21000,1609261,,5000090,2018-01-30 14:03:43,53
0xdc889794c7eb3bf16e6d2ee19ba066972c465d25283bcd776415eee165e8f5a2,t,21000,1630261,,5000090,2018-01-30 14:03:43,54
0xde16a641b071dc8ea4a06f6c6c6f303ac611731350292411381d9b39b07d58ab,t,21000,1651261,,5000090,2018-01-30 14:03:43,55
0x008018a003fcdccc977d046ac30c7daaa635215414a9c2712f1289e99c196b9d,t,21000,1672261,,5000090,2018-01-30 14:03:43,56
0x90a8c69d8462c7df47c6f947e72dbad55986001deb8e8fd09e61507d5d0f6db1,t,253854,1926115,0x8238dbE13f5d4D4D6EF0221E412e44b27A5c2DBC,5000090,2018-01-30 14:03:43,57
0x52279c65466074c3a2c010597d07a50fe6a3ec2906664751dac21ec05182cb6b,t,21000,1947115,,5000090,2018-01-30 14:03:43,58
0xfecd67b322607b5dcffb2496f0be242456c0674647ea73df200a5a82b0832168,t,21000,1968115,,5000090,2018-01-30 14:03:43,59
0x1ae5c4a50b8baeb467125cfdb947573eda407628a544496a0036b862c733afd6,t,54784,2022899,,5000090,2018-01-30 14:03:43,60
0x53b0628d5c42e5986a8ad20ef1188a58b00930f52b503def9ab968d05494bfde,t,21000,2043899,,5000090,2018-01-30 14:03:43,61
0xd883611b28ee8a1c19fca4321783b7126fbd8dc01d6ee132318b2db52876f957,t,37950,2081849,,5000090,2018-01-30 14:03:43,62
0x19da78c2fba80b060feb6aeb30fde9877d43e3cbf34708cde9ffc542ea4bf360,t,21000,2102849,,5000090,2018-01-30 14:03:43,63
0xae55564cdc8ae22f2466c25f75c51dc2dc99ec39788cca15e86ef3a8a938c965,t,21000,2123849,,5000090,2018-01-30 14:03:43,64
0x3f4b61014b5805a1b6d4f484632c0c186ad7ed4d33ea68516dff6d58a5d0586d,t,21000,2144849,,5000090,2018-01-30 14:03:43,65
0x71534eeda51acdd473c97d917268d4d9be4fd674aa44c271ee3482a617b58feb,t,21000,2165849,,5000090,2018-01-30 14:03:43,66
0x9c9807d14be939aca2ec33c831afd13694db9c238a23f2bffdc397bde46efea8,t,52084,2217933,,5000090,2018-01-30 14:03:43,67
0x454d6f9368715069b36191bb25f7cf41dc9b63bf0513d5cc34e97ad90167ac49,t,21000,2238933,,5000090,2018-01-30 14:03:43,68
0xf1849be88032b81744e71b70613f61bbcfac2a203085fd38426cad197c8e54e4,t,21000,2259933,,5000090,2018-01-30 14:03:43,69
0x6a21da603f8458caa4f6f5c2f91f1022c5a166f71cf05ee6fac0d12f3625c4ce,t,21000,2280933,,5000090,2018-01-30 14:03:43,70
0xb98f47c4c9f6555bcaa9933bc1c865f3b649689bb1f0ad09a7f053050ea70d2a,t,52380,2333313,,5000090,2018-01-30 14:03:43,71
0xb0e1774d675bded42d8b69bc6144b7616636cede55642b2919bf7f42360e1fa3,t,52948,2386261,,5000090,2018-01-30 14:03:43,72
0x1e2d2c5710c52e52d344faa6c6236a9e4e18f18f4adf9da47846b35ffec3e133,t,21000,2407261,,5000090,2018-01-30 14:03:43,73
0xee5c817c13149f385f168a66582cb34efa6e81bc853b6a2e2713f48d551e9ddc,t,21000,2428261,,5000090,2018-01-30 14:03:43,74
0x49a91250925590342519968669bc97b1a14c9017e488cb3bc1e56d06c712d9b7,t,21000,2449261,,5000090,2018-01-30 14:03:43,75
0xe5ba09cfc75cebc962da7e16c383f87f79e896d609601832e4b16be0389f179b,t,21000,2470261,,5000090,2018-01-30 14:03:43,76
0x72170157c9eb889406e99f1213f6f231880a56eecc0887aae897938b6da90151,t,21000,2491261,,5000090,2018-01-30 14:03:43,77
0xc7980b67d32efd4e9d5b24cd118be01bf7a59a3c31f87a6cc32c57b5d7de0584,t,21000,2512261,,5000090,2018-01-30 14:03:43,78
0x68415d7f3d9c9f8da142f7db52b51b2d47ddb7db41d5cd75155540f954e0c71f,t,21000,2533261,,5000090,2018-01-30 14:03:43,79
0xe8d07c2fd6c7df8dd82e21bd34fc5cac9af90fe6516ba73033dffc02e8a4a93e,t,21000,2554261,,5000090,2018-01-30 14:03:43,80
0x68d278e14b2f1495ecfce9aacecda2760b92b5a09af7ea8f1c7a746deb6731b9,t,21000,2575261,,5000090,2018-01-30 14:03:43,81
0x3e0b707edb3608bd7e949bc4710eaf6cdd631dbd0057643f039bfe38d2ed9058,t,21000,2596261,,5000090,2018-01-30 14:03:43,82
0xfddcec96c6748ad87be87d08dd4298fb02e788d7d08d88d0651f42a63ba2e954,t,21000,2617261,,5000090,2018-01-30 14:03:43,83
0x89a92f527541917334f9209e44f87297581da394e7d4ac69befc03652ac33986,t,37976,2655237,,5000090,2018-01-30 14:03:43,84
0xe71d69192ba86bf28ba66b8923af1c4b17469c3ad002ff2039e44bf0d4cdfd41,t,21000,2676237,,5000090,2018-01-30 14:03:43,85
0xba86b51e3e5bdb7ef4819b07e816844e23b4e80f32d522990a6b6a7a7f26cb01,t,21000,2697237,,5000090,2018-01-30 14:03:43,86
0x29322d2ea48d5f4f1b0a09fa40d14a110e9ca66011799b6596389815adf3d9b4,t,21000,2718237,,5000090,2018-01-30 14:03:43,87
0x5cd92981095124f9e68301c8a04b73829882c6521ce5dd30aeefe693a6d41050,t,93242,2811479,,5000090,2018-01-30 14:03:43,88
0x73f9a81399bd4a4a6eb56a5b9028b4a62d40510e87c5f22f46d7f54b40f1c1e5,t,21000,2832479,,5000090,2018-01-30 14:03:43,89
0x8c1cbd90fd824e1d200d841b1acc38d6941d588b4359e2ee1a88b64bc4363dfc,t,21000,2853479,,5000090,2018-01-30 14:03:43,90
0xb47f4d8b2820f0369ab565b1fb75469d80694b47806d19e00b4b7c5ad9fd2f9a,t,21000,2874479,,5000090,2018-01-30 14:03:43,91
0xf38e6187c9fbe479fb0f9245313e473654dd708cf8454915518e49b4ad0e9307,t,244829,3119308,,5000090,2018-01-30 14:03:43,92
0x3ed1bae245fc01279f0a4a95db059684ceaea4b0fcfb202b2ac3b223bef057c9,t,21000,3140308,,5000090,2018-01-30 14:03:43,93
0x4008d4105c31c6aa2230abb6eb4ac402bff1b15e45ff9594597201199dcc7b47,t,21000,3161308,,5000090,2018-01-30 14:03:43,94
0x44d305adaed695e7907031e5d6a0ff14538159ddc35095ecc80b7aab7fa84868,t,21000,3182308,,5000090,2018-01-30 14:03:43,95
0xfce6f00cbe0a0ef4ba6300ee1005ba8bddc10a8749016c8a2b2c0c177c1e4abc,t,21000,3203308,,5000090,2018-01-30 14:03:43,96
0x571347d42b0a85896a0402cadf84521479927d722bea4276afb06eba4a9e8d19,t,21000,3224308,,5000090,2018-01-30 14:03:43,97
0x1e4ba45540124d36545763922fd6de93c843b30418a7308e6e5970e54eac9108,t,52148,3276456,,5000090,2018-01-30 14:03:43,98
0xf43317b9f4cc2c4fe8eaec819bc68804454764fb68289f9b6d6d4eba7ab75965,t,21000,3297456,,5000090,2018-01-30 14:03:43,99
0x4ff3a82f1267d948a2106971265ba1e1ccf73698b5358cc4d2d868cdf270c077,t,51965,3349421,,5000090,2018-01-30 14:03:43,100
0xb514ce153db0cbee638c53dbe0ec959653c2bccf4ca3be94b430247672d57d30,t,36852,3386273,,5000090,2018-01-30 14:03:43,101
0xba7c5a55545e88dd43e5f7501045ec48cf8f0aebe5001086297acb75afef4382,t,37660,3423933,,5000090,2018-01-30 14:03:43,102
0x5ae3154a675a538d636d20048595831eb344425df194efb0a7b13199e548d034,t,21000,3444933,,5000090,2018-01-30 14:03:43,103
0x6f371df4822958374a78cfe1c67c6020d99f3737b802c6fc15508aeaa2774d7b,t,21000,3465933,,5000090,2018-01-30 14:03:43,104
0x07ad6f37d1b885c2dc5fcb758d7a3162c398b956659391077b3920cbf93fba5e,t,59034,3524967,,5000090,2018-01-30 14:03:43,105
0xea2c2ed877369b686e3bb0aec404ac2574a4b167af0e7bb7e2e277d61a6fa55d,t,21000,3545967,,5000090,2018-01-30 14:03:43,106
0xaf96be3957d2a3413c81f2b7a7cc72759ab1b945e3dafedc55b31e0199f7b89b,t,79985,3625952,,5000090,2018-01-30 14:03:43,107
0x4eb7c0b6c72237cbd285b9767b2ae7fc5db4cab00b09cb81fab902deee67be90,t,59290,3685242,,5000090,2018-01-30 14:03:43,108
0x610a36efcad3585b1abb84760f28611b776a00138a0b72c6307177ac3c14f8bf,t,21000,3706242,,5000090,2018-01-30 14:03:43,109
0x1cf24992713030111198a4d78f91fd040e6f43096f7fd43fef2b0dd802e71cea,t,77730,3783972,,5000090,2018-01-30 14:03:43,110
0x58787dad6674d40707707fc5bac19d295f572ae6b337a235c5c4a2bd67740c7c,t,51560,3835532,,5000090,2018-01-30 14:03:43,111
0x945ab913188ac53f8bc020911bf9755f1559bc2ae705216eeaf87cf46892c758,t,44290,3879822,,5000090,2018-01-30 14:03:43,112
0xccac5a6bab3fea5d37cb9a51d5dfc810c341283b4abb14c3ada9b6e54857da56,t,29493,3909315,,5000090,2018-01-30 14:03:43,113
0x011c6540827d976099f6be3f1bfd4b0fa208108a9d0f62d7288e681550d28093,t,21000,3930315,,5000090,2018-01-30 14:03:43,114
0x4a255e80b6a6b77b27a5114b651aad2349758b66f66174e0a5f9c49ac6085390,t,21000,3951315,,5000090,2018-01-30 14:03:43,115
0x289cdc09286933db9c4cbd6422945e3d0d1680814fb80aa2ac131440f79ce1e1,t,44493,3995808,,5000090,2018-01-30 14:03:43,116
0x46b936d600282602547c7dc33ca46a7ff90bedc488b6c0d5e98541b99e313307,t,40867,4036675,,5000090,2018-01-30 14:03:43,117
0x13eb789dc9f5305c7d6ca4322b343d8063f840347f2fe2daf31155ab26e571be,t,21000,4057675,,5000090,2018-01-30 14:03:43,118
0x53b7238d734244080b265c7dac4ec4ea5e7512578cf3182ce1590650c0ae5360,t,22378,4080053,,5000090,2018-01-30 14:03:43,119
0x7ea80dfb121cc754c7c7b544411ee7128ced38c4109ef05ca0223eb0fda644cb,t,21000,4101053,,5000090,2018-01-30 14:03:43,120
0x9348eda4c79cf2fef87433e387943f4d8cabb10ee4378723f8a2f7533c03c238,t,21000,4122053,,5000090,2018-01-30 14:03:43,121
0x482b63d1a48d30fbc14654c885cf7894c0b7cf2a3a611c967e3408b38eeb6bf6,t,21000,4143053,,5000090,2018-01-30 14:03:43,122
0x31e261960b92a11b245a373bcc08ebda38f353027a4a7235451caa1cb1b1020e,t,50057,4193110,,5000090,2018-01-30 14:03:43,123
0x81cbb1b60f31111d980d4b91892e7a38bf5d4bf437e6dcfccd98ed41fdcd51f8,t,52810,4245920,,5000090,2018-01-30 14:03:43,124
0x16d8ce5a28162528790e55252c59b99571aa45037993756f5411949cc11b2a30,t,21004,4266924,,5000090,2018-01-30 14:03:43,125
0x1193d4dab53c4a274bece35db5e39fbbdcdd7d923a0823192ea7e906030ac3b6,t,21000,4287924,,5000090,2018-01-30 14:03:43,126
0xdb62928f069faa288d738a99e623ccb793317dc7faef12a26aaf5b89ed3a79a1,t,157772,4445696,,5000090,2018-01-30 14:03:43,127
0xa6ca474b0ab64c3cd74b5950b90e788523796e9eaa4b7c3367a7154b294b05ab,t,52899,4498595,,5000090,2018-01-30 14:03:43,128
0x248602b478ad8487713096f281ce9bdebc205c0a35dee047fc5e6dfbbeb6a549,t,21000,4519595,,5000090,2018-01-30 14:03:43,129
0xeb08769f385384c5d5c135913796acd2c1db3fd808fb75e4e789dd6307c8c709,t,21000,4540595,,5000090,2018-01-30 14:03:43,130
0x8aca2454dff8898b21877ca8fda4d783dc3c253c2e07176a19a2f451b795980a,t,21000,4561595,,5000090,2018-01-30 14:03:43,131
0x5a3614aa3e09f47abbee62a6a57157138c7c7894e633c9d15accfbd4addd8095,t,21000,4582595,,5000090,2018-01-30 14:03:43,132
0xdd017f844de57da59fc4d53c94ddd7bb291523d1187b2d1cad05e6e3b389d37d,t,52886,4635481,,5000090,2018-01-30 14:03:43,133
0x45230ffe76f29fb6b03da1265251ca8ef8f57d4f5c4c81235de447a961295284,t,21000,4656481,,5000090,2018-01-30 14:03:43,134
0xff19c9a7472006ee2614ac920ef33d4e594c3ded68168d2a80b490ad2b328735,t,21000,4677481,,5000090,2018-01-30 14:03:43,135
0x981d1a181168d9784211befa11443cae2af3d4fadb11931282b6399ed8404d71,t,21000,4698481,,5000090,2018-01-30 14:03:43,136
0x336fc1c5ca6c0e7ead7805f829c19b3c7a96460d4a3b1378411ea2568d7c6d89,t,21000,4719481,,5000090,2018-01-30 14:03:43,137
0xe29dedae6c2bc8651e1455cdd13dce935992d278034ce492d29aa84bcf637ba0,t,21000,4740481,,5000090,2018-01-30 14:03:43,138
0x65dd8eadf0d04b57251091b00a207156b6b50cc689fe0aea454a02bed2b01cb5,t,21000,4761481,,5000090,2018-01-30 14:03:43,139
0x49a0c04e7d2c02af0b624807933b16d1e7d752528c9cfc73354a8f7b204c8a88,t,21000,4782481,,5000090,2018-01-30 14:03:43,140
0x7e52a24c032acbce6125b787ae1cfc6f93a9503aac92b981c70484e8c14d675c,t,21000,4803481,,5000090,2018-01-30 14:03:43,141
0x92a63601dbe007956352796c5b285d7e5cb00f9a228d26651ef86ab4400d77fa,t,253854,5057335,0x261D2f6b6E599E85D345e976A63dB0a32b4c781C,5000090,2018-01-30 14:03:43,142
0x367a73d335de9687852f62175d11d433429b4756d832dbef5c53bb45078554f3,t,21000,5078335,,5000090,2018-01-30 14:03:43,143
0x820fa46186ef1a07df3c103261f7fa3261fa937ce44c8fedab57dc4b64c9e5bd,t,21000,5099335,,5000090,2018-01-30 14:03:43,144
0x095b40e7ca04496d66b829272ddb89b086d4510ccc18cde518e56cf694d5b44f,t,21000,5120335,,5000090,2018-01-30 14:03:43,145
0xe10c6b96e55ae3dd6ba38162d9702a0bd68b2e3b4b11324524c7186dc160d359,t,21000,5141335,,5000090,2018-01-30 14:03:43,146
0x4ee965eedfe419ac0dc44fa9799a327cd2626836119e8a89bae7bc991d8fd9f8,t,21000,5162335,,5000090,2018-01-30 14:03:43,147
0x71fa20ee50d3786d8d958cf570829bcb89569b5111173d65fca63bf2a52606ce,t,21000,5183335,,5000090,2018-01-30 14:03:43,148
0x862636ec59ce330d50cb8f769e90ca3e17b8e26a43c3956676cbf6bd62993d9a,t,21000,5204335,,5000090,2018-01-30 14:03:43,149
0xe294eb133191b883a03c9473c0b951fe06f2a893a7d0da71511fadb68f4b46ae,t,21000,5225335,,5000090,2018-01-30 14:03:43,150
0xdf2219b6e9ac3e1ac1ad5430017aa637274ac8402c99320aa7b1f0908afb3cc6,t,21000,5246335,,5000090,2018-01-30 14:03:43,151
0x699e82be71d10bbbc6f69d9e338a83b8bcf02d7bf86ff45272aed7a32d922cd7,t,21000,5267335,,5000090,2018-01-30 14:03:43,152
0x067e9c97f2d2071312a0b8f753054ea2137f32bc36ce5efd198f35bb75adfe46,t,37660,5304995,,5000090,2018-01-30 14:03:43,153
0xf8e644c1f0d0d683af1716136bf301e34119bb1ebabfda91316b766828964733,t,44162,5349157,,5000090,2018-01-30 14:03:43,154
0x83181f37c6357db8744849f107805ee3ec59c68a00b6b07d9bc322734d51543a,t,51560,5400717,,5000090,2018-01-30 14:03:43,155
0x0bdcb042eedc4bcfdfe97b5121b4d70d2c5c1533eae41a4ecc57114db0c62784,t,21000,5421717,,5000090,2018-01-30 14:03:43,156
0xc1c9ca7b365acc65c7eada8982f65a9399b213d5b11c3ede3e2dbab98545af62,t,21000,5442717,,5000090,2018-01-30 14:03:43,157
0xec8c9e5cbf74db28053a7e99fce1b21330746a3730c9043f7df09d056ceecc33,t,21000,5463717,,5000090,2018-01-30 14:03:43,158
0xca32ce5c304ff2992483e2bcd55c138b8747ed7fb9cbfa98346904a096b812e9,t,49993,5513710,,5000090,2018-01-30 14:03:43,159
0xedf3e1f1e4c07de40ed944bc383a9b0479e3019045564e57d86c79f4ea67a28a,t,21000,5534710,,5000090,2018-01-30 14:03:43,160
0xdd78306d192927527b0ab9982ca2f59ccf316b9672a284a345a7263289b7cccc,t,21004,5555714,,5000090,2018-01-30 14:03:43,161
0x4e2e405247a4ada45c6d7fc0c8ab3c02f44c6b07f98ca6636bf7553c9b6e9c2d,t,21000,5576714,,5000090,2018-01-30 14:03:43,162
0xe4d3f9635d558e8c825d34e3712f044bfbb086375d938b6a8f5b18c9027b18df,t,142580,5719294,,5000090,2018-01-30 14:03:43,163
0x55858b40fb6d5b3c9771a943431d6c7ff0819b0699332d315a8ddd3f233e663d,t,52963,5772257,,5000090,2018-01-30 14:03:43,164
0x2431a3a4e223989d35c1f67f1b92a1f10685df0416a972a4dfdd5cfd49ceba41,t,52886,5825143,,5000090,2018-01-30 14:03:43,165
0xe0a87ea94ba8ce4d494b77f5fbbcf59c66d5589bbb2e7326afeedf8ff6d3e61e,t,253854,6078997,0xdd115F3E731755bCEedfE12ac3F17e6D5F776EBa,5000090,2018-01-30 14:03:43,166
0x18766f5af4585cbf22eccff9ef6ead37b473a78f1991aae031c37413491f8e31,t,44162,6123159,,5000090,2018-01-30 14:03:43,167
0x47cec084b049e384333da5765f0723e3e1f121312c8bc965b35f69913e4a2b08,t,51560,6174719,,5000090,2018-01-30 14:03:43,168
0x0c21773a225b8619a26530b828c1cc477bf508bb13588628f3dac5bd48aa8362,t,52094,6226813,,5000090,2018-01-30 14:03:43,169
0xb3e3280156f712856ab7f76792230e8adbb1eaae4a0bafc73f494fcdd087241e,t,21000,6247813,,5000090,2018-01-30 14:03:43,170
0x3a73f5f9db2ef52a700c3023b54749116179568f263701c81ede7e3972e47a8d,t,21000,6268813,,5000090,2018-01-30 14:03:43,171
0x98f35ec273e3d5997397ce5e8eae79908476164b21c794b3ae2358e1b1406ac7,t,50057,6318870,,5000090,2018-01-30 14:03:43,172
0x256aceb6fd5bf7cd9af50b5d829dacf6b1c6ea650f32817af4d544fb33063b40,t,51883,6370753,,5000090,2018-01-30 14:03:43,173
0xd768c9f11cd56d710ff6d6c33918cb14c304a078545b3be75f5a3ea4f4973795,t,21004,6391757,,5000090,2018-01-30 14:03:43,174
0x936ae6898bd282df56fb1967fafe3fe9142aeea109b474f35c39daf0a506d5fa,t,38382,6430139,,5000090,2018-01-30 14:03:43,175
0x60c4b41d07d2334809a6a165a6ffdcfea98a7ea2ed91257939d202ab451941a5,t,112388,6542527,,5000090,2018-01-30 14:03:43,176
0xe12ff1c477a51dcc0d0e33ef160971b5516234f08c42815c6bc10ea1db366d9a,t,52963,6595490,,5000090,2018-01-30 14:03:43,177
0xbed1e88c45b92d3ba4eae91d2a06c16232b36b74ca06f21db085ca9b5aff4e1c,t,36473,6631963,,5000090,2018-01-30 14:03:43,178
0xe870f8e479b9f4a0214f7a0220b2b835c6a421b7b23567d83849465056a8bbf6,t,52983,6684946,,5000090,2018-01-30 14:03:43,179
0xc51a875a0dd3342e38a87b683277b3976bad7d8e5ad1ef3c119f185cfd6c1e03,t,21000,6705946,,5000090,2018-01-30 14:03:43,180
0x04292e851f6f50e421cc92faaded6fd98216a398f7f30cc16a6e84b1294228ef,t,49993,6755939,,5000090,2018-01-30 14:03:43,181
0x97a32db59ab4c12d90d51c0e6b55d914d565a0173966481009b14eca70e5486c,t,21000,6776939,,5000090,2018-01-30 14:03:43,182
0xb24bb5633335f191f9977c156a31d2c73d8fef0d0bbf7a4dd9f20352700bdde6,t,21004,6797943,,5000090,2018-01-30 14:03:43,183
0xedab2fac945303e6c5a4f37a880986708baaee27de6fa9c4f86b9abd4daf2af6,t,53318,6851261,,5000090,2018-01-30 14:03:43,184
0xf2a43d5093bc000be04cb35e78608f6b5a03c10d34d19f1cf2677a04c392e1ec,t,142900,6994161,,5000090,2018-01-30 14:03:43,185
0xd66aab24442329d3c92376cb1b9edd57e19f1d872b37a8e0c33b181d85de6337,t,52963,7047124,,5000090,2018-01-30 14:03:43,186
0xd1679d1eb84d0cdded459fd2620f5b20b7462910e87821958488efe8aaadb7ae,t,51938,7099062,,5000090,2018-01-30 14:03:43,187
0x24d3576542497d3ff5202be965fbdf8fe30e7bd8b4c5bc296e2f7a10737e7c15,t,51409,7150471,,5000090,2018-01-30 14:03:43,188
0x164a0a1fd5655d27404643a81598f4b8d1918f0e54ef9b4fe0f6c4bb0608c952,t,55843,7206314,,5000090,2018-01-30 14:03:43,189
0xae0c93be4562c924a098bf618f0ddff0ed5e5ee13b1b207012932a8459fc8078,t,50057,7256371,,5000090,2018-01-30 14:03:43,190
0x6239a2420a70b01c027663ac1fe0ee9c7e9c1d671cfdf8423935956bb0ae0b09,t,21000,7277371,,5000090,2018-01-30 14:03:43,191
0x2c32f813ff54bd7e06f7982da04790089fe59f2db65940baf8cd8c34e8f43b78,t,21004,7298375,,5000090,2018-01-30 14:03:43,192
0xa06730e07aa4d45c686c1a3924ba357a238f71070eec63906348b9fae240a6f1,t,21000,7319375,,5000090,2018-01-30 14:03:43,193
0xf0aaf702e701f054efd788c57b48bd42a47cd6b1266ab9f6c51217f9c5720f7f,t,96072,7415447,,5000090,2018-01-30 14:03:43,194
0xf6499c6f2c623197850edbfa04eb1c0a95f5a67953ebfb350f8b59877a074567,t,52963,7468410,,5000090,2018-01-30 14:03:43,195
0x54d730138029c080000ee3423bf9940dd3d1f98e11e5ccbc41c259546fc949a8,t,51851,7520261,,5000090,2018-01-30 14:03:43,196
0xb2967e33af6ba70215bbdc438024616646d11a9a18f16806c01fc6d14be9f800,t,39835,7560096,,5000090,2018-01-30 14:03:43,197
0x5e39cd44565ce3adaee2917e93dc601bc9127c4d1cf5573147df9501878c4088,t,49993,7610089,,5000090,2018-01-30 14:03:43,198
0xa94ec71c75d5f5e2318fe377548acc173c1ef6cc0eb88a69b150e989a8e98067,t,21000,7631089,,5000090,2018-01-30 14:03:43,199
0x9ce3d6df84639ffeb70f6d5c81e267e9794973f82f97d4fc0f7f6730d83f2051,t,21004,7652093,,5000090,2018-01-30 14:03:43,200
0x829e5315d3249f99d48221b7caf9f171726e292572a5b92162cd6fc395193da7,t,21000,7673093,,5000090,2018-01-30 14:03:43,201
0xc954bbea7aa47292336d7aac34349bb5f35c2d2a1a4c3b70a7e2c2899034f4bb,t,52963,7726056,,5000090,2018-01-30 14:03:43,202
0x23a41eba4e4206dedc42115a09df49fe532f4c4a9a54b17da6dd141afe2496f7,t,52323,7778379,,5000090,2018-01-30 14:03:43,203
0xd251ad1455ce5ba174db27a647bd68957acc004f0d7353ceb531459885c17d14,t,49993,7828372,,5000090,2018-01-30 14:03:43,204
0x9e3337879dc5145fe3240bf5999339fa70c502db3b6a15a99997f0df74beac92,t,21000,7849372,,5000090,2018-01-30 14:03:43,205
0x4416b227492d51235314070cc381c98b103dbbc0efc1590af4397a820760669a,t,52963,7902335,,5000090,2018-01-30 14:03:43,206
0x3f68fa6b2203dd82e038cd455bbe74163941b57f91ce8b77ad7e8860392f25d9,t,53027,7955362,,5000090,2018-01-30 14:03:43,207
0xe7a56446a4a213cf31232db9b914b9b4383303fee937c18ed0d0ad6d99154d65,t,21000,7976362,,5000090,2018-01-30 14:03:43,208
0x9a7e9d04a1d19c527354125215d01f92c226cb314d109922a8409d380fb7f6a8,t,21000,7997362,,5000090,2018-01-30 14:03:43,209
0xb023655a3e7c834905feaa918b53d2dc81f8c86398bc3f3ff09c006aa8f05807,t,21000,21000,,5000091,2018-01-30 14:03:54,0
0x0ce682856c3b97c73f9acd918e6445cf28f1f5a805923fdef20de18b9d95a7bf,t,21000,42000,,5000091,2018-01-30 14:03:54,1
0xefafc050e1810571c172bcdf811b497d902d4227aecb6001abb12747962ad5a4,t,21000,63000,,5000091,2018-01-30 14:03:54,2
0x0bf26b0ad9a8d754c7587dcd8734765e7ab174023137b2442a5068ec1862e6f2,t,21000,84000,,5000091,2018-01-30 14:03:54,3
0x618d010e160d97b263f17b3d47eb728f2db1d558e607aa6612dca58c87210fd4,t,21000,105000,,5000091,2018-01-30 14:03:54,4
0x6af3dd3e3557db831de0ed05a5a9de299708494ccd93f3f55d2c2ea9ac9f9a02,t,21000,126000,,5000091,2018-01-30 14:03:54,5
0xde68e1f1cd237f14b705aee56cc2873b85f927e4c1cb2c4a134ee88935caa61b,t,21542,147542,,5000091,2018-01-30 14:03:54,6
0x33d6dfa3392823fb48de27917a34139ec67cbcdc4c9e6721db31afef0612d369,t,21000,168542,,5000091,2018-01-30 14:03:54,7
0xee291c9b2642aa88b9938d94630e0e22b3d9656d0565544c2a84499c3c9e3694,t,37155,205697,,5000091,2018-01-30 14:03:54,8
0x92c4984a5930a0ab83b9efb9974a028a12cdee649c8e1ed02a52c9712a2671c1,t,21000,226697,,5000091,2018-01-30 14:03:54,9
0xa6be8df573a91d225b37195035e89109ec2531ddfdb13e16e383dd095f771328,t,21000,247697,,5000091,2018-01-30 14:03:54,10
0xb6f33d944c443b21a8c3c8cc496d74b151374689151f77ecfbc8b42ee6286a41,t,21000,268697,,5000091,2018-01-30 14:03:54,11
0x91e53736e1fc48759acd22d097b72b691c40b978558ddb40d58e8fd4b03bd212,t,21000,289697,,5000091,2018-01-30 14:03:54,12
0xc4f35d30ada1d7fe1e3188d2d6b31cd9e667d70319fd70a70bc8f97a42cda255,t,21000,310697,,5000091,2018-01-30 14:03:54,13
0xc1f25823083718c00d6858aa7fc76e6f23e77e2eabfa14a1df7f66f78c683f1d,t,50057,360754,,5000091,2018-01-30 14:03:54,14
0x9ba159f2ced5df9f4aa97a244a7945a6cda71c58bdc07961f98c87c9c13e2dab,t,21000,381754,,5000091,2018-01-30 14:03:54,15
0x18db585f2976f9f9e5052ba43e935d18e5686fe2d309d6850d6990c93c059c84,t,21000,402754,,5000091,2018-01-30 14:03:54,16
0xeaf661a1cdac44e3e3373955e0d929575270f65d4be71f6f4871f5ef58d52fc4,t,21000,423754,,5000091,2018-01-30 14:03:54,17
0x42c2ea5e1953e2de883445cb8b23130ce125a5413ad0f5f28171ebb3413fd290,t,21000,444754,,5000091,2018-01-30 14:03:54,18
0x7fe7335db4b42de0ae6b586de92f3ea03d97da9900e6bb2b4d6b62bbd4196632,t,21000,465754,,5000091,2018-01-30 14:03:54,19
0x4a0c87141962194c9b4c3f578bf2fb3aba1cb32e791a7fd170f682eb0ecb5180,t,21000,486754,,5000091,2018-01-30 14:03:54,20
0x2f5e733ee4771cf6a51fcb0991b9f59c8c304f2432c1e2616bbaba9c05d83189,t,21000,507754,,5000091,2018-01-30 14:03:54,21
0xd0f3dc0d77a07e31451f2e3c2e81c736002be6f35f9a2f43ed5b5c7df66852ef,t,21000,528754,,5000091,2018-01-30 14:03:54,22
0x5e4102219f4d5aa8ba7fcaee2d6e642e836dd1ddf13963c78ad7d64aa792e0c7,t,21000,549754,,5000091,2018-01-30 14:03:54,23
0x96a3cf79ace30615044633933cd79af86398957fc33ffc245477344d1afac97f,t,21000,570754,,5000091,2018-01-30 14:03:54,24
0xde247576741e2d6488480c7b8229797d8b2facb873918c032d27fe5513288bee,t,53361,624115,,5000091,2018-01-30 14:03:54,25
0x59d42f2449e1a794e2c875828871cba84dcbe3ef0b168d7fa452dd8758ffa66c,t,21000,645115,,5000091,2018-01-30 14:03:54,26
0xdd214ae55937774bb44c01ca3c0b4fe9aa1c1cb40f2dd4ed0ff37600586d6c92,t,52717,697832,,5000091,2018-01-30 14:03:54,27
0x0f273f319210f5b1a33a076892044359653efb730aecb4f9a022445e5fc355d8,t,21000,718832,,5000091,2018-01-30 14:03:54,28
0x689e7317fe4b802697bd8fedcba6f602944baa88b671c636e01d417947d858e8,t,21000,739832,,5000091,2018-01-30 14:03:54,29
0xc42bf858e47990045c530495693ebe8590ea9a2107a814465f8c67f54d1d8d27,t,21000,760832,,5000091,2018-01-30 14:03:54,30
0xfae4179afe7564a1114bb822d29c748a68b7e8ae2d544be7f61cd18277020ac6,t,21000,781832,,5000091,2018-01-30 14:03:54,31
0x0e960fe00a406a9061506badc24390140e450572a5e6a781da6b59ff33d4a0df,t,21000,802832,,5000091,2018-01-30 14:03:54,32
0x178af86d758d2b99d46ca0ca93a8f7b8fc3c6fb51bf0d19a107f8819984558b0,t,23844,826676,,5000091,2018-01-30 14:03:54,33
0x95a4eef53d6e8e687358af5c3fb71cf9d7409cb78c4b0a8f14e2fd6540c0ec90,t,34725,861401,,5000091,2018-01-30 14:03:54,34
0x223c870b6203cbd686fe23016ce6f793aa507cbf8b5c439a38322e44b4bd36d3,t,52524,913925,,5000091,2018-01-30 14:03:54,35
0x1540b4b2a210a748e2892269fa8bb00b8852c289375a597e008428d71eda3e1a,t,21000,934925,,5000091,2018-01-30 14:03:54,36
0x46bf1aec9fea5ff4a02c3ad0864ae47765c9863a26bad48030d9b69b688c567f,f,21044,955969,,5000091,2018-01-30 14:03:54,37
0x5225980227ed4b3be1410b4aef62d2b3283bb00ca52fd877645c44a02ddb8500,t,21000,976969,,5000091,2018-01-30 14:03:54,38
0x278c98d3caef6de52a7527d845f1be7b61180985075f49bbbb1b5603cc31e5ea,t,21000,997969,,5000091,2018-01-30 14:03:54,39
0x8fcbad2e7fe87c09cf43281ec4f5b666686d0e05d1a82339415fbdc804e950b7,t,45864,1043833,,5000091,2018-01-30 14:03:54,40
0x3c9d643624c3cc86e54550d7d3f1358f6908922c8c25c39aa11c4b01f43199ac,t,21000,1064833,,5000091,2018-01-30 14:03:54,41
0x667a8952870932d527a47928778e5bbb3971ab251e86a624cbf101e5dfc33a1d,t,21000,1085833,,5000091,2018-01-30 14:03:54,42
0xe8506cc611669f7ee3aae7e9cf3cf643e49887400c1b5e85afa1da8dd3a37526,t,34725,1120558,,5000091,2018-01-30 14:03:54,43
0x83c2c41ab250580ac5c25a774614256fa4f383e331112fbd1c16917cc231627d,t,21000,1141558,,5000091,2018-01-30 14:03:54,44
0xddaad015673525de9fad16bd9faf0b4d5eaa3d6d59e5527a3979cde802665d72,t,167545,1309103,,5000091,2018-01-30 14:03:54,45
0x4bcee17917baa8034e28b8895cdf0ab144d69283df6f1f6e04410086dcaa1809,t,33665,1342768,,5000091,2018-01-30 14:03:54,46
0x47fe023f56deceb6a148a87cefdcd07847424aa961c9f6f5dc867c6dd3bbe76c,t,23440,1366208,,5000091,2018-01-30 14:03:54,47
0xeac1151c785ebd645bd8e84a6536b5fe348e604560ccbc2ea1f5b0a90a807264,t,21000,1387208,,5000091,2018-01-30 14:03:54,48
0xe22243adc9d0ad4dc9c8a60baf5117b1b8ac126a614ab243302c776e5fa7a6c3,t,38318,1425526,,5000091,2018-01-30 14:03:54,49
0xe204934ac2d3f3e092c01341bd78f5501e7db26708995176a443a58759735a64,t,34725,1460251,,5000091,2018-01-30 14:03:54,50
0x622e29b9ba15b3f839dfdc870786d976815306212a2a432952178fdcb2597bc7,t,65010,1525261,,5000091,2018-01-30 14:03:54,51
0xe43dd2b89a4d8bf880f9e0a41619cadab38147ca16936842821a7f6ea7fac6b5,t,21000,1546261,,5000091,2018-01-30 14:03:54,52
0x728b7460d0a3bdd934e472f78506135909b3a7930a3ad172daf10bda541471a0,t,53028,1599289,,5000091,2018-01-30 14:03:54,53
0x8b2fb837f544bb083dab2e3b566658d2ef0da005d0e778737bc6ca43930ee1be,t,52222,1651511,,5000091,2018-01-30 14:03:54,54
0xdb03ba27bc3418fd33bbd4c880a14931c169a006915b3218253546d00f4aec65,t,40797,1692308,,5000091,2018-01-30 14:03:54,55
0x37fe2a098fb170e9d08ec1fe9313ba28a869381ea5e4c14a725dd2449fc18500,t,40733,1733041,,5000091,2018-01-30 14:03:54,56
0x768d451058e4a464334a15c4d553c165a9b900e11d7d9889fba273a05c7cd311,t,40669,1773710,,5000091,2018-01-30 14:03:54,57
0x5f57f72c4a0049fa4747f4f86fbcd243d7a7a374b84b9bd2143eec3f34c7e83c,t,21000,1794710,,5000091,2018-01-30 14:03:54,58
0x922dcd28b2754a25536aebc95bd1069170a7e11b4e48095133ff367a97816835,t,142836,1937546,,5000091,2018-01-30 14:03:54,59
0x308721c5bc01b78164de025e8a08250c04154a8163d8b40733c8f918769c5888,t,52227,1989773,,5000091,2018-01-30 14:03:54,60
0xa347b67379c1257943ada0ab31fc5ec008436ed267c9e16e351d27de38d4c60e,t,52886,2042659,,5000091,2018-01-30 14:03:54,61
0x2180e9bb6513660493bd04240d75e3854bcf4d2fac6645763283f2ea82955771,t,244829,2287488,,5000091,2018-01-30 14:03:54,62
0x7d2d756c8792430165aed0e31f4b6d777489e925ba2e724cc1edbce3746ff3db,t,253854,2541342,0xAA81e07166134ff388dd453D0E427ab472613524,5000091,2018-01-30 14:03:54,63
0xe02a067728a1b67f7fdb552051d6cb737b34454fa26e1dbebd6eaeff9fc4479a,t,52963,2594305,,5000091,2018-01-30 14:03:54,64
0x5af6a932c49b2962ce51bf48a1603128497dd4a9fea5e26dd1f7b9df9724bba3,t,37218,2631523,,5000091,2018-01-30 14:03:54,65
0xe51d847fde71d4388f8f92235340df104125089790629d7471dc740570f8b6c4,t,21000,2652523,,5000091,2018-01-30 14:03:54,66
0x1e50b8865d72dec706a10be4e34459ecaaa3e60ac10492c06e94e4b30cd2eb17,t,21000,2673523,,5000091,2018-01-30 14:03:54,67
0x6c9829cb7bd01c382b308b9669112040b890ee753ebd9f01bc68b3e601fdccfe,t,21000,2694523,,5000091,2018-01-30 14:03:54,68
0xb14034561d6f2abdb340a7cf30be7d2ef6fab24638a18482bccf33143adb21fd,t,21000,2715523,,5000091,2018-01-30 14:03:54,69
0x6f877f1694a9bc865aef95af90e790c2229491e57b790a1625cdea0a1ba2d601,t,21000,2736523,,5000091,2018-01-30 14:03:54,70
0x47a36bec0faa2289f9c05b19ae781f9fff46822d61f09aa02929ce6cb71de58e,t,21000,2757523,,5000091,2018-01-30 14:03:54,71
0x0a093eae5f9f835086ece183d77d882f04dd53c40865423da6414fe998973bda,t,21000,2778523,,5000091,2018-01-30 14:03:54,72
0x05693d4132025012c2a6fe53fe0b68cd22b914c39d12cf32caebd19c64bf6b67,t,21000,2799523,,5000091,2018-01-30 14:03:54,73
0x6c84a72a439255409794779af08355ef9446b7821aa7a31b4434294f7d0080cb,t,21000,2820523,,5000091,2018-01-30 14:03:54,74
0xa85ac505bd7d708dfe6bf42357a6d7e3543ce5674691307d405415140c25c65d,t,21000,2841523,,5000091,2018-01-30 14:03:54,75
0x5a77f5efdfddd79a978f11451e9319cd6c78cdaac4432bc150d6d2fff71894b5,t,21000,2862523,,5000091,2018-01-30 14:03:54,76
0x19ce5ebe662197dfbbe97e5bd30b0b68eb555c994696a5258ad817e8e0d20970,t,21000,2883523,,5000091,2018-01-30 14:03:54,77
0x528db217e4d55a34d3ff7c727d8cc5155dfca502c2c436897200b078c40c56be,t,21000,2904523,,5000091,2018-01-30 14:03:54,78
0x98be8202febadf4aa422585c2f5305b2f462a4361dfcf2df852f761be04b2ad5,t,21000,2925523,,5000091,2018-01-30 14:03:54,79
0x14be5a02090b8cea47d8daa2f1d70f5e5b2f8d0229f29d7b56e5b80f7186e214,t,21000,2946523,,5000091,2018-01-30 14:03:54,80
0x21926493eb9680b1d7222a35e149384fd6c06f5d6c82b7c34486eb2e9f533f59,t,21000,2967523,,5000091,2018-01-30 14:03:54,81
0x04214049850a8ef3144eabe519daa6e4fec5e8aa35946a686c1f2ec42300c1ea,t,21000,2988523,,5000091,2018-01-30 14:03:54,82
0x12945975e7e7c55373004079818e95e56b0100af7496e2b0b5b5f5e21bca3ffe,t,21000,3009523,,5000091,2018-01-30 14:03:54,83
0x78d422a0449beeebcdf202cd2ee71e0b673d477af5b216f6ceaf55e2b5b0c95a,t,21000,3030523,,5000091,2018-01-30 14:03:54,84
0xef2060c370d878319fe3722002b0663459885106a581de7ffa3607ea50c00d73,t,21000,3051523,,5000091,2018-01-30 14:03:54,85
0x6ba6d96d63f4c259361a737ca15bd511451bf5967c008955376a2c71909d51f0,t,21000,3072523,,5000091,2018-01-30 14:03:54,86
0xdc3e65c16d501f6a31a70e8b471819fcfdfda8e5b408733aa2d47ecd78833321,t,21000,3093523,,5000091,2018-01-30 14:03:54,87
0x84f6cb755276d05c30d0cb7d66ebdfe3d7c08db1e3076af2ed89c8a295e0351c,t,21000,3114523,,5000091,2018-01-30 14:03:54,88
0x6d4e5f8407d47577e35b6f1b66e39889f70f022ef8666f56ce98e5cf8ad45a48,t,21000,3135523,,5000091,2018-01-30 14:03:54,89
0x3e84d6074ee150fe7edeedbe947734814c9388b5c0fff67c747b41c3ca0062b0,t,21000,3156523,,5000091,2018-01-30 14:03:54,90
0x2dedd7805651cd9ff0495dce215554713bee2e4d01175f3777370037731959fe,t,21000,3177523,,5000091,2018-01-30 14:03:54,91
0x754d8de054c0562fc5896ab5298da95ccddd8552858e01ea4a5c75a074c4a00e,t,21000,3198523,,5000091,2018-01-30 14:03:54,92
0x10055dc732471d0b793e21fa67216a6cef47c0e6c5f724b9d7f4bda9e15e3c54,t,21000,3219523,,5000091,2018-01-30 14:03:54,93
0xd645c26fa42a05f36dbc42c261cc8a0a898624ad886564569a6ba0e2c360499b,t,21000,3240523,,5000091,2018-01-30 14:03:54,94
0xa07cbf1d01255f6dbf412e624225c7c43d3f99fe8d7464da9524600aab8d054e,t,77986,3318509,,5000091,2018-01-30 14:03:54,95
0x3c1740613076627ae16279d59468703a2f7e872dd62682b397ffb2402f2ca116,t,21000,3339509,,5000091,2018-01-30 14:03:54,96
0x9fb31f852ca5e5b0e20707a5ce3b248e0dd4d7d1ff3c1cca06dff6c9e4ae3550,t,21000,3360509,,5000091,2018-01-30 14:03:54,97
0x0e2f9cd9170233a6ba72480d935117c829882d21e29085cfde50c277526e9bef,t,21000,3381509,,5000091,2018-01-30 14:03:54,98
0xbe407cf7ad133137bdc7115cc07ac275adbb4325498beff8a7c41618921f176d,t,21000,3402509,,5000091,2018-01-30 14:03:54,99
0xcbe6f13ab4d29571424228dbaac94a39ad4017f343ccb135610b044b764fb080,t,21000,3423509,,5000091,2018-01-30 14:03:54,100
0xe8e899842a2cfa55f988ec471b71edd5113445e56431d42725835de02ca87bfb,t,21000,3444509,,5000091,2018-01-30 14:03:54,101
0x54de62fcfd56abbcbdbfb670041193f4984afbc4e0dc94db56049ef2649a8398,t,21000,3465509,,5000091,2018-01-30 14:03:54,102
0xbcbbc4b63b5f54c65e1b78364f50b21074941ecec4f7be2027f6f35c2541a0e7,t,21000,3486509,,5000091,2018-01-30 14:03:54,103
0x76a091bebd40178bb6f5b996bc4ff6b2a69cc9c461265db7feecc34eb8606f86,t,21000,3507509,,5000091,2018-01-30 14:03:54,104
0x6a6c2193d0ea6615619c3b50903ed1d4bd3ee314dfbc05d4e16d29fc84a86332,t,52460,3559969,,5000091,2018-01-30 14:03:54,105
0x1ece65198782a187d88dc545de689c1f2b7de2948649b5c06bdd9d38625410eb,t,21000,3580969,,5000091,2018-01-30 14:03:54,106
0x88b8fc00b6453783bb65b5b678170441ebe567806a62d40529e686041f407fc0,t,21000,3601969,,5000091,2018-01-30 14:03:54,107
0x25355e7c596969aa947f509c132c7bb7a5220fc7768eab908afc186a2f4c94c7,t,21000,3622969,,5000091,2018-01-30 14:03:54,108
0xebde283253e6cf0160335f0d2d190c121deefc32089b7053629ea985db7a47da,t,21000,3643969,,5000091,2018-01-30 14:03:54,109
0x7fecdf80b1c39e5ff5ce71eb20cdf2e2c314d1294ee58bb9fb0d75140d68e1a0,t,39908,3683877,,5000091,2018-01-30 14:03:54,110
0xf93688c09413751a74a560ef0192467daae367e3d6eea36860fe653c48be0d02,t,21000,3704877,,5000091,2018-01-30 14:03:54,111
0xd42d837494e11ef71e26bb2936a293645dd91f9fee3bc165f4cda4ca219cfa76,t,21000,3725877,,5000091,2018-01-30 14:03:54,112
0xe27e7f68cd3d46cab4a2650b8062f4c7ddfadf202e238a6828c9b089f00a5f1a,t,21000,3746877,,5000091,2018-01-30 14:03:54,113
0x84f0e15deeb5a9f865d037b0b22ef9e430cfa8ec4245270e0cf295dbd4eb319a,t,21000,3767877,,5000091,2018-01-30 14:03:54,114
0xe1db70622b4ece03a201944e3d5f3f5f556940ecded9d1a34287a52b5f669e82,f,25200,3793077,,5000091,2018-01-30 14:03:54,115
0xc307416d2d8e2e9eddb7fb1ea01e8aac7976ea0bd3ceb1be3003872517a0e5a5,t,21000,3814077,,5000091,2018-01-30 14:03:54,116
0x9368ea2c3a1447d2058f03322e3327b726391ee68c0cfcf8c6bfc01c521a5a65,t,21000,3835077,,5000091,2018-01-30 14:03:54,117
0xc9b1dfd8c8b2c4d507c63e76811c891beb4c05a70d2f500ba0ee3160579b8d87,t,21000,3856077,,5000091,2018-01-30 14:03:54,118
0x32c03c109a7de768f439cca908bdfc6f20a4b0690e94289cdae1139716152f92,t,44025,3900102,,5000091,2018-01-30 14:03:54,119
0x05ca6be4a1608a5a52539624f39b6b4e411b275fe576fb711381bcb8f41ea272,t,37660,3937762,,5000091,2018-01-30 14:03:54,120
0x6c8b8eb17773e9f5d1ea7413c2ce3f1875e95547f6836ba2b240512ec73c9b84,t,23615,3961377,,5000091,2018-01-30 14:03:54,121
0xe8cd93f02d757a6f08abbb7c1da6a8878835a1e38ca1e525747a4cecdb8c8ecc,t,52912,4014289,,5000091,2018-01-30 14:03:54,122
0x83257c70d99e93520f3b7be21d62961adfbbf7a1fae07a0e529335cf669e84a8,t,33426,4047715,,5000091,2018-01-30 14:03:54,123
0x8f223275a20d7614d8df0192c9a6f3c8ba74d32ffcb9a1db0983e8ee734bea39,t,51560,4099275,,5000091,2018-01-30 14:03:54,124
0x8260494810275b3f2746bac3e1ca611d2be0f54e7446656114c51ae1c0edc322,t,21000,4120275,,5000091,2018-01-30 14:03:54,125
0x40b00570515e5ad420bd6cce8b3e837d5a07de0b00f99c150886cb37130ec292,t,23252,4143527,,5000091,2018-01-30 14:03:54,126
0x6ea58694fe9d65a6932fd89187d9029ae5fc1085cfa5d96986b2485b8ef4a168,t,58919,4202446,,5000091,2018-01-30 14:03:54,127
0xfb393cb9faa0a0ee396e3584c846de05143fdea8b2ac4ff73eeac14c5cc34153,t,64271,4266717,,5000091,2018-01-30 14:03:54,128
0xdc34d1798486be71fe228ed87f87c0d7fbee32426acac6392c149168660dd845,t,302333,4569050,,5000091,2018-01-30 14:03:54,129
0x34112e264cd004c50ec5fafe78ede63da104b149e613ec73a96e3b359f903a1e,t,108050,4677100,,5000091,2018-01-30 14:03:54,130
0x3fe429f62fc6be0e07959363771001a3f5219017c81967b8be38e9f964aa0ebc,t,78114,4755214,,5000091,2018-01-30 14:03:54,131
0x180b3601cf5c07ff30abeca5c9fd655bc5485f2e9880bded4ffecf26fad68738,t,174591,4929805,,5000091,2018-01-30 14:03:54,132
0x8946cc131ee6b4e2abc9b261ba8285d6d302e37acba2a44f402977305908124a,f,250000,5179805,,5000091,2018-01-30 14:03:54,133
0xda5c258d7b4e23fcc5bbacddd72d47630a5795f96621f46b1c7875abfb740b63,t,21000,5200805,,5000091,2018-01-30 14:03:54,134
0x5466ec044fcff28b7452b1a3fcf34f45cba1306cd0b7065da25df7fd5ad357cb,t,38885,5239690,,5000091,2018-01-30 14:03:54,135
0xd31f9b5bb5cdd2fbef2f850b9bbcb0b2722ced6beb0a59a560f98af80ec0b40e,t,140340,5380030,,5000091,2018-01-30 14:03:54,136
0xd6e58a4cba5957c88ad2341431e35a69e20d2202987e4f42002d57210fdce4d4,t,21000,5401030,,5000091,2018-01-30 14:03:54,137
0x75324b687d242ff9655479e097361a5e1910a328d5d820b75b6f8c1e17d1b7c9,t,48734,5449764,,5000091,2018-01-30 14:03:54,138
0x807c380dd4ea85a66b8b74b4e93ed0a406127036b8ba3e8536f29cdc4dfcd023,t,90117,5539881,,5000091,2018-01-30 14:03:54,139
0x028d7c36dcade3a6653b4a0dec90a65b11a5fce8da9a7a8161b437790e88d18e,t,176084,5715965,,5000091,2018-01-30 14:03:54,140
0xa7a40dcc7bd917a629c23acdebe9de22ededd0780dfed8a4e1930c3edffa1b3c,t,48670,5764635,,5000091,2018-01-30 14:03:54,141
0x69816783e82344e15899d2a7f60501ea01c87b8d5c975befbf6465c20c99aca9,t,21000,5785635,,5000091,2018-01-30 14:03:54,142
0xb8fee3f1b9769f6cb5978a6ea3b49abd0484650e3b65ba6fe69f16ee9d502398,t,77730,5863365,,5000091,2018-01-30 14:03:54,143
0x5a3eb41c3df9e9c5183295e0e9abcd4f1afbc7938fb769436fb5f7059cc5c270,t,49725,5913090,,5000091,2018-01-30 14:03:54,144
0x0bdd39a73d8879f80de21458d1a7d9ac42fe4ff8d56d0b3e316dfa0f58f667e2,f,74319,5987409,,5000091,2018-01-30 14:03:54,145
0x367a0ff844c1bef7b6945e966d5d39e1376f2ae60f17cca2dc6ffd73d5646fae,t,136216,6123625,,5000091,2018-01-30 14:03:54,146
0x47f5021188e00469153945a0ac22a2a8015f64ae17843afce568f0d9eeb9ed31,t,93050,6216675,,5000091,2018-01-30 14:03:54,147
0xfd1b358a8899356b91b0f0447478b426ba82e3cf51225cc4110e635e89f7b50f,t,124100,6340775,,5000091,2018-01-30 14:03:54,148
0x68e6749924ef7f867a44fc709ec0aa1e7a100f5919aae806af1b9473f0e2a730,t,141279,6482054,,5000091,2018-01-30 14:03:54,149
0x327a6818e7878679f4f129fc6bfcc18ec7368deaa1dd427b2ab5155b1e3e9cdb,t,765330,7247384,,5000091,2018-01-30 14:03:54,150
0x7bfc693bcb9a3b4fd5d6292778eee56488256f3d0b2446cd4756a8e25eff4ba8,t,231089,7478473,,5000091,2018-01-30 14:03:54,151
0xb771c7a5e6d270d1e4fd302f0b2945b8e90ffbfa3454bb2079a6dbee34e62d22,t,59034,7537507,,5000091,2018-01-30 14:03:54,152
0xe48da37a5a3a13e579d7af6bba6f79bc1985d3ea38ac6875af43dd897abfe8c3,t,137307,7674814,,5000091,2018-01-30 14:03:54,153
0x065abf12a5bb3d6dae067b3d4111dcc6186d5ac664a21995a6d55f6c49071371,t,52172,7726986,,5000091,2018-01-30 14:03:54,154
0x887c60d5282741d44da26fd39d7737273e18e9fe611d2ea84a10a1aa78b841b0,t,21560,7748546,,5000091,2018-01-30 14:03:54,155
0x0b65b108561767516a98469339c74a4fefc5103e6a090aeb542a713bfd14ee69,t,52884,7801430,,5000091,2018-01-30 14:03:54,156
0x7dc62ff108cd8839eb6b455c4c35bc7727776d332f8550b1e2cf734b60e5990c,t,21000,7822430,,5000091,2018-01-30 14:03:54,157
0x152f68a52cd182b94b34f1d1f59f083e937da77fca14b38825bfe5345c4dae9e,t,21560,7843990,,5000091,2018-01-30 14:03:54,158
0x59d68fc96854fc2c5ce860f28bfe349866f0cef11b5552b7f01aaf8741c01451,t,40806,7884796,,5000091,2018-01-30 14:03:54,159
0x06b3f41cd7b5785b72faa1869cda30bed82c5ddbd2a5b4abee07c5c35e4d5aec,t,21560,7906356,,5000091,2018-01-30 14:03:54,160
0xd944cd312fbe5ba0a747601fb55a36df8634193e68998534803c9cdf652fd5b2,t,21560,7927916,,5000091,2018-01-30 14:03:54,161
0xc771b6c0bcfd87a2a0efb8b3a0743ffcbfe3c6162f6770e7f344cd7ac860f9b0,t,21560,7949476,,5000091,2018-01-30 14:03:54,162
0x060310245df1246dfa2517896366a68ee9c506133675e5c0c6a79c382715a1f5,t,21560,7971036,,5000091,2018-01-30 14:03:54,163
0x50c9d2a41056174afeb0a2ed7b1f36a1316f80f6e7a7b3a0147a61267ab51ed1,t,21000,7992036,,5000091,2018-01-30 14:03:54,164
0x4aad5d5e006b2af138226413398136eb294670ababd62b0405897b47031339e1,t,21000,21000,,5000092,2018-01-30 14:03:59,0
0x07c5ef89e902fb9c0b3eeda9e2a8c586277848d912c248750f9f91d61fce1917,t,21000,42000,,5000092,2018-01-30 14:03:59,1
0xf10024712a714df5a3200e2e3ad00e61fd047d2808a1844f8f14ae30f571a0e9,t,21000,63000,,5000092,2018-01-30 14:03:59,2
0x909eacc486a01da493df456aabfe8646caa6b7961608705d653e86325ac8143b,t,21000,84000,,5000092,2018-01-30 14:03:59,3
0xa36daabe41158e7f0ef5c827302a245900c1602fcee9dd9f7be06465f00b0f40,t,21000,105000,,5000092,2018-01-30 14:03:59,4
0x2b0704d6856fb2fc143b8ff44bca9bc6b0f9edf538fa6ef38206fc405b1fed38,t,21000,126000,,5000092,2018-01-30 14:03:59,5
0x6b1cc115f572c1b86cc5019a5f447d6a047c2461e1df1fcf4af45a8c65bf740a,t,52091,178091,,5000092,2018-01-30 14:03:59,6
0xa81ea4fbe623fd27c5394f9b0ec639f6247511c0752b48007368fd55b4268ee6,t,21000,199091,,5000092,2018-01-30 14:03:59,7
0xfb5bb806bbe196f469fe0354b7fbc25f08313d9c4c676897e5c8768211fb33dc,t,50057,249148,,5000092,2018-01-30 14:03:59,8
0x02e300e6bfa1d3c44739810da102c0c10608a64d70e9c4d446ea1e61d7f393c5,t,50057,299205,,5000092,2018-01-30 14:03:59,9
0x93161e67cbedef3d09ed856565efd62b20784d94777c4159e86b527ad9dc6ee8,t,50057,349262,,5000092,2018-01-30 14:03:59,10
0x2876b0a87e168120b4e3c01de374607677dcaf2a890938448aace9d4148fa00d,t,50057,399319,,5000092,2018-01-30 14:03:59,11
0x1c0aaf5c07eff207a61cb90f66f336fa4cdda06c2f915cda0df1f057becacdb0,t,50057,449376,,5000092,2018-01-30 14:03:59,12
0x8ea2ed615c725dcd303abf358e2c3c914a6d495a065cc83e6e99463c6fd55ea8,t,49993,499369,,5000092,2018-01-30 14:03:59,13
0xe6901e4fbf1c918eb2efa4c67523e1ab1605a099afdad60eaff68a983f0c41b5,t,50057,549426,,5000092,2018-01-30 14:03:59,14
0x134eec8e1513c3f2c4dfa2c615d76bfacefb579eadf81e8eb9c7e5bde77f5a6a,t,49993,599419,,5000092,2018-01-30 14:03:59,15
0x3b69ed3a73c886f8fe78160fac758b3b4915a7ff94333fe84975749eccbd0c2f,t,50057,649476,,5000092,2018-01-30 14:03:59,16
0x66baaaa343b8f1ce57b01834382de299fdfa290d45768a2fb7326d10db7c1a10,t,47047,696523,,5000092,2018-01-30 14:03:59,17
0x0d8ff3db9a5cb9d327af7cab74a07fbcbcb9d19f7571deb5557584c14a81bdad,t,61473,757996,,5000092,2018-01-30 14:03:59,18
0x9fa2724ef72639408f6ca7117646bf576cac03a9ff8a413bfaac09dcf90795c5,t,46960,804956,,5000092,2018-01-30 14:03:59,19
0x41c916b747e76a63adb439d7b046a95d2a25723164425f8feda3797286c6c4c0,t,21000,825956,,5000092,2018-01-30 14:03:59,20
0x4f4ee323da34246a4c1515edb2d17e775b866aad56011ce3a0896a7041181fb2,t,21000,846956,,5000092,2018-01-30 14:03:59,21
0x830af08ddbe07a616db91caab1f738877b1c849a0929026df0a52d016d149c21,t,21000,867956,,5000092,2018-01-30 14:03:59,22
0x6dae5ebdd9ad7c71d4514df50feec97964b002bc9ea89fe8444af02ae265caf6,t,21000,888956,,5000092,2018-01-30 14:03:59,23
0x7e5a7e4d0dfced15c680e0ac7158c90f5f19a8b1855e28448a78ef33882ab8f3,t,21000,909956,,5000092,2018-01-30 14:03:59,24
0xa906e2601dc013354c2cb97b7b51ba6473a4c1eb7a074261e8ce99daf17552dd,t,21000,930956,,5000092,2018-01-30 14:03:59,25
0xe78fa19d5cf069ef30fa9259cc2c447a9748a8fbc7b9ed3e70fd34fd0ae9f4a2,t,21000,951956,,5000092,2018-01-30 14:03:59,26
0x8bb2937a94432b42dd8a2bbf83d111ebc8fa39c490d5c0920d92a5cd73d2b87e,t,21000,972956,,5000092,2018-01-30 14:03:59,27
0x29e77c96fec85003aec93eba3d8ae2b14231d67ee7908dbff942e63b385ee3c5,t,21000,993956,,5000092,2018-01-30 14:03:59,28
0xdab90a66502342e3178cb5b351def4d6337f3305450052dad14f1752c226a2f6,t,21000,1014956,,5000092,2018-01-30 14:03:59,29
0x141bc4c178193840320793ff0f55f18a555ff1ed1cd4670334a89e9ab8a84d2f,t,21000,1035956,,5000092,2018-01-30 14:03:59,30
0x5afaf0b758b565341ed27c2d3c73d5845f02c6479c36101e308ccaab0dd17273,t,21000,1056956,,5000092,2018-01-30 14:03:59,31
0xa1077e5ca9b8d145c6538d22131c5cac3097aef152db0a2af36317ab0d935bfd,t,21000,1077956,,5000092,2018-01-30 14:03:59,32
0xe3953a29ef987970104e865fc4b681e14641dd160bd3efe82d15f3f13a928346,t,21000,1098956,,5000092,2018-01-30 14:03:59,33
0x227dbf81da7ed193dfd501854e6701921c0d6b42e28353c843571793cf3092fb,t,21000,1119956,,5000092,2018-01-30 14:03:59,34
0x1621e1ffacb0626758b2fd0a11dfe5f2469c06dc06ee9624985a0c9bf41f7e20,t,21000,1140956,,5000092,2018-01-30 14:03:59,35
0xbd2b4a77342350019c6f1447b23a2e43c928fd420f890931dd97230ac29eab59,t,21000,1161956,,5000092,2018-01-30 14:03:59,36
0xf2fd200efe834f012598c3e577d199b501b71d3305ef2a46b9d9cc31fa0f400b,t,21000,1182956,,5000092,2018-01-30 14:03:59,37
0xc202c04950bc8aa935ddfddfbbde12c05c60acc2e8d482b097206dbea7db7356,t,53361,1236317,,5000092,2018-01-30 14:03:59,38
0xfb2b8c8c8c2ec5eef5867ea3b9cf60a8ceb04fb0f01ce0846f1ac44933b2e66c,t,21000,1257317,,5000092,2018-01-30 14:03:59,39
0x85e2cf9e3b6d12d1bc2ad4cadd563048b66504be341d5c6b7337ffcacf657fdc,t,21000,1278317,,5000092,2018-01-30 14:03:59,40
0x6ec3977064cb32158e465ca4e9d0ba5e0d3dab9281112561e3d72e4310baccf3,t,37987,1316304,,5000092,2018-01-30 14:03:59,41
0x189323290c69104c967df403dd549230666ad1f0b7fb84c8cda72119657f1b3b,t,102934,1419238,,5000092,2018-01-30 14:03:59,42
0x5aa1788c6c5627f53c4dfdee49b9adc80e84016867256a4771a303e1b2e30e3d,t,21000,1440238,,5000092,2018-01-30 14:03:59,43
0x9f5825da9771ffba93866583c78cd2dde2b9cb031f9f9de84caa06e8d7150649,t,21000,1461238,,5000092,2018-01-30 14:03:59,44
0x3560fc04434d08546b7c2fe00df7e13ecbf38d3bad4a207f3570fb3cb6a01564,t,21000,1482238,,5000092,2018-01-30 14:03:59,45
0x402121a8839a5034bfb8c99737f9e22427eee2b861132e1379f583c232542047,t,21000,1503238,,5000092,2018-01-30 14:03:59,46
0x5bcdb252a3baf24a6edca57abde04ec711694a5b483604e2032e3d3535857820,t,21000,1524238,,5000092,2018-01-30 14:03:59,47
0xb570db9b829cb3b622e197f357624cb6f3c0fda93d76afe254f8bb84375548ff,t,78114,1602352,,5000092,2018-01-30 14:03:59,48
0xa734773991f3b49248c818bdc7c91a806e5cef6703f2c691528df16267834b67,t,21000,1623352,,5000092,2018-01-30 14:03:59,49
0x4be632f18de657617c0c7da6ad3ef2fd7ab2e6d9147253ed25b00823ab878d06,t,52501,1675853,,5000092,2018-01-30 14:03:59,50
0xf6e029b82c79105545f87d92f980761513a45fc46c9426b589aa2611b4fd4037,t,59354,1735207,,5000092,2018-01-30 14:03:59,51
0xc168d55f31e5de0a50fa17feb5ceb84e433570238c6248dc596fb50c5b830daa,t,21004,1756211,,5000092,2018-01-30 14:03:59,52
0x90dc2f5a1dfdb5e2f87a3f0062b7efb2b341c0226b01da3c8adfb6cb2986036f,t,21952,1778163,,5000092,2018-01-30 14:03:59,53
0x279a2b71ba4411d0802857588c3c32d8cd625ba5c1d49b04d5f3675bae880881,t,38318,1816481,,5000092,2018-01-30 14:03:59,54
0xf02f8e0faf61cbb49537f4a11594066c8111bc4c8e106675deae31065cf810ee,t,21000,1837481,,5000092,2018-01-30 14:03:59,55
0xb3275b63a8315963fc8925fcabadac92e67e20438b02434fd863066543d865f0,t,55715,1893196,,5000092,2018-01-30 14:03:59,56
0x273c410d5cdf26676bbf583a08a876da6d406ff715fda5fa21f724494891a84e,t,21000,1914196,,5000092,2018-01-30 14:03:59,57
0x6ba44affb0a9c15527d4842ffb6d539e08bc4d8ccc1be5b67822f762ba0c67f7,t,55733,1969929,,5000092,2018-01-30 14:03:59,58
0xad1e2a821d6beae645303e9f2029b3f93d367974829f81a5391606ea754e3d98,t,21000,1990929,,5000092,2018-01-30 14:03:59,59
0x006e21a13112736655c67975351e9ca3a13cffc87b2a948e2815f94e5a35cc9f,t,21000,2011929,,5000092,2018-01-30 14:03:59,60
0x425c666de20e8f24ea8388e3c89d4c8daafe9a95d898b10edb8a5a7a0fa90094,t,21000,2032929,,5000092,2018-01-30 14:03:59,61
0xef4ef1e4afce8b9787371f07ce98065c43c519d53aad707ee8c3c69281794e7e,t,38318,2071247,,5000092,2018-01-30 14:03:59,62
0x842d1aa3f2291f30db10547287d4fc7fd269c3834237fae66e657fe7cab47e43,t,21000,2092247,,5000092,2018-01-30 14:03:59,63
0x75628c2c90803a895a96955a8fe04dd1177ca919f7d9475b751c1246abff700a,t,36411,2128658,,5000092,2018-01-30 14:03:59,64
0xecc294a627acdc19a60fb678ee1d0a36d894ab4b515ef693dacc56124412c783,t,21000,2149658,,5000092,2018-01-30 14:03:59,65
0xe997d6b287ff4f662f2356842fcc7b4d68f8027924949b2bb605ab7e0cf79cb4,t,21000,2170658,,5000092,2018-01-30 14:03:59,66
0x31e3e0740081098c0d1d6762920861107c57771e7b60c77fdcd20ce5869939f0,t,21000,2191658,,5000092,2018-01-30 14:03:59,67
0xc8c9f33241d7993613f1c2db4f462bc16c1807ac9e58c1ea855b5c296b572ab0,t,55843,2247501,,5000092,2018-01-30 14:03:59,68
0xeb898afaa37c7a1ff16e61970157b1765df3dd5ef2cc2381277fdb1cf0d77443,t,21000,2268501,,5000092,2018-01-30 14:03:59,69
0x146fd28ad4ce13c3fe1db44a66bd0a0d33a6497f2bbc7eff3260cecac9d440f4,t,21000,2289501,,5000092,2018-01-30 14:03:59,70
0xe74ca9aee2980434211d2a5c4890a7c929841fdbfa05863d2f105c1d6b3349f9,t,21000,2310501,,5000092,2018-01-30 14:03:59,71
0x257bfc7fd35c1b90faab929d65a0fa685c64a4c009ea0fb23497c07ecf8a5f1f,t,21000,2331501,,5000092,2018-01-30 14:03:59,72
0x5afb79ebd5ca21d68864f8cb79696348c8aa73074b94953733e8b2fb0128e457,t,21000,2352501,,5000092,2018-01-30 14:03:59,73
0xfbf7d107c492b4950fc9629422727be77c165d6a4d63b45ebe2a54477c2ef169,t,21000,21000,,5000093,2018-01-30 14:04:33,0
0x2c408e12dbeb19d60a24ff867d3096178dc191671b7f00817286ba53437545e3,t,21051,42051,,5000093,2018-01-30 14:04:33,1
0xce5da160ea9d81dabdb04696a322664e3b8419b855859a635068daaeb9c94c25,t,21000,63051,,5000093,2018-01-30 14:04:33,2
0xd82ee20385848287867a917284583cfc30bd1ab003a0e674e6653c148bf03f80,t,21000,84051,,5000093,2018-01-30 14:04:33,3
0xee83fc5648f521342e3fff5de1b6ecaaf24897ed1f54b9a5d59988cb037a9423,t,39512,123563,,5000093,2018-01-30 14:04:33,4
0x4d1e894bd83ae7f14eed4ab1f0e9208f4111ea72ffe35337067640a793ffde14,t,21000,144563,,5000093,2018-01-30 14:04:33,5
0xd752fb3755ca2e43759e35bfe79b6fd69436d20c7f34d99fe0d4ec31502cf8f3,t,21000,165563,,5000093,2018-01-30 14:04:33,6
0xd7a879dc26099e9e37422e0028ad00cbedca76755edf7440724e07e07e67e29c,t,21000,186563,,5000093,2018-01-30 14:04:33,7
0x24e7b0d77b98bc16d5a97c8f04fb268b97844f4bab35ebacf1b0c056ed286240,t,21000,207563,,5000093,2018-01-30 14:04:33,8
0x4fb9cdb9ea29df12a79361e798cf2171b3c2640712693fa80db4d60d04078243,t,21000,228563,,5000093,2018-01-30 14:04:33,9
0x09b519bd7e348f86c3d4f58bd5cdcb56906ee9e5a94d87886e25c44b70bf7042,t,21000,249563,,5000093,2018-01-30 14:04:33,10
0xc962a3cff623b5bea4c12adbf24053aaef92d8969ae08afcaa40219334283d52,t,21000,270563,,5000093,2018-01-30 14:04:33,11
0x4bac73a378171bb846cbbe3c6a64ca4deb6b6ce5ccaa6746d208ee2991694526,t,21000,291563,,5000093,2018-01-30 14:04:33,12
0xd9ccc276693f585c6fb893cdc17eff97c0eca518545ac1b8c0d5b4956b5c5e3a,t,21000,312563,,5000093,2018-01-30 14:04:33,13
0x3af5dfe72f903abeab2e7bef15009cfda92c9c3c58dedd5ac60ebaeb0b18c7ef,t,21000,333563,,5000093,2018-01-30 14:04:33,14
0xfc05a481003998fd945fbc8840ab6af613f420d7f558b607c014222744b0024a,t,21000,354563,,5000093,2018-01-30 14:04:33,15
0x7317450488fd3e7ae9e796c54cc1aaf59c872effd582e572c697efaa9c17a41c,t,21000,375563,,5000093,2018-01-30 14:04:33,16
0xd3337cfc8397b29c7aeadc3f595188804ad2293f47c8af61344ca6855f054a46,t,21000,396563,,5000093,2018-01-30 14:04:33,17
0xd289d60d7f64b51b836e531458f3c8f0478e24741f3ebb1dc5d820771dd6f296,t,21000,417563,,5000093,2018-01-30 14:04:33,18
0x4d42974d83361740e42dc6b5681a37382d7e37c0aa5c48d8550498816d0d2a28,t,21000,438563,,5000093,2018-01-30 14:04:33,19
0x7d286d7194bf0b013bf9ce79c077eb342ea8931beee8f25a07a9587cd2889416,t,21000,459563,,5000093,2018-01-30 14:04:33,20
0x41a08dde52473a972986dc0a610618594a6c9df84ae98e17c976f78c3b78e1a0,t,21000,480563,,5000093,2018-01-30 14:04:33,21
0xf0a3a48dc10412c2888ee1cb09dec1d991da54ba7a6b8ff1f2a6537eebaf1ab5,t,39512,520075,,5000093,2018-01-30 14:04:33,22
0xa0b422b35bcd018974bc2b7e7331af894178de951133d9376b6b800db053315b,t,21000,541075,,5000093,2018-01-30 14:04:33,23
0x5ee4777c28fb483abeba74f06407949de8d77d80c5a72bb8c368ebc72c7bf360,t,21000,562075,,5000093,2018-01-30 14:04:33,24
0x185f3051e15526219c7b58c50ca3cf923dd72102556df507e078765b36881659,t,21000,583075,,5000093,2018-01-30 14:04:33,25
0x54252273ec652cc85e5cc3717f5722e6d8e6c66cdd2e644b39800a174d7d196f,t,21051,604126,,5000093,2018-01-30 14:04:33,26
0x49742708d74a07e4c28802897aae2e72e8bb3b649a9a50adcd4c56e315c22bc1,t,21000,625126,,5000093,2018-01-30 14:04:33,27
0x29732a5cd97da3ef832d8b77281c060f7498a82acb3f48274122cff319790699,t,21000,646126,,5000093,2018-01-30 14:04:33,28
0x77d34251a875fd5eadc83020712e732e1d52f13d7080451d3d786f254056b0c2,t,21000,667126,,5000093,2018-01-30 14:04:33,29
0x1072798fb150c29330ce54aa50f1408447080efeb3f9c70cbd333f052489adf8,t,21000,688126,,5000093,2018-01-30 14:04:33,30
0x7edbb2258a4dd0cc83e260cf0ec6415c06644bd0a1e43c58c5d47da151a59739,t,21000,709126,,5000093,2018-01-30 14:04:33,31
0x299038c5ff1a5c3ea5f167bb42fc5ea3c676f3d85938539930e561f94a001807,t,21000,730126,,5000093,2018-01-30 14:04:33,32
0xa6ce589a78741cd0704ea623e2139cf6034daf97fc5ca1295bc47fadd589a3d7,t,21000,751126,,5000093,2018-01-30 14:04:33,33
0xbf670d515e450b958844750521163591d4d5c540b088075303f6acb996b8aa4d,t,21000,772126,,5000093,2018-01-30 14:04:33,34
0x7c0f0e50a20762ec1d6f249994be620298fa595032febe306975d5a4bbb7dd42,t,21000,793126,,5000093,2018-01-30 14:04:33,35
0xa4ee51f797ad9143afcc920ca22ba04be04da76f98423d571ef3706e08578996,t,21000,814126,,5000093,2018-01-30 14:04:33,36
0x7fdefeaf75afbbb6f24a6013f7b61a25c6e11070a1ee6ce43ee2a9d1f3215c2b,t,21000,835126,,5000093,2018-01-30 14:04:33,37
0xaa7632cd8f6ebaf2523913b43b0020fa527fd4d8ec10459acd6b2c51151c8ca1,t,21000,856126,,5000093,2018-01-30 14:04:33,38
0x16bf523ec25ee513af95ebf5a517ac2884fb402a4e1086495bf2d0aa31356ee2,t,21000,877126,,5000093,2018-01-30 14:04:33,39
0x418ea9f64a893addc4e67648bd4ea279b788626d6f423e52f187fdeae61ca5a9,t,21000,898126,,5000093,2018-01-30 14:04:33,40
0xc25fc44c846f318eac117285467a1285065be3dfeacebc2a8130f0792b5e8890,t,21000,919126,,5000093,2018-01-30 14:04:33,41
0x39556487170dcd6639d744e1316c816557861a8070afcbadcb07e328ccf44984,t,21000,940126,,5000093,2018-01-30 14:04:33,42
0x72006f29c731d586423829eb0e2984713945eb12a41ebcdd2a888ec53a1ca418,t,39512,979638,,5000093,2018-01-30 14:04:33,43
0x4ea2fdcde723a295aa3fd1607c8eacd94434fa18f74c95f7e3df059eeff6d323,t,21000,1000638,,5000093,2018-01-30 14:04:33,44
0x95201c3bcfedc3e903447f58016af07bdad296f83fcee19002b86dd0ad6cc69c,t,21000,1021638,,5000093,2018-01-30 14:04:33,45
0xec884714209800e08ba96bf16e5bda49a3b109aba137b0345d5bc810c44f5563,t,21000,1042638,,5000093,2018-01-30 14:04:33,46
0x962d256c9c191e555617df73c9e8cc5035c1c21832af11a8ed2c895ca3d352af,t,21000,1063638,,5000093,2018-01-30 14:04:33,47
0xcb65ce2e3248a5f69dfa49cb52f8e4d2a00f5ef9c7b60c3fda32cd726c26496f,t,21000,1084638,,5000093,2018-01-30 14:04:33,48
0x7b01ceba668ea0ed023bbcee8d252967da16f07880e9ec3fcc4753d65f137b63,t,21051,1105689,,5000093,2018-01-30 14:04:33,49
0x5452dc403dfb4c1908e38eba4de77d2d5b9949b7a25ec8b2c2fcb9cf82e8f585,t,21000,1126689,,5000093,2018-01-30 14:04:33,50
0xb423c1dd5d0de1d595edc7c26a4a975682fcbb14bae07eea41701cc7cdba87c2,t,21000,1147689,,5000093,2018-01-30 14:04:33,51
0x16afbd82f859f3d06bd809d80594475b2f441a2c78dc558e2b478bc8e5d0961b,t,21000,1168689,,5000093,2018-01-30 14:04:33,52
0x59bb62250b25073e5c1477dc6344fa71010b80033470b4c65163684d9199669d,t,21000,1189689,,5000093,2018-01-30 14:04:33,53
0x5d00b4c3e19e36ae049aac97d48d15d20540a925873fc004b9967e48593f4378,t,21000,1210689,,5000093,2018-01-30 14:04:33,54
0x6e16f725aa2b8f8d8f58bfe91451ae57526263d6e4238e7c48b3850945f40fed,t,21051,1231740,,5000093,2018-01-30 14:04:33,55
0x02e1eaac314a2f7d80652bd504c69effb2e89db174aed05df3b439190a2cda3b,t,21000,1252740,,5000093,2018-01-30 14:04:33,56
0x64248e717c50bee1ee7660adb4dd222147ca0c173da0885b22d997cc1fe27de4,t,21000,1273740,,5000093,2018-01-30 14:04:33,57
0xc7707f56e25e13800bf581190b9fe183e0250a8cc9cb4f8008d805904a674782,t,21000,1294740,,5000093,2018-01-30 14:04:33,58
0x05a12fa87abe94a5d20cda7e0406f5b87afa7639572ac0c34425bd7a1f911d25,t,21000,1315740,,5000093,2018-01-30 14:04:33,59
0x200231898e40c42c769b399d06f3d3694f63556747135929f2e5a110a1d3bed8,t,21000,1336740,,5000093,2018-01-30 14:04:33,60
0xa44fec8bff44588b625f20265a592ae793265272b772358eb2c6e2358ee37610,t,21000,1357740,,5000093,2018-01-30 14:04:33,61
0x8fcf943f8991761b62bd3342df407a9f4dcf1e027339772eb1114a40214d773e,t,36922,1394662,,5000093,2018-01-30 14:04:33,62
0xe36b5489126707829f8d8d74ef9e53535d80c52a5de0452bd35721a12689d028,t,21000,1415662,,5000093,2018-01-30 14:04:33,63
0xfb8d3b4167b709e92c52ff1dec9475f98d90e0d22ca140838c1e847e12cc5434,t,21000,1436662,,5000093,2018-01-30 14:04:33,64
0x2df9ef738415a1397001737d20614525d83fab3031933683ecec14de0af56cd3,t,21000,1457662,,5000093,2018-01-30 14:04:33,65
0x59c3c53c1434fd085a2b9b6ec385bfb5145089f1a226259ccc09deb9a2ce6213,t,21000,1478662,,5000093,2018-01-30 14:04:33,66
0x813a4013e1adbeda202d012ea6ab0706549951bcc4a3f042b4cb3e126f05c459,t,21000,1499662,,5000093,2018-01-30 14:04:33,67
0x5a0fa0e40f9ce8875555f6e343d60d61241bfb609e7e3ae90b94b7b14778596b,t,21000,1520662,,5000093,2018-01-30 14:04:33,68
0x4261853d9e05d9b211742463005b3975a81ee981d512609cf0be1ac3bc9a46e7,t,21000,1541662,,5000093,2018-01-30 14:04:33,69
0x754e8ea61fe0ec19c60041ff34c01599a5d8bd9d2c73612ed35c8d9b3e52eaf6,t,39512,1581174,,5000093,2018-01-30 14:04:33,70
0x509deaf0ff0d36d20bf4939884809735c38b51ced8fe300b0d7c3738b3842cb5,t,21000,1602174,,5000093,2018-01-30 14:04:33,71
0xe529928ffd6bd6998c20f05208bce4d11bea543aa3992f2751eb200e38aab596,t,21000,1623174,,5000093,2018-01-30 14:04:33,72
0x72b520afd90ea1a0d6b1e203fb301c1b744f0054f3a4813520691d54806cc14e,t,21000,1644174,,5000093,2018-01-30 14:04:33,73
0xbf79a5cf3d12df20854d5fce0d3cdddf35e5572e6192d0c525258fc6feab1288,t,21000,1665174,,5000093,2018-01-30 14:04:33,74
0xaae200f214eee01194ef104ad71c61e1f79a5eb5aa69edb965afe3e378727d7c,t,21000,1686174,,5000093,2018-01-30 14:04:33,75
0x2146233d2c01d351d34aec7f2aa2ec7726ae2795c2a27676b4181b2193ff2932,t,21000,1707174,,5000093,2018-01-30 14:04:33,76
0x8dd6f729f5b57f881e7766c77904525ff0db25d628d74c9ace6ee0614cb52a06,t,21000,1728174,,5000093,2018-01-30 14:04:33,77
0x1f8927b1dfd7aa9c4dd81cc9149198660f117490c1e0584fb3bf8b08e5e96f06,t,21000,1749174,,5000093,2018-01-30 14:04:33,78
0x68ea386ce68346c0de0f81b3143954bff47ed5bf27d26a76a84af7fbd6d191b3,t,31005,1780179,,5000093,2018-01-30 14:04:33,79
0x93c43282affe106fbee55a8fa02acdc5ade80e3923e96ce5d7ab8b41da85163f,t,21000,1801179,,5000093,2018-01-30 14:04:33,80
0xc9d56ccbd706e7c37cb63154b20c58bef99f3c0ad597f05ca04a6209b0a1995b,t,21000,1822179,,5000093,2018-01-30 14:04:33,81
0xc2513eea6dfb18f2bf0dc210c2d1d4664ed2a78a9faef327bca8c4e4a3c50a52,t,21000,1843179,,5000093,2018-01-30 14:04:33,82
0xd99b021aaee395b6e0a1d3aaaedee20ffc95aeaff6e89f2e60047d707ffdf3c7,t,21000,1864179,,5000093,2018-01-30 14:04:33,83
0x616702364514b9579a3f44b17121f502b14a59855ea9fc5bc0b14eb31c0db2a2,t,21000,1885179,,5000093,2018-01-30 14:04:33,84
0xc045229859dcb621d01348a227d6264e6de9a1564857d803fc889929c08df2eb,t,21000,1906179,,5000093,2018-01-30 14:04:33,85
0x9c517c0fb01f1ff7d008bd6d021fc86a571baaf399b24fa9e2fe382f3d52e6e3,t,21000,1927179,,5000093,2018-01-30 14:04:33,86
0xf5356b97df8eb6a08342f2cc8f3302556d76acab0e3a2477a75fd8cf494d9aab,t,21000,1948179,,5000093,2018-01-30 14:04:33,87
0x0d16ca41600d173902e24350378364f0e63947dff035ccbeb16e394b691932e0,t,21000,1969179,,5000093,2018-01-30 14:04:33,88
0xf1a686ca3f4e85cc937adcaa684808a845c16e37200111b0489c9eedca3f7761,t,21000,1990179,,5000093,2018-01-30 14:04:33,89
0x6c0d6c3cd5ca2dad68e1a6d26735d994e3dd596aa5be58ede584b49ab876272a,t,21000,2011179,,5000093,2018-01-30 14:04:33,90
0x68315caa765a9086a2d80fada429c85893667b93690447f4243d6dd4757f8549,t,21000,2032179,,5000093,2018-01-30 14:04:33,91
0x6d07173859a9715737318c9a58d474de039eac9306681d07d2ee08036cfa7439,t,21000,2053179,,5000093,2018-01-30 14:04:33,92
0xa83dd5faa9bebd509220cc89f6a2ff57bdc7b3ddeec6cc2177d63090f694d375,t,21000,2074179,,5000093,2018-01-30 14:04:33,93
0x2e86b823390c538e50a163171ab4bbac10e0015feaa0c352a411de1529e1844b,t,21000,2095179,,5000093,2018-01-30 14:04:33,94
0x7ab04675e71f764f04c7ee37595501600c69a2e2375bfc99e92b259508b9a548,t,21000,2116179,,5000093,2018-01-30 14:04:33,95
0xe389fd943779a3022c7be901b3ec2675bba850dbd1428f48aba9280ceeee6f64,t,21000,2137179,,5000093,2018-01-30 14:04:33,96
0xf62477dd4a78dba6163a3cc4dd63ffa182f541bde8771eafbe54cc3c6e2cc117,t,21000,2158179,,5000093,2018-01-30 14:04:33,97
0xf3cf0311289f2c2c0d8dc52954d7cbc52dc86f4625b53455c1ecbb882e91f292,t,52158,2210337,,5000093,2018-01-30 14:04:33,98
0xca296294e65908cdb9704f388e396e4d5a906865f298f92649724bb3ccaa0feb,t,21000,2231337,,5000093,2018-01-30 14:04:33,99
0x9d2b7401cfabf1ba96a1c994659b5f2732952c2ee4ee34d1019db885197f2b43,t,21000,2252337,,5000093,2018-01-30 14:04:33,100
0xf9cb10b5f42e8bbdea93aba11d271e499f0036117be5cdbc06fb412d86e44a12,t,21000,2273337,,5000093,2018-01-30 14:04:33,101
0x4faa35ad7914d471e32c93ebbb17e3cc1c8beb3e251fed18c0857db67f9049c6,t,37751,2311088,,5000093,2018-01-30 14:04:33,102
0x0a34fab7be38d5cf2e3088e84201bb34608037bb06e103f61eafee1b41b11c9a,t,21000,2332088,,5000093,2018-01-30 14:04:33,103
0xc7ddd1ab74ca4d9198dd3c0f021b92734973307038fe1edbbca377ec82f7a926,t,21000,2353088,,5000093,2018-01-30 14:04:33,104
0xb26b165f7722cf85ce9cf801733adf84481986db3f3debe638c678c0d499efe3,t,52091,2405179,,5000093,2018-01-30 14:04:33,105
0xb81b1df9d284621bb783d164062d9cf963ffc571dddfc2f60fd78727c21c1f45,t,31005,2436184,,5000093,2018-01-30 14:04:33,106
0x2a65ff66da26651b81aeda1c6f349ac257c4482709497cbff173e9ce29787436,t,21000,2457184,,5000093,2018-01-30 14:04:33,107
0xe0085d5726bf0dcaa4884fe11841c5eabea5f9af3102e41e383ca886a1676cf9,t,21000,2478184,,5000093,2018-01-30 14:04:33,108
0x1aaeba8c5d46284bf2b512e99b238d48e677c18531c24dcc2b5a3855dcad707a,t,54267,2532451,,5000093,2018-01-30 14:04:33,109
0x4e779fec29706cd650cfb61e592cfdeb22b01577d2702d317ebfd15ec689e689,t,21000,2553451,,5000093,2018-01-30 14:04:33,110
0x794e998eea30e2f83e6f4455d4d7d8006550b1323d073499176abe8a202be6a5,t,21000,2574451,,5000093,2018-01-30 14:04:33,111
0x5b136a235fcb632fa8debd4879169d525031685da8c58c5a5bf7827438a13404,t,21000,2595451,,5000093,2018-01-30 14:04:33,112
0x0158ffb113a7a778220f7e0ff7b42846599ce66a49fda523e0f060042f4a0252,t,21000,2616451,,5000093,2018-01-30 14:04:33,113
0x02481f8c580b81b79dc5c88032cf8a147148b85c69ee5c17b196c85349fab8e1,t,21000,2637451,,5000093,2018-01-30 14:04:33,114
0xf6cec4dd3eb8e59af48436c182dc6a0b3a2bb96bec758f13f18008d783ef51c3,t,21000,2658451,,5000093,2018-01-30 14:04:33,115
0x5a87b80f8c038bf3882d42b3024d07e528af72f267391f553f710cbe56c7443f,t,21000,2679451,,5000093,2018-01-30 14:04:33,116
0x0595092ae0098c905d4e9fb403b29e4aae5be61c7525dd59b2f5b2565df38ee9,t,21000,2700451,,5000093,2018-01-30 14:04:33,117
0xdf4e3c9acfa21b871d37877c23f30b0657e8284c11eee061c0c51a1909124a00,t,21000,2721451,,5000093,2018-01-30 14:04:33,118
0x375595da853af450e4d34f5f4deff52049f32e7c87911a110b4a3f083b9f9004,t,21000,2742451,,5000093,2018-01-30 14:04:33,119
0x639774f3c4b6d3f95aa8fe4c42d7c1082f957eb83eb592822c79a8170aeaf140,t,21000,2763451,,5000093,2018-01-30 14:04:33,120
0x5f684e64750637d616cdd3eb825bbf4e7e2cb90834adb59fa77d77bcf8cc9f9b,t,21000,2784451,,5000093,2018-01-30 14:04:33,121
0x070dcb7510aef90a103ec3d70ca549dc5bca83c20aeb236f5f91c3cbcd8b8a02,t,21000,2805451,,5000093,2018-01-30 14:04:33,122
0x881b34401be120072eb42890b0423bae91f2ff5042afcc72345afe6a75fc6155,t,21000,2826451,,5000093,2018-01-30 14:04:33,123
0xff556e800b5e91ee8f069a84caebdf5be7088db8620e609b70dd3c7612e68e7d,f,51406,2877857,,5000093,2018-01-30 14:04:33,124
0xb951735289c4be915cc09fe2359f3e22f3f6bb2b97ab3a32ac3590a0c09997a2,t,21000,2898857,,5000093,2018-01-30 14:04:33,125
0xa96c2f0255af5d0fc4e51675d8f98cd888ee3cb778c15319f7459e838576d0c6,t,21000,2919857,,5000093,2018-01-30 14:04:33,126
0xc5dc123efea03fe4ae8d72f97d475ad03d95012db3d2fd62ba61630bf7170a0a,t,21000,2940857,,5000093,2018-01-30 14:04:33,127
0x81b7068c05f52ef1732c16ca06663b56b6f684cb35a95d1afc365da51d64e9d1,t,21000,2961857,,5000093,2018-01-30 14:04:33,128
0x3c5b6f50fffc153fd761ce4f7efb5bfd3b30f81fc0c990781c90c4f24b8060b4,t,21051,2982908,,5000093,2018-01-30 14:04:33,129
0x69b9d1a32f889a735d40b6df0c3d68acb009150c845f25f3af0510b9a789c29c,t,21000,3003908,,5000093,2018-01-30 14:04:33,130
0xf7be66f94fe753a70be5cc1b5b201331873fcd75ded764044a6729768da96f65,t,21000,3024908,,5000093,2018-01-30 14:04:33,131
0xa9afca66a92ac9ba6c103f6bf1d287a373cea76f47beea4dfb67c7d36d6d3b74,t,48240,3073148,,5000093,2018-01-30 14:04:33,132
0xa2bf4a238ae9fa97f5c0e044d94e38e5f6867223a35e095e8f8b4d31207b7d28,t,21000,3094148,,5000093,2018-01-30 14:04:33,133
0x9e0b8d0bc80a54b451a62fe545d32c7c7724b3aa8e5a4d63bdcff41a23dc9032,t,21000,3115148,,5000093,2018-01-30 14:04:33,134
0x83517ff8566af3d98b83a29e438b88530f991b6e998f832adda44e0ba0730649,t,21000,3136148,,5000093,2018-01-30 14:04:33,135
0xfdc1b9fcd67abd2c56813e77f3ca4cfce1ec71e15d966f0011445cd48dfef64f,t,21000,3157148,,5000093,2018-01-30 14:04:33,136
0x66d22042caf1236cc1b3aa1a72b3bbc5d1a7bb01409d24ddc63a53a5d78567bf,t,21000,3178148,,5000093,2018-01-30 14:04:33,137
0xdf00cda1ef48aa0c8613b6b9b297828c2e7f7223aba17fc82e287731a77c1dd8,t,21000,3199148,,5000093,2018-01-30 14:04:33,138
0x67c3ba350db4518d32750329364c6f47967142b4afae1a703cd61b7fec7fd257,t,21000,3220148,,5000093,2018-01-30 14:04:33,139
0x38dc4c903a30d96dd649317094bde1a9408f3f14fc18abe2aeb22fab5f9065d4,t,21000,3241148,,5000093,2018-01-30 14:04:33,140
0x641847a63d158952cd7e6d8224f7456cee62bbb9ccffa509a40de57a72d12496,f,51605,3292753,,5000093,2018-01-30 14:04:33,141
0x35e357524755994895aebbde4c31bb75a6a9e0f70f92439cb01c8badb5289af9,t,21000,3313753,,5000093,2018-01-30 14:04:33,142
0xad9b80465649c5843581ebe69addad2f0e0514a7767a01b66abdaede023e3b81,t,21000,3334753,,5000093,2018-01-30 14:04:33,143
0xd46756bf66e29f4c8ae7f754df4c3923feb304993fb0902d67d15e330ac073b2,t,21000,3355753,,5000093,2018-01-30 14:04:33,144
0x1d8602aa4c283424ed2eaeea5e1c40415ef2a3e9179b5fa8210bec31c75fc79c,t,37441,3393194,,5000093,2018-01-30 14:04:33,145
0x6e481506fa99da1d28e725130e5ca6939af9865a85dac1bfd1c122b75ce42675,t,21000,3414194,,5000093,2018-01-30 14:04:33,146
0x4d128bf7bb72d425e4bbd49e251806102c2a93a9addeceee1e537b0b4cb72953,t,21000,3435194,,5000093,2018-01-30 14:04:33,147
0x1ef6d72bb041721e539450a1c0b3174701d396769d6a788d458359ab4e3bfa06,t,21000,3456194,,5000093,2018-01-30 14:04:33,148
0xecd68c2062871d716a5cdf148c396cbba24b8cd1b3b12f7370d1dba9cfa4bbf0,t,21000,3477194,,5000093,2018-01-30 14:04:33,149
0xa5bc2d1e7be76e062e3b30d4470798f0a3a0890ceab2f6ff465ca89332446507,t,21000,3498194,,5000093,2018-01-30 14:04:33,150
0x9f5462479ecfeae0dd3820bb389c73c91c3bb46c7a2f56822461d57840e66e9f,t,21000,3519194,,5000093,2018-01-30 14:04:33,151
0x4b84941c6b76e9e3879e4c438b33c4cac675f622d8976a38374db1179bfe6fd0,t,22191,3541385,,5000093,2018-01-30 14:04:33,152
0x3aa4a21e05dd90ada90e022c2795626c04f660444ac5ab4ee439e5fd22e2aa63,t,21000,3562385,,5000093,2018-01-30 14:04:33,153
0x0589d5beb88bfd1d2ae60ae0d67d0b2392334ad3f61254d1e8f5e40b6bb595d2,t,21000,3583385,,5000093,2018-01-30 14:04:33,154
0xda8720a37d13ba6989fe54bb2855f7e211ceed539f5f5efd57e599afc8d6c76a,t,21000,3604385,,5000093,2018-01-30 14:04:33,155
0x75b61d5dadd7432c85a7d92a9fd2ad54606eee39993135b3eb89ba98ba78d386,t,21000,3625385,,5000093,2018-01-30 14:04:33,156
0xa33600214a3d2a52ecb016da50f6b12c8bf61ac1fb578acbb649a47267d4d7c8,t,21000,3646385,,5000093,2018-01-30 14:04:33,157
0xf2469394feba8e24ed2dbe70e184f67710fe691cd703b9f2722863d812164827,f,50000,3696385,,5000093,2018-01-30 14:04:33,158
0xbf2d7fb1439a111ed5c42f917f78105243a3663b7525c51d05ff578143214aef,t,21000,3717385,,5000093,2018-01-30 14:04:33,159
0x05a3f7fd22ef8e1819b8f46eb5468e13a12b160cefa36a1a3bbcd8eea7cec143,t,63172,3780557,,5000093,2018-01-30 14:04:33,160
0x21e30d391c66d88dfc23d4615db8979d85c978b4ad32018be561850b83e7e956,t,37440,3817997,,5000093,2018-01-30 14:04:33,161
0xe97e76b70d701b390649eec86b08cca6cd1a7225da979896d02c2bc342646c45,t,21000,3838997,,5000093,2018-01-30 14:04:33,162
0x1b8bd32625f124090f7c848bb620ff3c5e76fb0934925a744caa8b52b4322bd2,t,21000,3859997,,5000093,2018-01-30 14:04:33,163
0xa05299c0035fb35eaad2bac4134dff4ed3aa1bfb59787488e7412a91c782da6e,t,21000,3880997,,5000093,2018-01-30 14:04:33,164
0xa52f9bddc3ae04a3f95343f9088b5d7795c4cfc05c5aa2314052e7fd08d6faaa,t,21000,3901997,,5000093,2018-01-30 14:04:33,165
0x9ac88fe5491c78fc9cf9cb4b08d11b665a640c85ab33502b0d3796c888d74c03,t,21000,3922997,,5000093,2018-01-30 14:04:33,166
0xf24043f44a52e3d8b38a0cb17085a1942854d3b7db67093518affc7628c16db5,t,21000,3943997,,5000093,2018-01-30 14:04:33,167
0xca9958abb80eaf61faf65278dd1695c7e6df425fbdfbe1bde43b27987b9d0664,t,21000,3964997,,5000093,2018-01-30 14:04:33,168
0xa3c2efb81843710a8f0f975ad9fafdd776dfca8ee8615d3161e257c06010ab8d,t,21000,3985997,,5000093,2018-01-30 14:04:33,169
0x07564091887fd70e7140c38b4ac652ef3b49d0ca1519ceb68f63cb18015a9ff5,t,31637,4017634,,5000093,2018-01-30 14:04:33,170
0xfd8a87635a603215b2168a83582d6c8d18740843288217c1f20e1fbde906af68,t,40843,4058477,,5000093,2018-01-30 14:04:33,171
0xb7074eb37be4c5a7622db80504eb3c3b14ece0e3e0a26a12a95dce5748404231,t,21000,4079477,,5000093,2018-01-30 14:04:33,172
0x4bd0f9b1c62b763dce21ad04c2fb057d870828287901c9070015e0c12d4a47da,t,21000,4100477,,5000093,2018-01-30 14:04:33,173
0xd98453963fca3ec5c1f197e729ece9c6802fdd6e247f5a82fee83d01fdd02042,t,21000,4121477,,5000093,2018-01-30 14:04:33,174
0x03d212d93b02c98ee22a89157084e3c9b96c940458d9b9c6139c09326b13890c,t,21000,4142477,,5000093,2018-01-30 14:04:33,175
0xe0a438f21be5a61158ec0b8d02981abb64d74d6ebcd4676caff1c38ff1b6673a,t,21000,4163477,,5000093,2018-01-30 14:04:33,176
0xc61c2be954d3a5ef799b3a180c74c81cea1cd9132761f1205495a5a7fc1307a3,t,53690,4217167,,5000093,2018-01-30 14:04:33,177
0x17270310024f6fe514d4d9b58cd39dc372403e347d6ecbf6a3c8825fbb052e5e,t,21000,4238167,,5000093,2018-01-30 14:04:33,178
0xe4ca3d270692c85910436c32d58bb80c975f57ea179a52a74ba3162a4ba4cba4,t,21000,4259167,,5000093,2018-01-30 14:04:33,179
0x6ce423d71d2b3d621154a47d99c9edec537e440d1c39a198d2888bd4127cf3d3,t,21000,4280167,,5000093,2018-01-30 14:04:33,180
0xb906214f9739cd74d7be3b2cbb2778710224938d7229236482309b0e276fcecc,t,21000,4301167,,5000093,2018-01-30 14:04:33,181
0x3b1dfe50e0462fac957541e271f26e9d5034545617d3c99f4e25fd69dbbd8c5f,t,21000,4322167,,5000093,2018-01-30 14:04:33,182
0x8347551e808ffb13aeffa076822ae123fa072d6d177f98d45093d17d25568289,t,21000,4343167,,5000093,2018-01-30 14:04:33,183
0x8be1bcd64ea28986cadde1c49786570bbba6693fac74ee7bab93f1a2b8a2888d,t,21000,4364167,,5000093,2018-01-30 14:04:33,184
0x271f0509bf72fd2614e937d7c797ada8bb55df0496a3c33e6a74dfd93db0c205,t,63139,4427306,,5000093,2018-01-30 14:04:33,185
0xa0580e3b16ff295fbe3f9bee65b276aa6816cd24c00786406af39c95369af38e,t,21000,4448306,,5000093,2018-01-30 14:04:33,186
0xe105ae450fc60231ef196416ca51e99abc65214c7c89caa0d679d21028dfe83d,t,21000,4469306,,5000093,2018-01-30 14:04:33,187
0x4c4d6555fcbf8933f3bc7b0ab7dd52ec246eedd43675781ab859f359f1de63a7,t,21000,4490306,,5000093,2018-01-30 14:04:33,188
0x66c59a4b21e39ff5b778871add5c6ef3481821cab9c2d9b673ade51776b9fd53,t,136330,4626636,,5000093,2018-01-30 14:04:33,189
0x7ea1028c9450b88efa95fffc8304350ab4b8084505b85212178dcb5f1e1f529e,t,21000,4647636,,5000093,2018-01-30 14:04:33,190
0xd3c7be938afd8ae1570b818be8b567946a86a0cdb55fd19afd8b90023fe60a22,t,21000,4668636,,5000093,2018-01-30 14:04:33,191
0x150f5321331aa423e3e27794e467d2ed58c7907fa676478d6e9b950c33836d8a,t,313061,4981697,,5000093,2018-01-30 14:04:33,192
0xec79b9e2aecdf6654dfc25e7d6583fe050131521e8f06ef97abdbd29fd36dd3e,t,44643,5026340,,5000093,2018-01-30 14:04:33,193
0x96fc1fc706613ba10cbf0c448e00671a62abf8e9906f56679d3355e5f03f31e3,t,21000,5047340,,5000093,2018-01-30 14:04:33,194
0x16df98b39e8098b8be7aafb5e8e8c0a15be259f6da7b1b6de9f56d9c2e392a38,t,21000,5068340,,5000093,2018-01-30 14:04:33,195
0x040d609673da56a54c56804a2320022e27b3071f957fac0612e6c4b5766fe719,t,21000,5089340,,5000093,2018-01-30 14:04:33,196
0x616bfd9a18b2a1df7d414d75152f0f3c411437a46bcc02cbee98a916be7b5252,t,21000,5110340,,5000093,2018-01-30 14:04:33,197
0x783887db197014db4dd229bb477fb920e077c38957a4621bfef8c5f6da4d70a9,t,52884,5163224,,5000093,2018-01-30 14:04:33,198
0x67a0a9b5c718e35fff958941af7bb640e17a72a3e4bfc71a399a4e2fd5376cde,t,31951,5195175,,5000093,2018-01-30 14:04:33,199
0x1637cc2ffdb3175452c1fa2a25c265e37aed6b7080393a8952b7310cb2cd9a92,t,47623,5242798,,5000093,2018-01-30 14:04:33,200
0x2a4b08c0829dc6b6a78359a3130b93f34bcc2de116667da1c6642980911b0a3a,t,21000,5263798,,5000093,2018-01-30 14:04:33,201
0x2424a148073b24ebb2895615869a17b09714b41a3f615e6c845f3fcadc723dd8,t,51712,5315510,,5000093,2018-01-30 14:04:33,202
0xc0ad27f794627c9ccebf3a8b98c02e5466f974ed4c48f6ccc88d821836e9d311,t,21000,5336510,,5000093,2018-01-30 14:04:33,203
0xa1f12dff0e07e35b742ca9f54c314eb966a020a7e12adafe206fcc6d6ca0f901,t,38254,5374764,,5000093,2018-01-30 14:04:33,204
0xf65569ae46df96d94f15777e132b7f13ac96a9ee4458a4a622e83294010fef20,t,21000,5395764,,5000093,2018-01-30 14:04:33,205
0x54af654342d14b29aedb36c10da353b13c91386dac2c0bbfa2bf4987d39f7683,t,36886,5432650,,5000093,2018-01-30 14:04:33,206
0xa625737005720cdfe861814fb947a3367f316bf8567719798269b2de844cf096,t,21000,5453650,,5000093,2018-01-30 14:04:33,207
0xf1da5fb191d845589245633c3bb9fc4412addb1e58aa20ab5485f76029a7cc18,t,21000,5474650,,5000093,2018-01-30 14:04:33,208
0x9de26b7543b016b9906e0a78fbf5578071739c2e313b61feef27bc75b1220d29,t,21000,5495650,,5000093,2018-01-30 14:04:33,209
0xef79f65583d2f21b17f7d62cb85abd55e21ee16afad426d6ff08782d27a325d4,f,35000,5530650,,5000093,2018-01-30 14:04:33,210
0x804f707a5e3b45a99bb8d898b11230013bf80776c6c01c5d122d70aa69a1ab8b,t,21000,5551650,,5000093,2018-01-30 14:04:33,211
0xb12f3fadf1bf313f43a2fee9651dc753a419764fe96dad153a198a9ddf3abf71,t,21000,5572650,,5000093,2018-01-30 14:04:33,212
0x6f6bf367b5407aca70ad0f1a9657b9c8ba9563c65e8f9a4203d24029c9455c8d,t,21000,5593650,,5000093,2018-01-30 14:04:33,213
0x9db641de3e01d014396718ff6c7c0db7c25cc38a8686f1bc8ea220c4d65ba86b,t,21000,5614650,,5000093,2018-01-30 14:04:33,214
0xecbb600e31d778ad2d65f09cc8658ebd0ba6030ed0dc2d2a7bd6fe8f08f11002,t,21000,5635650,,5000093,2018-01-30 14:04:33,215
0x653e14d0dd0b153338c1eed95fe3e2e648c0bbb92ce54b994389253b1f06908d,t,21000,5656650,,5000093,2018-01-30 14:04:33,216
0x842ec6da1f0752a3a5e049c0986ce6c0c63a1727870ce57b415d62b46e13dcf3,t,21000,5677650,,5000093,2018-01-30 14:04:33,217
0x62cc2136e95ba79ec9a5469a0397a647e815fb39418b520a8e10504f0d814533,t,21000,5698650,,5000093,2018-01-30 14:04:33,218
0xf8283f0309b85200677406b69a5c46e791d4b52842390f99a0fd93ba7dbe8af5,t,21000,5719650,,5000093,2018-01-30 14:04:33,219
0xb9cde7e5592d9109d27f511abbfef0d1479b4ffbe3c35bf8667fe572d35fe42e,t,21000,5740650,,5000093,2018-01-30 14:04:33,220
0xaf39e114b97aee1f2c66ce0cd014f40db65e5b9c10ae2c1fe6e94d42edac8f9c,t,38111,5778761,,5000093,2018-01-30 14:04:33,221
0x3397214b4ba8cf2bae4f1b5684d83b08172e1de9ae5d0bcf9ef9bfc162ca425b,t,21000,5799761,,5000093,2018-01-30 14:04:33,222
0x00ad8dd8780814920ba7d46eb79ef9e58e5b5852c1e2a8fc4112cdcf24631499,t,21000,5820761,,5000093,2018-01-30 14:04:33,223
0xe8937f225f72674771fc1a70fb81ed06618ef04b11e5856b52b25558d1af4d51,t,21000,5841761,,5000093,2018-01-30 14:04:33,224
0xc9f6b161c374759068ebe4ec96c2ddd8cb5a3f41583c954ef67e01451e16ff60,t,21000,5862761,,5000093,2018-01-30 14:04:33,225
0x781dd5660d41b846866c78ed5c8b9b182837e71ba081d53e88db1997d765e1a6,t,21000,5883761,,5000093,2018-01-30 14:04:33,226
0x5179c7a40d7e9c0c7e15a8d7e024ed9cd0c623b3f077e120fff58d3203339a13,t,21654,5905415,,5000093,2018-01-30 14:04:33,227
0x92371c3ec5edd759ef03ce51f9c1e46ed37266ec1f7af5641fe076159c97b449,t,21654,5927069,,5000093,2018-01-30 14:04:33,228
0x2fccd538c19b8e10b45984f5566e8008bf7f3071f0bebe1ff8003d6fd5f72f01,t,24574,5951643,,5000093,2018-01-30 14:04:33,229
0x858d128d71fba9b937cad75bf6b6b037d84862f8bc2cdb7df8c5a0435767e0eb,t,21000,5972643,,5000093,2018-01-30 14:04:33,230
0x7a82d5f55911e69f2b78b95e5ad92fd28ba0cb031e3a09b364680cf3d8bcd89d,t,21000,5993643,,5000093,2018-01-30 14:04:33,231
0x8306d7c5ccc1d0a0bfbd413e62a2607799dd574bbf8b0c79b1fe9d4c8280b1d2,t,21000,6014643,,5000093,2018-01-30 14:04:33,232
0xa34064091097a33e06e6111a78a7aac3a8906ff34a7d54c6686e84cd0c5d7187,t,21807,6036450,,5000093,2018-01-30 14:04:33,233
0x63aa2685195c50d143b3217ebd8bd13f80ba7c5cafe8d2ada16fa1ccfce449e7,t,64725,6101175,,5000093,2018-01-30 14:04:33,234
0x57226d62fcea908f743565d8d31f6c8dda94d6f391b73960d5795dd8892a20ae,t,21000,6122175,,5000093,2018-01-30 14:04:33,235
0xca7da1a6a246479ea97d41ac76ccd683f3d5795e90c08bdf2ba4deae97da1ea4,t,21000,6143175,,5000093,2018-01-30 14:04:33,236
0x41993f3c88f7358910d4d83022ae66b9d09cf8cc92a8365e9de43683bc9d4142,t,21000,6164175,,5000093,2018-01-30 14:04:33,237
0xf15df0dccf5cc6052b7586a9789b99773c80487ab7ba5f364c9d9a028696f219,t,21000,6185175,,5000093,2018-01-30 14:04:33,238
0xa594af36c4bd39724c22bd5b6f7f190b60879977f58f3ed6610e36cf063a6e60,t,21000,6206175,,5000093,2018-01-30 14:04:33,239
0xd8d01f19d5c9a079c496d4b4f17e3433d16589a457a0e5577bde051a83c21660,t,21000,6227175,,5000093,2018-01-30 14:04:33,240
0x3abad1cbadb29e54ae75caf12e757354bfa5794aa378d454fd0d3bc8cac218fa,t,21000,6248175,,5000093,2018-01-30 14:04:33,241
0x897a0e7cadfec3e25446df8a65433e122da6a27357ed5842d23929cd076e707e,t,21000,6269175,,5000093,2018-01-30 14:04:33,242
0xb1dbd2007de098662c56bccd904fb1ea97708e23e5363dd8723b4c16e47bbe86,t,21000,6290175,,5000093,2018-01-30 14:04:33,243
0x37a649c1cf9f7557550817e1a410104b87d7f94605699547a3733bd97194ed9d,t,21000,6311175,,5000093,2018-01-30 14:04:33,244
0xb5705f6fcb54968e12119a032bf5d99f1488d3364e29acf7202740e80e44347f,t,21000,6332175,,5000093,2018-01-30 14:04:33,245
0x57f77c783d6c9bbebca6b005de72d70cf35f287352ae2a1a931fc004fe82f2f5,t,21000,6353175,,5000093,2018-01-30 14:04:33,246
0x23be0d5d9a20ae91e2d49df589f52aef2384de8c0be836e8e70c79ea35e3cb64,t,21000,6374175,,5000093,2018-01-30 14:04:33,247
0xe88e786cb89e050509b58b0bf9d93ddc968ac756f06d83dc38c8dda2b976f20d,t,21000,6395175,,5000093,2018-01-30 14:04:33,248
0x3ac0a5516821e707d10c29a13d7b8e53a0e744cb0649038fd1247ffc50d930bb,t,21000,6416175,,5000093,2018-01-30 14:04:33,249
0xf69b8a0242f9e53cf523238eddab099d522ee10f451ee3e9e30a244befd5f51b,t,21000,6437175,,5000093,2018-01-30 14:04:33,250
0x0afded4e005995e9fbef6cce5805915fb02cfb4b21726f94933e9e1185f71d1d,t,21000,6458175,,5000093,2018-01-30 14:04:33,251
0x360e721d63371395f5d56d7c8c7f949a31b22baf9f5ec8ffe8845d888890c11d,t,21831,6480006,,5000093,2018-01-30 14:04:33,252
0xb4b99d727a9c26cbdbcaf7b7c23f33923a5a6e8edb8ad826472c3f916ff7cca4,t,21000,6501006,,5000093,2018-01-30 14:04:33,253
0xc69ae762dc322a75e09c02e94d2f45bea4147f0b9c2569a494540afadf7fa364,t,21000,6522006,,5000093,2018-01-30 14:04:33,254
0x41259c12bbc742a328e503e0b8b2de69caeccc53cd2871a457ff931ee9ddd539,t,21000,6543006,,5000093,2018-01-30 14:04:33,255
0x4241125869d961101f205bea8c921068b82f9ffe44174969ba471ba96e035fd4,t,21000,6564006,,5000093,2018-01-30 14:04:33,256
0x3530016bee458f041e932d68529b5596739400f83aee25fffedf945490d7da87,t,21000,6585006,,5000093,2018-01-30 14:04:33,257
0x1b19baf4a9e4a0b5285c9cf523d44a17e81d1c053939a4e5690ef3b17e705c5a,t,37148,6622154,,5000093,2018-01-30 14:04:33,258
0x0016acfcd407da2b42830c5806d0ab0bf42425f3154f211f04a2aeababd565bb,t,21000,6643154,,5000093,2018-01-30 14:04:33,259
0x72c02ea83f348aafae452695a49df194ed8759040cbc043e20be8384c6dd4c33,t,21000,6664154,,5000093,2018-01-30 14:04:33,260
0x5079dec42e188b2cace1f458cc7521bec4728590da5839f330da536b846f0420,t,21000,6685154,,5000093,2018-01-30 14:04:33,261
0x2d34072a6196908feff73933a9a3766d5bd79d084bf4fc07975461da68e99cbc,t,21000,6706154,,5000093,2018-01-30 14:04:33,262
0xe12d50478b5f8950bb24cb40c543872cc81a24cf4f2748931fa6f5c8c2bea041,t,21000,6727154,,5000093,2018-01-30 14:04:33,263
0x628204292990cbb8cbcd7859a634f55e95e2f2508ceb3658e8328ef0e3e74646,t,21000,6748154,,5000093,2018-01-30 14:04:33,264
0x4bb339c7d821e8c86f4532e5a3e2ce0a7b0a6b0622072f942358c39153924c61,t,25779,6773933,,5000093,2018-01-30 14:04:33,265
0xb9c350dc0e793de42e6bb7a543ff1918d1a75a1fffeb3abe8dd09c0e62a86d35,t,21000,6794933,,5000093,2018-01-30 14:04:33,266
0xeccef27efe491efdf4ca1d56564685c111250c0596bf65e933ab9f13a2d03c3a,t,21000,6815933,,5000093,2018-01-30 14:04:33,267
0xfea61665ef40a8cdfed5bde80a0445cfda8c6afac71056616ce95e3c3e5f4c6d,t,21000,6836933,,5000093,2018-01-30 14:04:33,268
0x6f390f634be5f7252decb5a47ee97ba115f662ad53d655e61f8625c616992783,t,52257,6889190,,5000093,2018-01-30 14:04:33,269
0xd3723fc365c449542a9c9bf3df09630e07fc4a40f308618bc0bf3639f741d7bc,t,104678,6993868,,5000093,2018-01-30 14:04:33,270
0x8d02ec3fee7f236219a2b6e0c1ae86495a0079894a9cf1f9171d88b400a6d3e4,t,21000,7014868,,5000093,2018-01-30 14:04:33,271
0xb6fc8f278fe2cb8c454c82bfcc59775c2dfa67e0fc336e07707f28e778b7d44f,t,174178,7189046,,5000093,2018-01-30 14:04:33,272
0x48d6827b32f6aeabcf120671740405c55c5b645ebbe6f300c598e3a0ca9f2006,t,40907,7229953,,5000093,2018-01-30 14:04:33,273
0x872d9728afc38c1a50ec149aa15a9d00b644a5c9d4cd108ff85e013161652fa7,t,21000,7250953,,5000093,2018-01-30 14:04:33,274
0xab1e62996541db15be141aa40c0134234a9fc2b21de63ec585a4f00115b960a1,t,21000,7271953,,5000093,2018-01-30 14:04:33,275
0x031916df0750d2a3c4312376f3db33a8aac6d1fa9671da7cf1976f1d3a6bb263,t,21004,7292957,,5000093,2018-01-30 14:04:33,276
0x52dd39818db1ad7cef5f5f5ce839f305b639bf02e30022fcd7cb57b023ec4851,t,21000,7313957,,5000093,2018-01-30 14:04:33,277
0x447d33502f18d4562eda69044d3b99625d4c08d9fdde67cdce75520ed6ea6c71,t,40797,7354754,,5000093,2018-01-30 14:04:33,278
0xf980d6c09235bca870ab922bfcc294e4a4959e615b64d4ed2bb51ffb8ddf0fc2,t,40733,7395487,,5000093,2018-01-30 14:04:33,279
0x3f2caee0634cc07c9d0e86fe007655f2c06ef06553206d0a8af79e109e368241,t,40797,7436284,,5000093,2018-01-30 14:04:33,280
0x89dba9b345f2d41abd468c40298320479988228a64d449bc65f7d82d984a928b,t,40733,7477017,,5000093,2018-01-30 14:04:33,281
0xed2b03334c3dd583b0eff1858293f82eb53120b644708a741f3fbbead0cd1e1e,t,40797,7517814,,5000093,2018-01-30 14:04:33,282
0x9af029b330fd5cfb1e05db16706c9f5575aeb5c47975bb42bd9667f5040265b1,t,40733,7558547,,5000093,2018-01-30 14:04:33,283
0xf5e1f3c64c2746ec0ffbd40ce33180e14970c4b07a944868e8d185d37109f936,t,40797,7599344,,5000093,2018-01-30 14:04:33,284
0xcdff9cd006b0a001afe5fcba743136f3d4d557771053f19e59a1aa583a3bc69f,t,40733,7640077,,5000093,2018-01-30 14:04:33,285
0x4dcf964552b23926dca4a358aed8c22fcd00c421f1fef3e110aabf225800eb91,t,40797,7680874,,5000093,2018-01-30 14:04:33,286
0x55c676255dbdb19445c4b64d9d4ecbfa7d287447041020a66d56b0d540bb2eb8,t,40733,7721607,,5000093,2018-01-30 14:04:33,287
0xd6aa24b5009a55564d09f33e2c3f0dda80428c2b477e28e97b6bf354f8d16b6b,t,40733,7762340,,5000093,2018-01-30 14:04:33,288
0x6b158297b939e6abe328cdafa0a07f87af2b46476d55aebb779542d98b4ef3c1,t,40797,7803137,,5000093,2018-01-30 14:04:33,289
0xc67a9c4db26b93c93a08add57b6ecfffcbe66cb03e4a06960727e9010077d835,t,40733,7843870,,5000093,2018-01-30 14:04:33,290
0xc0d8b061a781a13e9c2d429abcb43bfa80c3a793130439b97afbde172c1a5d98,t,21000,7864870,,5000093,2018-01-30 14:04:33,291
0x6c901be8e73eb471f57df65d419bb232550a249961e91e64fb56fefd7a0cc43d,t,21000,7885870,,5000093,2018-01-30 14:04:33,292
0x26c1269eaeb11d9ef40c0576709110b2e3953a8cc99aa6eac3a762b38058950c,t,21000,7906870,,5000093,2018-01-30 14:04:33,293
0x641a9f27050f2e640a2c441eb739eab0f969cb769fe19ae10adf240c726c1034,t,22142,7929012,,5000093,2018-01-30 14:04:33,294
0x2d488846c7e6f9aa28bd5eb560669c8c850f8bba8b61d7ef914c41d74fd8122a,t,21000,7950012,,5000093,2018-01-30 14:04:33,295
0x61f23879255fd6e0861f92b4957938bad6dede80f597df34eedb156ee5c08739,t,21000,7971012,,5000093,2018-01-30 14:04:33,296
0x0b7db842becee82b7286035ffca900cda323c86902670614e525714b16e53a38,t,21000,7992012,,5000093,2018-01-30 14:04:33,297
0xbc8164b397837dc8bbc0a5b4eb882e73a4b60b2bd01069172271330ae008a00a,t,21000,21000,,5000094,2018-01-30 14:04:51,0
0x3e7fcae032a46dc4b04648480d3be7021092ee3770831b3dbd3a0c2aef883e05,t,21000,42000,,5000094,2018-01-30 14:04:51,1
0x4930c2d3a96ca30ce2bbee82d2e6cbcf70794230e613c821ec241169b841002d,t,21000,63000,,5000094,2018-01-30 14:04:51,2
0xabf1fc0fc91a0072372b70bb94f03cd7da6dacda804133484f886e127b1a3672,t,21000,84000,,5000094,2018-01-30 14:04:51,3
0xd44e80792f3c034097055fd77b4c86b67ae8c29f50c22f53e83ed80c7c123672,t,21000,105000,,5000094,2018-01-30 14:04:51,4
0xd2e5d9899393814d007506ddb271a02a307b8fe11095ed7aa06541f73579fcb9,t,21000,126000,,5000094,2018-01-30 14:04:51,5
0xbe1037ea4a5aec2ff09bb048bab22fdc00e45f726e06fb8e9cb715592cf20bdd,t,21000,147000,,5000094,2018-01-30 14:04:51,6
0x3bc7d9033f93a9d6afc833208dfe20b926e5f63000522bab94bae4c1148a362b,t,21000,168000,,5000094,2018-01-30 14:04:51,7
0x0d43d7329270fd94f160b67d6e917bcbe6b95ba8f580a03b909105879473d93a,t,21000,189000,,5000094,2018-01-30 14:04:51,8
0x51c7ed3afdeed5c19c37ac4a93ed43db710628a913b2aa596eb41e8dfb8f1b3f,t,21000,210000,,5000094,2018-01-30 14:04:51,9
0x31de4bfe0effa63dcb257429ecd75249d9cf4556e6f1001e6c0e99fd78c3dd76,t,21000,231000,,5000094,2018-01-30 14:04:51,10
0xa468c7bd2181c7db95a7ad0989f36469232e5949074cdeed593d57b25939d7ae,t,21000,252000,,5000094,2018-01-30 14:04:51,11
0x9ae8aeb3933fff4139a9260b5f7ce075759af0b624ddbe6bc61e7c4b8e1ead34,t,21000,273000,,5000094,2018-01-30 14:04:51,12
0x3e647e0821a442d9a76d952a18117271341d9eba3ea014ebd5210ecbbc3f641a,t,21000,294000,,5000094,2018-01-30 14:04:51,13
0xb49a0f76e450fe2581eef7940a79b7e01925de7b42f602324a35df33c1db72ec,t,21000,315000,,5000094,2018-01-30 14:04:51,14
0x63d0160c2079af4fd666b462f7d1001007541adff7cedaa0912167a344154dc8,t,21000,336000,,5000094,2018-01-30 14:04:51,15
0x322849c5d4511d7ccbffea1a02c9a199b9abba553b61b83ba3a06fe99f6ab77a,t,21000,357000,,5000094,2018-01-30 14:04:51,16
0x8396010c9edbe5f1f9e2f9e5118e8e01b1e2d7101822e699232e1aabf6e10ce4,t,21037,378037,,5000094,2018-01-30 14:04:51,17
0x9c4c71a2c401bbf680a753e62012efde30b6e68fbb5b18ea3c3cbac50bbbd6b8,t,52687,430724,,5000094,2018-01-30 14:04:51,18
0x8650ca936747eca90bf4bc18704f19a2310f85927afcdc8244d72931a5f11baa,t,52611,483335,,5000094,2018-01-30 14:04:51,19
0xc745c63115857a9c41ab1d16f61c393b0e4ff1dea8fa0e62f8a9a270b65bda45,t,52372,535707,,5000094,2018-01-30 14:04:51,20
0x592524eaf1ea8ca2a89f243a6a10064b20b7c393170bca82447bb9ed17b2143e,t,37222,572929,,5000094,2018-01-30 14:04:51,21
0xa17de1db5532613770d669c8cc0684f844e324988eb4f8a4b2b7d3acd0258f50,t,21000,593929,,5000094,2018-01-30 14:04:51,22
0xbd891c6a158d05352ad6bf7a8a8c8c94c2eafe7faede612a170ffcb6bc76fe4c,t,21000,614929,,5000094,2018-01-30 14:04:51,23
0xca4a4ca4965e0cc99fbeb764e03a31cdc1055f96b20fe633c6747ce19ae84684,t,21000,635929,,5000094,2018-01-30 14:04:51,24
0x03f6da1b47cb98c7222aeff79c11fb3bcfb5ac8e485570f65833af09a16c29ee,t,21000,656929,,5000094,2018-01-30 14:04:51,25
0x80481ad2a5b825ed65819b7a81f2733a567dc7b41d8d3af188d7e28491990db2,t,36984,693913,,5000094,2018-01-30 14:04:51,26
0x99d6dd77e21a4d1c024e0bae372988e2dc78114f384c5610e11db3946f8b7558,t,107587,801500,,5000094,2018-01-30 14:04:51,27
0xb91ff512591a4d0d0fb1e170f537c99645875e82895e7bd8fab614ed18cabe55,t,21000,822500,,5000094,2018-01-30 14:04:51,28
0xf6937bcc4dcb293bfa6e3b1d66a36746417edeadc2d69d7eeb1619f9262be2c7,t,21000,843500,,5000094,2018-01-30 14:04:51,29
0x4a5445dcd37ad411bdcae53c3f674d2cab66046816d7ab028e5fcccf117af234,t,54707,898207,,5000094,2018-01-30 14:04:51,30
0xa8078b8f4e4ee655771505a142e1fe5b25dfc152504af46260e939df4d8eb1b4,t,21000,919207,,5000094,2018-01-30 14:04:51,31
0x355149384eb2580f0746ca3e3690b9744671bb0db9885fdae1e0d4e33cf853ef,t,21000,940207,,5000094,2018-01-30 14:04:51,32
0x576f0204e02456526c260d94dd4fe60af7cb06b8cd60e074e79927e08857719c,t,21000,961207,,5000094,2018-01-30 14:04:51,33
0x9bbb66d77d11317591def352f8fce5dbe2a29c1aef83ecb72241eceb12d07055,t,21000,982207,,5000094,2018-01-30 14:04:51,34
0x78744abc681171642cce999fa7d7b7b1defc3770d9030a868386762cd91ad219,t,21000,1003207,,5000094,2018-01-30 14:04:51,35
0x717c00ebfca499ab676167251f6ba976693dd02b528ab28851ad9544e088f8cc,t,21000,1024207,,5000094,2018-01-30 14:04:51,36
0x9a3775e4e7d855f69f1d5f2e6ef33fa7a02695c00b6cc0187d6b87a5493ed194,t,52547,1076754,,5000094,2018-01-30 14:04:51,37
0x13f34142f42592317721526abe8f177203bdf25093021945bf6427eba54ab459,t,21000,1097754,,5000094,2018-01-30 14:04:51,38
0xeab55597c4dd8fc6f440a661d61971e7855e4b365b03b9968bcac0a38f6b7662,t,21000,1118754,,5000094,2018-01-30 14:04:51,39
0xd7393b91462e6176a06837ae46539163e7c50e4c190dd22ab0cf3259b0a47939,t,21000,1139754,,5000094,2018-01-30 14:04:51,40
0xac1b511b61b4eba2037def32fc0702ed717d0199627599e1c19aca308a50887e,t,21000,1160754,,5000094,2018-01-30 14:04:51,41
0x94b46888926cefe0922147268c4ae03037c09c9d5a4318973342aba91d736cdf,t,21000,1181754,,5000094,2018-01-30 14:04:51,42
0x6e177c33143165eef2812e028fa0906508f86fc4dedfb1ad61d04c64eefd7825,t,21000,1202754,,5000094,2018-01-30 14:04:51,43
0xb3e6afd5958f7ac7694ec1ba89a5b984d7621c9e17e5caff7a5dba37e25c6da9,t,21000,1223754,,5000094,2018-01-30 14:04:51,44
0x6ba102b795fc7dff3e6d0447b765e8b037aa5beae37166da39606019535023df,t,21000,1244754,,5000094,2018-01-30 14:04:51,45
0x3ceae23e2493761eb38a8e33757cf102b67d4df34a3b74072c4cc31285f273a4,t,21000,1265754,,5000094,2018-01-30 14:04:51,46
0x38b0c6332fd983ad1fc709dae57a621a32e2d1f956b8569c764bd30597280724,t,21000,1286754,,5000094,2018-01-30 14:04:51,47
0xb95897891d9f79e6e8816b9171975f47abac9a8caaf284ac7d398d0e6788af74,t,21000,1307754,,5000094,2018-01-30 14:04:51,48
0xac39b1f804c14567dd7ba245f8361276cf6095ff30ab66da7d9c18443c998f8e,t,21000,1328754,,5000094,2018-01-30 14:04:51,49
0xa2a203e680b58cbd6567ae27fd7ad4db6b0cd27cfcab6ebe3963c20b48d92584,t,21000,1349754,,5000094,2018-01-30 14:04:51,50
0xb32fee546f48085c923f9ccd5140a78bae9e3e6714f54e3ed00dbe7ea1008f97,t,21000,1370754,,5000094,2018-01-30 14:04:51,51
0x9a2942ff034b9243bff775f3ec49a4b381585f4dffac683dd5e0486e390cb6ba,t,21000,1391754,,5000094,2018-01-30 14:04:51,52
0x0bc3fcde5df797f472e84ead5b398e13467c5439f468536adb280459c76b0889,t,21000,1412754,,5000094,2018-01-30 14:04:51,53
0xc0149826a1450b675703f80615711c860eb804ffa4275a6a05c23747c42566ac,t,28985,1441739,,5000094,2018-01-30 14:04:51,54
0xb1e22df481e6d7d0953dd4ea4209311c3a992f74534e462f4ab63d682f8c4574,t,21000,1462739,,5000094,2018-01-30 14:04:51,55
0x49cd9ae33ea328c72d04c613ddec8e33224dd1fd1bc7e67c5ed55725b9f46fb7,t,21000,1483739,,5000094,2018-01-30 14:04:51,56
0x6e202d8472e539e602aa8868fc983f3c9f8995ab1088ec35f02515acb3f86b1a,t,89678,1573417,,5000094,2018-01-30 14:04:51,57
0x21276a2b021f995568c8840bdb356c4e2b57375b5f3c148eae9cfd55cac332f8,t,21000,1594417,,5000094,2018-01-30 14:04:51,58
0xdd248ce0c32ace82b319ad5244448e4327da8339aa7de581d07ab4eedbe6c5ae,t,21000,1615417,,5000094,2018-01-30 14:04:51,59
0x4f197461ea31b622cf9e9eabc205ddb58f4ec27367fd658c8a323039fc88459f,t,37900,1653317,,5000094,2018-01-30 14:04:51,60
0x01cbf7d43d73f6c39a027aee8b7506fdfc553322586e61c10a6fbac5c7debaf5,t,21000,1674317,,5000094,2018-01-30 14:04:51,61
0x322ee2f4baca8287290aef6b1dda4ad233b6ce6091e036d8384da9027b8f75d8,t,117637,1791954,,5000094,2018-01-30 14:04:51,62
0x1e4292f9d9b7106731f6b9e961fdcb3438803de9ed6bc092a46d3f28c6e6e2d0,t,21000,1812954,,5000094,2018-01-30 14:04:51,63
0x0799f9e16327ef471ee13bb8a3201992bdb86795baa8cc15468021ab8a62dfa4,t,21000,1833954,,5000094,2018-01-30 14:04:51,64
0xb6c20b2407c7e63f577cb732f95e341e171749701798688d09256de3628308e1,t,21000,1854954,,5000094,2018-01-30 14:04:51,65
0x3e6bedde946546706eda08f0f11a03e2da433b664a71d0d0d5e677954cbee88c,t,21000,1875954,,5000094,2018-01-30 14:04:51,66
0xfec630fcd8798741fccbb33ad039fc0d0f9ba1a0fab134478fc6b6a32b7240ae,t,21080,1897034,,5000094,2018-01-30 14:04:51,67
0x9b04702dd16b9cc60e5b3ebbedb85b10cc0349343d99b2a0ce4b520ebb6f141a,t,51964,1948998,,5000094,2018-01-30 14:04:51,68
0xb798fd1a072f474ef00bf0269a9351fafac05a8d8875bbedc140aebfad7b00df,t,21000,1969998,,5000094,2018-01-30 14:04:51,69
0x368003f1f1ffe2cd9c8983516242827e50cb81392f2eec30f020c011b8745500,t,21000,1990998,,5000094,2018-01-30 14:04:51,70
0x63ad9edd7b9857720b0b38addff0594ab73c453f25d1b258ed37661017ba601b,t,21000,2011998,,5000094,2018-01-30 14:04:51,71
0x9de1e25fffe3306b64af9d00eeaddf753482b1930c0c1266e6a032a049fd737d,t,21000,2032998,,5000094,2018-01-30 14:04:51,72
0x8ba3c5aff9a0c06c33ec3375f7118fc334cebfc81a44bc93ad45b567601fec5c,t,21000,2053998,,5000094,2018-01-30 14:04:51,73
0x596e8c11721927327e3787cdc0c9548eef0e0eedf7bdcef27db9a11690e5359a,t,21000,2074998,,5000094,2018-01-30 14:04:51,74
0x01bb8ebbc9fef06b52321654ed5fc8b39773e424c89d46e1a1efb9b73ea921bd,t,21000,2095998,,5000094,2018-01-30 14:04:51,75
0xeb204d5c44221ca5601a11a380aa4fb8a1b78de997d34ce52644ca0251865007,t,21000,2116998,,5000094,2018-01-30 14:04:51,76
0x4f3531e7fa518e45cec20f5659c44973f3b7fe0de9ef3bfa1c1af00fe8175cb0,t,21000,2137998,,5000094,2018-01-30 14:04:51,77
0xcf108f8c7b3edcbeafb3d97df97e90b1a2ff56ca1ed58aac49e00c8e9e24f29a,t,21000,2158998,,5000094,2018-01-30 14:04:51,78
0x3ec89148076a7e820b4ca2f6cf395057af6844d8111c495e600f0f65dca95e45,t,21000,2179998,,5000094,2018-01-30 14:04:51,79
0x39fdca8505e6fa7066188a9b56544b299d1c719c0da60c492cf8fed51605b91f,t,53361,2233359,,5000094,2018-01-30 14:04:51,80
0x54f87b6986e290db0b46174031d553da247123c20bab54cae6e54ae0b260afc8,t,53361,2286720,,5000094,2018-01-30 14:04:51,81
0xa115e0f856a564a8046cd5ee088273a6f50569e4ab1531a549c03a6b812d20be,t,53361,2340081,,5000094,2018-01-30 14:04:51,82
0xe271d4b8928c5db0080fdb2ffa02b0a3aae0a7d979d9f13e5f5666cf885bd770,t,21000,2361081,,5000094,2018-01-30 14:04:51,83
0x0554c2538c977b4b3c43cb419f6e11350da618c95f1ee2899e800871ba0b3cc1,t,21000,2382081,,5000094,2018-01-30 14:04:51,84
0x2520dd39cae56c13be47657063fea5fca2cb07a134aceec6b7cb00844147ce93,t,21000,2403081,,5000094,2018-01-30 14:04:51,85
0xa57f7171f378b1b9120b6068caffd86932dc5e9937e0e8f2f57ec9df193dc600,t,21000,2424081,,5000094,2018-01-30 14:04:51,86
0x2553ee4d83e5d05c3bb1001b0d120381866454b30d6b3cfea61a3f436cf96910,t,21000,2445081,,5000094,2018-01-30 14:04:51,87
0xa5f9e2bc4a37c5ac5ad87ad84e815600ef470fba7036f63a9bd1b6d6f5bdf98c,t,53690,2498771,,5000094,2018-01-30 14:04:51,88
0x333e5c0b238e347b69eaee571f9ffcbc2aaab9c00677f5d5362adcf800f33f28,t,21000,2519771,,5000094,2018-01-30 14:04:51,89
0xd29eef84e03407c963b4b8055049ea16692acd4c4190884a91483b3112860875,t,21000,2540771,,5000094,2018-01-30 14:04:51,90
0xfc1151e48bb43370f2b75cb7735b6343d83b39c8dae2f8fd5f9d4fef252fa0fc,t,21000,2561771,,5000094,2018-01-30 14:04:51,91
0x656c291e14d6fb5613f4ba656340d503ac2e53106ecfadc83ec47036d3d1242f,t,21000,2582771,,5000094,2018-01-30 14:04:51,92
0xad3541ed845015c35bf42b951369d093ad13cf5dfaa90c9d129a7b6880e5bc16,t,21000,2603771,,5000094,2018-01-30 14:04:51,93
0xef00292d67f4f89340d4e5ff3f5e6fd610c861d977753cf575ea32796a375bf8,t,21000,2624771,,5000094,2018-01-30 14:04:51,94
0x89f1d923ab1cf323fb122bc43f23c849ed0e16d0d06b4569ed603dcbf0b047d3,t,21000,2645771,,5000094,2018-01-30 14:04:51,95
0xdbc274369e6b04ff2f2c7f59e600008b004ccc1995df209f2cb12c74e6f0c33a,t,21000,2666771,,5000094,2018-01-30 14:04:51,96
0x22a0e72d757be5323983f221f4bc011e821e06929e0c848b4a31dc668d3480a8,t,215038,2881809,,5000094,2018-01-30 14:04:51,97
0x702574c502e5f3424d6f9283c4c9f53d734359d4d3615113fb1213af78a6ca78,t,52065,2933874,,5000094,2018-01-30 14:04:51,98
0xcdcbf21f4aa009c9173ece3d0bdea9d17a9ae204abd64c5e7b984294b9507920,t,21000,2954874,,5000094,2018-01-30 14:04:51,99
0x5bfd5b7acda5ed4735947ea48aaf501755d76a3328c9b15cf40b226fa83acebb,t,21000,2975874,,5000094,2018-01-30 14:04:51,100
0x4613967441bfeedf9719f4743e7c3ef7b0a24aa72a642ba7bcc50180adb938c5,t,21000,2996874,,5000094,2018-01-30 14:04:51,101
0xe7c20552674dcc5b0ac87beb0811659b6071f619232d4273b7cb3a3ede6a9a8c,t,21000,3017874,,5000094,2018-01-30 14:04:51,102
0x3fead77bb8e830194a1a883bb6737aeda51bcee3043ec6303ffa7716ad506938,t,37352,3055226,,5000094,2018-01-30 14:04:51,103
0x0547ba97b242e8378fa39bad1dab6c0a5abe9fbd8960dae5b5bb828db68e33bb,t,37105,3092331,,5000094,2018-01-30 14:04:51,104
0x77e9fa054b68ebc56a2e601a04123f856956ceac66921c44deee08277bf3c465,t,52011,3144342,,5000094,2018-01-30 14:04:51,105
0xac66968b628af26501a2df401a2cf3af2274e4d9aa354d9b7806196e779ea950,t,52385,3196727,,5000094,2018-01-30 14:04:51,106
0x4362e04965d6250214e3bd3b1a8df4cbe42de8b55ce9cc57f13f5be4388cd961,t,21000,3217727,,5000094,2018-01-30 14:04:51,107
0xe14ddcd81e7908cbbf7018257f14b5cbdae5c848e96a91c2557435395bc8177e,t,51647,3269374,,5000094,2018-01-30 14:04:51,108
0x80f57a99f2742eae5629de91eb24d9efa44be11b8f6b6eb538841907d67b819f,t,21000,3290374,,5000094,2018-01-30 14:04:51,109
0x699d16c40db1b857a98364b24bbf8b46966c70ad6dd45060af84b269182f5462,t,21000,3311374,,5000094,2018-01-30 14:04:51,110
0xd09fc9d9ae5e7bd53e82a715767cfb3fcac6cf0a3fe15634a0060840808e96b3,t,21000,3332374,,5000094,2018-01-30 14:04:51,111
0xbd2e2147f186e9a70bdc70615bf32a19462adf5f027b6856d157ed55b24a11b6,t,21000,3353374,,5000094,2018-01-30 14:04:51,112
0x7b0bc8371fd4d9266378225fa9a866a5ea6a2ee9dd9330e3a24dc001876d7721,t,21000,3374374,,5000094,2018-01-30 14:04:51,113
0x1bde426419971b63bd2d825b2f7b3c9f65ed82d9aac69ad278207b19c94f4b54,t,21000,3395374,,5000094,2018-01-30 14:04:51,114
0xdd19cb0ed226e03918dee09d0f2ec3d7fe77e903b17a8859b22dbdeb0c7ffcd0,t,21000,3416374,,5000094,2018-01-30 14:04:51,115
0xdd51913cbac614d4774c1143229e410c1547901e7a7e824dd1b9e41dfbebd4b8,t,21000,3437374,,5000094,2018-01-30 14:04:51,116
0xa59ede59ef72cec12877e091dfd99f68698a3cb5748cfa1bf3c8ccf0070e2c37,t,37939,3475313,,5000094,2018-01-30 14:04:51,117
0xb03edb97434e46c03650b72bff0b5abac30e87edad2a004a06ee72b1025a7c5d,t,54987,3530300,,5000094,2018-01-30 14:04:51,118
0x97156bf9b196a1f5ebec9b9cfee88542f00b6894f970bcdcc08f005cf5804f89,t,21000,3551300,,5000094,2018-01-30 14:04:51,119
0x2ebae801596596cdf85168f66ac3b8f14f1531063eb55680461c9b5b3e11c12d,t,29493,3580793,,5000094,2018-01-30 14:04:51,120
0xd2b7bd6e984e299472d64669b1f1b3d8eba049c3532ca6c5710f2598212f24e2,t,21000,3601793,,5000094,2018-01-30 14:04:51,121
0xa22c65c630fa1b0f05ab8abb6f5f90c16b6dab41357d12fed8ddf047f6585731,t,21000,3622793,,5000094,2018-01-30 14:04:51,122
0xcb4137194a5f7ac9c490530e3a8cb38a7259d081ccf876db1356c639f98fa141,t,21000,3643793,,5000094,2018-01-30 14:04:51,123
0x1c389c0bd7917a8eaa7ae4ca4491de3a4b00ff6be05573eda46aabcb67df1416,t,29063,3672856,,5000094,2018-01-30 14:04:51,124
0x4229b59989279574c5fe6c03e9dd41a307e1f7889755c04851b3ac24d9eef0ae,t,40971,3713827,,5000094,2018-01-30 14:04:51,125
0x78a2823dbac9f9de2b3a4a0ba0db8975eb284c13b25ca2029337f52478549e28,t,21004,3734831,,5000094,2018-01-30 14:04:51,126
0xf70de61799032d5ed9d9a314b5b4a9b8be59271deff59dc13273ff7b9bda37b7,t,21004,3755835,,5000094,2018-01-30 14:04:51,127
0x24f524d613b4b1afb87f6cfeb3b51aa40f0455f31cf6b7d978ead3de13d75b96,t,21004,3776839,,5000094,2018-01-30 14:04:51,128
0x6a94836be21d95cde468e7cf5f61efdbff458288d18999681a3af2a567744e1d,t,21004,3797843,,5000094,2018-01-30 14:04:51,129
0x6a8d38ae982e0c397ffd363abf7fe096320da8f68405d4197c86d165b1e343ef,t,21004,3818847,,5000094,2018-01-30 14:04:51,130
0xad534dd252f85e0dc3c7a683da0d0e523d1a19b8ec74e21d706d80c4ebef10d6,t,37155,3856002,,5000094,2018-01-30 14:04:51,131
0x7f08399637c49376c1b264489b85a343af1386e758f904e19eabf520245bb241,t,29204,3885206,,5000094,2018-01-30 14:04:51,132
0xca69c6d1ecfe8d9d6935e31b4f92bbbd4d345ca9c8b625942f1f81b690e349c9,t,21004,3906210,,5000094,2018-01-30 14:04:51,133
0xef4f6588863c6d760e88e928488cd4f83e4edb9510db5a3f74610ffccfad5066,t,37616,3943826,,5000094,2018-01-30 14:04:51,134
0x7878cc32c65d4ce04dcaf6a3ab3b0d64ea44ea1d56b9db3fe3f2c014bb3495f1,t,21000,3964826,,5000094,2018-01-30 14:04:51,135
0x2a8c0d2383e38ae388c25c58dd10602345d477c3a46fc2f5a95d1c25ff7991a7,t,21000,3985826,,5000094,2018-01-30 14:04:51,136
0xc7fb5408a640ad8ad30152b9ccf75e71a2080826e61e4611d268a224a7963b98,t,40907,4026733,,5000094,2018-01-30 14:04:51,137
0x90e03704682cfba4d38bf478f236998fd9a14c2c076785695254756deba7c4c6,t,40843,4067576,,5000094,2018-01-30 14:04:51,138
0x68157ad2ffaaccd29a8afa80425655d521a20c9700d52a0618cbf5ca4cc1e965,t,21000,4088576,,5000094,2018-01-30 14:04:51,139
0xf012cf74babfe4460990ddd299cfa4b75c5591243e32671c71c946be01a0576a,t,21000,4109576,,5000094,2018-01-30 14:04:51,140
0x901746be29f9caa7e168724102524752171e091f97c1dff7c933438067345f63,t,21000,4130576,,5000094,2018-01-30 14:04:51,141
0x3fddcb564134309dfa48c1803cdcf2b1ef849846f665fb24a1da3eb325df554a,t,37380,4167956,,5000094,2018-01-30 14:04:51,142
0x38ba2eb83b77c5554c019219135c63f7b0d2dc539001cc84a9f0d2eeaf0523c5,t,21000,4188956,,5000094,2018-01-30 14:04:51,143
0xc34eb83c705734fbc89b49bfdb4bcae8395f8689424b6ddb42f5e366e45a96b2,t,38318,4227274,,5000094,2018-01-30 14:04:51,144
0x03b06146e1bb934a6971055f4b0dbc786d24ecd927543a5db833b7b828f581ff,t,21000,4248274,,5000094,2018-01-30 14:04:51,145
0xf04e950ce36590a4907e73cd69414af2f052cd72427ffc354f483c02eaff033f,t,21000,4269274,,5000094,2018-01-30 14:04:51,146
0xee6847102b963f45d6bf5760bbf7608f7bd840cdc91e2db2d98b361641568d69,t,53754,4323028,,5000094,2018-01-30 14:04:51,147
0xab6b15140532eed8adb55d6db49b21ca67a6408dc025f9efced70609011fef87,t,21000,4344028,,5000094,2018-01-30 14:04:51,148
0x8748c3e61b51656f09fc5da5d5e6d1822c9093e3a833e7872f304f00ca72c4ca,t,21000,4365028,,5000094,2018-01-30 14:04:51,149
0xc717c2788b7ee136a4f4ae4cd32258733249d8bbcd9455fe673f3fcf99af5e8e,t,40797,4405825,,5000094,2018-01-30 14:04:51,150
0xad205d9ce58d8f73063fc7baa5bbcd0e8692fb18f9b7571c0a057839ca66e97e,t,40797,4446622,,5000094,2018-01-30 14:04:51,151
0x993e60df5b46ff61644af6216d8544b83ae1932a9f71d8f13ea89e3edfe47d88,t,40733,4487355,,5000094,2018-01-30 14:04:51,152
0x16350efb228c3d2c816e0b062fa483c811ace515f3f911c12bc2dfcee9e1ccf6,t,21000,4508355,,5000094,2018-01-30 14:04:51,153
0x459d38d3710e167a5dbafbc54e65b91fbfd6eef296827ecf05a949c52e0413fc,t,52524,4560879,,5000094,2018-01-30 14:04:51,154
0xb27de2cf1c23dd82b24ecb8c7be7b3b4c50c9a53a8f930f1d77a54cde819ffca,t,36772,4597651,,5000094,2018-01-30 14:04:51,155
0xa99f972bce49954ed18ba9a08451ed77794f25eb05e5a5eb0d841506df47997d,t,102934,4700585,,5000094,2018-01-30 14:04:51,156
0xb123fc856a4197e8590cebe7f96b3be344dd82f270d65316ae942cc54042ea82,t,21000,4721585,,5000094,2018-01-30 14:04:51,157
0x86ffec2b43c4e98861ef1828512c10f001f4a9330bcce8bc8b011e57bc7f4148,t,86688,4808273,,5000094,2018-01-30 14:04:51,158
0x1fd0d00cbae902068f44931d106d9d1edacc1f089804af656e3f71c1a0dc1dad,t,44290,4852563,,5000094,2018-01-30 14:04:51,159
0x3679bbbef14f7e17aac7af708b3c507b7ae3e128ad9ad82695db2deb0a639f93,t,59290,4911853,,5000094,2018-01-30 14:04:51,160
0x5cd61b6348ec04db2d1c4b205269e84776f3e18e59703f162d8eefa8ae503966,t,102934,5014787,,5000094,2018-01-30 14:04:51,161
0xaf4e4f97637592514ccf3ac54ffc3ba3cf21ea8bacbcb917bca600409373d532,t,102934,5117721,,5000094,2018-01-30 14:04:51,162
0xd9876e14c77c413c4e3f213fd0d1f4e4386858db857fef1c3cdc3add5c1cbafc,t,37964,5155685,,5000094,2018-01-30 14:04:51,163
0x83d775996906439143fe8521c6247738999accfb2218af3d57ac7f9cd8ac8c8f,t,21000,5176685,,5000094,2018-01-30 14:04:51,164
0xa4dfe56517d7443653ba1c0ccdc589ab022c6af5fc39f09b6d231cca27f59434,t,21000,5197685,,5000094,2018-01-30 14:04:51,165
0x90854326de7cda4942fa9c1a1be0756fbe17aa2f4093757a3aca41e7cd7e9cca,t,38233,5235918,,5000094,2018-01-30 14:04:51,166
0xaf8364728f8c65b2529bc6361fb03485c6149c7533880c14441830e2a79d6d64,t,21000,5256918,,5000094,2018-01-30 14:04:51,167
0xefd1eae27b7e90074700f3f46d221da8c92d9c3c60f5bbeb31792e74bd88eef3,t,37678,5294596,,5000094,2018-01-30 14:04:51,168
0x2153647c11a48ea3109b45f3435e1e2a1a7f663aafe1419e1a1dab42b2ee7f50,t,40843,5335439,,5000094,2018-01-30 14:04:51,169
0x63c2690d09ac9bb23b2a15575e9f9c484e34db1dd5daa8449f3418bf4feb9094,t,51590,5387029,,5000094,2018-01-30 14:04:51,170
0x6aaf9b0b43a54a2753cfe30796ef122eb094bf59db740532506d4c64fdadc58d,t,46982,5434011,,5000094,2018-01-30 14:04:51,171
0x3043017596fc7a3fc1af945911fcebd59230a44a5f5836b1f940f51af1582811,t,31257,5465268,,5000094,2018-01-30 14:04:51,172
0x0ac02832faa20bcb15d87f18ddc1f3d3a273772c0c3eeb02f9230824baed5ce9,t,21000,5486268,,5000094,2018-01-30 14:04:51,173
0xb98fe6a22a6b07c8e649ab250118027ff4dc42774a5e1d1f229e0b3b1cc5c149,t,21000,5507268,,5000094,2018-01-30 14:04:51,174
0x8a22b6bb97083910c02b6f7f21d24db7c8f9b9936e886a8ff188c13b9c0182b2,t,36706,5543974,,5000094,2018-01-30 14:04:51,175
0x8a113edd49c7ca980e2099e87c09d93254d74f983927d32864dfc91206d984d8,t,36706,5580680,,5000094,2018-01-30 14:04:51,176
0xdd89c7bd8f1caadb8eb7148b8947b674d233a93600724628c29f234752cd9dab,t,21000,5601680,,5000094,2018-01-30 14:04:51,177
0x68748086e90fc036b3b95d5b41510f0b594afddc7b8c23cb1cd2e4060bf29ab5,t,21000,5622680,,5000094,2018-01-30 14:04:51,178
0xd03ffbb9a5999df4220d10a78352ebec62bd9dc44a2db8b2bae76ce6021a269d,t,21000,5643680,,5000094,2018-01-30 14:04:51,179
0x31dcfc8d96eac3f150a2d10967857fd9a590545a8e7c11b74c024d02dd4f3ab7,t,21000,5664680,,5000094,2018-01-30 14:04:51,180
0x82b34dd0c948f5a26cce6456ced6546885eae95972d3fa3e26d3f0be09d0c7cb,t,21000,5685680,,5000094,2018-01-30 14:04:51,181
0x71231a24326b2dac0b2fbdecd530c89defa58460f49a8680baabc8d9fd884888,t,21000,5706680,,5000094,2018-01-30 14:04:51,182
0x6ac222a22c4315d2748fcd95621e388c7f9cb77d476273161d1ab34f4db79817,t,21000,5727680,,5000094,2018-01-30 14:04:51,183
0x94a69083d39e3250c10304f72167c1d133d5704102146dcccf918c6bb5ee19cc,t,21000,5748680,,5000094,2018-01-30 14:04:51,184
0x3e7693d10597d110f49908b495078837be60b73353f824f73cbaa7905a03a2d1,t,21000,5769680,,5000094,2018-01-30 14:04:51,185
0x7b885fa4a12fc86004de1584d8f4d32cf9de2b069f564a2d4ad2a3a69289679a,t,21000,5790680,,5000094,2018-01-30 14:04:51,186
0xb16a0a42ceb9d524b7135c032d45b7593e3b8313d9e9bb3926e732090c8b15fb,t,31984,5822664,,5000094,2018-01-30 14:04:51,187
0x426aee4348f2c565ebaee5e87d44c7a12bf870b8a938c0e93ecf4bf2377c83fd,t,127836,5950500,,5000094,2018-01-30 14:04:51,188
0x136a86a164ea34cc84e982dc4ab7bbeb0bf3316ad429bcb65da8e72d23eecfd0,t,112964,6063464,,5000094,2018-01-30 14:04:51,189
0xeb4b4c95a27f2d85dbd72e32ed06e8118d0b9773b9d6592186ba314af103e143,t,77853,6141317,,5000094,2018-01-30 14:04:51,190
0xf93aa0f707d2bf3e2698d75d21faf3bdd8bbc77973886e7e6efc8abc2c0d6f64,t,77686,6219003,,5000094,2018-01-30 14:04:51,191
0x288ace6db181d6cda0feee8b42e0fab629dc07b364ccbdbf85b652f5ac2f78e5,t,142644,6361647,,5000094,2018-01-30 14:04:51,192
0xb788b24bd6076bdd6ab2071466913c7d57d12b713572f82abbe933eb7d48802a,t,92853,6454500,,5000094,2018-01-30 14:04:51,193
0x24b227efb5bccfb6ab231f2b182039f0e816933e320a24b6b41eff2bbeb33820,t,142196,6596696,,5000094,2018-01-30 14:04:51,194
0x44497cd1b4c806b31ef851e868d8b378e2b2ad362fd82eb63dd3744c21a31f93,t,142708,6739404,,5000094,2018-01-30 14:04:51,195
0xcc6880175b0f949e81d560661c82fad0fd7c0a0bf537ef72410467bd6a7668e7,t,157708,6897112,,5000094,2018-01-30 14:04:51,196
0xaca330dca1c6f2d2b0d0accfd3580a45fc392e175f7a5c4b8adff353fd17790b,t,142580,7039692,,5000094,2018-01-30 14:04:51,197
0xb56c4409ae91613218199ccb622d27e9b73b63adfeb04577b8ec56fa3b75d997,t,67877,7107569,,5000094,2018-01-30 14:04:51,198
0xc4b35b417dc6bb581ba37d8e14aa86e280b08da972bb2afcc595f73374ee7942,t,157772,7265341,,5000094,2018-01-30 14:04:51,199
0x9f3ed9574bd75dcdc51a1ac0a787d214913bb76ad7091c432548721aa67d4617,t,237070,7502411,,5000094,2018-01-30 14:04:51,200
0xc0f02dd0410b98d5986cbb8ff91a2cfe2e864ef2dc94ac9517112bcc757a8018,t,21000,7523411,,5000094,2018-01-30 14:04:51,201
0x901c82b7333829ecae4bca64c0722b51b28568f557d49ba7fb500a9939431168,t,21000,7544411,,5000094,2018-01-30 14:04:51,202
0x23b117efbb4d4d753b58e059e57c136c85f77a525c7016448ed4b5b0133b9c1b,t,21000,7565411,,5000094,2018-01-30 14:04:51,203
0x207da8d81a76da4bc638d77f828ea847e1e81355ee5b9f8db3b5b5af04eee6dc,t,21000,7586411,,5000094,2018-01-30 14:04:51,204
0x7ea62fccfe10f8555a65e8ba3dc2e15544d765281ed83e46714eb55fb5fc63bd,t,21000,7607411,,5000094,2018-01-30 14:04:51,205
0xa7f09e160aecb6710fb75c97587834c2a4e27be6763a123e5292dbf2f41de815,t,21000,7628411,,5000094,2018-01-30 14:04:51,206
0xbdb720410953c28a1c462a119251a8ae8e5a6e6609c3cbfefc21495004e0707c,t,59116,7687527,,5000094,2018-01-30 14:04:51,207
0xea2a0493cdbf960951bba2f61a8169eff7d1d8ce9d71edf343e01232b8813ba0,t,31984,7719511,,5000094,2018-01-30 14:04:51,208
0xc371b0a6cb9d695b80478a96fcf484c2cbb8604a60f79bedb9ef9954311a415a,t,37378,7756889,,5000094,2018-01-30 14:04:51,209
0x57e7191f6cb07662124ef1607c40b615dfdb61e87b5acf9a8fa20488e7483abf,t,52257,7809146,,5000094,2018-01-30 14:04:51,210
0x7f8f3cba6efca1654e0299022ec558d7f8a9ad2d330130ded346137b3cd48a0b,t,37048,7846194,,5000094,2018-01-30 14:04:51,211
0x2f4806e297e367bda204f04fff5f0abea1a69e1d902841c2419cc78e40b33201,t,52912,7899106,,5000094,2018-01-30 14:04:51,212
0x4f6dfaeed4bba64eb4f7b2978a1f70d57bf72032dfc36a318e686566f160ee04,t,52881,7951987,,5000094,2018-01-30 14:04:51,213
0x3ff4cbc4f844bb23127c6d48bb33b7d21725562bf1156ef2d543b62614880fdf,t,30981,7982968,,5000094,2018-01-30 14:04:51,214
0xafb10e307ad25fc593dcdffdb7b2b4ea88af8dcd53abf57ac931a2f8b4054995,t,21000,21000,,5000095,2018-01-30 14:05:15,0
0x4855d61bf86c84dc7fe1c819ee70976d1f829e9587d2cb19fca3728677145d8b,t,21000,42000,,5000095,2018-01-30 14:05:15,1
0x6b364ef63bf322b1202762f1d4f2896a627b43332b32e6a3f266a6a2ca2875e1,t,21000,63000,,5000095,2018-01-30 14:05:15,2
0xda28b76ae564f1df1116f1eb1f6ed7220c1ff9c68e0eed1cd22f8320272abc82,t,21000,84000,,5000095,2018-01-30 14:05:15,3
0xde3ac1c186d41912db3d0ce341c1f4f4a8dffbcb9cdd4fba4270e326ffeffc74,t,21000,105000,,5000095,2018-01-30 14:05:15,4
0x12306ecfe83bb9319d943014b44fc25602f4a9eb283ac183664942ecc910c557,t,21000,126000,,5000095,2018-01-30 14:05:15,5
0xe394e8227a64b6ab2dce31a275fdbfb83650d8e20ae1c0fcc4610726e31eaa11,t,21000,147000,,5000095,2018-01-30 14:05:15,6
0x4269b19863b1fe2fb1312306308ee8abf5a24e41eab1e2cfeeabfb26f31ce6d7,t,21000,168000,,5000095,2018-01-30 14:05:15,7
0x87ae9a63105615eed7cd491481da261464cc47b1d3bafa08877e49ea2ff19fab,t,21000,189000,,5000095,2018-01-30 14:05:15,8
0x9b129f6d9bbb2ccc48e2c6774bb092d168fbdc916f7b7d57bd4bdd8305d1c49e,t,21000,210000,,5000095,2018-01-30 14:05:15,9
0xc89d04b61f9daef8208dfd5718f83e46152e4b56a66f83db491c81f583e6073e,t,21051,231051,,5000095,2018-01-30 14:05:15,10
0xf1d54078adcf50c5187ccd3f47c4bf9da937ad560a3830226b5545956407b747,t,21000,252051,,5000095,2018-01-30 14:05:15,11
0xaeef093c922882f5ee99c5df129c888ccdf683e644b101f80c0f301829862685,t,21000,273051,,5000095,2018-01-30 14:05:15,12
0x26345ef9b5fc9317fa990450119e474272a3f87774a61c248850c54bf9aec95d,t,39512,312563,,5000095,2018-01-30 14:05:15,13
0xd502e2348d8b524fe8921a82cbb9a6c9cc6ebf18551d4fb9ecfde8bfa7358e62,t,21000,333563,,5000095,2018-01-30 14:05:15,14
0x1f67c9168bcf84ed32afdb84ad447fd2abf4966193c974bda92d7bd446d6faa8,t,21000,354563,,5000095,2018-01-30 14:05:15,15
0x1e9a39a3e24b6bbc4e8075f362bcd9a6a2d82160bfac357557b41dd256ca707f,t,21000,375563,,5000095,2018-01-30 14:05:15,16
0xf4322fa46709da1adb615ecce7a9667d01c1d32cfe5cf610e0c7a43177057710,t,21000,396563,,5000095,2018-01-30 14:05:15,17
0xb2b3a78bd0a0c4eb5012cfc071a445bac784f6e7b7a50ae4890df44a753f8568,t,21000,417563,,5000095,2018-01-30 14:05:15,18
0x3adf8f7503ba48e5f89f09179148b0bc9f00d4346dd57217f5e9a7a0db62af07,t,21000,438563,,5000095,2018-01-30 14:05:15,19
0xd3a121a6f73046839d3b62d3837c43c727aef99daead5b2bc8fff3ebe181473e,t,21000,459563,,5000095,2018-01-30 14:05:15,20
0x84273fc8c50fdce04a68a3f9b2dc466bb2890ded5e8846f966594173523e5252,t,21000,480563,,5000095,2018-01-30 14:05:15,21
0xf0d5dd790a90a8c4a1084ae88a5874aacbf3231e96951280558b4f8df0060251,t,21000,501563,,5000095,2018-01-30 14:05:15,22
0xdf6c3003c7943a4967fb0f819af36cedc284bfe16336adc104e17f743b4c4e17,t,21000,522563,,5000095,2018-01-30 14:05:15,23
0x783c93ea3adcd6f7dd12da2651df52b4809ab68544a9bf4d5fd5511b56445efe,t,21000,543563,,5000095,2018-01-30 14:05:15,24
0xd0bbe2e22ea97f7a254f620c8e49ab38358d764a8ef9aedb3bba933db57a337c,t,21000,564563,,5000095,2018-01-30 14:05:15,25
0xb3e2edff95b3a5e02902e366371232fbeb63dd13f70c1b4676a0df603060bccf,t,21000,585563,,5000095,2018-01-30 14:05:15,26
0xde1952ff5165006f544514d1f87dcde7b2b6ba70b7a8b94425e30e021986b4a1,t,21000,606563,,5000095,2018-01-30 14:05:15,27
0xf35e84d18125faf4fa0e3240870d8897514629a11e4f2ec0248e3cebe019c1ba,t,21000,627563,,5000095,2018-01-30 14:05:15,28
0x480c68af1670e4cbeeb19a30e7da8124b874eaf52835cc72c64fb7efe8ec7195,t,21000,648563,,5000095,2018-01-30 14:05:15,29
0x1ae251735d5234ae99d6bde5e97531384f28122e7eaca6af79d8a0e14f8ca281,t,21000,669563,,5000095,2018-01-30 14:05:15,30
0x3336a814c5cbe1f8f0b3f252cfb422402c68056b88acdb67c79ed02476dac10d,t,21000,690563,,5000095,2018-01-30 14:05:15,31
0xef124a400a5804170cb916081d928d9dac2bc080fa01f132d2ada045f8c62a2d,t,21000,711563,,5000095,2018-01-30 14:05:15,32
0x18360918434a99f2326e87929eeb5b24275089b87c67928ffec354092c48a50b,t,21000,732563,,5000095,2018-01-30 14:05:15,33
0xb7526a801ca82ee776725de570d6710069988b0670e69e748998f3b17e67b116,t,21051,753614,,5000095,2018-01-30 14:05:15,34
0x981eaf8133628d00b3cf9167c49a167de9c49c80099b332aeff06577fa27b88c,t,21000,774614,,5000095,2018-01-30 14:05:15,35
0x36fb09186f3add3f1a2fbcf775f65cf40be28c589bf775dcf92866e851873426,t,21000,795614,,5000095,2018-01-30 14:05:15,36
0xb7a10d915aa72214d29ed4590acee4af79833658cd3ac863b65071405e4ea3b0,t,21000,816614,,5000095,2018-01-30 14:05:15,37
0xa9b18bd37f2f69459fcd6ca12ab2b3fb0dac748b9138ce7eb11921f269d5a0f6,t,21000,837614,,5000095,2018-01-30 14:05:15,38
0x79adeb6adf1671fa582099fe6c23bfaa74fc846aa22365d7fc7ec6be9b1eecd7,t,21000,858614,,5000095,2018-01-30 14:05:15,39
0x5eb3f765cb9b018638aa35402a9982a56a0c52ae9d9afb22d846ef32db93f403,t,21000,879614,,5000095,2018-01-30 14:05:15,40
0xb55f0f5751487a74a453e9f9ed168ff22f51b22d440a36e0593cc20cdb453185,t,21000,900614,,5000095,2018-01-30 14:05:15,41
0x833aedd5d0d4583976ac28aabe5d8eea16e3dbb3c1fc1b8c13a06573d227eec6,t,21000,921614,,5000095,2018-01-30 14:05:15,42
0x1e9f347217c1605a2bbec1f28181d6f3c0ef46457041ef9c0d78ac24a762cc86,t,21000,942614,,5000095,2018-01-30 14:05:15,43
0x8c8cc4bc4d057f93354cf5719dd894b196c76f05195f61796424d713eb04ae81,t,21000,963614,,5000095,2018-01-30 14:05:15,44
0x194c2b11904f2bc4859b2b382929af6de56b367a817f85b28be7c662d8264827,t,21000,984614,,5000095,2018-01-30 14:05:15,45
0x146d89713b51e37b5908182f79678ce920da43f75e51454b316cd04b391cc624,t,21000,1005614,,5000095,2018-01-30 14:05:15,46
0x94a1ee6d265019848ecd9793f566d94ca4344687c03f37d94d562a6e6db90169,t,21000,1026614,,5000095,2018-01-30 14:05:15,47
0xc2f0bd42bb31526990ca6e747e00f5e313bfad13b1be67feb1fd512d3612d953,t,21000,1047614,,5000095,2018-01-30 14:05:15,48
0x7e11dd8ca6d39ae8af30b0b23a5a7e02f4817e9630f7a97481cd34ab44789a6a,t,21000,1068614,,5000095,2018-01-30 14:05:15,49
0xb9912863d5010ff1344349427bde727f304ff89fa403e40dd578db74b30d0387,t,21051,1089665,,5000095,2018-01-30 14:05:15,50
0xe2bede0dc93449959a5cfa8436b0b08537997fb5bd2b128963b72a4f5f4d839d,t,21000,1110665,,5000095,2018-01-30 14:05:15,51
0x8ab09a46458a321f9556c2c55321e6312ae1e167be000282c2e713b834967571,t,21000,1131665,,5000095,2018-01-30 14:05:15,52
0x107ceea157db281cf93ba56f9778a71a178d31b234e7948933bb496abbbd2356,t,21000,1152665,,5000095,2018-01-30 14:05:15,53
0xc60661f3732ab53d1c613b37395bf063041713c027c7ed85df84fed5f50fdf31,t,21000,1173665,,5000095,2018-01-30 14:05:15,54
0xc122a69bf81322c79bf50d80b243fe3a8fae862c449f7e4884d319eec6c45246,t,21000,1194665,,5000095,2018-01-30 14:05:15,55
0xa0bd6b68ed9015acef53b08bb5116e83c2da9001778f265692378fa297ed9b55,t,21000,1215665,,5000095,2018-01-30 14:05:15,56
0x88a9ecc606903af3935e4993ddac81b51ff5ff687615d904279c27febbb8ab3e,t,21051,1236716,,5000095,2018-01-30 14:05:15,57
0xd243c418849cee9d30d6479f49145bbee97feecfc4f478d4521cc328b3168da6,t,21000,1257716,,5000095,2018-01-30 14:05:15,58
0x3debdb44a34a454fc13477386ca250d72d2148a8ec4a533f789d71435fc7a2b7,t,21000,1278716,,5000095,2018-01-30 14:05:15,59
0xf6b3b52deafb07848a578a50140d9a6915bf4c8f85d51c9a339ab591a3f87b1a,t,21000,1299716,,5000095,2018-01-30 14:05:15,60
0x2a6e6dbc1ee25d54d1450f36006f9c4e4481a1bb48a0ef32eedfcbc4bdd8bdba,t,21000,1320716,,5000095,2018-01-30 14:05:15,61
0x385bda3792ff68f532602d75b2b8b85bc89215ba689dc4fb7f3a31efcaa61ec8,t,21000,1341716,,5000095,2018-01-30 14:05:15,62
0xff3615622210b6cb0071fad73d010b0e77276cc4fbde1fcc3ba92b36131c7513,t,21000,1362716,,5000095,2018-01-30 14:05:15,63
0x23708cf5f7660f1d8ad22b5a1da0b11b11ec332fa0ded685e125d6b717df725a,t,21000,1383716,,5000095,2018-01-30 14:05:15,64
0x72eac96ba1353d1a1976fbded129fc4720a26a07260799ad34054f65c389ca89,t,39512,1423228,,5000095,2018-01-30 14:05:15,65
0xd659f4247bb4b21686619d15a615057ca26a330aaf92734253f2e19db49586ac,t,21051,1444279,,5000095,2018-01-30 14:05:15,66
0x6461d89d647d20d0a4813f67b571f3455bfea90caed29496943fbf37f7b8948a,t,39512,1483791,,5000095,2018-01-30 14:05:15,67
0xd16187d6f3816e741e8b35c6c7a5dc93f4bd7fb2e8c68c31a1b0da64239d15b2,t,21000,1504791,,5000095,2018-01-30 14:05:15,68
0x24683796cdf7b43a94cc9501f03737cd5f4455ac982089767987bb61f974f8fa,t,21000,1525791,,5000095,2018-01-30 14:05:15,69
0x04325b87ede173baf110afc628182cd023674879517223b638d31e950e7839d1,t,21000,1546791,,5000095,2018-01-30 14:05:15,70
0x4670696940721dc0e36e9214d4b7ba1e2ab6b67264f485ce65032cc1349f7a99,t,39512,1586303,,5000095,2018-01-30 14:05:15,71
0x90e5cb1c979f8cfc2766eeef73f0c4cc94e346cbb54ff2578b347d41eabd2782,t,21000,1607303,,5000095,2018-01-30 14:05:15,72
0x183b4d7fb16378c9d3da0ad69a3d824b369ea6e177cd180ea770bc31beca2f1d,t,39512,1646815,,5000095,2018-01-30 14:05:15,73
0x44fbf8429b804f94cd7ca6392db1cda45c80f93ee840526fef2a76afa216120f,t,21000,1667815,,5000095,2018-01-30 14:05:15,74
0x86a5087899badbf84ee82209114c31c532e467790e2b55b22f1fd0b84c3d8c8b,t,21000,1688815,,5000095,2018-01-30 14:05:15,75
0x51b26b932f599f4f11f894637890439315b93780c8cecb00bc9f0aa036eff2d1,t,21000,1709815,,5000095,2018-01-30 14:05:15,76
0xf55ed9ed730ba60879e38abbcd2d1195cf3dbf31a153ca15ebefc4f9db9422c8,t,33705,1743520,,5000095,2018-01-30 14:05:15,77
0xfd9a0a7efc06da00ce76d7e60a33f8f1e5dcd5b8e4ac3482e10dd43c86ee24be,t,21051,1764571,,5000095,2018-01-30 14:05:15,78
0x9a0bdc5943663f16c945b98229dcffbfc499a3870ce0a2154f86c5062d3ce52c,t,21051,1785622,,5000095,2018-01-30 14:05:15,79
0xb556aaa33d47089169b0b3dddb83132204a204a71b9244ea9836da0b59960181,t,21000,1806622,,5000095,2018-01-30 14:05:15,80
0x543ba04d953add391cc8bfd0baaafccd51492a7a615f14cc4dab54714831ef7f,t,21000,1827622,,5000095,2018-01-30 14:05:15,81
0x697a70a8b57486e78390b6038dafbe97801bdabefd1105a409f25d576e654ef5,t,21000,1848622,,5000095,2018-01-30 14:05:15,82
0x01a4e045b5d95b6b10313b3d2db780f58673c74141c2b3f0c5d3a13cdd68754e,t,21000,1869622,,5000095,2018-01-30 14:05:15,83
0x3b59394eba18ac3b3beea1d136a687ebcb52552532b9e3653e65115aaaf423b9,t,21000,1890622,,5000095,2018-01-30 14:05:15,84
0xdfee6c1b96b67a861159b678bc240eb7cae0c1e7dabd202788926ce8a5a55154,t,21000,1911622,,5000095,2018-01-30 14:05:15,85
0xbafa55907f6fd9d1922ee1fc5331f54d5fa198f4eb0b636978f1d3de72fdfd7a,t,21000,1932622,,5000095,2018-01-30 14:05:15,86
0x8347504104da857c30218233bc723876d812b51b98bd6341750275270627a3fd,t,21000,1953622,,5000095,2018-01-30 14:05:15,87
0xe0a433453f8005a96e462f116604d5369208e241e4e765c9cc01e749acc16f9b,t,21000,1974622,,5000095,2018-01-30 14:05:15,88
0xdf7746542cbf0c7edfa3d1c51b43c13a2e63fbff08c4637e530eb3ea76432366,t,21000,1995622,,5000095,2018-01-30 14:05:15,89
0x33cf18579c3b4a5cefbb6d7e02369de25772e5bfbf6c99932425f9c8849b5a18,t,21000,2016622,,5000095,2018-01-30 14:05:15,90
0xf57980ed433e3edd6cb948fbb3a393a86bf91472a142efa50a6928fecbafc7b2,t,21000,2037622,,5000095,2018-01-30 14:05:15,91
0xcc12d09c3099ecc5e3ed4fa5d555d9e37999fc30a480af682b0bc18d5080bea5,t,21000,2058622,,5000095,2018-01-30 14:05:15,92
0xbce56debdb180b66c6e41994e3df739e7541c7d9ad5b738a9900d752539d08f2,t,21000,2079622,,5000095,2018-01-30 14:05:15,93
0x8f73e85e2a483d9257553ae7aa5fe3f25ace93df51e63ce28c055fae87cccfbe,t,21000,2100622,,5000095,2018-01-30 14:05:15,94
0xc045ef1a48bcd067b4efdb9eb95312ec4789a3a3dc3a56a264fd456b4e920b5c,t,21000,2121622,,5000095,2018-01-30 14:05:15,95
0xab400105758ed5eed426f00379c1717aabc1142ef5e71b6a9d82fa08c100e018,t,21000,2142622,,5000095,2018-01-30 14:05:15,96
0x4ad10b6219b57443291dc7301d17bad69bf8ff55855ef4bd5ad29dd4bb925154,t,21000,2163622,,5000095,2018-01-30 14:05:15,97
0xefdd2b5d4188ce77b1f588ff1db3d9a4d44de64045f16d947ac008fad94e9e33,t,21000,2184622,,5000095,2018-01-30 14:05:15,98
0x3c7ceb559fcaf306c3fed40a734d3ef0b3403181533937ff04892665be2aa507,t,52219,2236841,,5000095,2018-01-30 14:05:15,99
0x7875b94eb3ed9f2aa8a2ad68901219f0de2214ef935189123aa8d393025dcb0f,t,37027,2273868,,5000095,2018-01-30 14:05:15,100
0x758864a45bcacf235de4cf77d6fc26b4b8a835805b8bb0b5db360623e8da8564,t,52109,2325977,,5000095,2018-01-30 14:05:15,101
0x06979446b2b4821617b488d1de07a251aff2859caec5959f37b2ef6a48d40203,t,21000,2346977,,5000095,2018-01-30 14:05:15,102
0xf62f96d8def0582ebafff80e615365f336d346f53e7b0fde5650dbbbdad54e01,t,37116,2384093,,5000095,2018-01-30 14:05:15,103
0xe66da42d911081635ae0c0601ecedb305ffa1bd7ea7e5101eecd5fd0c99fbc56,t,21000,2405093,,5000095,2018-01-30 14:05:15,104
0xde4f5bce7b22d076989946b7f2a6f5b534ef4d4e112105b159ba6d799fd5e800,t,21000,2426093,,5000095,2018-01-30 14:05:15,105
0xaf76d44d5425d16e04a2b18f8d121fdd365f8f8c0cfd42ad99a9dc6863992d48,t,21000,2447093,,5000095,2018-01-30 14:05:15,106
0x5b6af9bb90850e38d0073f352836366b22d63c747fa49d635eb64c283779caa0,t,21000,2468093,,5000095,2018-01-30 14:05:15,107
0x49d6011fef7e77849ea3527bbef149299e06156ea020026fd4cb153c436114e8,t,46018,2514111,,5000095,2018-01-30 14:05:15,108
0xe7f709d0942e30de66d077fe8133d808dc2c232926a7687cb5325943ff0ca0e7,t,21000,2535111,,5000095,2018-01-30 14:05:15,109
0xf528605f5f005af54baaffcf60c679d44dda0f67a0ae892fa5358739be7268e2,t,21000,2556111,,5000095,2018-01-30 14:05:15,110
0x11db8c181abd731024b3183ad936ace5f3a78a6681dc8cabb526326ff99a0623,t,21000,2577111,,5000095,2018-01-30 14:05:15,111
0xcba3ae550c295fa4d478f15fd24d557059588aa5cdb8626cfa02a950989e1545,t,50057,2627168,,5000095,2018-01-30 14:05:15,112
0xb6c38c053c8a5b62e9a2bd68a27cf2ecd2146ff2ec93ce2b43b9970ad1e5d7f1,t,21000,2648168,,5000095,2018-01-30 14:05:15,113
0x9e1122c1a6cb36f6c4a80d0d1c17625a38554ce55a9e3a7559e7ae062c877da4,t,21000,2669168,,5000095,2018-01-30 14:05:15,114
0x8b3ce16ca383aa65e9bf4c231a2a6c9c05a1be9c161ff5c2e69520f8a32c7ec9,t,21000,2690168,,5000095,2018-01-30 14:05:15,115
0x1d052b6d8357060250019862f6c6af0e70ed49d85a7c2845eb09529f13208fa2,t,37323,2727491,,5000095,2018-01-30 14:05:15,116
0x190631d60dd0cabd92d587fceb7a34eba784991051d94169510b6775feeb0dac,t,21000,2748491,,5000095,2018-01-30 14:05:15,117
0x1182c676807ead77716572c01355c224eab58bcd3e9eb0c0b4dedb98935cb30d,t,29144,2777635,,5000095,2018-01-30 14:05:15,118
0xf5f53bcbbf1d7674281d2606dcc3485a5864fb5ad031df2c9c848d9a4d51748b,t,22049,2799684,,5000095,2018-01-30 14:05:15,119
0xbbcac0d3af246e02f44576a555c84ee7f86ed762a1f6260d9f0105b1c5b9edc1,t,21000,2820684,,5000095,2018-01-30 14:05:15,120
0xa9bcfdac17e475c9ad28ef5ee5c312432ba975ec9d02e9d3f7e2ce116bfffbdf,t,21000,2841684,,5000095,2018-01-30 14:05:15,121
0xf21e5455fa4fdbe09d657169c953739a33e220dd0dac65674b447ebcc0cd1432,t,21000,2862684,,5000095,2018-01-30 14:05:15,122
0x93302d9c049dee909c902e391d2105f303c8cff87ccdc2d96129dffaa4e2676f,t,21000,2883684,,5000095,2018-01-30 14:05:15,123
0x18a2e6d21a24c22c8678edfe5caee4bf6ef6a0b92de182bd99a93a2739f50777,t,21000,2904684,,5000095,2018-01-30 14:05:15,124
0x2093da9e97b245a2389805cb73b3e9e05b44b46f74e36a6e6652651111709933,t,21000,2925684,,5000095,2018-01-30 14:05:15,125
0xb67c079ede40aca162b6baed1227b49e35b77837c0ec858f56618088b54a7b9e,t,21000,2946684,,5000095,2018-01-30 14:05:15,126
0x2956da4360cb93133d3d55192369bf2002f820d7ebc5633c7a08230bc580513c,t,38361,2985045,,5000095,2018-01-30 14:05:15,127
0x2a9065304d6360a1df30b77d1a579e7b7e3b70d7a8c54c30c61a03b555cf4028,t,21000,3006045,,5000095,2018-01-30 14:05:15,128
0xe6118dccda9d682c72f7d4e19587c06dc04b80bbbe37e8dc8bfef0ed32e52c4d,t,21000,3027045,,5000095,2018-01-30 14:05:15,129
0x73d48cbf9644f377573675112a703eb7dc79531435ba18c22af52825d5349eb4,t,21000,3048045,,5000095,2018-01-30 14:05:15,130
0xde9ac26eee673cc15d4e43c1093f8beab7102bd993abac3768a74488e0624522,t,21000,3069045,,5000095,2018-01-30 14:05:15,131
0x89c1c5ef7e7587de38316346c57659c866c36389f5e5f5f5271b1220ecc26e7a,t,21000,3090045,,5000095,2018-01-30 14:05:15,132
0x18fa34211b55180489f605ec625c73d005b2b20369304e424d06d64b54991b81,t,21000,3111045,,5000095,2018-01-30 14:05:15,133
0xdf258c0de5284819fa6448dbc68d14b09476270a39c08981324e3b72fea386f7,t,21000,3132045,,5000095,2018-01-30 14:05:15,134
0x17b4c52ecff4919053cd1a39200c6a0d41ee11f3492338ade5018982557d1c01,t,21000,3153045,,5000095,2018-01-30 14:05:15,135
0x86cbcac6cd12f7f333c063f3e23b7083ec2d30a05e00d0b294ae99d9b6e3c1d7,f,21001,3174046,,5000095,2018-01-30 14:05:15,136
0x55dd57d29b649ebbc6cee5403461fb966b67cbbdb90ad6a209f54c3cbebe6452,t,21000,3195046,,5000095,2018-01-30 14:05:15,137
0xf2b8c617d5406aa336fd948b608132ccc8f60a50331903c21ef1145a1a694c5c,t,21000,3216046,,5000095,2018-01-30 14:05:15,138
0x1ebe0b6bb21f6d99da703c24fef3ed4a9c9ae3b51afa4e29117ed7026b4ce889,t,21000,3237046,,5000095,2018-01-30 14:05:15,139
0x7101a512d9d8cffa53a7a49b27914d167a0fb7321b1fb20ba3ba015e5c4deecd,t,21000,3258046,,5000095,2018-01-30 14:05:15,140
0xa570a16801888061845ad378238aaa75b65e906a76603d87c17f2af91fe7579c,t,21000,3279046,,5000095,2018-01-30 14:05:15,141
0x8997fb09322f553ac94bc9cffc732463dff4bc43f9589db5a53d75d5a15479bb,f,300000,3579046,,5000095,2018-01-30 14:05:15,142
0xa32b0efbb58598358759d93157dc093e7527327fcc9db8445eb58ef9407541fd,t,31005,3610051,,5000095,2018-01-30 14:05:15,143
0x14f4c4b3a6cae0ca859a4a5803290049c8acba35faba92c4186d6ac29dd87145,t,80651,3690702,,5000095,2018-01-30 14:05:15,144
0xacb2cb678cccbb82308bf37fc3e1157c10ee64a187d5a94e3e3e30419f80c2a0,t,52568,3743270,,5000095,2018-01-30 14:05:15,145
0x5571758588dd1bcf2c661816b0e9a83f7375e9767528861bb98fd581f4935567,t,21000,3764270,,5000095,2018-01-30 14:05:15,146
0x23ac26277afe47b922ae4cd10bd4dcdd06a1cd2873536bfb9ccbc8ccdeac172a,t,21000,3785270,,5000095,2018-01-30 14:05:15,147
0x54de80eca43913a8293190be1eb104f1997744555ee2ee987e8cefc4f55ad172,t,108242,3893512,,5000095,2018-01-30 14:05:15,148
0x3a232f96a74bba1ee7f8ce51f1c776273a6977da335201dce8186397e16a935c,t,21000,3914512,,5000095,2018-01-30 14:05:15,149
0x7d2b969130c63eab0ed3bf4849f07992daccdf276812a693f435b4c9de37014e,t,52416,3966928,,5000095,2018-01-30 14:05:15,150
0xfbc5d44aea367b4deeecaca7b895783f6c7961d87641b5387bcc20ddbab74f95,t,21000,3987928,,5000095,2018-01-30 14:05:15,151
0x129ef8c542a57e7a326dd6dd3a6bf2261ea8c3b84beaff71d772c4a5a88f56e1,t,21000,4008928,,5000095,2018-01-30 14:05:15,152
0x6f911bf8d115c53b6d02796ba960f777eb3ce33b7097cc5192a1d2a1ad8973c5,t,21000,4029928,,5000095,2018-01-30 14:05:15,153
0x503fba5ad84ca2b6291fa98ef12ec4d1124135869c3b948eecccdf69147cc568,t,21000,4050928,,5000095,2018-01-30 14:05:15,154
0xb5cd4da25b0cf411596c1cc03cb735f9afd8cbc63178f3f787c32561d0a39ae6,t,21000,4071928,,5000095,2018-01-30 14:05:15,155
0x8c7d27264e6e3e1c44c911390cf5727ff3f833bc08db99affbdcdea3d328b53a,t,52524,4124452,,5000095,2018-01-30 14:05:15,156
0x74c27da91ab620eb0abdb5da48581a1fb25dd0952d19f8b059f2bd8fb06c394d,t,21000,4145452,,5000095,2018-01-30 14:05:15,157
0x548540343e76154feb18a1d9ce001dd1b0f4c563f994d94924e02047b081765a,t,21000,4166452,,5000095,2018-01-30 14:05:15,158
0x611405928381bc226b955c7df4da04badbd211de2edf227de7c9a4d8f6508e75,t,51950,4218402,,5000095,2018-01-30 14:05:15,159
0xdc6a7eb9ff1a841864d7a8224b973c7dcf8fa97c77cdf2059078f8fad6c7d0ef,t,21000,4239402,,5000095,2018-01-30 14:05:15,160
0xa913154cf9f9e42e9e369b9af62dc670190ee88762852d434e9ec3eefb37ae16,t,21000,4260402,,5000095,2018-01-30 14:05:15,161
0xf7ad55645b168c1095c3a9732fbc60cc71ebe2dcbf5c6b6aa4c13082bd3184fa,t,21000,4281402,,5000095,2018-01-30 14:05:15,162
0x9f1e41600d38fef4c604e5c10fac2ac75a129d42b7b3d0366754e294eb6db3c9,t,21000,4302402,,5000095,2018-01-30 14:05:15,163
0x91337e25562cb43a78a10bf99180c67abfaad22366bc7fb485829afae6fbc8ef,t,21000,4323402,,5000095,2018-01-30 14:05:15,164
0x4097895e24c62bfc56a3031f8ee601835d50087e51e8c16f9dbf2f7cd666198a,t,21000,4344402,,5000095,2018-01-30 14:05:15,165
0x35811a144ea8802c4db93642158866585af928253831c0a5cbac3a7ddba4e29b,t,21000,4365402,,5000095,2018-01-30 14:05:15,166
0x13331ff210f276b94efec06fdfcd0d757ff6a9083887b70975ac38c2a301be85,t,21000,4386402,,5000095,2018-01-30 14:05:15,167
0x5e2cccc3d3f952e1353b4100695fb855cdcde8d76802bebfe05fbcd75c063544,t,21000,4407402,,5000095,2018-01-30 14:05:15,168
0xdb989f36bc207ffe4a71f30a7eb473dbc97062d00b0def8d4828d6846a50acca,t,21000,4428402,,5000095,2018-01-30 14:05:15,169
0xef9feff66287331df8bbf079a923c69997c4bbcec21e21f3ca4325e981a0ac46,t,92434,4520836,,5000095,2018-01-30 14:05:15,170
0x70c77d219d14355aafe20ed8a4f89c77595e9affdf431bd3c8ab4351c15c4f98,t,21000,4541836,,5000095,2018-01-30 14:05:15,171
0x3c3ef78a7a89431c96d2cbec45cb902b1fd8df814cfdb5d056d0f1399513905c,t,21000,4562836,,5000095,2018-01-30 14:05:15,172
0xc486027271bb5bb80fa28b9b4383f49d3a63baf31720acf7db8b4a45fd064b9a,t,21000,4583836,,5000095,2018-01-30 14:05:15,173
0xe3f4856a7daa3802f1fe76f1be54e5116e28faa4a20f3b8ff53dd03b4303a6d1,t,21000,4604836,,5000095,2018-01-30 14:05:15,174
0x6b67ef5f14253c12f2f112491b13f6d37663701831abd9c5d5dbaf3279606ed7,t,21000,4625836,,5000095,2018-01-30 14:05:15,175
0x6d543d37ae0af0f0d10d0befe3f0b33057ac25b41968a59f986f0442f4e2ab1f,t,21000,4646836,,5000095,2018-01-30 14:05:15,176
0xad3588f27a4c9ba42a6fa89de0b9500980b2ebe96d0f04fc62a7866f7ab7bc2d,t,21000,4667836,,5000095,2018-01-30 14:05:15,177
0xff2601dc0b5766a4e6e04138af38ecfea68fcac5613f6d915a09f65d252736af,t,33705,4701541,,5000095,2018-01-30 14:05:15,178
0xd0fda6afcdda6f943c50a6992463156b9e91ce8bdaecdc208897c49f6a52ddef,t,43842,4745383,,5000095,2018-01-30 14:05:15,179
0x4bfbd5e1f0dd43813cdd28ff7333b7f71de63f5616651ac2f1e94ccc0dd9cf88,t,52219,4797602,,5000095,2018-01-30 14:05:15,180
0x3c995293d780cb4ddd3ff9721a86447e8028a0850c389f0f460b37d97cfd2eb7,t,21000,4818602,,5000095,2018-01-30 14:05:15,181
0x061f78eb1eb79522044965b41da4b7097736f84d07cd3464c70dc7721333285b,t,93178,4911780,,5000095,2018-01-30 14:05:15,182
0x541f2195a689ddf150f95665892127f9551034f15ad21d1246ce322992928103,t,21000,4932780,,5000095,2018-01-30 14:05:15,183
0x45b1597cea316037e609e47e71143fa2989715155c652c5a752ee176bee30360,f,25098,4957878,,5000095,2018-01-30 14:05:15,184
0x828cc630bebef1ec669fc8779579154cd4529e75699caeb1cdb9e050a92fa3c9,f,50735,5008613,,5000095,2018-01-30 14:05:15,185
0xe5ca472f1b3a5472eb18bbd2e0aeaf0e2ac03407436b032ae3ff300d377bca7f,t,21000,5029613,,5000095,2018-01-30 14:05:15,186
0x6350a073eeb95edada355dba7e5bb666bf091936691ccca8225980cddb4758e5,t,242521,5272134,,5000095,2018-01-30 14:05:15,187
0x405eebdda54627b18bf63b90b3f2a707847a237fc8d71a16de31c0c23ba851e7,t,104187,5376321,,5000095,2018-01-30 14:05:15,188
0x10e2d6dd0ba1a3d64f68ae2b4a4e412f77533b59fc022ce18d64529bd3ef688b,t,22091,5398412,,5000095,2018-01-30 14:05:15,189
0x7f34f812788d80d21ac93e0d4e6dfe773b98c51e396e041d3e330a8ed7c9aacd,t,21000,5419412,,5000095,2018-01-30 14:05:15,190
0xdbe54f1c33e45c04e4c11dfb6e7edf8a6ec69c2cbef8797ca647ea983de94e20,t,21000,5440412,,5000095,2018-01-30 14:05:15,191
0x27c4cdd3ffeed76558a3aa158fb6a68bd7f4de26bb6b8979e63bd513374a74bc,t,21004,5461416,,5000095,2018-01-30 14:05:15,192
0xd2c9cf5fa643f282f0833c38898901f457b9f75d262d2e730ace0c95e5a4ea90,t,21000,5482416,,5000095,2018-01-30 14:05:15,193
0x145228e2e6406453cf8ba1c4ce0597b8ad5855227ce89d5f15bed71f10c28c18,t,70195,5552611,,5000095,2018-01-30 14:05:15,194
0xbaf198b9874ac2e2e2169d4f63c962534facac020ff465c2843bef5e72da9915,t,52235,5604846,,5000095,2018-01-30 14:05:15,195
0xd6263a0177f9b0fcb4048a340ed6dbcf460f59e343e499aacb560af4b233f09f,t,21000,5625846,,5000095,2018-01-30 14:05:15,196
0x5b444bee6c6f35ac6fa5bf63720c29f62650a47ef9cdc75d09fc3e095d3aa6b6,t,21004,5646850,,5000095,2018-01-30 14:05:15,197
0xea382d8d1fa8bed80355696381d58cceca2fdab0aa7e9922ed419acec571eca2,t,29063,5675913,,5000095,2018-01-30 14:05:15,198
0x65806c27a0247c9011022ca65a3efc28353ec2dedecc9c0d17bc796b348d2953,t,40797,5716710,,5000095,2018-01-30 14:05:15,199
0xf3f405c276abd8bbffd9ba6023ed20838a24685a146155a76dae642668629217,t,40797,5757507,,5000095,2018-01-30 14:05:15,200
0xfba0012237f2f7e0f8e986247a526b029de820b5bed6cab2a2fe904b697ffe91,t,40797,5798304,,5000095,2018-01-30 14:05:15,201
0x821615093d4876a934a5e632875eebb5086297f5464ea0b1381b134891de6611,t,40797,5839101,,5000095,2018-01-30 14:05:15,202
0xd85828ca1d3a5309c6c2cd3445260eeec48372c3b5d4e1997a7deeecc325fc20,t,40797,5879898,,5000095,2018-01-30 14:05:15,203
0xa06ebf6e01c7d6482a9ff0e435b941a4285e466478353e602cf02045cc5fb621,t,40733,5920631,,5000095,2018-01-30 14:05:15,204
0x88eb6ca0f59db08cc937c392d6636f5c6379372bd7f24e8d3196b96c9fde2e76,t,21000,5941631,,5000095,2018-01-30 14:05:15,205
0xe75f0c12eb73fdaed2957993129b351b1ec32f8eac3ade7932693a1647902bf2,t,38624,5980255,,5000095,2018-01-30 14:05:15,206
0xd2fd8a1d5bdc6039eb25eba85e672d581ef45b90b2a673bf26b6fad3d810cb66,t,21000,6001255,,5000095,2018-01-30 14:05:15,207
0x32bc8e05ef38f9c5f71acec02fa0a7ca21cbd7cb065c1f74fefa4af645984a16,t,60109,6061364,,5000095,2018-01-30 14:05:15,208
0x258dea5bc5deb12196789a418ed910143dc89d5003041f2f63ceb7e212c5e90d,t,21000,6082364,,5000095,2018-01-30 14:05:15,209
0x58a1cde6b41578ba560eb516484f9f203c55c8d47b91e3b074e8131928786fec,t,83569,6165933,,5000095,2018-01-30 14:05:15,210
0xe03c6214d571bc745b493646dc14c5e50533f861a1e5f36d62b9f0e0524ef620,t,21000,6186933,,5000095,2018-01-30 14:05:15,211
0xedd83f263a47c3c38e2319ce1bca90cd20daf19d04037415fb3718f90e4ed5fc,t,21000,6207933,,5000095,2018-01-30 14:05:15,212
0xfd05aba6b8b1749e6fbd180c4543d922f330229e3d8dd2cd1cc6028b2dc0320d,t,55843,6263776,,5000095,2018-01-30 14:05:15,213
0xeaa7b57fbfe23a02f49cca985505082e9b354450fa029734e24c2f268bb1183e,t,110342,6374118,,5000095,2018-01-30 14:05:15,214
0x5da10358fda9a0299823d07a14b27202e32c565d6d6d0efad1ce54f309d43b3d,t,30981,6405099,,5000095,2018-01-30 14:05:15,215
0x6d9da781af5c4281f88b020e9aab599fcc21af3b1db68dad6112142ab8cfed5f,t,30981,6436080,,5000095,2018-01-30 14:05:15,216
0xf48ed02fed482d50904c4e1047d91bfd19ec97173b6539772272856c5c0359b1,t,30981,6467061,,5000095,2018-01-30 14:05:15,217
0x78a5ab479ed9c5d0d255863b63696399bde4c07c02741c904f1bd099b1d82493,t,30981,6498042,,5000095,2018-01-30 14:05:15,218
0xf3bb6ca555960e1eab92951aed8f3047d31fcf61ac3ba879d5d735d78f4f9e03,t,30981,6529023,,5000095,2018-01-30 14:05:15,219
0x6edb58c4ed4672e9b28289bac72f180571576a1448f433f9731ef16dfdcbafe4,t,30981,6560004,,5000095,2018-01-30 14:05:15,220
0xb2b85db5ddfa3a43ca5901693871e1d39f184563e2a33f1638f3d44873eafb26,t,30981,6590985,,5000095,2018-01-30 14:05:15,221
0xfb2008dd597dca18c9235516edbba6d0920172d04cabd28593045192026483f3,t,30981,6621966,,5000095,2018-01-30 14:05:15,222
0x950699ffd76430ac13f58e0015076851bb8cb22895a0a6da38284d44dc989cae,t,30981,6652947,,5000095,2018-01-30 14:05:15,223
0x4e93579bd91fe838150bf18bb3ed7cc4a9ad17e736a871afa2aa3680ed0b0b76,t,30981,6683928,,5000095,2018-01-30 14:05:15,224
0x2d8e708196bf35617fd33b0fa47208ee26bc75fd8367bee21dd5262355e952de,t,30981,6714909,,5000095,2018-01-30 14:05:15,225
0x163c7323026fad2d58c877da075ff90a572276fb5241f3284181a4827d27742b,t,30981,6745890,,5000095,2018-01-30 14:05:15,226
0xa8ab15aac83638b9bf04108a5d302b626b45b75d360518bc26d6c80e88cf1349,t,30981,6776871,,5000095,2018-01-30 14:05:15,227
0x818591c81d588eb9a5778891044d870fb0556bc9764930cf47c22f2be76bfd3a,t,30981,6807852,,5000095,2018-01-30 14:05:15,228
0xca859fe90a269eb458731cb9dd4a2d91d1a8e40f17d3e3e0c0ebbafff7a161dc,t,30981,6838833,,5000095,2018-01-30 14:05:15,229
0xb356ecd9f0005843957cde982e801380c0dc80be9a7ffc58e30f47b54e5f07a7,t,30981,6869814,,5000095,2018-01-30 14:05:15,230
0x6aa55d6bd923096d4253db038267477233e32d3ed17ae746935314d49c6813ee,t,30981,6900795,,5000095,2018-01-30 14:05:15,231
0x4bb5cc7fdb08c43fabe07dca3093093714ea55ff7b0082f2404feff2d3fb9719,t,30981,6931776,,5000095,2018-01-30 14:05:15,232
0x9cd030708304a3c840313c1701cc029822fc60ae00ada195bfdf45ce6e3c8363,t,30981,6962757,,5000095,2018-01-30 14:05:15,233
0x7030043cfb2eab3b222b2e1722eeb7efeb95d988e3ea4978bcf109d7fa005495,t,30981,6993738,,5000095,2018-01-30 14:05:15,234
0x4385d4758ad2d33c69908d15bf19522189700b3c824677a6958b86f60c4f0a4d,t,30981,7024719,,5000095,2018-01-30 14:05:15,235
0x078463ef3fbfb602b8752eaad00b12dde9089b31f349f2db87d1890fb63d0fed,t,30981,7055700,,5000095,2018-01-30 14:05:15,236
0xd41585db8561dbeabb62307e69b2f25d193edc62d6ca1a4106c9d95beb4350d1,t,30981,7086681,,5000095,2018-01-30 14:05:15,237
0xa863348efb619aaa9e272758d875b334a599fd77cf0a91036fc93d7074eb76e4,t,30981,7117662,,5000095,2018-01-30 14:05:15,238
0xdf85cbdaf543b0d006a7b0f4c05d5ed21236821c4789a1e03fad9e35a27df828,t,30981,7148643,,5000095,2018-01-30 14:05:15,239
0x6cc05344e35decc63b27ed5408c42b8fdebabf81b986fcd9f098ff76b5ed8b87,t,30981,7179624,,5000095,2018-01-30 14:05:15,240
0x791f853fa7d004bf0c998c1bf4acc1886d5e58589e63f5af245c2a56bb2c62b5,t,30981,7210605,,5000095,2018-01-30 14:05:15,241
0x0efc2045dc0862a7a169df2c48b6153c23d125c4518713920d3df737eb72f064,t,30981,7241586,,5000095,2018-01-30 14:05:15,242
0xc3a6d6456b4bea9f9a67b6e98720afe514a8eef135a33ad8732a8a17edd9a076,t,30981,7272567,,5000095,2018-01-30 14:05:15,243
0x6fb56499f56aaa3fb0f2d83b5be8be675091e887d8754775eb8756214f04c515,t,30981,7303548,,5000095,2018-01-30 14:05:15,244
0xa7a4772694d873b2e72d60ea9462cee70e2d081d29188f890a5dc420c1e28d19,t,30981,7334529,,5000095,2018-01-30 14:05:15,245
0xfae2dbb5d0dc8f31ee080e10cc1114e5b2a5dd99dd8dec681505502346072a73,t,30981,7365510,,5000095,2018-01-30 14:05:15,246
0xe645f4cab54941e527a2a90e49b26b848b7c098bca6cbd8d33cf21815423b9dc,t,30981,7396491,,5000095,2018-01-30 14:05:15,247
0xa59e84e6d517adf3f63d366c63a740473581ab268886bd6c9c5a5f983af5dc67,t,30981,7427472,,5000095,2018-01-30 14:05:15,248
0x1e93e4bae7597d0a11cbd5014295bcfa3f3b5ab5181bd7cb951a06a1b226d1d0,t,30981,7458453,,5000095,2018-01-30 14:05:15,249
0xbd141a754604f343adc7e1f9321f61627449a658938a327012c781d620c05aa3,t,30981,7489434,,5000095,2018-01-30 14:05:15,250
0x96a4a4454cea440ef242def8d54d88689c834656d81c7ad324ebf434a1e63c8c,t,30981,7520415,,5000095,2018-01-30 14:05:15,251
0x8f298461856ee26122273500f81670c4957ef6b98fd0f3e2c8392d138dd53224,t,30981,7551396,,5000095,2018-01-30 14:05:15,252
0x7dc9adccba12a5848af912929d2012a80fb0cdf88d0f73feb7d85b5b1e97c766,t,30981,7582377,,5000095,2018-01-30 14:05:15,253
0x185d102cf17c8c5417df4ec1f659998ce2d06ea8f7d3991613ad0ae74b16d681,t,30981,7613358,,5000095,2018-01-30 14:05:15,254
0x4765338c56f4d8a8a5c8786a28645415e5ea06231c1c1a8534de955b5e0ef9f4,t,30981,7644339,,5000095,2018-01-30 14:05:15,255
0x649d728a142550071ab3dd2328edcfedcd448a7c6968b9095133e1555a2bb7d2,t,30981,7675320,,5000095,2018-01-30 14:05:15,256
0x420e4ecbe90bf33cd1ec1a7cbd15a78c81a893d658c36c5a11ee851488f07088,t,30981,7706301,,5000095,2018-01-30 14:05:15,257
0x2da65f9d309d5ff7c1fc45d2aafa2e2062986dcab47474ccab5d9eeabb7acfa8,t,30981,7737282,,5000095,2018-01-30 14:05:15,258
0xe293f5329aa7ce69892b04ba9804eb1b1299b834186599843cf3d84a86b440fd,t,30981,7768263,,5000095,2018-01-30 14:05:15,259
0x85380a0d446e4b34cd416353bf274c6ed8af020150cd01f6feedb34bfc613f38,t,30981,7799244,,5000095,2018-01-30 14:05:15,260
0x220b6d85a9cb548a6c0e6ef066d04ebe4c2127c7d324f3c8a7cc7136caa7eb4e,t,30981,7830225,,5000095,2018-01-30 14:05:15,261
0xf5dcd0068fff1c995fc99f5c35d1fbebf93844e2b3a51ee98d417d997ff7c135,t,30981,7861206,,5000095,2018-01-30 14:05:15,262
0xb4999731983f5126fde3cb90efdd0e17c25b735a19503fae31bac89d15eeb665,t,30981,7892187,,5000095,2018-01-30 14:05:15,263
0x900d6c72a4a06baf86f8a6237fae85c943e3bf33c025a86149944729bf8759a7,t,30981,7923168,,5000095,2018-01-30 14:05:15,264
0x01dddcee677cc1b9eb72619a6dd44a585b7ec2e05b2f43af2dd76c93c8b3459f,t,30981,7954149,,5000095,2018-01-30 14:05:15,265
0x52fb8b7eeacfe3da44ac31659ff153d8aef45d4964b6478bf72aced0b9ae6eac,t,30981,7985130,,5000095,2018-01-30 14:05:15,266
0xfad0dd3cec1748ca2dbff032cd9cc4b497db763d14177244551e990a3c6c2026,t,21000,21000,,5000096,2018-01-30 14:05:35,0
0x7da3bedb4cff3ec9ddf08d1c7d1d5ae46de9ec58ec6f0b3403a4984162f71850,t,21000,42000,,5000096,2018-01-30 14:05:35,1
0xc2415d38a21d63a4a7916522d02d1ba4097b05effb131c41d70459de37af23eb,t,21000,63000,,5000096,2018-01-30 14:05:35,2
0x42cfcf3fd1a344cbedc692c870959294bf1eccfdfcb71e3a00fca001967df670,t,21000,84000,,5000096,2018-01-30 14:05:35,3
0x847bde067b2c82aa6387bd5da1a997214998fe309bca9db678b5cd55b569dade,t,21000,105000,,5000096,2018-01-30 14:05:35,4
0x5c77bc42d07880510d84fd9db3e3da493bba40442346d98d45fae54f41e93824,t,21000,126000,,5000096,2018-01-30 14:05:35,5
0xa85f171c595f443daa3f83e56fff93a82e63e01d9a8a3808f80f6503129088cf,t,21000,147000,,5000096,2018-01-30 14:05:35,6
0xe48b1f0460646e8f0b8ad45e5bddcd963d29eac5ef4b863ed36da6834ec9c172,t,21000,168000,,5000096,2018-01-30 14:05:35,7
0x72fffab3e6dac42920a672303d3c5445394d26d7928d7f9693151b3a4c7e9d50,t,21000,189000,,5000096,2018-01-30 14:05:35,8
0xaaf2f5c3f72cec10f488e02a253667b5ea4fe3a592be6091cda341a839526657,t,21000,210000,,5000096,2018-01-30 14:05:35,9
0xe089d47aa9e303a788b201bc13dbfe48507f13843c0cc46908b73084922bef3a,t,21000,231000,,5000096,2018-01-30 14:05:35,10
0x9b2f33108fe818c6454e382f27a373bd9523d85d34675b6e9adaf2a88c76695f,t,21000,252000,,5000096,2018-01-30 14:05:35,11
0xfe40b45793d68226dd604eb27c275dad5dbac9de73bb4b4bbd4b509161223ce8,t,21000,273000,,5000096,2018-01-30 14:05:35,12
0x06a1d1f95113a97869a846af8991ed4dda665aaf7fc14f3a4bfd50def32e0791,t,33705,306705,,5000096,2018-01-30 14:05:35,13
0xa2e974e4cf47eaec7376b7facf87ff04ce4edd5b7815e6bcebaf83be55d60e84,t,21000,327705,,5000096,2018-01-30 14:05:35,14
0xabd0039594a0b758876b05de6ec69ea8db48b2e69516c8d408a19f8f650f39d9,t,21000,348705,,5000096,2018-01-30 14:05:35,15
0x26f6d9fc3695d72fe15cb8ad89bb729b0ca2aa1df52168e4ed139e113f58fb12,t,21000,369705,,5000096,2018-01-30 14:05:35,16
0x2d0e4471de81a6e697d587a2845e7c77d43a23ba16dca25154f06bbee34f6d20,t,21000,390705,,5000096,2018-01-30 14:05:35,17
0x68b7682c21279ac8c983330a18f87ac0cd0ce3a94bed59f14c07c91fea5e4ae6,t,21000,411705,,5000096,2018-01-30 14:05:35,18
0x6f86f32d29f447d6ae0390fd375707e1f636745025913578af665aa79acbf0e2,t,21000,432705,,5000096,2018-01-30 14:05:35,19
0xd1e00452b296a5329548dafde9b42763b0301e259bd4b5166a3d42906e93b2fc,t,21000,453705,,5000096,2018-01-30 14:05:35,20
0xc31941f2a539f58c4b509389ea8beafcfabf6c33b2265f1caffe18de280dca00,t,21000,474705,,5000096,2018-01-30 14:05:35,21
0x55d1d8bbbbd72c7922c4b4c4af1d948330a3f9928fc5356569059b59328debeb,t,21000,495705,,5000096,2018-01-30 14:05:35,22
0xd77adf3ab2f619ca370dde044159da420ebc8a3d3e2383161e3ee6121517bcd8,t,21000,516705,,5000096,2018-01-30 14:05:35,23
0x53267853f170f2f3c7b0fdf6ebf10d961a93f875927358438b80e4fd42384712,t,21000,537705,,5000096,2018-01-30 14:05:35,24
0xe44dd473e48e116e88e04f2a841d655202f75a61a99faa95d2e45dc450f18a34,t,21000,558705,,5000096,2018-01-30 14:05:35,25
0x67dc89f4205a513940f78f9dda339712a0de727cdfd78d1ed4bd54606339358b,t,21000,579705,,5000096,2018-01-30 14:05:35,26
0xc1e32185d779c1636b94c1cc2dec5286dff7a738ebba2cec4c6d8d2005a65ba3,t,21000,600705,,5000096,2018-01-30 14:05:35,27
0x6dbce465dd7c521d3d7c4744d1244d55bd1b906170ec11bb2a9eb70c447199e4,t,21000,621705,,5000096,2018-01-30 14:05:35,28
0x4f2858703a312b8a020143532a30e5d6bb209c338848f33a956a197893af363a,t,21000,642705,,5000096,2018-01-30 14:05:35,29
0xe5490d5a6b68cc1afb40deb12596a051e09676463d60898801342ec437745f72,t,21000,663705,,5000096,2018-01-30 14:05:35,30
0x93e1a8d0443d3405c7e8c341de20e98820242d981312b6bebcfaedccf0799865,t,21000,684705,,5000096,2018-01-30 14:05:35,31
0xe72740e12e6897502cacd32a0de0c6f6be8d0d0228b49043d1ae0d893a711ebc,t,21000,705705,,5000096,2018-01-30 14:05:35,32
0xb9860892ce35d94c796a8cb26c30a7da257569af4b27e7e279b19c540239c749,t,21000,726705,,5000096,2018-01-30 14:05:35,33
0x5d3019c34752acc97b9a82deb88b4d89ec0260d086fe6bf33ba2f87245e723d0,t,21000,747705,,5000096,2018-01-30 14:05:35,34
0xf3e27570d9dc8dacf087215cb8a12383aa346c123e55665ba593e231f6282d61,t,21000,768705,,5000096,2018-01-30 14:05:35,35
0x46c569cc8925e4fda962add65ddf93f5ff0c568e5675ed23cde321374532f027,t,21000,789705,,5000096,2018-01-30 14:05:35,36
0x6286173cc04227b7ef380879031a7d3916809d26a40035cbc5c25f938d10c3c6,t,21000,810705,,5000096,2018-01-30 14:05:35,37
0x358391caa04206b99f393af81239dfa25e74d8b3c8fa20e4c73e7bcb703c62dd,t,37173,847878,,5000096,2018-01-30 14:05:35,38
0xd8081f1e6d33daffce995a775695357fbb93059e3e666899b530e02760860184,t,21000,868878,,5000096,2018-01-30 14:05:35,39
0xb896f32fa04f56281badc4f5cd16088f69b529847f63375e38114cbfa128b0cd,t,37524,906402,,5000096,2018-01-30 14:05:35,40
0x2660134373e8dbb529031f393c61cc57037a909d6cae0b4d2ed9794156164bbc,t,21000,927402,,5000096,2018-01-30 14:05:35,41
0x3fee52dff930122455309666c54579b3e795cb817ee1aeb39995984e9b960638,t,21000,948402,,5000096,2018-01-30 14:05:35,42
0xc9656762760c9b34fbe507dedf04eedc4aeeee550491677dae89686df54d4e92,t,21000,969402,,5000096,2018-01-30 14:05:35,43
0x9eefee90c87358406dc16c5a5eae64f47c36d5bc50614620374c3c0612e988e5,t,21000,990402,,5000096,2018-01-30 14:05:35,44
0xbd95d814899117c5d1f40acc2c68ae191d760c2ab0ce6514344f051426ee2b5d,t,26183,1016585,,5000096,2018-01-30 14:05:35,45
0x76f479c46448cdff558d69821280ea381cf82fb148459cafa81479416c60eee1,t,21000,1037585,,5000096,2018-01-30 14:05:35,46
0x726612a14431e98353b9a021935855553e9458a28851e6d03c7cec8a8e6149eb,t,21000,1058585,,5000096,2018-01-30 14:05:35,47
0xbf28619197b3a19016fb1c4c67b304f351d4798e10031007fd563a1ae32d0002,t,21000,1079585,,5000096,2018-01-30 14:05:35,48
0xdba1692d1ed889ecfedc3486b24fc736c898317c33afb68ef699a630dc8f0f97,t,21000,1100585,,5000096,2018-01-30 14:05:35,49
0xa633e7801c9dbe5fca9100ee80581fd2cb1ec7932d33c4432482ee6b462722a2,t,50057,1150642,,5000096,2018-01-30 14:05:35,50
0x34a49cc513e0d10be24e8c86887b96c161fccfd4098ee8a30f8d18fdc824b8e3,t,50057,1200699,,5000096,2018-01-30 14:05:35,51
0x7a92a5482bb548ed6f67ef835a7c5b330fc7b740631c601ad6d164b0bf7861b2,t,50057,1250756,,5000096,2018-01-30 14:05:35,52
0x2e88f64c091192df4ba4dd0eee50e547af457245e5cb29eb9ccdf981dd3b1847,t,50057,1300813,,5000096,2018-01-30 14:05:35,53
0x7096173cf03eb447e5d8a579682c2e86b568576e7e9044e15231ebf07c303306,t,50057,1350870,,5000096,2018-01-30 14:05:35,54
0x1b341beca169c51cfb7172eaa588cfa58efcf81194e761db7a820ac7cf4fc209,t,49993,1400863,,5000096,2018-01-30 14:05:35,55
0x0df3b7589ea45eb98c6dec1eaef26ae02f6d442c025e191dd73df117cec65d2a,t,53590,1454453,,5000096,2018-01-30 14:05:35,56
0x365da958b8b23e392761bc9d7258f4c9f20167fdf931243e6c50a07b15fec7bb,t,21000,1475453,,5000096,2018-01-30 14:05:35,57
0x4fa75298c9888e32c86551640e1901a4ffe49e0f3ec8b51feaee5dfd5f3daa4d,t,21000,1496453,,5000096,2018-01-30 14:05:35,58
0x58957f4e7f9b37cdb349bcdcbf2c3804ca520b175787ee266bd4ac897108f295,t,21000,1517453,,5000096,2018-01-30 14:05:35,59
0x03f6f77619a1c5ae557098bbfb92b62d8ff77d0b8aa01b622376a07f1dbf4f19,t,21000,1538453,,5000096,2018-01-30 14:05:35,60
0xaad3f624641737858c3499fabcf8bce051ccf8cd31efb217fa598050c7dca5a8,t,21000,1559453,,5000096,2018-01-30 14:05:35,61
0x34af9f877a143b4107e5cd1b4156cabed76861f3aeda4dcbae3e55eff207c19e,t,21000,1580453,,5000096,2018-01-30 14:05:35,62
0x30795a6ab059039309536c864c25ade0e5453a58597397bea265a78c6d67daa6,t,34978,1615431,,5000096,2018-01-30 14:05:35,63
0x7f8587db011f74cf8f6438d7d413ebc08ed449ea59cd67d37049b06d7605b117,t,21000,1636431,,5000096,2018-01-30 14:05:35,64
0x1ba16461c8bcfb4a850b9088862d153f68f4a3b4e8b9411474b5339918e1de0d,t,21000,1657431,,5000096,2018-01-30 14:05:35,65
0x45bf6e89a13df0bfc6e5bad15e85d1b786317ed4ba62294e5800f1563468f6bc,t,21000,1678431,,5000096,2018-01-30 14:05:35,66
0x7d5782e1c065033770c8f062f815308ad10350fd7635c51d4f2d2442fce5dbe3,t,21000,1699431,,5000096,2018-01-30 14:05:35,67
0x163ac928c51e24955160b178468d619428037cd52dd676ba397bdbae7bd9b8ed,t,21000,1720431,,5000096,2018-01-30 14:05:35,68
0xcb98a32a22b250e2d4865aeb9b3cd2bfee72d26db2b230a3e4371a88879db202,t,21000,1741431,,5000096,2018-01-30 14:05:35,69
0xff0676c96383b976466556aab8c0e38adf86f8b2f25d11c81da0e6654b9c6bc8,t,21000,1762431,,5000096,2018-01-30 14:05:35,70
0x1d6f6a77cdb5476eb2b973c57bb51c62d70926289dbff0048258edcab43a654b,t,21000,1783431,,5000096,2018-01-30 14:05:35,71
0x8ec98cc28d69837f19e5a771895977ad18990563e870ca58fe362c4b5ec191a4,t,21000,1804431,,5000096,2018-01-30 14:05:35,72
0x7e39d07b84a094b83ed48f7c4b3f57fa16d8f9281692ea4135f6a82ec77ae940,t,21000,1825431,,5000096,2018-01-30 14:05:35,73
0x4728da7cfc3a2fc49d3b1bd0b6a890f4039eab26f084d8df8f62c612578eda26,t,21000,1846431,,5000096,2018-01-30 14:05:35,74
0x997670ae9eeef979578c8e01a2a8073ab3793ecfa4ebd3ed45b718db8378b470,t,21000,1867431,,5000096,2018-01-30 14:05:35,75
0x0aece08fb1955c575ca52c547c30547017e5f6f9dfa6aa0dbada4a72618482a8,t,21000,1888431,,5000096,2018-01-30 14:05:35,76
0x4b9f1bdf6d80486ab7075db3598fcb810222b094399f1db2383098bc7dfeef16,t,21000,1909431,,5000096,2018-01-30 14:05:35,77
0xad8af9f531b5a56ac3d5adbe3d37b49e4d3e9e10560e6de34131596b2f129313,t,21000,1930431,,5000096,2018-01-30 14:05:35,78
0xdf11486ef943e7ee2476fafb9eb1c8aa6cfffd2816db1272f392d11d2252722a,t,21000,1951431,,5000096,2018-01-30 14:05:35,79
0xdf7af20baa9bf7006c2145820a177b0c918bfd9bba07a3af213b9d12e7e9fd3f,t,21000,1972431,,5000096,2018-01-30 14:05:35,80
0xca09236770972be5a5f97ca15c5728f916e9076af96f219ba9738d7eee9f518d,t,21000,1993431,,5000096,2018-01-30 14:05:35,81
0x917cdd22a61c568499ff024a3d8d85292dfd05ef808341306d915b6d754823af,t,21000,2014431,,5000096,2018-01-30 14:05:35,82
0x74776a35deb567937b68be9ab0bbf4be49cf9715def4c0e70cbdbc0bc7c0fc32,t,21000,2035431,,5000096,2018-01-30 14:05:35,83
0x008e66fc2cf7f74323d2253cf67d7293ff04d0ecdd1e9b64e9d5ea2fd1703eff,t,21000,2056431,,5000096,2018-01-30 14:05:35,84
0xf48c3126b19fb41487ac16879d6367eee14f751351c31c0065f36fd61b935488,t,25971,2082402,,5000096,2018-01-30 14:05:35,85
0x899726c6134d5e2ecb15c99a81e1bc7c69d99ae4d6da68f15d61ad1012ba66b4,f,66666,2149068,,5000096,2018-01-30 14:05:35,86
0x431bcf8e014d76c5cb1b7fce1ca1558f3d75d3e8a1d2e712548e2828038274c3,f,66666,2215734,,5000096,2018-01-30 14:05:35,87
0x2bc42f7811a4bbe1c9614b208d342d565d6c8007d2ae6134d27133e99ce5ed2d,t,21000,2236734,,5000096,2018-01-30 14:05:35,88
0x7beadf8b00f63da1d0433d2c6f72ca016eb34392b9e8242be9688161bee14ed2,t,21000,2257734,,5000096,2018-01-30 14:05:35,89
0xf3e0d9fd363a0b509c0d47730f2805d413d6a5946f8fd3b4b1a603959a2dfa5f,t,21000,2278734,,5000096,2018-01-30 14:05:35,90
0xd3bd8154880582bc253a8e9f05d67afbb83f1a713a53db8a9b30e44f36cf7cc5,t,140972,2419706,,5000096,2018-01-30 14:05:35,91
0xdc35f7f775ab9bb0ab3c5dd77e08598e05b634876ae5e219146f55932733881d,t,21000,2440706,,5000096,2018-01-30 14:05:35,92
0xf70b6fdb44bda90408b7eb58d4f152369e32081052c21ef4e74798acc4a20382,t,23115,2463821,,5000096,2018-01-30 14:05:35,93
0x22863a6f682104145d41b2c3a1db3b36d4b91850b4d5330349a465b48b4c5e3b,t,118634,2582455,,5000096,2018-01-30 14:05:35,94
0x437b75a4482c588db1af85c97fb5d147d55b89041315e1f761538960cec45dbf,t,21000,2603455,,5000096,2018-01-30 14:05:35,95
0x032f04f0fa7ed1bcc7bd53dc5508eafdc0727faeb8e1513bbc974c563b06dd65,t,21000,2624455,,5000096,2018-01-30 14:05:35,96
0x8cb0d2a0d6ede5792f047b15e6102edce6b3ec03739e6c5eba9a99e11590e7da,t,21000,2645455,,5000096,2018-01-30 14:05:35,97
0x35b5ef1999ac5ad6a3bbacf42c529d694df36454ec7ff57afa473a7829e2285c,t,21000,2666455,,5000096,2018-01-30 14:05:35,98
0xa1c60d4d20b3291176446847d1a49eb72035f3d2a3f790bbbe6fbf8d4fe64ed4,t,21000,2687455,,5000096,2018-01-30 14:05:35,99
0xc81807230c8ff254fb137f069ca50c7e9fad642fffaa8dc1a3677b0aade42359,t,21000,2708455,,5000096,2018-01-30 14:05:35,100
0xa38d0a428bbfad0a151dbe3cf9f4c294af2c1d60259221920dcde00f7b4fa823,t,52441,2760896,,5000096,2018-01-30 14:05:35,101
0x3d9511eb1c7bd0725567995a93af5d8704f2eaadc79ec96d58047b63b6858266,t,21000,2781896,,5000096,2018-01-30 14:05:35,102
0x92a216d93d32880f4cd52c4bc7b751494469c6196b10885b69a06b082774ac69,t,21080,2802976,,5000096,2018-01-30 14:05:35,103
0x8ba5369b19f85774d56060e8e70b619764ab760e4725fd86f02b873f970370d3,t,21000,2823976,,5000096,2018-01-30 14:05:35,104
0x2b459c753e3b01d0ad66455d56d36551527500ffcea5c3a9b28d479e5ddc9a5f,t,21039,2845015,,5000096,2018-01-30 14:05:35,105
0x25bfac226469b9be1d0647ea87e1153c19afeee99bede6089b82b8babcee9f47,t,21000,2866015,,5000096,2018-01-30 14:05:35,106
0x4bb2f88315a6adecc1897dcdd9a77a13582410f8f66b9f3ee2d84594717d41b4,t,21000,2887015,,5000096,2018-01-30 14:05:35,107
0x56945355494a08b25a9cc76b6fceae3647c043da61990764644af2e75ac9fcd6,t,21000,2908015,,5000096,2018-01-30 14:05:35,108
0x0d28c3b14242385d7958a540e06a671579a89dcdfe1e7768c9cabb49ec3a8c8e,t,21000,2929015,,5000096,2018-01-30 14:05:35,109
0x2583925221bc305646142edfece4d72f7362e2f5c32cda76a40756a46be8210d,t,21000,2950015,,5000096,2018-01-30 14:05:35,110
0x128f7b779703696d8d56c4dfd5d7812962cb16aef27b83240bc71dc96818cb51,t,21000,2971015,,5000096,2018-01-30 14:05:35,111
0x85c01017a23fd528d484e2822bb563c1faa8fe3846817d846544157701fd7612,t,21000,2992015,,5000096,2018-01-30 14:05:35,112
0x4bd12a3a610c1a366d0af7b5f3a77136e18048b640f9e254468190f04ed22639,t,21000,3013015,,5000096,2018-01-30 14:05:35,113
0x0d9ff8adb320acfd86d7ade4d6383f678917ca1feee5580189294e285d897091,t,21000,3034015,,5000096,2018-01-30 14:05:35,114
0x8400f2777657a0a4ea39e8520be9f699ba56b8fc29f4ae07b85f665e0909e686,t,21000,3055015,,5000096,2018-01-30 14:05:35,115
0x27d8a4b9dea1b5d06e057c1aceb5103cccb0dc23a5a36a7957bbd6f234b8a414,t,21000,3076015,,5000096,2018-01-30 14:05:35,116
0xc81bceb0b6b4757827e1c74e66793494715b5d52621bdc5deace50d0b39cf029,t,21000,3097015,,5000096,2018-01-30 14:05:35,117
0x5b5efb7da1a3a6ae2ae0a552f8a4d63520c1734ce2f4ef106b75f6b533b009e8,t,21000,3118015,,5000096,2018-01-30 14:05:35,118
0xe901d35e24486e9ef6bd872eb14bd4da062872e92dc4929ba966581268d612eb,t,21000,3139015,,5000096,2018-01-30 14:05:35,119
0xd77c0c3fbe2530536a1b0457f641f89ff2bdcbcb0bdae6e61d7c95468ebda59f,t,21000,3160015,,5000096,2018-01-30 14:05:35,120
0xceb8ae490cb6b00c0d01303b372eb05f7680ba5aa8a75bd21eca28250838056b,t,22950,3182965,,5000096,2018-01-30 14:05:35,121
0x7e8afbc4274725d4998f804f5a2683950bac22b4ae1b57f7713695fd7fae77fb,t,21000,3203965,,5000096,2018-01-30 14:05:35,122
0x66fd1e8576dcf105520b6ad73923218b66a3f7bb6ca71cb1781370b0de33beba,t,21000,3224965,,5000096,2018-01-30 14:05:35,123
0x586cb5e28b5d8ceb35fc7417cb0488ec393aaeea4f9eeebc943f6a8e568710a2,t,21000,3245965,,5000096,2018-01-30 14:05:35,124
0x8619dcaa2746789fc878202c18d18c584dae3a07dae8de28f007729eb4781143,t,21000,3266965,,5000096,2018-01-30 14:05:35,125
0xbc6949a4c661859aa87cc3affc3d0bb48c4afba3d82cf273c38ae712330029e6,t,21000,3287965,,5000096,2018-01-30 14:05:35,126
0x6ef2388fa776c8b183f13cf54e268d9ba1f1fc4687bf47d4fc5c1050155bf527,t,21000,3308965,,5000096,2018-01-30 14:05:35,127
0x470d5659dbf69e182cd3ca1caea8a43ffc3dcfcd2d67e968ae4a662527408f93,t,21000,3329965,,5000096,2018-01-30 14:05:35,128
0xab81f5cb4d77c982e8bcea7a4f78e36bb48710d1be41f1b3df794e1f2c2d8bc6,t,21000,3350965,,5000096,2018-01-30 14:05:35,129
0x30d8ab5fb4233ccbfcda00f87fa5bfd172b22888d38a6789fae85f326e133b2c,t,21000,3371965,,5000096,2018-01-30 14:05:35,130
0x80a4e41178595487453feab1d6b08c4cdbfb8221c6bf5753b8079e3d8e4f437d,t,21000,3392965,,5000096,2018-01-30 14:05:35,131
0x99d77be7c97f8f4b574b591572d07bbb2c1f1bc75100b732b9e6ef1ff3d52d3c,t,21000,3413965,,5000096,2018-01-30 14:05:35,132
0xd034b3de97d1b5e98cafa3596c8339b89d988991eafa0f04b2fa3b07bed939bc,t,21000,3434965,,5000096,2018-01-30 14:05:35,133
0x848e51fe33cf6fffc286c5254aec93ee1743a95cb184ee9383bc1ea28b942e54,t,21000,3455965,,5000096,2018-01-30 14:05:35,134
0x25d732cbd1fecdc127ed38e9370020222f6081a6b94e80ae4e4ff0299014b8cf,t,21000,3476965,,5000096,2018-01-30 14:05:35,135
0xa0ae96df46628af7100618660d29c04e2f34711cef6c429412d7fd4e614b99bf,t,21000,3497965,,5000096,2018-01-30 14:05:35,136
0x5b1cbe22a359681dc28442de0a93ecc53dc94373c6993022cc15e624053742ff,t,44305,3542270,,5000096,2018-01-30 14:05:35,137
0xf0c2651b74463df4a66fe1a0497d6cf94df8425abe315dbf7a1954e8ac11b89b,t,64725,3606995,,5000096,2018-01-30 14:05:35,138
0x799ecc5e5451f12877685dd1ce49593c4d5585ad7eb71fdc8bbd6034960f6f00,t,21000,3627995,,5000096,2018-01-30 14:05:35,139
0xb9d778903e817dac3897188b2110f36160451bef7f271f02822f29b28a36d41f,t,21000,3648995,,5000096,2018-01-30 14:05:35,140
0x8e03f570f5a576f216dc5d305ef1f519230a2e15e5123fd39c03339fa5ffe621,t,21000,3669995,,5000096,2018-01-30 14:05:35,141
0xd26b644782067ae6b24c149369e96f148b1916db0bea3bab370bbcfa792f7226,t,21000,3690995,,5000096,2018-01-30 14:05:35,142
0xd276a1cfe02deb760dbcfafcd4631c0f713797900d6aa3c2b121fb26d8aa3fc0,t,21000,3711995,,5000096,2018-01-30 14:05:35,143
0x9b242126e4bc29949ff0b844c7cdff26ccea7e1f3106bddc6e1eb2a6bcfbee7f,t,37964,3749959,,5000096,2018-01-30 14:05:35,144
0xcbec43dd2049a6329a576ad1a15d1474d5d44c4736c88b41f9457be63c8b161a,t,21000,3770959,,5000096,2018-01-30 14:05:35,145
0x52fe8cc165e46090daa94ebf0fc80004a1215fb8d133fa64f337783d96c88c8d,t,21000,3791959,,5000096,2018-01-30 14:05:35,146
0x881e85e5118139e9c7f00e94c661c8599a5a84e11d2e6c49d2cfb54f7ee5d8d3,t,28687,3820646,,5000096,2018-01-30 14:05:35,147
0x094b737a875d15158025edd90b9bd83d6335db2e82afe860793163d43135dfa7,t,21000,3841646,,5000096,2018-01-30 14:05:35,148
0x48937f2c96fe4bb50491c60e34028ff445f26587513322365b119251f2ddf3db,t,37616,3879262,,5000096,2018-01-30 14:05:35,149
0x7d49eae15c68300f0f1a43869315ce1e882e0d938019a21b05ca000c7d877698,t,21004,3900266,,5000096,2018-01-30 14:05:35,150
0xfacc7433e5b6211bf47c481b5363df0d1ea0f2950858b6548dfef2f2e2834d29,t,21004,3921270,,5000096,2018-01-30 14:05:35,151
0x391f6679130a795294c1637ea4624eed8bd3783fae9a4024f5296d9b3254fb84,t,21000,3942270,,5000096,2018-01-30 14:05:35,152
0x587918d1f7bb2667b542a8701d84fe8262320d6e26d15c4b792f392eb9d56d18,t,38382,3980652,,5000096,2018-01-30 14:05:35,153
0xb70f6cc13f6a6ae25f842e81206598288b2a851aecc58bcd6ac7ec0b671e6fdf,t,21000,4001652,,5000096,2018-01-30 14:05:35,154
0xbae562691615a7df48ffc860c29677fd100bf6a4fc3d68091470199dc04d1632,t,21000,4022652,,5000096,2018-01-30 14:05:35,155
0xdc1beb07a37a5263ade182a674aa51390bafd64085b6e33597b013506d9bd1ad,t,21000,4043652,,5000096,2018-01-30 14:05:35,156
0x278763eb6e7e8cbc20d224b2a54fa064765311c412bcb082122e62c30573470b,t,21000,4064652,,5000096,2018-01-30 14:05:35,157
0x08ba4c0c508b0ae56dbd6871c31da4d700bedb74a09d071b72ae59f49201c1f2,t,21000,4085652,,5000096,2018-01-30 14:05:35,158
0x55e416b31c0e223a3ee347af42793c17d53e62017c78569718b6af2845d00826,t,21051,4106703,,5000096,2018-01-30 14:05:35,159
0x9f51dcd02ae2873138879c6a168f20bac0c914e7b3582cbf5b1c0afe2ee7d125,t,21000,4127703,,5000096,2018-01-30 14:05:35,160
0x3c6405405fc4df99510e5eb52cf75ace338344bd0012b3cc6819868250413bb6,t,21000,4148703,,5000096,2018-01-30 14:05:35,161
0x038dfca9b2a0190d1c5ea32abe998ab03a6a776341805292296225af3a6e1974,t,51411,4200114,,5000096,2018-01-30 14:05:35,162
0xc15e582c8cae956d045b003522a139e256ff6f21215dd846f726617ebb16f567,t,21000,4221114,,5000096,2018-01-30 14:05:35,163
0x2cd356c548b340f322718667808b9e4e0c93de99c4428c25f90640dad2f3c3cc,t,21000,4242114,,5000096,2018-01-30 14:05:35,164
0xaec170f27a5ae31bff1215e1331a75ef0c1c363d75c1d39df3a438f09e7fbae4,t,53254,4295368,,5000096,2018-01-30 14:05:35,165
0x5c728b63f23981d940505fbdbedfa680b38dc87074d50afbba3cddbc2a498a3c,t,21000,4316368,,5000096,2018-01-30 14:05:35,166
0x9bb892df5baa98196395f2054d3f4cd16b5cd3a984c1cd0ca084cbfc4946bac4,t,21000,4337368,,5000096,2018-01-30 14:05:35,167
0x02f3d8d6038cc849d36cd6493aac7c81fec02c7d22d86fd8cb872060fabb02b3,t,21000,4358368,,5000096,2018-01-30 14:05:35,168
0x1317682d87a458023276bd6619f1520296dd8fdd41e3ac8344ca3f19402e3139,t,21000,4379368,,5000096,2018-01-30 14:05:35,169
0x45f119e1331cc3b1bd35f030558ddedffd11bfe0d76c149e17a39bc059dd7799,t,21000,4400368,,5000096,2018-01-30 14:05:35,170
0x55051ecfca1e6830a41c33d2e8b5997dd2e453ba051dcba73e522a5f54e144ac,t,21000,4421368,,5000096,2018-01-30 14:05:35,171
0x6c3402ef879cf97baadc7ca86d98dedd37b9968c6819142e6974dca4af81a84c,t,21952,4443320,,5000096,2018-01-30 14:05:35,172
0x64dc67e48e82c600729098f63e1c26767c356679902da8caebf787057d87614e,t,21952,4465272,,5000096,2018-01-30 14:05:35,173
0x2479342e522eaba0c41e0a0dca0c5cd2e802d53f172c9f634dde967255bd3a0d,t,21952,4487224,,5000096,2018-01-30 14:05:35,174
0xb1740c558d7bfbff5a4aa485f147645545479029f69065612c91a4acdaed0448,t,63240,4550464,,5000096,2018-01-30 14:05:35,175
0x4c9a5b4526d5c083ada3a7388e63afce2bc088fe8e1d907bc009ec2101354b7b,t,21000,4571464,,5000096,2018-01-30 14:05:35,176
0x22cc55f8d94c9b6b19edc8e0ed82d08c472a56d1d163bce78f0948f040a82ec4,t,47919,4619383,,5000096,2018-01-30 14:05:35,177
0xed7da052d0603a1a119cab45a13a003207293316dcf641c6727fa6096c377aab,t,21000,21000,,5000097,2018-01-30 14:05:42,0
0x03646e5f5d62128f2228c946d6930875ca41e8526dd641a4abbbc5cc8c8ebdb9,t,53221,74221,,5000097,2018-01-30 14:05:42,1
0xc05793827659be4b5376ad737f0b7039e2866cdd26ef39f001311d57cb91dfc6,t,37385,111606,,5000097,2018-01-30 14:05:42,2
0x568e5d74dba69e545188f8336d69130d0b0a26219531c9e9e3a82ebe5497fb0e,t,98873,210479,,5000097,2018-01-30 14:05:42,3
0x2cf47209f32e92c1059e935711ed5dc03b89a5eb3fe3b68d36ad9b28d85b01b5,t,36409,246888,,5000097,2018-01-30 14:05:42,4
0x1b8efeb50d7e2605e58752383f4fec110834d8c4c62cb9225d43c66c7ce583ef,t,21000,267888,,5000097,2018-01-30 14:05:42,5
0x1b0051d3c7a4be626740ec11e23786051be7ef32517071fa41b0424c531c9c3b,t,108242,376130,,5000097,2018-01-30 14:05:42,6
0xb84e8469177281fa3b1c07a690464707170770f6383501df702967ae419ebb62,t,21000,397130,,5000097,2018-01-30 14:05:42,7
0x864946dd171370f77238e298de1a3891dd5c3aec97b914a3261da87ed9ffed95,t,21000,418130,,5000097,2018-01-30 14:05:42,8
0xcbb8a5a6412f1d9675a0534b3e336979fa7419585aff014368b1dfbe2ab4ef98,t,140972,559102,,5000097,2018-01-30 14:05:42,9
0x8d68497315af03074b786f28ad5566dbc68d33f71aafba8283afac4bc63a6537,t,21000,580102,,5000097,2018-01-30 14:05:42,10
0xb2b85290f10fb0bbe25702284dfb676c71754f60f123cdd222b34d990cf0edcf,t,21000,601102,,5000097,2018-01-30 14:05:42,11
0x84ead34a92bcbcad50cf286db7df9e5429ff0dd92b6040b2f87305a06817392b,t,21000,622102,,5000097,2018-01-30 14:05:42,12
0xaaff4d92d1209ed64982ca6e08880b406ec4b6c6f8ae13b254483ad8433e5fbd,t,21000,643102,,5000097,2018-01-30 14:05:42,13
0x49afd18d79f18043d6a5a8e974eb1027f8d742ae6d58f06e48b4f641a2ed8feb,t,313940,957042,,5000097,2018-01-30 14:05:42,14
0x6816f26f48c2ce046af6911e22898b33ca3a6e72bb93b1629050f5674664b1b5,t,21000,978042,,5000097,2018-01-30 14:05:42,15
0x1868b06662b17c324bbe45ce31610ed800e4d7425a94ad7eb4856a9b0902786c,t,21000,999042,,5000097,2018-01-30 14:05:42,16
0x5b6d9ae87890abbb6c61fb10e6cf71ae25d84d7663b5166cc74b1259d7e1237f,t,21000,1020042,,5000097,2018-01-30 14:05:42,17
0xee832f64ec180f18bdc391fd9e5bb035722352f420bc991c4ce62ad29ac6bdd0,t,55779,1075821,,5000097,2018-01-30 14:05:42,18
0x8304f38f52b1152ee8e50c2d52c64fafbeebcca86d487255315e56dd0783f9c5,t,21000,1096821,,5000097,2018-01-30 14:05:42,19
0x9d05ea848b86718a7acd00a5995cf7e64c72a38213e8b14eb32d86fb4b8f93a9,t,21000,1117821,,5000097,2018-01-30 14:05:42,20
0x33809c48687dadce0d8881be2c0c7796c2393f2181c80aff1c53d0dc32d0bab7,t,21000,1138821,,5000097,2018-01-30 14:05:42,21
0x2e297d4c3659f94dcb4f0dd28ab73b31d42960b683907c5c2ae93789e1988fcf,t,22222,1161043,,5000097,2018-01-30 14:05:42,22
0xb8b0fcdde91086fa80bcd94a9c2dfcffd5172a4fff589482a56058e41132e0a3,t,21000,1182043,,5000097,2018-01-30 14:05:42,23
0xc7da1acd473226113ba8556a231f67ffd6d3c4f00eff99df9ac319d75bf51928,t,59354,1241397,,5000097,2018-01-30 14:05:42,24
0x72c32ad29bf4ae0208da458b8cb80477bfd667d94168a1de8a00a37be573b763,t,21000,1262397,,5000097,2018-01-30 14:05:42,25
0x08d0541e6c650c297d91b50d1548e881606db2042de11714996c233cef7084a7,t,25030,1287427,,5000097,2018-01-30 14:05:42,26
0x307335b558ac71e797d18de9e3ee6b9c09eb0e3769e254f26695c5c1914f30e3,t,44095,1331522,,5000097,2018-01-30 14:05:42,27
0x97bf39a6e4b4934673116a5599793da22ef23bb79fb4af1c37bd59c9ca5aedd5,t,55843,1387365,,5000097,2018-01-30 14:05:42,28
0xac2c295c8cafd237eafcbe54f5c842550b7b57054c6bd680471602533d153de9,t,21000,1408365,,5000097,2018-01-30 14:05:42,29
0xebd17bb2c73272c1534c0dcf418a2b2b00a216ecd9bccc5d330e19b29662bd2e,t,38318,1446683,,5000097,2018-01-30 14:05:42,30
0x1512308c6d3be948181d989dd6c7097d1172080968ca8ddd978b0d1380a68364,t,21000,1467683,,5000097,2018-01-30 14:05:42,31
0x4e062210b352014f6ea1eb0bf20b2ea8ab6d9d1bc6d38f1ba4b831eb5f0ff777,t,40797,1508480,,5000097,2018-01-30 14:05:42,32
0x8bf2993545861c8b8589c6788afab3ea0907232ee391c8ed5ff4fe437ec997a8,t,40797,1549277,,5000097,2018-01-30 14:05:42,33
0x6beeb7673ed69501e68f0e9698d03e915c62a1624afbbccb7779980b28650cbe,t,40797,1590074,,5000097,2018-01-30 14:05:42,34
0xfe960a39f69d73df80ab4ffc2e96d92d334eac6a9be412677efca07a3c1305e6,t,40797,1630871,,5000097,2018-01-30 14:05:42,35
0xbd3539d97955804469a8c7362fb4b7aea4bbdeaf314d88b834569a4b2f61bb02,t,37923,1668794,,5000097,2018-01-30 14:05:42,36
0xa6598ad23a78f168f940e030d81515a6ee8d0b06ac4f28f6626707236216ef21,t,53313,1722107,,5000097,2018-01-30 14:05:42,37
0x259dd8740fe6057960e5631f91b14a2e292517ddfd5e436ccb18337d8355e75d,t,59354,1781461,,5000097,2018-01-30 14:05:42,38
0xe574a94f675cfdff73eb8f86d6677894bb37cd647dde63bd3fb4cc9cd315942f,t,21000,1802461,,5000097,2018-01-30 14:05:42,39
0x372c83985c3bf3589d547631d012de4db0ffc735697d414bdb572a12abc3bf24,t,21000,1823461,,5000097,2018-01-30 14:05:42,40
0xa79d6dab4e3b74fbb71555f4c97574774c130b4d7df20ceb0879ca134def5530,t,102934,1926395,,5000097,2018-01-30 14:05:42,41
0xa5e3b64b824a45d13a37a5ada0fb59bcfd905fff66118f65fa0735b905dcd087,t,21000,1947395,,5000097,2018-01-30 14:05:42,42
0xd89852de8d9acd14be36f260d9979d0d9447e50c35c50d5f87116dd0ee3ad1b2,t,21000,1968395,,5000097,2018-01-30 14:05:42,43
0x6b6cc4a69e4461af73fc287a9382c90adf3504b3bebbad45b011ab25ec72e6ed,t,21000,1989395,,5000097,2018-01-30 14:05:42,44
0xbb3f6e4061416f729bea2e932b828791be837bbb5adabb9ea9e6b63b76929bd7,t,21000,2010395,,5000097,2018-01-30 14:05:42,45
0x3e94e3f75c5d70441bbdb748a4e4e1abbadfe279f21d408769e577226d28ccd2,t,21000,2031395,,5000097,2018-01-30 14:05:42,46
0x9b7ede319c773113cdf4fecb64570ef1ef8a0c2551fbf441a753230804a55676,t,157708,2189103,,5000097,2018-01-30 14:05:42,47
0x264940b097525641f91f5af971881cf1681b7274ed70a94150e9861a0f47ac0f,t,39760,2228863,,5000097,2018-01-30 14:05:42,48
0xa13c61d59cbd70d8ee3469ff0840a16297a9b55fd16057f3a0b371b3fb1b8a67,t,52420,2281283,,5000097,2018-01-30 14:05:42,49
0x72d3862f29450e86f657674dda85817407d5ba3a4d0024060f4da2a1d23d5d1c,t,52391,2333674,,5000097,2018-01-30 14:05:42,50
0x2141be601f19315119ee73453eab1f386846b22217b6626ddad7b8f0f445e86e,t,107598,2441272,,5000097,2018-01-30 14:05:42,51
0xcad5a99312a87f6e56606a4649ae96a55c6be2b43dc6a639dc4a15941f5f1da8,t,51955,2493227,,5000097,2018-01-30 14:05:42,52
0x48597dd8ee3b672c38408e7047b12b828ed51efeeb7e76bc957c703f9038e393,t,30981,2524208,,5000097,2018-01-30 14:05:42,53
0x8b79cca0a593e8564aa7eaf151f8ef1eac44c0f06c74227c8daf06ffc2f022c2,t,30981,2555189,,5000097,2018-01-30 14:05:42,54
0xe11fae28065e9bf5881c59fbaf97b8ce8966139d9e3452b1455aa33ac9d95254,t,30981,2586170,,5000097,2018-01-30 14:05:42,55
0xf21f2cde2f94596106780e673ab0a18eaa20909cac7738f5812a55fb96d519fd,t,30981,2617151,,5000097,2018-01-30 14:05:42,56
0xc84cc49ee85d2c342f99df198b57194fc9c6dd0573b9e524720b8e8f9087b696,t,30981,2648132,,5000097,2018-01-30 14:05:42,57
0xc054ffe530fd7de12e45bdc7e92f71d16ac57bbe020444d8ac34209cb638b0b6,t,30981,2679113,,5000097,2018-01-30 14:05:42,58
0xb28a5bdee2cad12327abb3bbb06184f39844b1e36b0c2213c7529e6eab2e726f,t,30981,2710094,,5000097,2018-01-30 14:05:42,59
0x742fab5a41a39af12e2fcc92a8b45a15285fc0070595e02be2efc1fcdb0a0f28,t,21000,2731094,,5000097,2018-01-30 14:05:42,60
0x1710c03d3b39a9d4b19378f5e24d19166c2793d9cbb83335b221f03c4c4ad13b,f,21000,2752094,,5000097,2018-01-30 14:05:42,61
0x005e14bf57bfbf88b9535ceab397dbae45ccd81e13ad25f1a24029444de73a2e,t,37987,2790081,,5000097,2018-01-30 14:05:42,62
0x50e58ce59b470940e456c713348dc5ed04f05602d805d2631b7cca6947823559,t,140972,2931053,,5000097,2018-01-30 14:05:42,63
0x9b2bc80cd8e9be333556ba5538ba5bf149e58b8d91454d40a88d6c6ccda72a5c,t,21000,2952053,,5000097,2018-01-30 14:05:42,64
0x3bd539bd794bb9ed3eb1d655bcbaeea3185a25f80009259ba6ddcf30087c4824,t,21000,2973053,,5000097,2018-01-30 14:05:42,65
0xd4d9d6c29129b76431bdc16cfbb3cdbe4a45e72e0c2f8f1a3591823567a608f1,t,37200,3010253,,5000097,2018-01-30 14:05:42,66
0x17819e4bdfd76e8ac8f2994332bfa9e57dc248623a376bfa70442a5ac1328fa8,t,21000,3031253,,5000097,2018-01-30 14:05:42,67
0x1172a5dcc69749bda9e47429cf1c1990f0832f1d64dd699df9e7cd17b836cf68,t,21000,3052253,,5000097,2018-01-30 14:05:42,68
0x640b643290ba7ad74676b278b1b7b24af9b44c63df619b14a5db51f248529493,t,21000,3073253,,5000097,2018-01-30 14:05:42,69
0xb9d436da81f217548f4e07f45137b5fdaf322d077d5cc1806a439e81c636d8b7,t,21000,3094253,,5000097,2018-01-30 14:05:42,70
0x7c0ba1e48a998871c89d57b6c1c91fc086dccbb5e578fa169c865eb252e7dafb,t,21000,3115253,,5000097,2018-01-30 14:05:42,71
0x07b663de9f406be2d2e50962f213ccd2b982550acf8f44a820b45ac02405d367,t,21000,3136253,,5000097,2018-01-30 14:05:42,72
0xab15e79db2754f5b3661feba07150183efc16cb8ec39444835bf882d28c865d5,t,21000,3157253,,5000097,2018-01-30 14:05:42,73
0x37246e4592560f569695ed166f52456616fd028d6f05b16bbd9cdf7947382ca5,t,21000,3178253,,5000097,2018-01-30 14:05:42,74
0xeab6472f55e011eb12e80c9b9bae979c580a3123ee8334de2153210ebabeb59d,t,21000,3199253,,5000097,2018-01-30 14:05:42,75
0x16d086bf3b5328d9068ab58c00be065a658e7876fb4a96f5e2654109badfddcf,t,93178,3292431,,5000097,2018-01-30 14:05:42,76
0x7d079932c907b00a7a699845e0198e2357c16751e0551a120d40225854679f95,t,38103,3330534,,5000097,2018-01-30 14:05:42,77
0x5b4091ee70327806fda2cbfdd16db666da7871002158090c5c6a3c7cf03658b2,t,21000,3351534,,5000097,2018-01-30 14:05:42,78
0x6b1724f7303eb7eb8d61aaa55dad8d8076567299e1658b4157e74873060aa229,t,21000,3372534,,5000097,2018-01-30 14:05:42,79
0x1effc501304d0213967b2ac96506fe1ec02881256701cdb5242086f398a2760b,t,21000,3393534,,5000097,2018-01-30 14:05:42,80
0xff675efec878c4f52677f1e521f9f09569e5c8895fefa74cbb231d31457ec6f4,t,21000,3414534,,5000097,2018-01-30 14:05:42,81
0x2d19b1ef86d6d98a49a44869874a7db34a50ada0946e8e43bf66f03c0a95b1a1,t,21000,3435534,,5000097,2018-01-30 14:05:42,82
0x0f2b5d2446b41dc016c23c47e7bcc1b4577aa83f1b42995e6990584102826c39,t,52830,3488364,,5000097,2018-01-30 14:05:42,83
0xec34cbf85de3f7d7948d2d4c5ae5101653679a66853cb09afebc435c999ada1e,t,21000,3509364,,5000097,2018-01-30 14:05:42,84
0xc3220a05b88d43b2c2d036d31ecdce88af3e5bc7c83cae4bc3e76b601f6d4ec3,t,22048,3531412,,5000097,2018-01-30 14:05:42,85
0x5b408f188b3354961c63de66da2edc1dc380e4cae3518388b7ad6ab44694b4de,t,22313,3553725,,5000097,2018-01-30 14:05:42,86
0x24a3545d8a24f982080ac47e9ad8bac0868781361de672e1e566ec77c2697bbf,t,30327,3584052,,5000097,2018-01-30 14:05:42,87
0xc58240ff01e6634293792106e98598230fc009d4b2aae3aee9b0840242c4daab,t,33571,3617623,,5000097,2018-01-30 14:05:42,88
0x669dd1f3d0cb102a0c7843fd327e70ae84a985e072ff3d9d84ee77a93433716a,t,33571,3651194,,5000097,2018-01-30 14:05:42,89
0xd3ff4441eb33a03eae1041217873a1569ec08975de188e60e9606ac5a1c2e44d,t,33571,3684765,,5000097,2018-01-30 14:05:42,90
0x901f194c89ef514e5fb5b1d4b67e9b6c0a513a977d74d29c8ce9d2e345246a27,t,21000,3705765,,5000097,2018-01-30 14:05:42,91
0x5aaf1473be731e354d95da2ef432abb8b41d5d76f1a9d483449f4ffa502bcc20,t,21000,3726765,,5000097,2018-01-30 14:05:42,92
0xfb516f1031b15aa9354f5d591203397c87d2c9d7d89dbd84db0fcd23ca1805e4,t,21051,3747816,,5000097,2018-01-30 14:05:42,93
0x5835bf001a1531648d8c4b2a0f499e15c86bc3c3e39425a05da6b1152a2ae952,t,37136,3784952,,5000097,2018-01-30 14:05:42,94
0xcfe82d9881307169e2bc0d9b492c06b5b28e60d2b383711c6090146738101170,t,21000,3805952,,5000097,2018-01-30 14:05:42,95
0xfef7183982d4cd79f2bbe8e2b572c40f1807714a3d9a959a459bb97ffd532777,t,21000,3826952,,5000097,2018-01-30 14:05:42,96
0x69a2bc17c08298238c3a2549fe4a0ea4aa1d9dabde108eeea80a8c2b537b05ab,t,21000,3847952,,5000097,2018-01-30 14:05:42,97
0xc2d9322829215aeb2951bdc7b216d8d7d666c9d3caf3c4eab3cabd409cedd1d3,t,104678,3952630,,5000097,2018-01-30 14:05:42,98
0x42ec33fd018c65bb83196f63c1fb4ded0f94247f247e41c38f7f430f010a3a87,t,21000,3973630,,5000097,2018-01-30 14:05:42,99
0x18886c21fd928e2d83ea00b3408ba718b107a8a95be5086d37792ae9de7865bd,t,244829,4218459,,5000097,2018-01-30 14:05:42,100
0x25c7d725ff9b088059a753cfa0fc82ba17b08213f881ae72991d02300fdeb5b3,t,253854,4472313,0xBF034f43D457BC8109C97890a126Eee4B6C4AD6c,5000097,2018-01-30 14:05:42,101
0xf395f4ed9dd78da17aa42a69a7be25a2bb1c17cb8b63e1a0edd87e53d6ab861d,t,53027,4525340,,5000097,2018-01-30 14:05:42,102
0x95fb0bbca9a296ffb3eea16db68ad01cb1af54f7471b6a9dd3c431bb23ea3ade,t,21000,4546340,,5000097,2018-01-30 14:05:42,103
0x9eb1b3ef4cc3eeb9652cfbd0c3fed3be256ddf793dae1da90336ccdacfe8d61d,t,21000,4567340,,5000097,2018-01-30 14:05:42,104
0xbc2b944746b54149cf7c06f1ea033624af5031883a1574a6376d484001559970,t,21000,4588340,,5000097,2018-01-30 14:05:42,105
0x6518d96bb7bee216bc4045fbff8c3a1524bcf64919784ec64ad03a778cb5af0f,t,21000,4609340,,5000097,2018-01-30 14:05:42,106
0xfe7e5b49bd54327f26305e80382ecdd3b6d05279929c2464b2c720e487fc44b9,t,21000,4630340,,5000097,2018-01-30 14:05:42,107
0x868f2c9ffaa280d0521a3f6d64f069bf5201a96d1e43d42377013ff1b9ced5aa,t,21000,4651340,,5000097,2018-01-30 14:05:42,108
0xd81fb9951464a75be973acca4de4f4baacfa8bd203c9f1e765a29c04e7449e12,t,21000,4672340,,5000097,2018-01-30 14:05:42,109
0x00bdd6a94c3c9594eb1de8217e828d2c7cae12691e13d3913859e33821c66fc6,t,21000,4693340,,5000097,2018-01-30 14:05:42,110
0xe0e82410cd5cfeb053e03c5511ff46e62da78dcb93c517cfd5735365ae5d234c,t,21000,4714340,,5000097,2018-01-30 14:05:42,111
0x3608da86734de1ff84a3aa6529cc2686aa24a079bcaa798d308963b3f41fd4d3,t,21000,4735340,,5000097,2018-01-30 14:05:42,112
0x80d1c874b77215b1c88c564f35ffca2fcb53bfe2721dde3e7ffb5f7fbd110b71,t,21000,4756340,,5000097,2018-01-30 14:05:42,113
0x1da6c55247f6b1719cabf052cb8c7e6575362b8f3b666d838795ff3d7c7092cf,t,21000,4777340,,5000097,2018-01-30 14:05:42,114
0x599214b436b6fc864a5bc4a16bab7823dad244d0920d4e392e33dd81a880a8fc,t,21000,4798340,,5000097,2018-01-30 14:05:42,115
0x336a91872b3d17a51f5c6cac6581deb55d396aff489b5e65ec9b502d0530a170,t,21000,4819340,,5000097,2018-01-30 14:05:42,116
0x26b38257ff9cff3668a2afe4d14e3874791095f428c399273a9d4bc8566562a3,t,21000,4840340,,5000097,2018-01-30 14:05:42,117
0xdeefc0f632d16c18cfe70e5f9a24562c8f7d077d70e97873b92a96b70f502456,t,21000,4861340,,5000097,2018-01-30 14:05:42,118
0x402980d8871f7b9e23415017775ee3faa0b2ce1a79948826b3ef2c970d1b6c3d,t,21000,4882340,,5000097,2018-01-30 14:05:42,119
0x8d4be57b78dea4d5997c8f6f98546d9382f1098b7d744d94b3c907e8af4b2cbe,t,21000,4903340,,5000097,2018-01-30 14:05:42,120
0x3a68e8abbfde927ac34adc5e894f9412c59e07295135e50f435b29bf5bd08520,t,21000,4924340,,5000097,2018-01-30 14:05:42,121
0x08e422642c11ac4cb44428b7a28703e52304709ed8def387d20f5a2db6744250,t,21000,4945340,,5000097,2018-01-30 14:05:42,122
0x89f7d729e715264be5b161af1ccaaf2b9ca47aed7097826f8e06cb978132e4fd,t,21000,4966340,,5000097,2018-01-30 14:05:42,123
0xae71822da438e80e6f662391451f771e2884c60b8e6f8880d19c1b966fe03083,t,21000,4987340,,5000097,2018-01-30 14:05:42,124
0x325a8f78f37a06c04f4a394a84d89999ff35faf7d5ab197870565792c8e3fc73,t,21000,5008340,,5000097,2018-01-30 14:05:42,125
0xd2170fa73987b36c805ec60ac39f01e76913d06140867bdbf2580de7c1cd0e8b,t,21000,5029340,,5000097,2018-01-30 14:05:42,126
0x5bb0372b14bc664a09cd1667422f3cbb8e3c851f7648e78a112e7dfe84b7c818,t,21000,5050340,,5000097,2018-01-30 14:05:42,127
0xbd5e12051db4c1d9e34883663928671d1eb832e1d045632bc1e98f2aac273d39,t,21000,5071340,,5000097,2018-01-30 14:05:42,128
0xbe6f923db34a7b1b8a3a24cb79a5a481ccac98bf6ba0957e9acf170b62213ab5,t,21000,5092340,,5000097,2018-01-30 14:05:42,129
0x2eaf6a43124322c4e3bbd98c82a3d1ffc5475929202e513603454b5a60bcbe5c,t,21000,5113340,,5000097,2018-01-30 14:05:42,130
0x0b3b61be1f09ec1f5f2eaf253f51c9729505be5fccabb16f5932663c8d86b50c,t,21000,5134340,,5000097,2018-01-30 14:05:42,131
0xde39d77ff4f339599dc3e1ea37bcea993d0d95398bc455752e89c940a5501aba,t,21000,5155340,,5000097,2018-01-30 14:05:42,132
0x55da6dc8f3f3ffad514970cf7f24c1dbdf1f35a4ae65f2e6f0e46075381c6334,t,21000,5176340,,5000097,2018-01-30 14:05:42,133
0x3a2a23609b6b755a96d73b27a0fda8268336c986d7a57942b6e0480d25807f37,t,21000,5197340,,5000097,2018-01-30 14:05:42,134
0x2d80fe437217f7df96754174529d451392cb0bcb9178f1cf358920ba01751a23,t,21000,5218340,,5000097,2018-01-30 14:05:42,135
0x938b057fdbb2e57994fc54f890053579ca021e20c8b827e1ee802b47ae262ede,t,52822,5271162,,5000097,2018-01-30 14:05:42,136
0xf81407cc750ffbba2652007b53be09071a810fb3da66e99250303aee0926e1e3,t,21000,5292162,,5000097,2018-01-30 14:05:42,137
0x73b6ae3d03b4d167b7a8ebddf03b5ca2397c2957ad66bab953a7a1c6d814fcf8,t,21000,5313162,,5000097,2018-01-30 14:05:42,138
0x31d6969b48428b93243ac4a7e94c2e5beac01481862c27903d57211026e8ced9,t,21000,5334162,,5000097,2018-01-30 14:05:42,139
0x5a9c477b8a35e00807e98666279d89f63ce2dfc66212ba7f4e0e95c7d12acf29,t,21000,5355162,,5000097,2018-01-30 14:05:42,140
0x795bfbc78a10280cefef262fe507ab764cf94587eca20bfc9c7a664f1975297d,t,21000,5376162,,5000097,2018-01-30 14:05:42,141
0x9c373e39f597ccb9093caab298d6728d0d8ddd1fe723372601c3495a25f61163,t,21000,5397162,,5000097,2018-01-30 14:05:42,142
0x5e011521f50be3065804afd3932c5feb4aa1780708b1e06d9fdc16ff1dfd8123,t,21000,5418162,,5000097,2018-01-30 14:05:42,143
0xbecf9c092dbb76a833e2b0b67733c286732b8d75e5bc604923e6911514da99f9,t,21000,5439162,,5000097,2018-01-30 14:05:42,144
0xc04aab3309dc70749ad8093cecb85ff51b875b0bab57659ece82976a91c5e82e,t,21000,5460162,,5000097,2018-01-30 14:05:42,145
0x95961a0f8399fbcefb9feeab28f602bd9082f2206733674ce8613dfc78115e1f,t,21000,5481162,,5000097,2018-01-30 14:05:42,146
0x187e5cc8a27b9f2ec52a9e52c8f7c70151d173f28d5aa9bda35912aab0f1772c,t,21000,5502162,,5000097,2018-01-30 14:05:42,147
0xaa4cfc7408617c99545747f3711fce283210347557947e2909b70dd6a1679470,t,21000,5523162,,5000097,2018-01-30 14:05:42,148
0x2ba95798e2d32a64b4971df404cddf673ebd7fdfdb9c40bfa07775176c03fd99,t,21000,5544162,,5000097,2018-01-30 14:05:42,149
0x66e58916f90f2543c64804728c626935bb74ebdb1463f4aa8e192213cb72c436,t,55779,5599941,,5000097,2018-01-30 14:05:42,150
0x9af5869b8506c325007463ac21996fdd084a0e3920f62cc189e92c23a35fad77,t,21000,5620941,,5000097,2018-01-30 14:05:42,151
0xcec114693f0b5f1f9143c908834d8146be806b2c1990c29191c39c67f741aca2,t,21000,5641941,,5000097,2018-01-30 14:05:42,152
0x8429add74483677818754c4bc3508d7ab32d5a3e4e7ac096987bc60ba4a3ae82,t,22577,5664518,,5000097,2018-01-30 14:05:42,153
0x4c954b6fe9c56c955b4abdca402d601b6be56b74e86a156ef4fcdaac916a6f3f,t,21000,5685518,,5000097,2018-01-30 14:05:42,154
0xc404eab1cad02966dc3fa57a6ccae6001b98dd1a32c7a176b1bad38b67ca7c66,t,21000,5706518,,5000097,2018-01-30 14:05:42,155
0x619c64255c523e9d04d640ad280f7c1b458120bce67d6d9c7f1e9bc3ab7c53b5,t,21000,5727518,,5000097,2018-01-30 14:05:42,156
0x58cab0f5738a2f763d940e4924023932d6e3672b2f90bf981bfe606ded48e952,t,52483,5780001,,5000097,2018-01-30 14:05:42,157
0x1bbc3acdea5351f64d593edd39171d3dae6ebe9c00a453e3f8c92e2e58c67216,t,21000,5801001,,5000097,2018-01-30 14:05:42,158
0x1b96752c581fb2fa9ac75903876532b90194c6545c19e72440da50bc7ddc223b,t,21000,5822001,,5000097,2018-01-30 14:05:42,159
0x70c23f4277d6a2732669e59da2ffbfe6e5d7b13b46761daa4694a089ad55bd74,t,21000,5843001,,5000097,2018-01-30 14:05:42,160
0xcb30a4759faf2bf12c8e7537bb521590a29dd32170d92030a10a9076bab4a087,t,21000,5864001,,5000097,2018-01-30 14:05:42,161
0x746e5fc83aa1b6daf2f036bb1579281d51fbcf32e993578a520e6998b3dcc712,t,21000,5885001,,5000097,2018-01-30 14:05:42,162
0xbb1dcacce28d941de8893dd775b77e7987b91900a5cf32eeec6c11f6aa37de8a,t,21000,5906001,,5000097,2018-01-30 14:05:42,163
0x513ecf28c70f35d2836fcba98496392d2e84b8abfd6a94d855b8f449532139cd,t,21000,5927001,,5000097,2018-01-30 14:05:42,164
0xcdf91a6e6f234ac8fb0f530eae156315553c9d140973195b0e8513d1111c9820,t,21000,5948001,,5000097,2018-01-30 14:05:42,165
0x4bcc8b008f78837421fb017c6578b3adecdee38a57814ab8abef25fe8e4b3c5a,t,36706,5984707,,5000097,2018-01-30 14:05:42,166
0x5497c63e432cb9054736ec7419c07a947f8ac29c2225c7df8236f207d261605d,t,21000,6005707,,5000097,2018-01-30 14:05:42,167
0xd2db183753d9fbc56a841686b164f0389728fd5002cb85110837c509021dee71,t,21000,6026707,,5000097,2018-01-30 14:05:42,168
0xaa261980e3c754cb4aceaf7315dd72144fced131a5cf80400648e79236380d25,t,21000,6047707,,5000097,2018-01-30 14:05:42,169
0x5cec4ed965b9fe87e029e0250c7cc4cc14d08c7ef3020b7a04a30122fbb0ce9b,t,21000,6068707,,5000097,2018-01-30 14:05:42,170
0x36e26f630a0a0758b4189f8efd57d0e23f242dd4379defe576a05f162d144796,t,21000,6089707,,5000097,2018-01-30 14:05:42,171
0x47bc7859b974a6d086cd546c549ef8eaa0b50e55c6d5a65debc30b48a278b149,t,21000,6110707,,5000097,2018-01-30 14:05:42,172
0x119bb5875831dc0f51dffef5ad061d852260812ee4b3093237f4ee0306a607d4,t,21000,6131707,,5000097,2018-01-30 14:05:42,173
0xb9995af1c273ae106fc0f20b87c5fddef742d34fc12c3526a49534c1085367d3,t,21000,6152707,,5000097,2018-01-30 14:05:42,174
0xd0af9d24cf43d2d573f36099138f8997b337e5d2ac1925e931a99f02fa116070,t,21000,6173707,,5000097,2018-01-30 14:05:42,175
0xce24c4ba909c5014d5097e92117a301836e9df4942525b8c96dfc46cdd205106,t,21000,6194707,,5000097,2018-01-30 14:05:42,176
0xa2e8d6e4854707c41d873660ea2ebec9c1f498bea68bd4db7fc489678abc0ca1,t,21000,6215707,,5000097,2018-01-30 14:05:42,177
0xca386f1a669aa411d1437a174389ccd3808a3aa15772e79421a695aed60543f0,t,21000,6236707,,5000097,2018-01-30 14:05:42,178
0x6c33eab9d7f026d0710204939d3af035e9379e4ab86a4180e0c7ac0f4fc1bbaa,t,51883,6288590,,5000097,2018-01-30 14:05:42,179
0x416d8524b203c0c1744d720a10adfe815ec5676ac6aefa61457ec96322f3ef2d,t,21000,6309590,,5000097,2018-01-30 14:05:42,180
0x41d9db8b28788fa4f46b326d87fc8c22b4e8d5caf742dc8d99e90bfebad3e3ac,t,21000,6330590,,5000097,2018-01-30 14:05:42,181
0x7ad42449979e9ba6e345f9bb6f3278a881aafab4a53837f1fe637fe4d4dc9d6e,t,21000,6351590,,5000097,2018-01-30 14:05:42,182
0x957de9eff30d4a70a35f23a6383a0debd9a4d4d246ab56575524bfab28914a0e,t,108178,6459768,,5000097,2018-01-30 14:05:42,183
0x0add7fdc32e7782924b045a10928793bbbae32d34cd3578e30f5d153cb36e05b,t,22263,6482031,,5000097,2018-01-30 14:05:42,184
0xdc04d7893fd6a5e49335460340f15e6a018d506cdae891598a24e5138b64ed44,t,21000,6503031,,5000097,2018-01-30 14:05:42,185
0x00e7ecd30b4163d7f5bfb5dbbb72fd0a7083c72d7f0bd8e444023256763282d4,t,21000,6524031,,5000097,2018-01-30 14:05:42,186
0x5764d30a235a58b938f6ee6b8a4a43bba8c118a3180b5956b11f534634f5d005,t,21000,6545031,,5000097,2018-01-30 14:05:42,187
0x780e6ad2eb242979bd0f4db968e550b7d9fd2e6792bac5059a99b4ff6e3c50b8,t,21000,6566031,,5000097,2018-01-30 14:05:42,188
0x97f405a2cad68b8c686ccefe75655117d621e710584fe07dac10e020731993c3,t,22142,6588173,,5000097,2018-01-30 14:05:42,189
0x4c3f5ec267733d8d526f55221929e6914bfde86e0e12e0ddcea7afae9ca37f93,t,21000,6609173,,5000097,2018-01-30 14:05:42,190
0x490300dd7780c144a1ca4d4c6b2d53b56f36d2260636ffe902d51668026e1176,t,21000,6630173,,5000097,2018-01-30 14:05:42,191
0xda42a67f3e9cd5a2c515082e34c5e72111f632e4f944fe7c081a8e60b17bd702,t,21000,6651173,,5000097,2018-01-30 14:05:42,192
0xb0002f5c25e6571a301472bced97bc274397a778bb4a7ca0f60b489ee66ddbf1,t,21000,6672173,,5000097,2018-01-30 14:05:42,193
0x3c6c73b21e75810d518dca79a6e1ef36daaebc958e09e0300b3c1c9b078870f7,f,50000,6722173,,5000097,2018-01-30 14:05:42,194
0x8d5010659ed2be61d7eb5cb29fbfa603cd6973c7b61092d0d5c829a1db7b6c48,t,21000,6743173,,5000097,2018-01-30 14:05:42,195
0x4d16200b1ade5824f7117a779cc55ddd495e63f1e315d05844fa465dd82b22be,t,21000,6764173,,5000097,2018-01-30 14:05:42,196
0x1a92ec334a49d8429903d8a2b34e921211e8e5cfce9e20c1201c45deeab3c1ac,t,21000,6785173,,5000097,2018-01-30 14:05:42,197
0x61f278ac5a2870adc8f8e37236610460f0f1cf728db046e658660683c6916f7d,t,21000,6806173,,5000097,2018-01-30 14:05:42,198
0xa9dcc3b69d8d1e93ffe1382c817772ac3506901e0b43424d7653e0ae68d1713b,t,21000,6827173,,5000097,2018-01-30 14:05:42,199
0xd1d09850d3af849c0f7620f1549c71c946810df9476ef91ca2208ddd6a2674fe,t,21000,6848173,,5000097,2018-01-30 14:05:42,200
0xade62ae47ee88f065eb8f844076bff761f2d7836ecd7fc035198b2c65ea572b4,t,21000,6869173,,5000097,2018-01-30 14:05:42,201
0xcc4009fa4979d59ea2d428b98f35a30698fe01c7e898a013e1e44e663a98749d,t,52155,6921328,,5000097,2018-01-30 14:05:42,202
0x77bcef513832a842ed26b9e7b5f06a1c5c269cea3ae24c774b7782115280a354,t,21000,6942328,,5000097,2018-01-30 14:05:42,203
0x039ceb8c1b885b589d5121cb071adb882da4086bc5f76a7f993079a6b95db200,t,21000,6963328,,5000097,2018-01-30 14:05:42,204
0x71d40b1000d670815ec7f4e7069a2f6e3d7add6c40daf1a5d4d614beb1d9aca4,t,21000,6984328,,5000097,2018-01-30 14:05:42,205
0x062dc82b2c3e83277ff7392f961494bdcd99f780540a55db78bbecaa9d36c3e7,t,30327,7014655,,5000097,2018-01-30 14:05:42,206
0xee6238a02816f0654816514f3fbcdec9e651739b87b2ea645cfe520c57522352,t,53226,7067881,,5000097,2018-01-30 14:05:42,207
0x93c37457e2f5fd20212519eb200a6c4bb876b4d4074eff52542b698e9794368d,t,21000,7088881,,5000097,2018-01-30 14:05:42,208
0xb1ea86e805ab17f6a19b10816f099f9fcb054819d6cf3546ccae2eacdc9e88fb,t,37233,7126114,,5000097,2018-01-30 14:05:42,209
0x991996a4ee26251d159c1d8b8c096a5b132797faa5df351cc385e0263a1d80db,t,21000,7147114,,5000097,2018-01-30 14:05:42,210
0x94f57145bd571ab83069f4a3e58ad7dcda2eed5d37bb071d50ab552d94fc3378,t,21000,7168114,,5000097,2018-01-30 14:05:42,211
0x4501bbe300561dd09056208ddca5430249152cf8f7b174b3c9d194a6970dc565,t,88628,7256742,,5000097,2018-01-30 14:05:42,212
0xdc8a0c56caa266e60e4697dc106dde281b2b7f502a61124f9c5c6087980d9108,t,21000,7277742,,5000097,2018-01-30 14:05:42,213
0x771b9410dee131850954a987157fb692f2052ea01c22a9240cd2b6edb8e8b9d5,t,21000,7298742,,5000097,2018-01-30 14:05:42,214
0x422f9c0a4aeaf8cc72f42d8e3e451e88e86a51069b0c2af9c888a0fce3f46224,t,87489,7386231,,5000097,2018-01-30 14:05:42,215
0x12104f913a6499fd2c0440f7b09f2828371dcd06c091a417eea541590306ba66,t,21000,7407231,,5000097,2018-01-30 14:05:42,216
0x18af0670dbd22355e27cde09ea3dc4b3aeb38f4dc6e72190fe6117ad4680a3b7,t,21000,7428231,,5000097,2018-01-30 14:05:42,217
0x675d04dc49a1d6f34779e738e0ee3fd16d6bee91420a032d86d7dd1db3174bc9,t,21000,7449231,,5000097,2018-01-30 14:05:42,218
0x98ec8bc6e6280b9c0fdd1601caa53db48cd68277a8d419c4e02d23c2074811da,t,21000,7470231,,5000097,2018-01-30 14:05:42,219
0x5461968abce14b9a7800f39c61551fc1569cb74f27ecf67146c2ca0fa2960a45,t,21000,7491231,,5000097,2018-01-30 14:05:42,220
0xf7173f21dd03d7ef0abab3869364ab2ee1e8996ee848839e61c03ec238ac0dd8,t,21000,7512231,,5000097,2018-01-30 14:05:42,221
0x42652c205f0e196714f492dc8d5a8554fe604d0b5a13e65b092be822c93c5111,t,21000,7533231,,5000097,2018-01-30 14:05:42,222
0x7cc2b45a4f991f7a43e327032029ee7ce147d7e764c322e505c33f13407c4fbd,t,21000,7554231,,5000097,2018-01-30 14:05:42,223
0x73a05e7ea03a3fd9ec711ed63e92d97be721a33cb4ee69ab5039a62a203c534b,t,21000,7575231,,5000097,2018-01-30 14:05:42,224
0xff21b01043da2ad1c7c00c4a77d79ff2c6144da1b56f5e5581c79a4eee7e35a8,t,21000,7596231,,5000097,2018-01-30 14:05:42,225
0xee35ca809e97014dc17e3f60800bbd86fe245b43052eabf23c3f622b18e8681a,t,21000,7617231,,5000097,2018-01-30 14:05:42,226
0xc61a67d656bd614b130025091b8ef246bfe688ae63a1514129b501080feabc75,t,21000,7638231,,5000097,2018-01-30 14:05:42,227
0x6e62a0212afd81b96d559f825855c4dc3d77ab4cdfe5d3b9d00d7f376cb8abed,t,21000,7659231,,5000097,2018-01-30 14:05:42,228
0x3d5007e6feacb1a329e5bfc624ad97b226069b64b9af8bcc60b8fcd69e9d1f39,t,52221,7711452,,5000097,2018-01-30 14:05:42,229
0xaa7a5b09cd711b60f37a6ab475be7a85d4d6d54f682cdcd5e2ab5d292120ee43,t,21000,7732452,,5000097,2018-01-30 14:05:42,230
0xfa6e7014c9a50fac4160b96aaddf88a4bfbe78de41a7d39878876aaa934ce86f,t,21000,7753452,,5000097,2018-01-30 14:05:42,231
0x30facd19b672652d4f006922eb9a0bf1e7246e9a19f74d750e99b47018efedef,t,21000,7774452,,5000097,2018-01-30 14:05:42,232
0x46c683ce9b3f991705201f6333ab43aa8f83a76b360c7b663bfdbbd4150abe9d,t,21000,7795452,,5000097,2018-01-30 14:05:42,233
0x715f42468c7b9e46f292127784752ca32cf38186bff863bef1efa0ac14c5354d,t,21000,7816452,,5000097,2018-01-30 14:05:42,234
0xf3606202f580cd54f710ee2602bc806713398f4250d0d9f96339ae7881a01546,t,21000,7837452,,5000097,2018-01-30 14:05:42,235
0xa0937ee2e52518723f7d664cd8d3908f34d71a3d5604d399675639c227ad603c,t,21000,7858452,,5000097,2018-01-30 14:05:42,236
0xb5e945a7a17e8eb7d9d652ba14d1f956b67f357570adb3aa7d87ac722ba46ef9,t,21000,7879452,,5000097,2018-01-30 14:05:42,237
0x697db9b6efa4d9f794cf1e57b96e5a855ffef6b64666da390b5a2705f4d59934,t,21000,7900452,,5000097,2018-01-30 14:05:42,238
0x9596b4bbb26f9c6c3c2f28b54c8a78c026251ef9887feb4e9b44b54d02a0789e,t,21000,7921452,,5000097,2018-01-30 14:05:42,239
0xff2e5a5f9d00d921fbd18444628a95504b4e544e60be64b40c3446e6f4f0e17b,t,21000,7942452,,5000097,2018-01-30 14:05:42,240
0x18c5435370fede88ba0786560d76849a5514b26c5dffd6bb4ebdba8b636b0cae,t,21000,7963452,,5000097,2018-01-30 14:05:42,241
0x819373d4550bc9aceb40e2db4c198ac44aaf0999cffa8782e8ab490a130e2a2b,f,21000,7984452,,5000097,2018-01-30 14:05:42,242
0x3d727be7f3a388a556f836a5eeb1fad1c5aa67bd75724c503b41854177e24fd6,t,21000,21000,,5000098,2018-01-30 14:06:41,0
0x5b4a4dbdab3a439802195d7bc5f96b55150f4203b1c38b8796ab7ccb021ea911,t,21000,42000,,5000098,2018-01-30 14:06:41,1
0x73df49e647e53b3a3a3ac109474ec4338f2a93c2792a058fb0f7107eb555334f,t,21000,63000,,5000098,2018-01-30 14:06:41,2
0x2e677a380b3f49a486e7a9ad8cd73d73add176e6eeb175a020a8a34645ecdfe3,t,21000,84000,,5000098,2018-01-30 14:06:41,3
0x94aa7c34637e09a6172ea3782207e006b4fd6c37a838a663332004ecf2d84b4d,t,143081,227081,,5000098,2018-01-30 14:06:41,4
0xd5369b4badf73413a47411777fb767fbb1fb691b320d737e38d00ed8ca053913,t,52687,279768,,5000098,2018-01-30 14:06:41,5
0xbc3aa74703ee2c1b2ae9c2e07194cb08664d60205347143269b2530cc018243a,t,52091,331859,,5000098,2018-01-30 14:06:41,6
0xb991d425b62d5e219683dd2d69ecb8551fb981c38706eb60f18e4e99f62f4979,t,21000,352859,,5000098,2018-01-30 14:06:41,7
0x325e96e6c4a684fdf39a92413957f885131cd99dca40e1727d18038a670e645a,t,52087,404946,,5000098,2018-01-30 14:06:41,8
0xdb1bfd245d8179eb91bf96d4ec584f4eeb00927479f2dd49c2559e7cb2f772a8,t,39771,444717,,5000098,2018-01-30 14:06:41,9
0xe0c7bb51329f3b636dccd22038112d9b26efac50c6144c151949d09109b632fb,t,21000,465717,,5000098,2018-01-30 14:06:41,10
0x37218648b233335f4f5d5b482eed3e981439aa21b096147017793966fc141b99,t,21000,486717,,5000098,2018-01-30 14:06:41,11
0x7987055bf605be99f24f1dac7e75c19a2381a6041c6c9d59c2e8437828e80ebb,t,21000,507717,,5000098,2018-01-30 14:06:41,12
0x397e2ec57181c1967c8947884b00c8b40bb12a4fe3c738b2c3056be68ce4a128,t,21000,528717,,5000098,2018-01-30 14:06:41,13
0x330ceaa68d3d66b703acfa6525005efa1aeb5703574f8510e8af66e5d428e70b,t,21000,549717,,5000098,2018-01-30 14:06:41,14
0xee55051f8d4d3eeb9ffb24a2d19104b34ef64df6c24c6e891ba4659cfe126d47,t,21000,570717,,5000098,2018-01-30 14:06:41,15
0x999860b4276a32069884095099920dc47997b5378bde59d96154227e59307384,t,21000,591717,,5000098,2018-01-30 14:06:41,16
0xe384395c1ce40cd29d8b7b1072f0b96bd710a2e9b949283fc85ec9b2e4297e44,t,38175,629892,,5000098,2018-01-30 14:06:41,17
0x9468cdfd05b20e66ef063acc8f77e742ff5362b213e1ec3088c549c90bc209e4,t,52151,682043,,5000098,2018-01-30 14:06:41,18
0x576bd8b1c7a62e695ca8d596ea18cca79c2120bd554b8b4e883631a4feb5aeae,t,21000,703043,,5000098,2018-01-30 14:06:41,19
0x6f4dcb1df0cdbced763ea1218da43fe10a3b7cea9c672573abe8573ea92521f5,t,21000,724043,,5000098,2018-01-30 14:06:41,20
0x528f90cf7fb7c5018bcdfea959684582ce094c2cf53a2573a5d2a2759aead605,t,21000,745043,,5000098,2018-01-30 14:06:41,21
0x3fd487281d83ff146705df0f029aa1fe3cfe3fe47e69a3f640fe4efea41cfb53,t,21000,766043,,5000098,2018-01-30 14:06:41,22
0x4a7ab9dc18d7eb9cea79c875f3effb9d69b40ce8e1be9b0a5084b1808f4bcfb7,t,21000,787043,,5000098,2018-01-30 14:06:41,23
0x917bc8e593f3428db4b51de75a0445d29015eeb2d884df3b5147640ce1a5be6d,t,52091,839134,,5000098,2018-01-30 14:06:41,24
0xa60336cb6aafbdcfde684578705a7523a2f40736eaaf39123fc8f1435f8c0273,t,21000,860134,,5000098,2018-01-30 14:06:41,25
0x8c5a2cd5f62a435e4bc4482a703c5111d9ff116ddb8da41ee4bceeb4cde097bb,t,21000,881134,,5000098,2018-01-30 14:06:41,26
0x0c4b9eb379764286e3a1a1dabcc6576639540309d2e6913f53933f507990cd06,t,52158,933292,,5000098,2018-01-30 14:06:41,27
0x4139f34ff573c861475702e37dc16ba32498ef8dda6b8cb9d9ec51a499541654,t,37912,971204,,5000098,2018-01-30 14:06:41,28
0x90dd4829098baba4d911ca1922be5a4c6fd786eee6a1d701d999598756f50781,t,55907,1027111,,5000098,2018-01-30 14:06:41,29
0x3214def81cc4d22b4c632f35cbb86fa5997f941128681c8b8fcfb2eed62d1740,t,55843,1082954,,5000098,2018-01-30 14:06:41,30
0x9df3948caaa46b71ad78cc2492df4485bd715157683d0de663e846ce8a2a38c6,t,21000,1103954,,5000098,2018-01-30 14:06:41,31
0x3e01233c67a1fb73bad157178f1955c0048899fa913c0a063cede07717176958,t,21000,1124954,,5000098,2018-01-30 14:06:41,32
0x8290f087a10c52c7501e8520c965a20659c8b82dcfb8597b1b4139c085118458,t,21000,1145954,,5000098,2018-01-30 14:06:41,33
0xc2b622d2fad6ec6e8575740239a5ee03d2eaccd9a37479b9a3c3ad2caeb7008f,t,21000,1166954,,5000098,2018-01-30 14:06:41,34
0x721efc9c3b1b7eb200a317deb57a636555951768cc741809262e1f4da69e7db9,t,21000,1187954,,5000098,2018-01-30 14:06:41,35
0x1ed19311a4be7915717e682b61b4fdb46deb663bcd6c9892441cc124d7b8b986,t,21000,1208954,,5000098,2018-01-30 14:06:41,36
0x020190251a2192b8b3142745284c834996844a1e65f89ef4618c08ab6dc30443,t,21000,1229954,,5000098,2018-01-30 14:06:41,37
0xb8daf0b27c55863c13fce0bed30a9db7b69df982110dcff1708fcfb80457967a,t,21000,1250954,,5000098,2018-01-30 14:06:41,38
0x05866284581252d24500beac1893678d9ecb1fb4794e9b331dca9cad6b7541d6,t,21000,1271954,,5000098,2018-01-30 14:06:41,39
0x93a789434631af096dc7efdaccab9e825ea4200aca97cb994e5d4f46c0453736,t,21000,1292954,,5000098,2018-01-30 14:06:41,40
0x9f143e88c8369d958663c0945d60a3cee7de37b061a4a0ed98df705893aceb33,t,21000,1313954,,5000098,2018-01-30 14:06:41,41
0x863cc76a0b43ea56c3d492180ba71cec1f75a769298f5bafb66861ebeccb5c05,t,21000,1334954,,5000098,2018-01-30 14:06:41,42
0x50079b973c9cc10e487f3dff064578a77debba0eaf33f179940a636634d13976,t,21000,1355954,,5000098,2018-01-30 14:06:41,43
0x60fa3e6e205153c114b0e4351691b559dd4d70531d5c6b2a25ad951ad8f18de5,t,36851,1392805,,5000098,2018-01-30 14:06:41,44
0x860983b39412a320e3cddb8a01a717e03e3a7048a26c7d51832f9ac5c37f8963,t,21000,1413805,,5000098,2018-01-30 14:06:41,45
0xd03e42bc313259095f155f136bb28a7f4adb9d2f16bc3e7bebba3b09e87d2e4c,t,21000,1434805,,5000098,2018-01-30 14:06:41,46
0xe877883760892f2ec01f2c5db872da7992c7821cca2950e2ec2b021929a241f9,t,21000,1455805,,5000098,2018-01-30 14:06:41,47
0xaab7547ebbcfab6d8df147af53a2437b6d64ed13d01b3b832da73b79ac84e38f,t,21000,1476805,,5000098,2018-01-30 14:06:41,48
0x1e67e60a6b01a4830836ff91f0dc9fcc883b9db6d485cb3eaa3885066a68d797,t,21000,1497805,,5000098,2018-01-30 14:06:41,49
0xe3f0fd126570ab910297ab16be6e951c552efe05be08f48a336216c5461935ed,t,21000,1518805,,5000098,2018-01-30 14:06:41,50
0x378f553d6729f8965602a4d30e81be9649934c6a1b180e52376af48c7881b007,t,21000,1539805,,5000098,2018-01-30 14:06:41,51
0x68e55582af287ee91b2599cabd6276782fc0a3c9064f825f44b059332677a5aa,t,21000,1560805,,5000098,2018-01-30 14:06:41,52
0x67e13fb0391923233cd2d6eb0e3d29ee1e2ef52a0bdccf7c8a4d4b37029c0c91,t,21000,1581805,,5000098,2018-01-30 14:06:41,53
0xb7de340bb09250ed96d170eaaf5cb4f504092f0bca374b0601d47952be07abbc,t,37091,1618896,,5000098,2018-01-30 14:06:41,54
0xa0886694326dad4936e3cafc29b5786efe4df2e2bd83d4a38bb2c308da2841b6,t,21000,1639896,,5000098,2018-01-30 14:06:41,55
0x3d21ac70b4cfd09255b4480f79fdc1b5df4d4620660599c40a34848f31f76122,t,21000,1660896,,5000098,2018-01-30 14:06:41,56
0xbdfb03e0a6dcd02feabe4e30372fbe67e77a211ee3b12c6e80f4b9f2e2916ce5,t,21000,1681896,,5000098,2018-01-30 14:06:41,57
0xba551c23b026a26300b78bf12d95bbc76b9224cee2226596309e6239a5236255,t,21000,1702896,,5000098,2018-01-30 14:06:41,58
0xd9d1df09fcfbb08785bf6c6d9c871368292ed3656fb2d754dc2be063679776a2,t,21000,1723896,,5000098,2018-01-30 14:06:41,59
0xe0eeb5a6a61b3b604b388a639f1be634f1398603f696181a634be11bdf684a5f,t,21000,1744896,,5000098,2018-01-30 14:06:41,60
0x9861d04a682fca8dc261b824a41a27598edd4c957af4d67f1493b355c9d44db4,t,21000,1765896,,5000098,2018-01-30 14:06:41,61
0xe167746ad612e12f8d86cd89dfdf75556d63b15fc85d268428fccd1024d36795,t,21000,1786896,,5000098,2018-01-30 14:06:41,62
0x2794762c205bc1a222614fce5c4c29ea868ee59d4d959761692ac1a680ac298b,t,21000,1807896,,5000098,2018-01-30 14:06:41,63
0x0aaa284920b1053f12e3a9de5b65133635e272daf71ec4f1107e357059961614,t,21000,1828896,,5000098,2018-01-30 14:06:41,64
0xea034e7cc4adabfbcd7d11c42e797cd2a7e868457471002aa69c5e6cce20e7c2,t,21000,1849896,,5000098,2018-01-30 14:06:41,65
0xc7aa6488f184a62955b615513a1330a8de10427adca3d69db644756a9fdd5733,t,21000,1870896,,5000098,2018-01-30 14:06:41,66
0x13b1b97ba872922581eb5aeae340b09dd281e7f5573e4226da3417d1202e0064,t,21000,1891896,,5000098,2018-01-30 14:06:41,67
0x6b9bb8c7389a72c04c7a6e66e2e01d084a44311d772624454bcc4a2d272eca72,t,21000,1912896,,5000098,2018-01-30 14:06:41,68
0x1292120282d954fd870285971c5a8112911f8a1b050c7d0bf4a875eadbdc4a40,t,21000,1933896,,5000098,2018-01-30 14:06:41,69
0x2d9996fc3fd492dd02e983fc60726c789d74d6687d72077ae709725f822cb1d8,t,21000,1954896,,5000098,2018-01-30 14:06:41,70
0x1ee7d1a8dc1c4b2d4ebe7431108be186c63ee945519b91d2ffc6f482769a9317,t,21000,1975896,,5000098,2018-01-30 14:06:41,71
0xc4642c7a05ce553d771a7c6e3ae83ee44a557fd12e79889c1c62c6bb1b27b5b4,t,21000,1996896,,5000098,2018-01-30 14:06:41,72
0x56615dd67146df58a3e2f767a81a9b96429c77545c014a27bff91ee576bc5bef,t,21000,2017896,,5000098,2018-01-30 14:06:41,73
0xe0b06ff4b8c5b3a7c4dbc6b493985b5742942fba91a2524e0fd162d1f2b3aafc,t,21000,2038896,,5000098,2018-01-30 14:06:41,74
0xfa003f28efd637e772366ecf95805c1268aee35a9003ea10b023434c6a3e55f0,t,46044,2084940,,5000098,2018-01-30 14:06:41,75
0xd825580a69ad85496ebc014f36cd5bf1afb38f9095e67c65d1c6ad3bd96a5ea1,t,21000,2105940,,5000098,2018-01-30 14:06:41,76
0xc193c40acbfabb5fa7cbd0c2093967b05441438441756f4d2db4af6c4b325585,t,21000,2126940,,5000098,2018-01-30 14:06:41,77
0xf75db8954b98e785ee2d95c5ce9f08b48416b71a5da71a29b03a65d5eb17c69a,t,21000,2147940,,5000098,2018-01-30 14:06:41,78
0x0b4e6f7a380f61affa70692642a7641802e622ce10bcdc176a627d9f1dd9baf3,t,21000,2168940,,5000098,2018-01-30 14:06:41,79
0x91f34993c3309d1e46479928b83af2744d799f24368fb72bd28c76ada6b6047e,t,21000,2189940,,5000098,2018-01-30 14:06:41,80
0xd9b0daec2ce532e6cb8531a81f949f9b49242deeec0f78ee891d0a2e6af5ba9f,t,103499,2293439,,5000098,2018-01-30 14:06:41,81
0x46a9871371c819dfb69e05cf20c61ef6aa551ae411725c2a6e0534f7c99377d8,f,51605,2345044,,5000098,2018-01-30 14:06:41,82
0x8371748d0fb2ad50374dc72f947031a88ec027ac0cda4dcbbf9f67db4ed4dd33,t,23355,2368399,,5000098,2018-01-30 14:06:41,83
0x8e9f5eeb70b3e28e1a13fe0e9328d514ecbd5d2b4a14e7f5086b7477297dd92a,f,24028,2392427,,5000098,2018-01-30 14:06:41,84
0x71ea3c19fc6c15a682508ab6b44a474960f19efe67a46b7c22cd486efbf8107e,t,21884,2414311,,5000098,2018-01-30 14:06:41,85
0x267b5327d00ba4710fb2888e89e3363caace8772c7ba848fe70a49d30cf8638d,t,21000,2435311,,5000098,2018-01-30 14:06:41,86
0xba563fecfac0220b374a8a7d574110a7cc261e8e8f4f7ca1b80f99a8fe816169,t,21000,2456311,,5000098,2018-01-30 14:06:41,87
0x496aa29cc6a6a9e156a9a0d431a6f228714679a0fcbfc0d2cc1e116e9a9cdf78,t,21000,2477311,,5000098,2018-01-30 14:06:41,88
0xb77c964e8f4425aa29f22ad829cb0ab7c9d4cce10f0c43e489608da60c6e5cf8,t,21000,2498311,,5000098,2018-01-30 14:06:41,89
0x31eb552bac4bc4f22cb148f6dbf46eb8c45cb829f2bc6b99db682a950d6c366b,t,21000,2519311,,5000098,2018-01-30 14:06:41,90
0x79e35534a5d32b97f57e5b67d0c9cf5a402770afc5693373324f75c3480fef43,t,21000,2540311,,5000098,2018-01-30 14:06:41,91
0x9733c4ab62767a8235ffc1b701e132b1f04588e8e15ef4bfda46d57c378110e2,t,21000,2561311,,5000098,2018-01-30 14:06:41,92
0x96a1796f1d17b5b7c938e97344c7d91282aa4e565797451c9cba3ad8d6c0c495,t,21000,2582311,,5000098,2018-01-30 14:06:41,93
0x48564c7aa35e0566f4b8a4dec6c0a977dd39f9b336c8265a18f406f953d03684,t,140972,2723283,,5000098,2018-01-30 14:06:41,94
0x579239b230dd7433b285fcbbba201843822fbc9f81ba7ceff6e905d4795aae9e,t,21000,2744283,,5000098,2018-01-30 14:06:41,95
0x9ffd127cafc04b62fe6ba112902aa86c710b6ebb8dfbdb227756feb556dce612,t,21000,2765283,,5000098,2018-01-30 14:06:41,96
0xe5b1ad90b7361a480145f8d8a3b23fd5cfe5fba47bdcac9e2a988514ca97584d,t,21765,2787048,,5000098,2018-01-30 14:06:41,97
0x24dca9565b24b10a90be04397aaa8e20b50b2a1542238a5b836e0eba06b78615,t,21000,2808048,,5000098,2018-01-30 14:06:41,98
0xb38b284b01d774afa4436be1acdfbb262ca03e94b12c6ffe51622fef11c30384,t,21000,2829048,,5000098,2018-01-30 14:06:41,99
0x2dc35acd53064b9b5f696747e651efd2605010ff2931364796e1da5125b47162,t,21000,2850048,,5000098,2018-01-30 14:06:41,100
0x605da011c11f61908e276817d14f1369d4b6d92f341896d77f939dbdf18e8cdb,t,21000,2871048,,5000098,2018-01-30 14:06:41,101
0x946a96891b3c4317d055505e793e14d39f4e9c937218ea37eac93cee18b1bf4c,t,21000,2892048,,5000098,2018-01-30 14:06:41,102
0xbc6be87eb3ad84e6c45e564723bdb1ab7cbfa15ca47f1b52b8e1fe4da4ad9439,t,21000,2913048,,5000098,2018-01-30 14:06:41,103
0x8477858bc3a1ba0775c58f34610fd4be1455bf7aba457109b23f36ff36b44f6a,t,104678,3017726,,5000098,2018-01-30 14:06:41,104
0x46d39fcbdba3f82ad68701942a59eea926b5c2c418c9107d75c71dad14e26945,t,21000,3038726,,5000098,2018-01-30 14:06:41,105
0xd6d5a6e016cdefb1e3929de56b8620e0dca805f3e507a3b5833e745b5a4e4880,t,21000,3059726,,5000098,2018-01-30 14:06:41,106
0x911575eee208fa8a1b75eadd8755f6e666046196070e4d7d739ea2b68b5a654f,t,21000,3080726,,5000098,2018-01-30 14:06:41,107
0x0174e0d99683f4b4186d4f49096ce0c5406e6d067abe0b6fdbf3364be5ba4100,t,21000,3101726,,5000098,2018-01-30 14:06:41,108
0x7794112958c9d0b1fde36109719c4410fc4d1f3839b23dac33f874730b2514a5,t,21000,3122726,,5000098,2018-01-30 14:06:41,109
0x66da839fbe69915ea9d16d505cec8df2dcf9c56ad64154c8dc3b575ef02dddc6,t,21000,3143726,,5000098,2018-01-30 14:06:41,110
0x5fce14cba30a07f021c0e526b394b3298f8495f204f6f3cf278dc9f2acabb457,t,21000,3164726,,5000098,2018-01-30 14:06:41,111
0xb5785d6f519212104fd9d856a79155c1315995af2ed48182bebabf22967ca1bf,t,21000,3185726,,5000098,2018-01-30 14:06:41,112
0x457bca79f187301c10f5a2cdddaf2a627f3e148a7b512b716cf14aa9644e6495,t,111829,3297555,,5000098,2018-01-30 14:06:41,113
0x475727b8505a6a0d2c770dbe459287651a8e7ed3691234f5e6122183318b951a,t,21000,3318555,,5000098,2018-01-30 14:06:41,114
0x0150ddf6fe9ac9cf4a1518dde8215cb8be9e6ce16b1022d418cd5dc3cd710fc4,t,21000,3339555,,5000098,2018-01-30 14:06:41,115
0xa2aabcb5b8b98d9fdb9a278c2df51ebcf2ac3ad3cb6e21253db4144b7e0a9e68,t,21000,3360555,,5000098,2018-01-30 14:06:41,116
0xc011e4d5a001aa164ab3625f315f83b0cf214709d7970822f25871fa281180a0,t,21000,3381555,,5000098,2018-01-30 14:06:41,117
0xa9ef680dd91afd07883cd4b438997830e1a19d56f471102511475c07d5ac59a4,t,21000,3402555,,5000098,2018-01-30 14:06:41,118
0xdfaa765a7251476d840553a3a70036ace7de673018d4a6eeda4946ebbc756299,t,21000,3423555,,5000098,2018-01-30 14:06:41,119
0x34dfce842bbed37d8b390d55aef6a5d4d926643ce17162a6c76fd7d46b0ea540,t,21000,3444555,,5000098,2018-01-30 14:06:41,120
0xf3d94f8c5f50aa3c359db0cfa2e203e9c9cef2122fcb45d7ebefcbe9a447ba9a,t,21000,3465555,,5000098,2018-01-30 14:06:41,121
0xc74ffc250412424ade734c3d04425a1882ef346c7ebbc07477dfc48cb37510a7,t,21000,3486555,,5000098,2018-01-30 14:06:41,122
0x204a6b664f4771d8ad3288857614d6a270d00203e9450073cab5942b93335a80,t,21000,3507555,,5000098,2018-01-30 14:06:41,123
0x39a2bc7ec40fbcf319d61589e51a30ac8d23978d0c5ce48a6610b927be434bbb,t,21000,3528555,,5000098,2018-01-30 14:06:41,124
0x53b1dba8cf3cf05fc15d042b2c73d8a4c409700ce3ffa3ec99d6b46b74cba169,t,21000,3549555,,5000098,2018-01-30 14:06:41,125
0x23f0c07e70c0d2512a56786baf05bc786bf0dc2d6f9f30e125b1fc9e74208b5b,t,21000,3570555,,5000098,2018-01-30 14:06:41,126
0xc67949e626dea3462aaedd024fa6d175fdd0350d2f501c0fa6802666a9cc3ae5,t,37468,3608023,,5000098,2018-01-30 14:06:41,127
0x9f65751c691fdec433f630cf86d663d273d89e3f93b6e2f24c51c34e54e4aa5d,t,46109,3654132,,5000098,2018-01-30 14:06:41,128
0xe9329d645231fdc11ae318d76da59d2aaa5ddb1dade3829214df06deb7b5ab7c,t,58862,3712994,,5000098,2018-01-30 14:06:41,129
0xa0bacee3c7cb586bc60783d578a277c28d9657318b175e567fd8fadce001d14a,t,21000,3733994,,5000098,2018-01-30 14:06:41,130
0x8e2aebca80a5dd1604022543462cbcc6ea99e6f65143f1e9a1fa7786b6ba6f7c,t,21000,3754994,,5000098,2018-01-30 14:06:41,131
0x87db06a2eb5b11a2f3b2b04c3033c8ccc3364ae6ad4a6e458d774e5821e5b81f,t,36779,3791773,,5000098,2018-01-30 14:06:41,132
0xcbe87ec7fe85cc5af74c40c18eb4ffe0d3b09285eee500b732a7ef328f2f17b9,t,21000,3812773,,5000098,2018-01-30 14:06:41,133
0xbc0f82c1530997c5514ca62156660bde400188fff615f1f71798debd07a08836,t,21000,3833773,,5000098,2018-01-30 14:06:41,134
0x3e90c20cc920159479414ad8ceaff465e50c86b6f59c1c70ea58c5f10cbb2e24,t,21000,3854773,,5000098,2018-01-30 14:06:41,135
0x8e58fb0d318b0b934f9338c04e84e5952278e42c6f2a5f8888d840bc65a274f2,t,21000,3875773,,5000098,2018-01-30 14:06:41,136
0x828f43078f35464b3f0877c355524f1ba9d7c9b14aec7e2d722ae255ecacd328,t,21000,3896773,,5000098,2018-01-30 14:06:41,137
0xdbb905e5a3fcf97f820ba161a7dc4b89ed17ad757092f7febb9a40c73480e6ec,t,21000,3917773,,5000098,2018-01-30 14:06:41,138
0x4fb6ac577fd1c82d86a352f0654c4b38673b0399a8fed2de086bce757d94fba3,t,21000,3938773,,5000098,2018-01-30 14:06:41,139
0x3b3f314f157f4081ffb050327e9795f79cdd2b825d262dc1e03d14c1d3a2c7e9,t,21000,3959773,,5000098,2018-01-30 14:06:41,140
0xae8fc3dbc5ea5c3c54f66cf47ea5e3a90003f3cc24efa2ee82679b8e10877255,t,21000,3980773,,5000098,2018-01-30 14:06:41,141
0x426c2f404ed6aea75c2bf72d6bbaf142c8497cc22a17ccb6bf42b2fdaa68d7e9,t,23375,4004148,,5000098,2018-01-30 14:06:41,142
0xd3c806c37d09988c76ca3653b6ada812457dc40f597b6ca0cedf56a5123df277,t,21000,4025148,,5000098,2018-01-30 14:06:41,143
0x4b6b27488825eeaa256bf27c66147ed358059e93b04bc90dbc495bc9fb95a7ca,t,21000,4046148,,5000098,2018-01-30 14:06:41,144
0xab5397adff0efef7939ddbafafe97d50db9cc6fe86616490924f8cacfdb039a8,f,66304,4112452,,5000098,2018-01-30 14:06:41,145
0xed79f00024dec60291acbb8849963e8e62d55d0f23a08b78888344889e7d9ebc,t,21000,4133452,,5000098,2018-01-30 14:06:41,146
0xa80dcc9853054702ef2099c167cc7b187203ce66e215eca1b7c929d6186f43ec,t,100076,4233528,,5000098,2018-01-30 14:06:41,147
0x0bd5cee3e735d18ab0614c9adf9c25f7f5cba0dc7db421f89a06ed2d7abea864,t,21000,4254528,,5000098,2018-01-30 14:06:41,148
0xf509214d84a129a86e9c66369858fa1222029b528040e62f9a725cc9c7ca675d,t,21000,4275528,,5000098,2018-01-30 14:06:41,149
0xcc06977cfa5a4aac6e9a6218b14633e6c36f5628a5a114642a27ff549cf788b9,t,21000,4296528,,5000098,2018-01-30 14:06:41,150
0x33a44b4e472982f47f078d3b90d65ad3f973407b14b41d96e1dda90548d19b0b,t,21000,4317528,,5000098,2018-01-30 14:06:41,151
0x27ce51999d7a705a8f4d970f6279e17ef6b72b7e4f402542400bb4c7e69a1afa,t,21000,4338528,,5000098,2018-01-30 14:06:41,152
0x08c922bee4318d3cf8efc71948317cc231d8ad9daf961b780ea66be4b9ec6dde,t,52096,4390624,,5000098,2018-01-30 14:06:41,153
0x5dfa136ed962d4a96e254199f1d7a098db985ef30cd76b7c223536d96ad14810,t,21000,4411624,,5000098,2018-01-30 14:06:41,154
0x88d53ec90aa14e3105efe07e02730665041769931c51cac1058b936f355463e4,t,22136,4433760,,5000098,2018-01-30 14:06:41,155
0xc1b6543009fa3b77c8c77f539e01bd923ffdbb92910fcfb75c8b853751db5fcf,t,37222,4470982,,5000098,2018-01-30 14:06:41,156
0xc93ca75439b778d98a52e4f5b31ea06c00aa69264e9ac5876153a213e8036e01,t,51457,4522439,,5000098,2018-01-30 14:06:41,157
0xc81994e4c41cb1cccfe126baaacabbe55b986eac37155d7294a88cdbb639917a,t,21000,4543439,,5000098,2018-01-30 14:06:41,158
0x9951e4baa9f925e4146836af22638e25c9ba8f560365c419b8cf8659b7e77dd7,t,37948,4581387,,5000098,2018-01-30 14:06:41,159
0xa5d631e579505724e48df08aceab8922a20e5dade4fe4c77d4b8ecfea2f8954c,t,53615,4635002,,5000098,2018-01-30 14:06:41,160
0xb38087375ad848beec2b8fde00bace2d571a35b7c084bf9a1bf027026522ea90,t,605988,5240990,,5000098,2018-01-30 14:06:41,161
0x31806f277ebe76cf8a53567e3004db58a90288ce4593b4d9cd22791e3394dd6e,t,29073,5270063,,5000098,2018-01-30 14:06:41,162
0xd13c5d50ec7cc340d8e35c39dc312b0af07c65ad74ecf00031022ff74c567f7d,t,64427,5334490,,5000098,2018-01-30 14:06:41,163
0xad15eda35d6ee42db1b88bfe3b44780081c60a0f239e4553a0a7d9ce656fa067,t,48240,5382730,,5000098,2018-01-30 14:06:41,164
0x1a305e402da641e295e803ad999d5f425aefa7d1dc6d91349a3602427186bd5a,t,21000,5403730,,5000098,2018-01-30 14:06:41,165
0x8d7ba560327eda9550d52d56a44f0526fe18d8d472da000a10a3a7a1d4819fcc,t,21000,5424730,,5000098,2018-01-30 14:06:41,166
0xc306a1465234f6d0ea598afed80cf2183990573a7a7347366a5767fc43460467,t,21000,5445730,,5000098,2018-01-30 14:06:41,167
0x31051aeb2d1ecfe83a38f8d0fd1f17efac98aa7950fa03a6d4d633f672254ce9,t,21000,5466730,,5000098,2018-01-30 14:06:41,168
0xc7ab3abfc09765a900cae23137069a59ce81e5fa124b776c1d696e24a3172283,t,21000,5487730,,5000098,2018-01-30 14:06:41,169
0x59e3fbdc983439963a86af90d4de0a8b5f5ef004da4f7808a85524cbad3cdb41,t,21000,5508730,,5000098,2018-01-30 14:06:41,170
0x979651e889535f27316050e92bc0638080b6e6a6229a8d7ca516170fea0b2dd8,t,21000,5529730,,5000098,2018-01-30 14:06:41,171
0xe2680b80003d2403bba31e59353797d0590542b76962424070f195ca2f63991e,t,21000,5550730,,5000098,2018-01-30 14:06:41,172
0xcba9e0fccf3231514a5c62ade576ab1746af6af1fb680ebf0439dcc3b3da0328,t,21000,5571730,,5000098,2018-01-30 14:06:41,173
0x433cac6b556633d88602e79c72fcf8f0067ac5f417b9843825528d1cb1430f59,t,21000,5592730,,5000098,2018-01-30 14:06:41,174
0x17b27dda888ab8995c456dc74328b339d86eb5d204bf1669afaad634f2612663,t,92513,5685243,,5000098,2018-01-30 14:06:41,175
0x35a465c140e6bd1eb562c184ade55c6f3ead3cb7c24ebf32912d3e4629ab7f56,t,21000,5706243,,5000098,2018-01-30 14:06:41,176
0x4f8e3dfbfababc6a975df0ade75ce639b608dbc4a8bc953965bbd799632d50cf,t,21000,5727243,,5000098,2018-01-30 14:06:41,177
0xf2d4eb00da3da942aeb8dbeca4a8f2ddfb74a6e8451978ff7e5828e9be4bc5f3,t,52136,5779379,,5000098,2018-01-30 14:06:41,178
0x9a1ac24e82e96aa43965aef744d6723511a7d8547f3e4b33b0c24a8aca1ca8c3,t,21000,5800379,,5000098,2018-01-30 14:06:41,179
0x77f0c85d2de8245631732a4ed19a09d35c8a9ab5922c61b4d36c9fb9e943c243,t,21000,5821379,,5000098,2018-01-30 14:06:41,180
0xc0462b0d6544c098b285b95ce356fee86d34fb8da919a6885e217fa1a4aa7d1a,t,21000,5842379,,5000098,2018-01-30 14:06:41,181
0x62bb857df4f6227cf81833531afcde7ae165c48c500af6122ec8c3e8a549cf3d,t,21000,5863379,,5000098,2018-01-30 14:06:41,182
0x742fbac2c6852a98a8cd1bde3a6a93f8a9646b466507428be2f0cd5cd531aaab,t,21000,5884379,,5000098,2018-01-30 14:06:41,183
0xd8bf14af5ef7f34e1f729ca970eae31b57dedb6d757545c86ca3948b699752a9,t,21000,5905379,,5000098,2018-01-30 14:06:41,184
0x84402b320d8710d5b74669919fe8a5463fbec1ae12951f1bd35e7ea78d7ff747,t,21000,5926379,,5000098,2018-01-30 14:06:41,185
0xec5ae91613fe7f321ef16c78a4ccad7e86e4a32f73727e249919d2075a2cedb8,t,182041,6108420,,5000098,2018-01-30 14:06:41,186
0x1721eaeb8eae918a0ce34a43a64334c8deec8442448a8c04ea354c74447ac28c,t,21000,6129420,,5000098,2018-01-30 14:06:41,187
0xba61fe4dfdcc57b5deeebd5967c687d1e46cfb2b4639aa7386b099e47c66b5a4,t,21000,6150420,,5000098,2018-01-30 14:06:41,188
0x0723d6a2d0cc18d8a8b82d66bc8e954ee33601b141ab7df3b7c143be2d8da2e0,t,22387,6172807,,5000098,2018-01-30 14:06:41,189
0x33d4b702e8501fd01c514b37008ae408eb50f1cdbe8da6e68f8f107312900392,t,21000,6193807,,5000098,2018-01-30 14:06:41,190
0x5913c62b67094b5beaeed3c3b820910d6e49885d2a778f9e0047b0356aa5a665,f,399127,6592934,0x7C9DcEaDfE7Da98758D1C9bb5f13123d5585e1eE,5000098,2018-01-30 14:06:41,191
0x89a6f2ac0ddbf024d8813a6d576aca61fcec17a57a61faa0c58363418e993027,t,21000,6613934,,5000098,2018-01-30 14:06:41,192
0x65cba17c50c256e86ce198f10b7d66c36f4e9c6090ed896a5173206f91d4e548,t,21000,6634934,,5000098,2018-01-30 14:06:41,193
0xaf316f1758bd8f9d9a4d02c0656b05a4f5f46347cb21b582d699246a6558556a,t,21000,6655934,,5000098,2018-01-30 14:06:41,194
0x91fe01736ef962bd144b2f0bd206c1647000f036015e9d9dc92a4976b31d2c05,t,21000,6676934,,5000098,2018-01-30 14:06:41,195
0xf097ecb555c41ffc5ec13927ed33facf714b5c2ba4b367a2ce08b8848fabd781,t,21000,6697934,,5000098,2018-01-30 14:06:41,196
0xf334824389bba5d8afe5061e490b8f25caf0420f24b00c21dd5d9c8c1b465ba7,t,21000,6718934,,5000098,2018-01-30 14:06:41,197
0x74debe2c0d14246f39ae3520a4f9eca3f797d4cd0ccc1c99047a229aa160e291,t,21000,6739934,,5000098,2018-01-30 14:06:41,198
0x08d3bc7e0cd583061185b774daf38574143e89687734d13f3a1f87339672d2da,t,21000,6760934,,5000098,2018-01-30 14:06:41,199
0xc27340ba81200a7aea9282a923576e64195efaa976521568508a173da60b0120,t,21000,6781934,,5000098,2018-01-30 14:06:41,200
0x6c8fec2767747caff8136f5cf74971fdb1b553111195584bc1a3ee554390aaf0,t,21000,6802934,,5000098,2018-01-30 14:06:41,201
0xf8bc1fc6936ef2e08117f3b286988ce090180731dc780bad6bf96b5c00ddfedc,t,21000,6823934,,5000098,2018-01-30 14:06:41,202
0x944d9db6b764e52f6dcc9184d17084a9e59704d5d16592fcfa5dcd7be1e40745,t,21000,6844934,,5000098,2018-01-30 14:06:41,203
0x130f36b3519759e2fa9f50d6dc12b4bee718e3996432c6eb8e3ecda2027e3d01,t,21000,6865934,,5000098,2018-01-30 14:06:41,204
0x6708e91eba925216070ee8cadb7e70e7dca6568143e00f6cd0c3172f6fd0785d,f,24496,6890430,,5000098,2018-01-30 14:06:41,205
0xa73406e49cd7dcb457b72565532ca6d1dd501c542ea6edbfd6dca6354d119cfb,t,21000,6911430,,5000098,2018-01-30 14:06:41,206
0x96b67705b51f28ee1f870fc81614af9a197ff3a2ef19181f026fec7003e04fd3,t,22611,6934041,,5000098,2018-01-30 14:06:41,207
0x02baf69f30e39506952b266166a35081d7b40f43755adbaab62353677766597b,t,21000,6955041,,5000098,2018-01-30 14:06:41,208
0xdf54b4f4df1b66b233ee83d95c094e2e366448d508b1bc994e1b56e29aaa3476,t,21000,6976041,,5000098,2018-01-30 14:06:41,209
0xc451373ba30097b8f0eab8dbd44dc705a8d4d834b46571f7395af076fe149d81,t,21000,6997041,,5000098,2018-01-30 14:06:41,210
0x84c863ab91208578f0d80f376b1907a6e3e443a2669334cd7c71103f498b70c8,t,21000,7018041,,5000098,2018-01-30 14:06:41,211
0xec7253083d2f20a1ff6d79f550ce6c5a685639e7fa4571d2d188a837c8b07149,t,21000,7039041,,5000098,2018-01-30 14:06:41,212
0x855963f2280339712276a10f84a5f5217d0b7883a6a7f0daaccc2ace3a5e2772,t,38318,7077359,,5000098,2018-01-30 14:06:41,213
0xf75af87e89ade024e6117d79dde6cc500bab10844113d31713e0b7e1446cfab9,t,51947,7129306,,5000098,2018-01-30 14:06:41,214
0x0fe07f417e906871f8c0448007eb810e3e6458d8c9fa21f820dbff0b08d77a78,t,36947,7166253,,5000098,2018-01-30 14:06:41,215
0x9c9aa8ba75b8e4a534ec94fa78a01a9fb9aed0f79154b80e4fdd4f884cc5d2b6,t,21000,7187253,,5000098,2018-01-30 14:06:41,216
0x144b20721d45dca55d3cdc4cf9b2718715a2199576a5693dd093fa994b495f60,t,21000,7208253,,5000098,2018-01-30 14:06:41,217
0xbae84d9d9a5f60abd264d19dfa4422dff18aa61a8c2b1b2f6001ef6d599c8358,t,40843,7249096,,5000098,2018-01-30 14:06:41,218
0x5ed0c96febff803a675f6e118d83ed3d4b9ff0632d264e600c164a20b78356cb,t,43812,7292908,,5000098,2018-01-30 14:06:41,219
0xb10618b974700554736234a8fa6073bf8dd8cfda26bac4125655d11550d86e2e,t,44700,7337608,,5000098,2018-01-30 14:06:41,220
0xb213c45b039a17e2467bd049e8f6a92e3dce8ad03d484e61a7fb407dec11b694,t,21000,7358608,,5000098,2018-01-30 14:06:41,221
0x848590fabf99f193d800007e5ff02a9e73d9170afd997e4bf8b67bac39744854,t,21000,7379608,,5000098,2018-01-30 14:06:41,222
0xd56c3cab4ba9a9f9d5dac405ae4ebebe193e5b4aa676939c6efa618454cb9e8d,t,21000,7400608,,5000098,2018-01-30 14:06:41,223
0xdf0f6c7b7ef55a82de8419c325de884470dc7ab29318946519825f7df26ee5e6,t,21000,7421608,,5000098,2018-01-30 14:06:41,224
0x6469f9592c328e3797e9e65d5b54476874b4292b80f44f2b83bd078d690af4fc,t,21000,7442608,,5000098,2018-01-30 14:06:41,225
0xb65f2fd01d121141ad6e1feb6ef976ca900ab595cc3f02eecaeaee36b6e28f53,t,21000,7463608,,5000098,2018-01-30 14:06:41,226
0x3488a9f3aef79a6cfcfd82ed9f9a8c79f230ee5a744a4a906fbf3ec6a820ffcc,t,21000,7484608,,5000098,2018-01-30 14:06:41,227
0x5daae08203382649a3ad910f21fb9bc3be8a8d0d49eb16334db8f85f944e3bf9,t,21000,7505608,,5000098,2018-01-30 14:06:41,228
0x6157bb10e970691e8bb99fd2528cdc38613df585d903f3f5716649dce2c2b58f,f,61849,7567457,,5000098,2018-01-30 14:06:41,229
0xff1223805a56156fef99c0fdaf406d4f5d3c95962612616038a617018598c283,t,21000,7588457,,5000098,2018-01-30 14:06:41,230
0x990dd31b1a57c4d4bba36827a03a8318be6058c5b6dcefc0f40944ad723625e2,t,21000,7609457,,5000098,2018-01-30 14:06:41,231
0xfc3091b99c3b534afa0b4769e19caa5df6102d00b3a783740d768b021de0b547,t,21000,7630457,,5000098,2018-01-30 14:06:41,232
0x7bc501b02ac31e03f2fb8090e6ca4e0929dab0858363a62accc281953d1171c4,t,21000,7651457,,5000098,2018-01-30 14:06:41,233
0x06255ed5641ad3a23d391f5767d940a77dc9d54a4454304c668e335d82f3d5a8,t,63067,7714524,,5000098,2018-01-30 14:06:41,234
0xe965914dfadd0c1442dfb64a350f83be215f288d2dac75f9ee94fc9742307935,t,21000,7735524,,5000098,2018-01-30 14:06:41,235
0xc17535699aa81b37591a277150660ada68dc68893d410c7ec88e1d1d30139e0a,t,52472,7787996,,5000098,2018-01-30 14:06:41,236
0x0303d9b3e314c58907dbbba6b20f491205e8c1611832d63e66a542b78f784f2e,t,21000,7808996,,5000098,2018-01-30 14:06:41,237
0x0a8d4e42da85a715f387cbe787ff795df3c21e2afd3a98143c3cec9d811fb002,t,21000,7829996,,5000098,2018-01-30 14:06:41,238
0x38e9e4604589986396de88e1ce7671de9465a42fbe70fddf29c8e43f89d31c14,t,21000,7850996,,5000098,2018-01-30 14:06:41,239
0xdd32d97ab13e7eaa9b1b68c6eceb790cf4acaab8fa1fd5ad8f505a4940fe04b0,t,38318,7889314,,5000098,2018-01-30 14:06:41,240
0x6618ce51e7c6b88110eadf0115d4b8b35a15494f39462125a4de09426f51e175,t,21000,7910314,,5000098,2018-01-30 14:06:41,241
0x65b538e43710d315c94cd348a0f70d42ba2d0964e4d734f11ec1afb925679240,t,21000,7931314,,5000098,2018-01-30 14:06:41,242
0xef8369f3cd1e4e444bc478778148715f4558bdf1411d4367f3938c526fd52fe8,t,21000,7952314,,5000098,2018-01-30 14:06:41,243
0x3dab0230b60e3a4673b898c5716020a3f1fae776a661eae5719fb2ecb781cbcf,t,21000,7973314,,5000098,2018-01-30 14:06:41,244
0x4638adb0c1e472f105f6dad2e56ed1aceacd76d5962bd035d7a8d8d836d9aa61,t,21000,7994314,,5000098,2018-01-30 14:06:41,245
0x8adb5707921d82c68b96bf1b8f65cc7638df50e0b46b2e3374cae524639db2a4,t,21000,21000,,5000099,2018-01-30 14:07:12,0
0x3534560004c5a96a557160fbace83aeb5a782af8a82c763f5bf28363a2f3da63,t,21000,42000,,5000099,2018-01-30 14:07:12,1
0x5035e9bd93d0b5c4e060282c1beaa2fe5455fc16fd7bf9099941c85b899a14a0,t,21000,63000,,5000099,2018-01-30 14:07:12,2
0x27626dc543f14ea706c72163615d593fb77b7a406eaf4be28a91c2c458a7522c,t,21000,84000,,5000099,2018-01-30 14:07:12,3
0x4e13f9ea01c7f6aaf9ab0cc5d84eba8883a621dad4e7fc73a6cc675b9b5b290a,t,21000,105000,,5000099,2018-01-30 14:07:12,4
0x1b3ca21ea7647d68b34243fa7456c405b4114fc09bff46c6e4b5f2a83798ea6a,t,21000,126000,,5000099,2018-01-30 14:07:12,5
0x97b98e87d0c993a1764124504b66c837e4679d1c0308b10fc8b23d6c386730a3,t,21000,147000,,5000099,2018-01-30 14:07:12,6
0x73b126accf3a42eb3e7f7043a36b7863b6d1b95fc9e248d500be8c61220a3a26,t,21000,168000,,5000099,2018-01-30 14:07:12,7
0xf7e03a97ff967813f06e0d849590629026485dcee74086ced7c93888e15307ee,t,21000,189000,,5000099,2018-01-30 14:07:12,8
0x6770cbbfb076cf3e57418285ffe9db22d8cc8e1062bff49aa7b483dd2a37d33c,t,21000,210000,,5000099,2018-01-30 14:07:12,9
0xa3efbe413a69c81e7f116b03b45ed2b69184a3f576db738c35b310d27c78c79d,t,21000,231000,,5000099,2018-01-30 14:07:12,10
0x5d1dbc36b80f66e6e445eec30c9262cefe2f53f8d46182e76a2c5ceade3336a2,t,21000,252000,,5000099,2018-01-30 14:07:12,11
0xb37f921b6ee586c3fb4088717477d468d9d33dabfe672ad4c23d9cb2518566a2,t,21000,273000,,5000099,2018-01-30 14:07:12,12
0x2117e2757c8c7b241302ce070972ae0bec4d0082e36fd275632356f903c47d4b,t,21000,294000,,5000099,2018-01-30 14:07:12,13
0x0ff6513ccbc0825bc4b4d70c46adf9319ac5656fbd3ddad257d41709e8bd2fde,t,21000,315000,,5000099,2018-01-30 14:07:12,14
0xa74558af69e22a9b9f19288bf334a195acdbb83be5af525c4d8bb51bdf69b45e,t,21000,336000,,5000099,2018-01-30 14:07:12,15
0xc1146cc7466d600b7a09eff131f9a6c8fed9919c0fbe4c27d51f810e82dd35f7,t,21000,357000,,5000099,2018-01-30 14:07:12,16
0x391c6414bc7010941d93bfbfe58e9aa956255530c134ffea79f9264c615d12f8,t,21000,378000,,5000099,2018-01-30 14:07:12,17
0x894317f4f1e681dbe8e2e5588a62d6099d48d4993a360f88c0504cc15c8b42ac,t,21000,399000,,5000099,2018-01-30 14:07:12,18
0x29ddf9c7d4c8767bd872d0ca17bff7c2e5e2760dc9b986a5829d154f79a68604,t,21000,420000,,5000099,2018-01-30 14:07:12,19
0xdf44b7b2ca8a3807f8ae6908cebd88b7d92b7e958ce6f487656849da8c90e187,t,21000,441000,,5000099,2018-01-30 14:07:12,20
0x8246207eac94da30400657765a84c0ae15aaf4c20f0ec2bfaa2456c7ecf65a7a,t,21000,462000,,5000099,2018-01-30 14:07:12,21
0xdbfa1b8ab56cb358436830df4e0c64b5e4e30dfbf5844df304647131a485ac94,t,21000,483000,,5000099,2018-01-30 14:07:12,22
0xf88bccbd952ab30e79a578c98e9a5fc1f4d62396bc5a69643ceed24e214f1b66,t,21000,504000,,5000099,2018-01-30 14:07:12,23
0xba02424b0b0f720011b588f9a8dd113fd37bf6b8f213725ab54953c47738a5cc,t,104678,608678,,5000099,2018-01-30 14:07:12,24
0x61e28cad67b2ab6f78970a22dd1d73b0a0f41a755249c3f12faa25b216a3ff13,t,21000,629678,,5000099,2018-01-30 14:07:12,25
0x5a48f4a269999d04b9deeff1db9b49788f2d4d9337e39b53724d9a1c3e05a932,t,21000,650678,,5000099,2018-01-30 14:07:12,26
0x1452d840a3c6d0d977346dd29d0a66ed04dd07ad4aff3667df82e5333dee6df9,t,104678,755356,,5000099,2018-01-30 14:07:12,27
0xa9132c11c74f87a9e4647617a76f49fbafc05c80ef40084ad1bac52b7328b8db,t,21000,776356,,5000099,2018-01-30 14:07:12,28
0xf94a21272c682c5140464e2db57ac8853b325805eb4e0e91a414545b283d0707,t,21000,797356,,5000099,2018-01-30 14:07:12,29
0xa5618d12882bfaebd5ce75687ec10f454a4b56fb978bf403244ffe4f2e99a807,t,21000,818356,,5000099,2018-01-30 14:07:12,30
0xe03647b7f0901364ef2cf0c6053cce94c4a1c5c98f63bdd3467c4463d21a79a1,t,21000,839356,,5000099,2018-01-30 14:07:12,31
0x821348549b6334a90fba7036213051c4e80d2846610f9f6bfa2f27c94d3e8fbb,t,21000,860356,,5000099,2018-01-30 14:07:12,32
0x52f6875681c96325d65a96a4ca38490f02eed1645c653f850ee2a5db50f9481b,t,21000,881356,,5000099,2018-01-30 14:07:12,33
0xb97ad3c003f0b9aebdca19c18d2d1d6091ed09f2b407f2475a122d022cd69fe8,t,140972,1022328,,5000099,2018-01-30 14:07:12,34
0x2cf96abcac3b6413476837eeafd5d0d25237e1aa4f6d87897a06e433f37173e6,t,21000,1043328,,5000099,2018-01-30 14:07:12,35
0xe12db876d3edaa21f0a5dd47c9c3dfe79421123292c3140564e4317755d7d9ff,t,21000,1064328,,5000099,2018-01-30 14:07:12,36
0x85c8178a1f34a89bf984b684f35d424b0e544a9b0ecf71e17dd36a0530719bfd,t,21080,1085408,,5000099,2018-01-30 14:07:12,37
0xa9e9f6deedd4227b69a92843ded5f01b1cedaa264b83ad8467ebaef48ee91e24,t,21000,1106408,,5000099,2018-01-30 14:07:12,38
0xc36fc58cd86412ed2c460c2b605445db6f9db32af236dfa66c767bd46201b312,t,21000,1127408,,5000099,2018-01-30 14:07:12,39
0x0554957b4b115cf9afd0e906b1b870ecd0ffcb4effba0503ade3c72c82e55c0a,t,21000,1148408,,5000099,2018-01-30 14:07:12,40
0x2e4818bef3f4658ee7c958969ec04e6fbb920308f9fbbcce85eeb7630c6c3777,t,291498,1439906,0xab282c9Ea9F4B57483912e7464880F4272d1fAC4,5000099,2018-01-30 14:07:12,41
0x0c9031cf277a599aca836697f20451199aa8c965aa1784ce90342d0a39eab775,t,21000,1460906,,5000099,2018-01-30 14:07:12,42
0xf1fdf8bb3aef54bb47c929d167fb44843b1f5e859f704feeaff7ac681244c13d,t,21438,1482344,,5000099,2018-01-30 14:07:12,43
0x6cbc8ed13b5a2c032754d13df64b123826fc29ce20782aeebebfc1df849ede2f,t,21000,1503344,,5000099,2018-01-30 14:07:12,44
0x0cf289c82187b43623f7a57e740e7ad4c0d56b015626791ff74306a0971b9d79,t,21000,1524344,,5000099,2018-01-30 14:07:12,45
0x1305148eedc3d522d28c1cce21de672bc24c360be4f0a020d9b3fdef080a9311,t,21000,1545344,,5000099,2018-01-30 14:07:12,46
0xf61ab3d1e49d52c22111a048417e402755075f015ca06fb7027be56ec4e4a39b,t,36347,1581691,,5000099,2018-01-30 14:07:12,47
0xc4b2874b902164e040e5d12f48fba67ac71e7dcf3ce34279f25a9cfeaaf4f784,t,21000,1602691,,5000099,2018-01-30 14:07:12,48
0xba8f477a819a6e0e96b06065fa34eadfd6c151ce87d8add7f2d4afbeb90b562b,t,21000,1623691,,5000099,2018-01-30 14:07:12,49
0xc37c44d7ce88fc4d811176bfc70439077044f00fa753f30dd701b75a58b7c40a,t,21000,1644691,,5000099,2018-01-30 14:07:12,50
0x7826b04f66831cb47c8c4ea2f22aba8c8d57fffefc5d7acba1741428cd621baf,t,21000,1665691,,5000099,2018-01-30 14:07:12,51
0xb0a6575dbd22273bcb9b69b7f21ad867d697f47f4c53c7bbeb0ec671ca05a415,t,21000,1686691,,5000099,2018-01-30 14:07:12,52
0x6dfa39d9b4d96a3834a512a534d941534dd223e319adab76668ec1a4f3b6c8c0,t,78867,1765558,,5000099,2018-01-30 14:07:12,53
0x15ef18664974d95164b6ad389de81fedda002ca7d2de4ba6f1f876474ce7065e,t,21000,1786558,,5000099,2018-01-30 14:07:12,54
0xf7ef9adb89c6e206ec2212605dedeed87c3fea7a46e0c7936c372af55ea6e30a,t,21000,1807558,,5000099,2018-01-30 14:07:12,55
0x94808cdbfe1ae085ef0182750c75aba6e978e9d0d168e2dd5f3553af783a8e4b,t,21000,1828558,,5000099,2018-01-30 14:07:12,56
0x8f8724f3a046bffcd1d55cbe39e38eeb5eb0583a0b69856d61bd72ecbee9f9a2,t,22912,1851470,,5000099,2018-01-30 14:07:12,57
0x27a6a0b7e275d0c54fcc92ad79cafd361b79672743fe134441ccbc203710c6a2,t,21000,1872470,,5000099,2018-01-30 14:07:12,58
0xa26c782c9b4c2ce6a4cdcca6612b63cd5499d3ca04daf997f575d2e4da2aefa9,t,21000,1893470,,5000099,2018-01-30 14:07:12,59
0x8d3d3d6d458b6bf3ec9b19d70a690a1cc398d538223be5c35a04e7423fca1386,t,21000,1914470,,5000099,2018-01-30 14:07:12,60
0x679e89bdaaf89f415571532c3da652df4e4459bc6fed2b89671ebc7741d2a4e7,t,21000,1935470,,5000099,2018-01-30 14:07:12,61
0x6e69f21988e490613218cfb454f9cc0f3a66a25ba3c76353b06ea2b57301720b,t,21000,1956470,,5000099,2018-01-30 14:07:12,62
0xc3ffdb18440a30ee02f39e642118253e678fc8eb8c3b57b07b19b3db328b67a0,t,21000,1977470,,5000099,2018-01-30 14:07:12,63
0x1eca484d010a57aa3f1b7fc4d84e7b4b8eaec3e43936c3455e7c46644f3e6b7e,t,21000,1998470,,5000099,2018-01-30 14:07:12,64
0xf5cbc16628682924bbf713e02eab74b09d55539e0b4dcf7b6331684c07831cfe,t,90558,2089028,,5000099,2018-01-30 14:07:12,65
0xc5c696bd0d4905fa54efd8aeb06fc1c0e56190c22add6085c820a1b07f387201,t,21000,2110028,,5000099,2018-01-30 14:07:12,66
0x4c3d900d3e2e169c72a829e94a7891122e38c3633574df926a587525e098af87,f,24000,2134028,,5000099,2018-01-30 14:07:12,67
0x86298e4a2c0c5ed72429cc86def13d4f3ba10bdbeade1a534caa880d70894992,t,21000,2155028,,5000099,2018-01-30 14:07:12,68
0xd86fba84d123259523bd1ffc9e5149d315b5751b8d43d37a8ee7132384cd4798,t,21000,2176028,,5000099,2018-01-30 14:07:12,69
0x7039abafaba7a1079b02d171132ab84e29c2a376d6775cec5e43b6ba35ff7f7b,t,21000,2197028,,5000099,2018-01-30 14:07:12,70
0xe7a4e69d3d4135e8f4239a29db789f6668ff3e7b1d8ca8b439f728d5da22738d,t,21000,2218028,,5000099,2018-01-30 14:07:12,71
0xcca02c41c3acd33180ee9693aaceea17cc1a09d275684ad3d81d8cb4265955f3,t,21000,2239028,,5000099,2018-01-30 14:07:12,72
0x661b856ceb88ff73b5ce2f29f314af86792192d135a0bad32b5efd330a4dfb4d,t,21000,2260028,,5000099,2018-01-30 14:07:12,73
0x244151049a27d854a0529887b29ca16b84ba5c65535e265dfde4a6f4afa51972,t,21000,2281028,,5000099,2018-01-30 14:07:12,74
0xc6fc91d87aee2730e25a509cfbfc682d37d6633c99c6a83c1ed66da28dd97516,t,21000,2302028,,5000099,2018-01-30 14:07:12,75
0x89395933968bec34893bc6153296cef6efe7c4860a60cc654491ef5718291cdf,t,34725,2336753,,5000099,2018-01-30 14:07:12,76
0x9b6f8e8c4217a345debd2dc4ab64c9d6fc6976f6eedf23dedd7a4d97b7d800ea,t,21000,2357753,,5000099,2018-01-30 14:07:12,77
0x86a33d0cf271e8bdf8669b92d1750c14fe1b7fd4c195d8735355ee21a08382ab,t,21000,2378753,,5000099,2018-01-30 14:07:12,78
0x8b0696a41e7249092cf346c547680065c9cb6b707c416a213987a3fa060c2693,t,34725,2413478,,5000099,2018-01-30 14:07:12,79
0xd5bc413d8d5e89513d41533f56dbd34ed5f9f8170d9b657601941498a152fd00,t,21000,2434478,,5000099,2018-01-30 14:07:12,80
0x3814353eb5ba302a2e0d8c72a83b7c582928f1973d290c1ba058c497b05194a9,t,21000,2455478,,5000099,2018-01-30 14:07:12,81
0x40cf2d93b020d39d9d5246b77a694d851a5152b751a3d6d66508af2e81a0d10f,t,21000,2476478,,5000099,2018-01-30 14:07:12,82
0xca721f25471c4ed3ad538fb833f9d6084b6ed72b30a63820bae950a64580bfb4,t,21000,2497478,,5000099,2018-01-30 14:07:12,83
0x27132006ba2a19b69961aa35244620eef333875c000cc70daaab0d1193b8ad13,t,37283,2534761,,5000099,2018-01-30 14:07:12,84
0xa2d5bd2578f11a2212fa9dabfbc5053ac09260156c94b61500053c3ea481ba19,t,37900,2572661,,5000099,2018-01-30 14:07:12,85
0x5c908f1cb7380666e3467be3f20a9cfe0ff99093d037cce6760f43fb511550b7,t,21000,2593661,,5000099,2018-01-30 14:07:12,86
0xea98c7130c5864a80c3da354f188a6e1ca5b7bf529f21864437042d9f8fd915b,t,21000,2614661,,5000099,2018-01-30 14:07:12,87
0x97d97f37e1f317579ad5223a42f99e4541d2d332e5334df1b379ff05e6b405fb,t,52061,2666722,,5000099,2018-01-30 14:07:12,88
0x0d32a869214985b0cfdda973f3ce6ffa4453d59498061eac5d4c4ee0298c0e34,t,21004,2687726,,5000099,2018-01-30 14:07:12,89
0xbb8127c9e1dda31978ab239e6e823b003e2bd87d91f28298633d02f6168b7967,t,55907,2743633,,5000099,2018-01-30 14:07:12,90
0xc7736062a96cbb0fca103e5bbd21804abdca151935007abbc2ec7c1bf5584ba9,t,21004,2764637,,5000099,2018-01-30 14:07:12,91
0xb0a5c0f49521f2965135758f73aadc223cfc32b3e991ed82c39899695eda6445,t,21004,2785641,,5000099,2018-01-30 14:07:12,92
0x4265b8d8d66e4c193254472931d4d695ce30c0f5d6fbb5a99af6caffda794a24,t,89558,2875199,,5000099,2018-01-30 14:07:12,93
0x570f05e58df380507eb4d4f5de41b941187938d1bfe3c52f20ac6f890c6e8885,t,21000,2896199,,5000099,2018-01-30 14:07:12,94
0x35cba16226dee6ce9598388075338d35b2ea0db9b13581efdf8cb25f076493d0,t,21000,2917199,,5000099,2018-01-30 14:07:12,95
0x23a867fec25c4d3df880baf82bd46d623b314f9d3e7b2c4cc275fdf2a608d2f8,t,21000,2938199,,5000099,2018-01-30 14:07:12,96
0x0ee6886e54a6789f8f2b3889ca98d09efe80f450e3bb1360866557f9a9c97b07,t,91845,3030044,,5000099,2018-01-30 14:07:12,97
0xe4ba7fdb16c012d440a0556c56956309162e2fa67c9714951f6626a0204124d7,t,21000,3051044,,5000099,2018-01-30 14:07:12,98
0x197a0f94d660ce2baf6fb6b2a652d65793555199e107daeec604a217c2eff77a,t,21000,3072044,,5000099,2018-01-30 14:07:12,99
0xe7fcf044f9b3d1cd5cb51e915bab97d3f7a9ccc1d1c686778e10722c05948f3b,t,74244,3146288,,5000099,2018-01-30 14:07:12,100
0x19b6f323cd7fc986ec1ee1896916666d6ac2b5159cf980b411ca77ec69908f4d,t,21000,3167288,,5000099,2018-01-30 14:07:12,101
0x4ca01d029b87afa1e3d0073e11e9fa9ab9d01f95e7c3ed57bce295812a88bc96,t,21000,3188288,,5000099,2018-01-30 14:07:12,102
0x3c9b1d2ef8bf00715fd2ce8fb7d5b59922386bea5627cd310769a1c040a67319,f,50000,3238288,,5000099,2018-01-30 14:07:12,103
0xfcfa37b35e82df72e52a2a412df976693059c940b5074bdeeb088db5914511ee,t,52299,3290587,,5000099,2018-01-30 14:07:12,104
0x4ccca9d990f5f0a8375060037848634920790c3b83b4b72af1fc663d0ef20279,f,210000,3500587,,5000099,2018-01-30 14:07:12,105
0x4a98c2c9d32d0a8e8d769367e9df9aeac13e8cd17be55a6fa5526c7dd20823eb,t,21000,3521587,,5000099,2018-01-30 14:07:12,106
0xa9d8500c89c36981712d7638470cfb46bdc7788ce48ba2445c73f46ea0e315c5,t,104678,3626265,,5000099,2018-01-30 14:07:12,107
0x9a6d0db24246a983f00f594fb95f3d2ade181959966d6a7340a773f55da34be7,t,21952,3648217,,5000099,2018-01-30 14:07:12,108
0x115bb5004e74d82f9b4ee91e70aa6eb7b52c6f68a5b1469acaefef392029b541,t,27976,3676193,,5000099,2018-01-30 14:07:12,109
0x95967ec78ceba299f08a0241869ee15dfa9a37c261b4ae496cecee6a627b8464,t,63240,3739433,,5000099,2018-01-30 14:07:12,110
0x4f8dc4a6238225fc3a4cd43bf0fbcf8ee6b9e05d916c13684bd6c02fa56e3b02,t,22155,3761588,,5000099,2018-01-30 14:07:12,111
0xcde69b01da8af039f13d71d090dc92668cfaf6250aab380c4fa9be397d73e0bd,t,21000,3782588,,5000099,2018-01-30 14:07:12,112
0xcd85976be29fcf510271ba4e1298b8de66e5b9353808f294d7e3fa4a57736701,t,45546,3828134,,5000099,2018-01-30 14:07:12,113
0x85d9cc6dd8e3e0d4ee640f10bb80f7ec1d5cfe55fbf1efcfb6cb39b5746f2723,t,21000,3849134,,5000099,2018-01-30 14:07:12,114
0x52f8e14bda13731ffe08b41d85200319926aaae07d37257c48dd001c89834f59,t,52004,3901138,,5000099,2018-01-30 14:07:12,115
0xdb07fc9a2198178b1e4899ad2cd810aee6c362882c5c544af1e84eabf49c1078,t,21000,3922138,,5000099,2018-01-30 14:07:12,116
0x0fb481ba562e132aa2c4f071e47b70441526bbb69f6180802e3b046a7f7505d8,t,21000,3943138,,5000099,2018-01-30 14:07:12,117
0x057832329aaa69d0f1d3a96cc7451545417a9d3d1b8e620222a6ab1dbb8e74e4,t,21000,3964138,,5000099,2018-01-30 14:07:12,118
0x735a6f2b8066230bb512d839bb4545493cdf7a1340fddc16758635da26f339b5,t,52234,4016372,,5000099,2018-01-30 14:07:12,119
0xaa90e6003fce77ef32f0ffa3b182d02528f0e9c45ec9b4701179773df1365241,t,21000,4037372,,5000099,2018-01-30 14:07:12,120
0xd3faef468c49703c81e1b2a16bf7cc35265389508357d2875f0b53c758886664,t,28838,4066210,,5000099,2018-01-30 14:07:12,121
0x00535c73bade6d1b8bf45b1851d0e0c1dbe1c16300e199b98f017ebcd663c64c,t,21000,4087210,,5000099,2018-01-30 14:07:12,122
0x2e27f2670c2bede15dd37fae7d206258f73ffe306bb9d98b9e58011e2da7cbc3,t,21000,4108210,,5000099,2018-01-30 14:07:12,123
0x445fa987b4bf4fc39811e9c1c24ca707ad123a41c10141ed5b289c14a1e26ef4,t,29110,4137320,,5000099,2018-01-30 14:07:12,124
0x8d4869d8ef4f57481cc0119fed2a31c92860ccf578531808c2dc3fe488ff5da0,t,21000,4158320,,5000099,2018-01-30 14:07:12,125
0x347ca20558c4507b85402823b4935513ace404f55728914d8a678f95624a4b6e,t,21000,4179320,,5000099,2018-01-30 14:07:12,126
0x2e63253dcd1b11e860c3c4d4e8b1f9fdb624a445ea6308990bc2d6f6283dce8d,t,37320,4216640,,5000099,2018-01-30 14:07:12,127
0x621f90a9c24c10d272e2ee81940d920918af5e96b3b7c67ba97ebc875d91e6b8,t,21000,4237640,,5000099,2018-01-30 14:07:12,128
0x372b9eccea88f9eb463e0a5bcb61586cd8e99858a2f6cd7a9015a7e9c8b72c7a,t,38318,4275958,,5000099,2018-01-30 14:07:12,129
0x03a73816bf050ddce68263d84797e1307015529964ef3666fc432eebbaabdb64,t,40733,4316691,,5000099,2018-01-30 14:07:12,130
0x824c7b3791ce4e22709c55fa389342e9fc6107800e2231e52c6d575622246c73,t,40797,4357488,,5000099,2018-01-30 14:07:12,131
0xa9100fa24739c170d26dda30af58a22d71189196195c02eb7735bcbd3cf0bb71,t,40797,4398285,,5000099,2018-01-30 14:07:12,132
0xadeb14225fe78b4a824eed276de9d69fd470f4288b4d9d63702082ec01104dbc,t,38382,4436667,,5000099,2018-01-30 14:07:12,133
0xaa1c06de702e2d6000b51719837e4324d67f10c1f44a70bb22c7296b6f64e8b1,t,38318,4474985,,5000099,2018-01-30 14:07:12,134
0x7cd890a768afd51e49ef0492691fa1f1b515452a91c7c63b9f07cb1f923a33e4,t,38254,4513239,,5000099,2018-01-30 14:07:12,135
0x4e583318ccee269284c131de16b43f1c4eaa6b1b413e46a55a32e9f46c5b7ab5,t,22155,4535394,,5000099,2018-01-30 14:07:12,136
0x2678aab44b043dee2693a9ca315dabd655122d5dad711a425405a31168806cbd,t,22155,4557549,,5000099,2018-01-30 14:07:12,137
0xd31c334952677253b6a26076888640cd967b466b86b2ba3a66a4d34aa63197c7,t,22155,4579704,,5000099,2018-01-30 14:07:12,138
0x9f3c406d9c9ec1e4fb290736dc26d6cc7b0c4659bfa6921f1fce0374de586726,t,22155,4601859,,5000099,2018-01-30 14:07:12,139
0xcb142c428366d5ec6f3060ad8eb67f6df7919e0eb12ff04c44e0ffdff42eef95,t,30327,4632186,,5000099,2018-01-30 14:07:12,140
0x888c080286709b2e7624f8df824d7a887a770a6088fdea776e02fc278146b530,t,30327,4662513,,5000099,2018-01-30 14:07:12,141
0x5273f55f682403b13d0e48349549784e8698f258a4660b3a1745dd5e0acf4932,t,21000,4683513,,5000099,2018-01-30 14:07:12,142
0x45614e8f15f0b1a63b83ffcbf950b1f32ce93dfb358eb74c41f6d29c77a79708,t,22155,4705668,,5000099,2018-01-30 14:07:12,143
0xd28ace73b16ddd241dc81b570e406beaddaadd38da925d0ba19f6408b8207ed6,t,22155,4727823,,5000099,2018-01-30 14:07:12,144
0xc0164704552ce46a0dd5d021de16a26a6b202ff6f25f776fbe77ac5d22707150,t,22155,4749978,,5000099,2018-01-30 14:07:12,145
0xa403652ae7d48f4192145b54f09bc808da6c7b30a071e14b02083752f603c410,t,38382,4788360,,5000099,2018-01-30 14:07:12,146
0xe19d74e7dd716811cf42283b1a3286ef5b3d8e59af8f1eaec62b154580be85bb,t,38318,4826678,,5000099,2018-01-30 14:07:12,147
0x599398a8a0bcccd2c8ae23c1aa385126449a3cff036e05533e54e0355a65d870,t,36410,4863088,,5000099,2018-01-30 14:07:12,148
0xce5628f89d21d716d9d5e8782a47d463f08328c5537b6679cb65212cdd3b4a27,t,21000,4884088,,5000099,2018-01-30 14:07:12,149
0x8b36c3b711ab3da90127596a665d688af9b586f46ed58035601a91ca9d5d8804,t,22155,4906243,,5000099,2018-01-30 14:07:12,150
0xec02f4b2b0245243c9ebee461dd610d6323d4151fd89a8bf9536d44fc20ca0fc,t,21000,4927243,,5000099,2018-01-30 14:07:12,151
0xd43deb3fcde06551245eecf7f67e955ae7b67cfbc79be4665f9ea2fadc59906f,t,21000,4948243,,5000099,2018-01-30 14:07:12,152
0xad4eb517cafda314c8c4809a6dd1d2f90ec0b8e14cb0f6848f85df0a6efb61ea,t,21000,4969243,,5000099,2018-01-30 14:07:12,153
0x78e86e047484016fdbddaebf1b64c054cecc3c1ac98fec7aef4815e2870bf46e,t,21000,4990243,,5000099,2018-01-30 14:07:12,154
0x18a73576b98a9c949cb6e6d89efefd0a13bbccb4a224c34afca765f0636721ed,t,21000,5011243,,5000099,2018-01-30 14:07:12,155
0x1a43d4b2a2003d8d2acc7c4b581f551c41086054e24ac953797efd0f47a48980,t,37401,5048644,,5000099,2018-01-30 14:07:12,156
0xd0ea2fefc49d603ee49c68e025d50e8f34dbcc66fce5c42fde4895ab14c9b513,t,21000,5069644,,5000099,2018-01-30 14:07:12,157
0x69f4ab3628b8c1245c2ce70ea2370bd22f4de815d2cad77590687ae55c5a4fe9,t,21000,5090644,,5000099,2018-01-30 14:07:12,158
0x0b0d437b8436713bbe54f1398543d7360a07cd884002fb28bedcaf053a2611f0,t,37380,5128024,,5000099,2018-01-30 14:07:12,159
0x1739ce82b3ab431930f0b936ef5ee046631271cd38680c7bc10a112bd5d7f641,t,37444,5165468,,5000099,2018-01-30 14:07:12,160
0x26eee6727a44818229fa3963fd3b245e4476679134e24b248b9f9aec6061bf01,t,21000,5186468,,5000099,2018-01-30 14:07:12,161
0x1b572f3f58aca2fddce125d1553a73c134860fb9f7c8c15297d8af1d1aa421ab,t,37444,5223912,,5000099,2018-01-30 14:07:12,162
0xdb61390742ce4afd08414d8ff5682c617b4842e4b183d15efbffe8dfd7831010,t,22372,5246284,,5000099,2018-01-30 14:07:12,163
0xebd759f20fc19c767043db7106209069b48fe0585294632fc58c2374ee6363dc,t,37380,5283664,,5000099,2018-01-30 14:07:12,164
0x8d6e74b0d9f01528517943985576872e35bb94ac8399232d93de000369f27331,t,37444,5321108,,5000099,2018-01-30 14:07:12,165
0x93ad816d442205a8bfeeeea32e6ce36ed8c3c30dc1c9dad45ebd5cd949fa1e93,t,37444,5358552,,5000099,2018-01-30 14:07:12,166
0xbcff2986ac6bb5459448624202e12027123baeb55ae878a01a0e41fbd7061385,t,37444,5395996,,5000099,2018-01-30 14:07:12,167
0xf6c0ed537685f9aee7d7552ec270d0cca3e3173cceecf3260853b496f55fe0d0,t,53233,5449229,,5000099,2018-01-30 14:07:12,168
0x3305ec3610898232bc10711c347d25fe8b2f4ae7fbb011234ed1ac9df88da1f1,t,37444,5486673,,5000099,2018-01-30 14:07:12,169
0xa4d05f03321f038f516234634a96a8bafad4b51dbd718d2d325b8d6583fe7da1,t,22611,5509284,,5000099,2018-01-30 14:07:12,170
0xcc5a853a4c562938a91e3e05a761a6e98a6a30e3c0da9bc4d2943f9f6a2bbdb1,t,22400,5531684,,5000099,2018-01-30 14:07:12,171
0x7ed030d3031295a35f2bc23102ff2712efc72d9092e2365157eac38bf366872e,t,37292,5568976,,5000099,2018-01-30 14:07:12,172
0xd41ff6e3b9499921ffc1070f87dd95ff58a3bdb698eec0b0ab6cc0d2681e952c,t,37444,5606420,,5000099,2018-01-30 14:07:12,173
0x36545f13626d5d75738460ead14d3e58edca645e75c5c86f81183423ceca761c,t,37950,5644370,,5000099,2018-01-30 14:07:12,174
0xcc29b98dd85b3b889872382ea792af2d816c11b93378255eb66cab9196ddd5ac,t,51955,5696325,,5000099,2018-01-30 14:07:12,175
0xbf80f35318caa573112606ad540277cdb0a1b198404c18e5f3b23217fa923f5e,t,21000,5717325,,5000099,2018-01-30 14:07:12,176
0x6cccdfa13c422512ff1d0f4842ab68932c7af753859e60677166468393abf1bc,t,52011,5769336,,5000099,2018-01-30 14:07:12,177
0xbf58c44d93071b51d2c126d2bfa1eb1d170f4d632319d59c2341f0f961fd8c77,t,21000,5790336,,5000099,2018-01-30 14:07:12,178
0x95521390dd8c0cc4f896bedb3942a7f0d8df8bc3a06d20765ae349c6e614fb00,t,21000,5811336,,5000099,2018-01-30 14:07:12,179
0x75e768942fd4f5961b5d41cc8b33da35a9cc7db4a6d6e4736564d1459ffcc16f,t,21000,5832336,,5000099,2018-01-30 14:07:12,180
0x2c2e0f3fda8bc0f6d834b5b81f547fac1a7b679d33324c29e8b7f1a31e6734d7,t,21000,5853336,,5000099,2018-01-30 14:07:12,181
0x4ac25d70f7dcbb8fa4ea97dcd7a468726b3d9eb350de3ef38e7a1475f5c1437a,t,21000,5874336,,5000099,2018-01-30 14:07:12,182
0xf0e57661f69657487194d4d91ad28a460a57b39fc1fb34472b787a3f44c15c80,t,21000,5895336,,5000099,2018-01-30 14:07:12,183
0xfbf40aa3c97d02fd8c4531651b18167e9855ceca4a324e812a91ddf83949ce23,t,21000,5916336,,5000099,2018-01-30 14:07:12,184
0xdfa0b4c63e1fac84d3683e23f2c2d015a7d2c73a822954f2162e39a645fbb4b2,t,21000,5937336,,5000099,2018-01-30 14:07:12,185
0x376959fba4717ca2754a540a5f781903ece6c5292aebe0b2e10a3932d894b94c,t,21000,5958336,,5000099,2018-01-30 14:07:12,186
0x82d63874f7fd888749b85a13060ecb044ef90470cf7cb31f9b7999b5e6a35ab6,t,21000,5979336,,5000099,2018-01-30 14:07:12,187
0x5612694b433b3846a57623b1aff3bc8ce9e5a0f6d25b036f9e8c9b548d35cc26,t,21000,6000336,,5000099,2018-01-30 14:07:12,188
0xcd30c278c51d767b243a54d40b6aa9e5f5e2a30798f1c1d4a33a70f83bc5757d,t,68696,6069032,,5000099,2018-01-30 14:07:12,189
0xb0afdd58badd90b13101f19233e9bd3864f26eb4ecc14f16e735afd7898d34a0,t,21000,6090032,,5000099,2018-01-30 14:07:12,190
0xf61239d0e0a70af21de94b624cf272284b7c5d3be13b4591a178855b466c3a1c,t,21000,6111032,,5000099,2018-01-30 14:07:12,191
0x2b0589739bf91c0d117f439de0fd99054d818d91e4ab64820a9dbe372ed5965d,t,21000,6132032,,5000099,2018-01-30 14:07:12,192
0x2940c34cdba49bd7e1346fb8cc25da8766b5a9de00386bb04b4fc31a1b9c558d,t,21000,6153032,,5000099,2018-01-30 14:07:12,193
0xa441ef6dcc10530eefe93229b7a1603e7debd09a5ccdc2e58e0c74ece5cd3485,t,21000,6174032,,5000099,2018-01-30 14:07:12,194
0x42405d19bf2cda525938c279ab9837e28f19fcb023418a337c03a8af1e0e7eb0,t,21000,6195032,,5000099,2018-01-30 14:07:12,195
0xe2998a763a20a6dd8b355dea6d9f3f9a12cd0cce4a1931c18cf6b00209f2cbc3,t,21000,6216032,,5000099,2018-01-30 14:07:12,196
0x29088015e931529309b8dc986ba5d9df557343bf2041dfa1fef70df12bd8074c,t,21000,6237032,,5000099,2018-01-30 14:07:12,197
0x0fd5c5f89a0fc11a25e0b91e350108c0173bc9fe473a06c3d630f7aab993acaa,t,21000,6258032,,5000099,2018-01-30 14:07:12,198
0x92d41ed9134e329d3d2b21d5b8f20c6839491000826614afc7b50c852e0c649e,t,31984,6290016,,5000099,2018-01-30 14:07:12,199
0xcfdbec73373131dfa8b0533bdd0dd2abd527c034a8893cb9eb5170048115c206,t,36882,6326898,,5000099,2018-01-30 14:07:12,200
0x3fbb266bcfcfc89ec917edd18f5d231068b24ab05b6b206a6e928d2bf40bb1c0,t,21000,6347898,,5000099,2018-01-30 14:07:12,201
0x3872db11ecf2b44358136984e84e8e614c4d54e4b33f651a32a4ac3251a99d56,t,21000,6368898,,5000099,2018-01-30 14:07:12,202
0x2fa27262a132ba47d6e33f6a8fc2994f25964c6cd98fc51c85359792af466e8d,t,52640,6421538,,5000099,2018-01-30 14:07:12,203
0x7a60352026c009111d62e3d31eceeb927bf3dd89c29ff6effee04fd8158de1ef,t,51943,6473481,,5000099,2018-01-30 14:07:12,204
0xc368f79f721e00f125a9be71408a64a995a0e1de7ea2eef474fbf951c5a9dc23,t,52173,6525654,,5000099,2018-01-30 14:07:12,205
0x39878eabaa3478adabb3b08b803dd532714c772ffd436ea11ab045cf7fc52b58,t,51884,6577538,,5000099,2018-01-30 14:07:12,206
0xec8e78acbd4f90af31823679a58abf53de2feea74a6642b8947b6020c2a272c5,t,36930,6614468,,5000099,2018-01-30 14:07:12,207
0xf38b624b96988e9ff0b855050696e41ad497eb5478d3aec2cf2c00b797194683,t,112027,6726495,,5000099,2018-01-30 14:07:12,208
0xf8b7517e79ea4065553ceaa4251060f8366535c3e966a62e090db0654057a158,t,21000,6747495,,5000099,2018-01-30 14:07:12,209
0x80ecac3ddeb37486221488bc27c46f9987dac9f85c18e44e7b45c3fae6058ae0,t,40649,6788144,,5000099,2018-01-30 14:07:12,210
0x79b5f769997a2e3315368ddd1a8036285b4eab04e4bec5a97574458a31885c3c,t,21000,6809144,,5000099,2018-01-30 14:07:12,211
0x425f6475d6b616a361d3ab63cb6b785890baa08dcdac409d049287e9c1ee3c36,t,21000,6830144,,5000099,2018-01-30 14:07:12,212
0xa243c3d8b250a2ce5e834639e6f4a02de1744e7802f5255dca907f02e39c2d22,t,21000,6851144,,5000099,2018-01-30 14:07:12,213
0xd4e933b4a4d7cca40de9af41b5b8d809a6d28754e866f128d5b76937c590b213,f,22348,6873492,,5000099,2018-01-30 14:07:12,214
0x57e27c006d30d63de8a3c70d1ed7c4bed34f47c1081491f4cb8b60244c148555,t,21000,6894492,,5000099,2018-01-30 14:07:12,215
0x0178b72063ce02a0b57a8350e14a2f0fa829ca424efc360d0b000446ce251c5b,t,21000,6915492,,5000099,2018-01-30 14:07:12,216
0xd0918decf0939a496234304a932d8a4404486db1bf80ed7f4a88f5a161c82faf,t,23064,6938556,,5000099,2018-01-30 14:07:12,217
0xa726286995c4c7209cdd665b5de33a86da2135af14f4ea7847b6ac80f468c3d6,t,21000,6959556,,5000099,2018-01-30 14:07:12,218
0x022c0839113042de5ba55b864c7adc453ac8da4624d69e3ba83f803b05683e6e,t,37142,6996698,,5000099,2018-01-30 14:07:12,219
0x3efa243e803004e670df1ad942802a66464202b4cd434a7adc2c7765ac0be11c,t,21000,7017698,,5000099,2018-01-30 14:07:12,220
0xcfad2403ec45628a85bd60225156cf586cb4902658ea7983667ebf77b40fac6f,t,21000,7038698,,5000099,2018-01-30 14:07:12,221
0xc532f591f09fa8e40aa3adb37a61ad059b9631b7341f528de8760352dc512b92,f,21044,7059742,,5000099,2018-01-30 14:07:12,222
0xe03e727382bb017fc7b7a5f98282856ccdff2593926abc76cf3955efc5f0210c,t,21000,7080742,,5000099,2018-01-30 14:07:12,223
0x92f766756e731d4c30dae3c9f09deff42b3cf10ae6c6d83b7b64e03297374a8d,t,21000,7101742,,5000099,2018-01-30 14:07:12,224
0x03bf6a0425b383e14214880ca909476834fe14203ab05676f34e51aa67401447,t,21000,7122742,,5000099,2018-01-30 14:07:12,225
0xcd4523974eae99e7286431da65492f23fda1f082fffc8d6c3aa4c8c4c1ae0036,t,21000,7143742,,5000099,2018-01-30 14:07:12,226
0x6339e10150f07839fc618ff33a6febbbe559cad4b33e1ddbb34cf17329f21927,t,21000,7164742,,5000099,2018-01-30 14:07:12,227
0x786e42d0d6986b5b2bd83137d2d326152aa424ae5a892346dd692510d05a9261,f,21000,7185742,,5000099,2018-01-30 14:07:12,228
0x11464d387a7a019b66caa14774806db5c6064767ce3dfcff51208e9acc6c2d02,t,21000,7206742,,5000099,2018-01-30 14:07:12,229
0x7737a2f1f7482e5e41ef4c0bd43513516385b5c521060b3daa3caadce926ec43,t,164823,7371565,,5000099,2018-01-30 14:07:12,230
0x940e5e66b09883a5bd8c4c2340751b934f7a2bdf844c8bcf014fcdbddf4dd664,t,21000,7392565,,5000099,2018-01-30 14:07:12,231
0x61125e6fe6acd7c2d45b4d208a355473162317bdfd6c14ef2244f4283e6c6d3d,t,37197,7429762,,5000099,2018-01-30 14:07:12,232
0xfa7717643520059c93eb043b278ba53a1c369d03de5aa5bdadd4b6cc755e4ee1,t,51353,7481115,,5000099,2018-01-30 14:07:12,233
0xd9959d5132c2ae71ce5931e6cbadb0a21c8c84b6afafc0fc5f64a2c91f6a6932,f,21000,7502115,,5000099,2018-01-30 14:07:12,234
0xeae974ec9c460d51767fb95ffd3da677369b6df2672b0658a02b2d15a8a71c63,t,21000,7523115,,5000099,2018-01-30 14:07:12,235
0x3ea24af9f6cfe6a4951dda9353f7ae3321bcbcfdc7b8e816b5e867fe02f6a385,t,21000,7544115,,5000099,2018-01-30 14:07:12,236
0x0bb9e09acfb21ac4dbfea29f213b49931e7e6e4b60c82c7aa294ac590266f145,t,21000,7565115,,5000099,2018-01-30 14:07:12,237
0x5c7ad5ca326d45566630665258e67f577aac600e0bd5a1a48facab76e9e3dc78,t,21000,7586115,,5000099,2018-01-30 14:07:12,238
0xf9c890f7fdf989e1e3f9e8f15c1fbf965b8b0b2895fbbdb9af64d2b70a8177c3,t,21000,7607115,,5000099,2018-01-30 14:07:12,239
0xad4df16e61c468c7a1258ca51816984c1ceadc45e48815850f1b68407fdf3ed0,t,51848,7658963,,5000099,2018-01-30 14:07:12,240
0xfdcb98084cc7f184c72e7e3fc540d24ce246bf60bb99ee1b3052fb8038916b3f,t,21000,7679963,,5000099,2018-01-30 14:07:12,241
0x6e83399023fb644651e9dfe01521ef8b3117340e6bc3e7d7abf6d3ff839274c7,t,21000,7700963,,5000099,2018-01-30 14:07:12,242
0xa5dba5f455e9ac073351ebe405957d00334f7f97f2c141166936e71cd7e592d6,t,21000,7721963,,5000099,2018-01-30 14:07:12,243
0xc2e2aa801d5e7f675f2e3bb442d326dc418aff7986d1a2b463d3a99ead83ff27,t,21000,7742963,,5000099,2018-01-30 14:07:12,244
0x5735612f56ccdcbf795514505ecde175b8b888df55ac87a9f1262d049ffde6a9,t,38876,7781839,,5000099,2018-01-30 14:07:12,245
0xbcc8fcec5567cb56eeacc3a3f7a8d7d8cdaad548538a29bdb96ec028b416dffd,t,21000,7802839,,5000099,2018-01-30 14:07:12,246
0x61b759467565022d4ad5662276c9a1af1207d6ea337198ff24c2536acccef9a0,t,21000,7823839,,5000099,2018-01-30 14:07:12,247
0x24e9f9ba17f94a85537febeca713ba941c385383589bdceffcf690a9f2429f55,t,21000,7844839,,5000099,2018-01-30 14:07:12,248
0x647513b9261608cf810b755fdc754c2377c8bb2d8b96e1d08e14c2c7aacf4409,t,21000,7865839,,5000099,2018-01-30 14:07:12,249
0xb14baf42f207dac0db9391e805bdbad23e70361fc8b6fcaafb5116b2883c8883,t,21000,7886839,,5000099,2018-01-30 14:07:12,250
0xe4190086e989c4d772f3344d9b2e3344f98fa184e20ef7156ada742304e7eb76,t,21000,7907839,,5000099,2018-01-30 14:07:12,251
0xc73f28b04eafa4e52a884448c33335603501b6479b83f8a13c75a677f78e7207,t,21000,7928839,,5000099,2018-01-30 14:07:12,252
0x5e367af2079a308ae4006e9cbb740374e2aeca300c62b1ae8e7578f3737dee55,t,21000,7949839,,5000099,2018-01-30 14:07:12,253
0x9499649bc885a612643f0d278e4684f6d895c873955a7f0cb427a33e3570984e,t,21000,7970839,,5000099,2018-01-30 14:07:12,254
0x7d17bf00e20b0b60564ab27dd0271716395b31f35912728445a287318996ce19,t,21000,7991839,,5000099,2018-01-30 14:07:12,255
0xa53940ec1655edf948bf3263cb596a4a6d1147eb5ff3419decf9ca597fe3c960,t,21000,21000,,5000100,2018-01-30 14:07:22,0
0x23a1491da8de479845cb9d37728d8d1c475ab5d47a3e019fa477bba7d130a0e2,t,21000,42000,,5000100,2018-01-30 14:07:22,1
0x385f11278d3a6e87f16560d6f45ef13117c1a9a3a7d20fad5505fe2af013fb2f,t,59098,101098,,5000100,2018-01-30 14:07:22,2
0x560e41a2e7f0fc32cf0a1679f55924a99478b006e266637ac6a95cd27934b8bd,t,52158,153256,,5000100,2018-01-30 14:07:22,3
0xafe90c462afb7dcfbe71cb60388110cc43e258cb3ecc0d97c0ac3130fdf69d46,t,21000,174256,,5000100,2018-01-30 14:07:22,4
0x6f07537d567e6886e28a983720ba4197b297d92e50384c2d85e536d4e1cf3c36,t,21000,195256,,5000100,2018-01-30 14:07:22,5
0x3c38b8042280d1d16fd7194de8dc996fef8aa53e9a66a5b5bd666bc285fe2bc2,t,21000,216256,,5000100,2018-01-30 14:07:22,6
0x9dec1916ea73cd5fe5e9930fb4546fef9922374eafaad9e90bde23c49fb0e748,t,21000,237256,,5000100,2018-01-30 14:07:22,7
0x6ba6b79ffdbddc309b024cce92152b201780b16072ae17957a5265f424c3ea92,t,21000,258256,,5000100,2018-01-30 14:07:22,8
0x9bed3f8568338cef66ab5bed541bcac89d74b00720a152ff7e9a7ecf00b6ef91,t,21000,279256,,5000100,2018-01-30 14:07:22,9
0x2f0d6b5287f4f44bc266508ee383a911ab7b06aac0fd65fb91633051e3e958d7,t,58771,338027,,5000100,2018-01-30 14:07:22,10
0xe6a29eecc1c076fca51bdd890f2e704fa44415e79a87db1615fd1d9f5cc2d578,t,215038,553065,,5000100,2018-01-30 14:07:22,11
0x116521e95fb14dd2d58a506c06bfe8d9882410b98c1f646250aafab728402954,t,92794,645859,,5000100,2018-01-30 14:07:22,12
0x4c3d196aea57f45e2232f0d8ed18aa1dc681547e5d565be0d18151556a994119,t,21000,666859,,5000100,2018-01-30 14:07:22,13
0x14abae93e96583e9af8817f2ee105de2b5bf68adadd1499d738d669174179889,t,36667,703526,,5000100,2018-01-30 14:07:22,14
0x0757193ee7b410a959e5026e211a08e09f7c780bfb3e170bf5e9731ddbb68340,t,21000,724526,,5000100,2018-01-30 14:07:22,15
0x558597be52af1916dfa4ece3d58e4b18cbee1f255b74df8d773f79dada6cf64e,t,22053,746579,,5000100,2018-01-30 14:07:22,16
0x3b106d208bb31e1c0c4816808290f88c203f104cf75efa484ba458a5f166176d,t,63240,809819,,5000100,2018-01-30 14:07:22,17
0x7e97f3d3e36dbdbb105de20159160eaaf46ad74c9e7f0d1afbea0d35a615ba31,t,21000,830819,,5000100,2018-01-30 14:07:22,18
0xa7080210ac20afea7c90dc46348c02f171087099d4829bddb5ca559d1427b963,t,36940,867759,,5000100,2018-01-30 14:07:22,19
0x8e75a0d32444b7b16eb9a893c800d61a6afac7873b9a7d401b24acdc8c808960,t,23974,891733,,5000100,2018-01-30 14:07:22,20
0xfba7f8c053aa08c61ce273864840b688aab204204b28150facae6d16d6a1c5cf,t,21000,912733,,5000100,2018-01-30 14:07:22,21
0x09f288172788525679090e050a4c8101435e9d97e04d6a1df762d1b32d143454,t,21000,933733,,5000100,2018-01-30 14:07:22,22
0x2d7b3f37d9cc36b1791038ca54a246920b5d34d175c950a0a7e61ef667491268,t,21000,954733,,5000100,2018-01-30 14:07:22,23
0x26ef33f1b7953c48e5e656cc147e5f46555b54ee2a5166d8d82a44e37745e727,t,53361,1008094,,5000100,2018-01-30 14:07:22,24
0xf48a2465877e08f070c416c90b110cd5b30878f429eb4134867de74ab7413ba7,t,36546,1044640,,5000100,2018-01-30 14:07:22,25
0x8da6e2cf3dbb10c72f67b751407c05c5e554e6587dbcfb35891f21d165e88f3a,t,21000,1065640,,5000100,2018-01-30 14:07:22,26
0x04a60544cdc8f01a4e1c74284c4aaa8a250f4adf24caca98d3088979af67de0d,t,21000,1086640,,5000100,2018-01-30 14:07:22,27
0x20a63faece7f44b5e2ef385cc6007177a198961dd54799c3efb36324650c4b79,t,21000,1107640,,5000100,2018-01-30 14:07:22,28
0x2a0de6a23ee38790d8ea64102e4dc899549240634ba2710cb1608a9a92dbfdff,t,21000,1128640,,5000100,2018-01-30 14:07:22,29
0x188e9e9f6d6c243383980d28f0b29fa0f1733a5911387caa464e922217fff7b7,t,21000,1149640,,5000100,2018-01-30 14:07:22,30
0x661c5255cfa93dde026b001d918487dc41169a796c769e495fc8265677b5d7f6,t,21000,1170640,,5000100,2018-01-30 14:07:22,31
0x55587e36d66fae823d296880ec3f40901b7757beaf5c9192e10de8f9eb86254f,t,21000,1191640,,5000100,2018-01-30 14:07:22,32
0xfde621497b81d3a0e9b078f88b442cba3432a425c7e2c3999d2690809ac8be85,f,26523,1218163,,5000100,2018-01-30 14:07:22,33
0x26fd62d55a0680d43fdcee571d2cc407072349961f319d8637000159b4266775,t,21000,1239163,,5000100,2018-01-30 14:07:22,34
0x806365522fe0e62841995b25f8048b2123616b5659bb5408e2384cdce72a9b60,t,21000,1260163,,5000100,2018-01-30 14:07:22,35
0xb744118f22d821b07c0a182dcd315fc34936a1f450439ef055b0baa972f765b2,t,21000,1281163,,5000100,2018-01-30 14:07:22,36
0xc8da950b829db18cb8cc1f7c38d23a454e059c3b7d707733754b55df96c81b0e,t,21000,1302163,,5000100,2018-01-30 14:07:22,37
0xd0e73be7f5f1fac1db60a0ec0be263ff5393e10c8d2045575fffadc060610b2a,t,21000,1323163,,5000100,2018-01-30 14:07:22,38
0x8f36f0781ec8468367232c96a93f8c0b7b32912d23e40af59950086cebd5cd87,t,21000,1344163,,5000100,2018-01-30 14:07:22,39
0xc4290928b90c4618e1a0e9fde3effeb07d6a26a4f6f3b85c1e94b233cd70c071,t,21000,1365163,,5000100,2018-01-30 14:07:22,40
0xfc86a7ce5a85537de33144cd94b75b2227193ab875d39ae8de45f650c9dcb3f4,t,21000,1386163,,5000100,2018-01-30 14:07:22,41
0x587825206d09d87e5ae6b9f5e7b65b66c832cbd3674c52e308f05fa24d7956d9,t,25843,1412006,,5000100,2018-01-30 14:07:22,42
0x949a1b738c066edcfe02cb34c00fe453fbc9a52ce25daa3ca75a8b26c7810af6,t,52011,1464017,,5000100,2018-01-30 14:07:22,43
0x705c9c5208a21db7ae9800c7935827e74a9c23d4213f160153eadaefa2639f3f,t,21000,1485017,,5000100,2018-01-30 14:07:22,44
0xf05771d60a599d364df9d8ee6f3a1e8283a74da1d6a88f42c41d1a9a2e1c9c93,f,90000,1575017,,5000100,2018-01-30 14:07:22,45
0x35386920817712f5595be9b682c85bdf2f90a531a83b53ea2efcb14f4234a3a8,t,21000,1596017,,5000100,2018-01-30 14:07:22,46
0xa24a5673a441e0138cc3c768b34de114163b70a87d2b2ddf6c9abf7ef67c487b,t,22061,1618078,,5000100,2018-01-30 14:07:22,47
0xe9a38f56063acd58de709522a7674fbde62e0049939319e608c490308cecbd0d,t,22233,1640311,,5000100,2018-01-30 14:07:22,48
0x6c616cbb0ab8b6d5c5891cb079729bdb13053702def6a3f725cbd17a7ebcfc9d,t,21004,1661315,,5000100,2018-01-30 14:07:22,49
0x8e777c3462e1dc4c2c4e34fcc953b0961c052b1e5d4a16cab1aad9785438dba6,t,21000,1682315,,5000100,2018-01-30 14:07:22,50
0x55a77072e12079e8cd569225b23be2f3764a0d176d8e706eb81f4142c0e5b086,t,21000,1703315,,5000100,2018-01-30 14:07:22,51
0x4ac1118c2a16b7d9d7c81d34a47ed85f49f77c39e0ca70e917fee9bac6e64ce9,t,21952,1725267,,5000100,2018-01-30 14:07:22,52
0x9ef1c6d339ead6cfcfc7549e41909317b03371dc1c3d16d8baa9b268cc54d16d,t,21000,1746267,,5000100,2018-01-30 14:07:22,53
0x282329502392b664f5866154d976587c9d654d20d2562ed96cf13f71e12f7430,t,64701,1810968,,5000100,2018-01-30 14:07:22,54
0xb86ce018d5e7752496694bec95f3b41f2707e907a1d3fb290284912fe0113277,t,21000,1831968,,5000100,2018-01-30 14:07:22,55
0x5022c32c74d51ce048059ec651d1bdc64eaaa4079c69c7d075950a45d474f3e8,t,29110,1861078,,5000100,2018-01-30 14:07:22,56
0x12b207149802aed923a9d1b8085cd92072595b2447100e5b22e8d6a66f936d03,t,39844,1900922,,5000100,2018-01-30 14:07:22,57
0x56d0ada47dff5cf30ee19ac54a8daffa825eea968f5e7e9aef2f898ee59dc7d9,t,37444,1938366,,5000100,2018-01-30 14:07:22,58
0x069d71792419e85d2676ad2d72d2dddce880056be16fa632f26da2fac9c91dba,t,36734,1975100,,5000100,2018-01-30 14:07:22,59
0xcc808e99ac954e46ac858d3be7387a63fd57753c813bc6b4d198c404a88ad4c0,t,48640,2023740,,5000100,2018-01-30 14:07:22,60
0xf8929384db6c2ebc92e24e8cf7c4b6e03ab9aa3a073d05ec0403fcc682b790c9,t,21000,2044740,,5000100,2018-01-30 14:07:22,61
0xc28d0d40aa8c2744cca48b81a6cc40f755538fb80dda35edfe2848ec81992092,t,21000,2065740,,5000100,2018-01-30 14:07:22,62
0xcabb6b8c2272ac870db89f427c6e3a12b16317cc4b48c0eab96b499f3c5833be,t,21000,2086740,,5000100,2018-01-30 14:07:22,63
0xd9c3bd5e6a6da7eac663b1b19b5817048e0203042a39f62c8109801123239d7f,t,21000,2107740,,5000100,2018-01-30 14:07:22,64
0xe369a0d66b25209bd2ef2917551a08cf428219c2fafedae16addc5f61fa78745,t,67877,2175617,,5000100,2018-01-30 14:07:22,65
0x10913f111a50a15db6824ade4821cbfd2a79ac1536ac10e425780114aac245c9,t,31984,2207601,,5000100,2018-01-30 14:07:22,66
0x96a508456e5cf7df069e5c5c9543b5b618224af47901a265b1600213340c1f22,t,52881,2260482,,5000100,2018-01-30 14:07:22,67
0xccd09656c7e65cd953e4dac4d072c8d0277e6da104238f97a656bb679de12671,t,55843,2316325,,5000100,2018-01-30 14:07:22,68
0x65ba2fb081282e8558dafcb341e937d138bc99d94204462bd3867354d755a6cd,t,52170,2368495,,5000100,2018-01-30 14:07:22,69
0x0a278e5b08ca81139c483f9c5e5d15e50f746d2511d3879adf11394a10e3186c,t,586540,2955035,,5000100,2018-01-30 14:07:22,70
0x4b18b744a0becab72e49ed7427da4a23f82290e9d6fba96512c4309163bba39e,t,52830,3007865,,5000100,2018-01-30 14:07:22,71
0x7e72b83bc3982ce646cbc46b8ce4fb1074dd6c95eed1c4fc63bffe4c73951e6a,t,184956,3192821,,5000100,2018-01-30 14:07:22,72
0x52ca96cd01fc48e729e08154bf6c772f9b16e8cc5cddd99ef848e15ab0165702,t,51725,3244546,,5000100,2018-01-30 14:07:22,73
0x6bea19e18b210528bf3aac6b834991a83c56b0450e8a4e567e3c606e6d963c17,t,52904,3297450,,5000100,2018-01-30 14:07:22,74
0xaf1e326659e51ed53f465eb50bdfdfcc09b16e04bcf4afc7345cde7476b0740e,t,21000,3318450,,5000100,2018-01-30 14:07:22,75
0xe0454c40f208ce649a5c6d59021de31f1fe7fee6938ae159d95b21d0828e2c8e,t,21000,3339450,,5000100,2018-01-30 14:07:22,76
0x7ea6031660ff4c8fc49d81e77056df81e282476bc6098cc3d93501a6741f306f,t,36792,3376242,,5000100,2018-01-30 14:07:22,77
0x8459d9f6987c9a0a87138ef9587911e50952ae5eed6741865cf362416a4c77b9,t,21000,3397242,,5000100,2018-01-30 14:07:22,78
0xa30907b749ed15fd4722809ebd19e26c5a7ac926c029e81c4d8076c5a6907188,t,21000,3418242,,5000100,2018-01-30 14:07:22,79
0xd8f493ce95a708d5e82c594ea32c2a2e7078ebd59289ee145a8c60b8dc66c16a,t,21000,3439242,,5000100,2018-01-30 14:07:22,80
0xb2a19ebe28751e3be71e59d0c4bd78a5ff6a3d6aafa249f721864d72f3d8a893,t,21000,3460242,,5000100,2018-01-30 14:07:22,81
0x123ef304ceee79a21a6dbf4627b421e13f1e4cfd3c6f392d03eeb8873823337f,t,37950,3498192,,5000100,2018-01-30 14:07:22,82
0xd9546f2567e09123393079f8c91602007da65a574825e9b5f0f194500c203314,t,21000,3519192,,5000100,2018-01-30 14:07:22,83
0x1cb06009feeaa624ce868507e1e51a4cd0d8801c27d06d101001fad85dfd8cd3,t,93306,3612498,,5000100,2018-01-30 14:07:22,84
0xee591670d097a0a63c27d74133be86b7a0547cdf1f2698e90d757b82c819ba68,t,21000,3633498,,5000100,2018-01-30 14:07:22,85
0xae4f7173d7b9f746f2458c5e8a3a7d3b0c6fbc8c13840459df8b14aa80331833,t,21000,3654498,,5000100,2018-01-30 14:07:22,86
0x74bb9abb517359f36591dbb8a30301b83d4f4ffc4d23450d10d110ff24e6f0b8,t,21000,3675498,,5000100,2018-01-30 14:07:22,87
0xc1127bb8cf295cdc8b185b6e776f781894a9809d1c1facfd3aaec0b8107471aa,t,21000,3696498,,5000100,2018-01-30 14:07:22,88
0xb549d48b3a5b19999d57740f3b23822dbc7b0af8266c19d671f2f25d99935237,t,104678,3801176,,5000100,2018-01-30 14:07:22,89
0x91254a8c932ef0352975a29d2fdee7a803063b01f60e432f6d2fa8dfce9e8588,t,21000,3822176,,5000100,2018-01-30 14:07:22,90
0x164b0b90fcdf77c67adbb0dce2fa4ef2868130dea2958d90e18bbe6dc38a7f87,t,21000,3843176,,5000100,2018-01-30 14:07:22,91
0x7c78f9104c4830d4479164bf1d9680ba4857f862891b6514f708c368a39e5707,t,21000,3864176,,5000100,2018-01-30 14:07:22,92
0x1f54913e88e96482360bfa95aab3f19250ed1ef21a3c167c8e5d3aef6d4b553c,t,21000,3885176,,5000100,2018-01-30 14:07:22,93
0x2cc8b99612a13504bd5bb3c47c265c6e4ecfe4964e74990046f267fd942449bc,t,21891,3907067,,5000100,2018-01-30 14:07:22,94
0xb818d4c6506d5cb76a2da35a16f766ed161e5e5ed0779ca0cf860081c9df31c7,t,21000,3928067,,5000100,2018-01-30 14:07:22,95
0xb19ecca27bb74e979ebdae0b5b17a20a641e7daba3db7d0266dbd8f1cbe96b94,t,21000,3949067,,5000100,2018-01-30 14:07:22,96
0xe5d1b2be700c5735068529a59901b64c68ceb7132f8c36a0181596039b279304,t,21000,3970067,,5000100,2018-01-30 14:07:22,97
0xc7e026eb6b9342695ec0db1d181f3fb7a724da3d66db948e6c850c9856b6d0c9,t,37091,4007158,,5000100,2018-01-30 14:07:22,98
0x734f1cea4bf76b75fb608000189bcef658d28d1013e93c00360256aa1d6c7083,t,21000,4028158,,5000100,2018-01-30 14:07:22,99
0x51a2e32502e60d6b51cfd7b6a98afe4abe879c76965eee295ef6b595c08230de,t,21000,4049158,,5000100,2018-01-30 14:07:22,100
0x9b1162dc926c3bdfbd9c9b913a2b6d7bc81cc908d1710081903180785983f526,t,21000,4070158,,5000100,2018-01-30 14:07:22,101
0xa98cdef3c9e0bb423b0a5a9f130b0f9f19ef3ccb503fd5e5f531545eece8cf22,t,21000,4091158,,5000100,2018-01-30 14:07:22,102
0xb04aedc2683363b2b3577e2efca3f48c56f72f0ea97d124404b85fb5045bb71f,t,52396,4143554,,5000100,2018-01-30 14:07:22,103
0xcbc5208c29a8b4cb3806e27fd0f370703776a02ca8d6baaf47ef18d685cdc649,t,22474,4166028,,5000100,2018-01-30 14:07:22,104
0x0866d5be4b204c4af983f9a2459145d28b7a2ef7b7d7100699bf14090552ec19,t,21000,4187028,,5000100,2018-01-30 14:07:22,105
0x88122f170afe8e9c4f34fc4b8fa5880f5d4be660bfa9783ecca2a5b1122ece45,t,21000,4208028,,5000100,2018-01-30 14:07:22,106
0x44227e501ddc59f2b0b3d568baf8e6d6a6da2cecd099c5bbdaccee04aea72023,t,22474,4230502,,5000100,2018-01-30 14:07:22,107
0xe22cb35d79400a88b9729d990150263f6f74b1485cc1f0c8a5465a6a558b9e7c,t,75293,4305795,,5000100,2018-01-30 14:07:22,108
0x0afae14f74df17763c0c92b14a99813a248f6a690bc2e9f98a0c171a4ce412cf,t,21000,4326795,,5000100,2018-01-30 14:07:22,109
0x22b4f651a8b982229e68d3fbfdeb3aee600487b564a0777418dbda6b763d749a,t,21000,4347795,,5000100,2018-01-30 14:07:22,110
0x0cdb05d1ac6f525a693c95377b7a8ca1c9df82523217b5e8867e52a13ca43c8b,t,21000,4368795,,5000100,2018-01-30 14:07:22,111
0x7588b6f8ee08d9f0f00e97dafa657d0f827d354a6911cb32bc7c5f3b0b7c58a8,t,22848,4391643,,5000100,2018-01-30 14:07:22,112
0x645f3a3876ba0608adade499eb1099fd306ad9fce7c070ea903c16566de2449e,t,22474,4414117,,5000100,2018-01-30 14:07:22,113
0x41cb3f464ec48822b62feb10560807ea1ebcbcdb7ef7fc8cb6e0806a262dd88b,t,21000,4435117,,5000100,2018-01-30 14:07:22,114
0x934ec5ec5c0504f609c8fe5223d55ab4197c375937b8e5766fab84a3404c980c,t,21000,4456117,,5000100,2018-01-30 14:07:22,115
0x87398f2cfb169f78d667d6532179f0a247dbadb8caa7b80460c99f4345281265,t,21000,4477117,,5000100,2018-01-30 14:07:22,116
0x66a928517766cc8b8ba9be8329c4108387f70334448d5c72d85d77bc254e2002,t,21000,4498117,,5000100,2018-01-30 14:07:22,117
0xa5dc5bdd7e8bef88b52e41677ac1dc18a443b1bc7afebdb972dd3bba4fcc53c0,t,21000,4519117,,5000100,2018-01-30 14:07:22,118
0x5449770fd0401897ae435870c4f457d8a2077a5c6f1e52860b45458d86d258a0,t,21000,4540117,,5000100,2018-01-30 14:07:22,119
0x71b974a369edbc07d3a21c6cb2b0e6fe95833791f871582b3085f925d3252972,t,21000,4561117,,5000100,2018-01-30 14:07:22,120
0x303b35ce1a268b65528425f4df364dbb1691f2ebe9f3c2306fd009c933e63e7b,t,21000,4582117,,5000100,2018-01-30 14:07:22,121
0x2d3a329ed2117d4ed6418a5d6c0ffa0ce31f8c86fe744ac1c99ef858232fd040,t,21000,4603117,,5000100,2018-01-30 14:07:22,122
0xc153ff2d2f3360aaa439dc97f43ae78e3a8a36aedbd4406672b990b17cd79fea,t,21000,4624117,,5000100,2018-01-30 14:07:22,123
0xa7d43bd20b1739593b2f0778418193401ebcdda144d877ffb1cbf913e7b3abc4,t,21000,4645117,,5000100,2018-01-30 14:07:22,124
0x4fe72295ffd74ba2bf3117ae34d424f1776d47dd431b6cf466f6de29576964ca,t,21000,4666117,,5000100,2018-01-30 14:07:22,125
0xfc1a73d1466b2b9063ecb44f825debfc77b8dfe096ffc1004817053410632c4e,t,21000,4687117,,5000100,2018-01-30 14:07:22,126
0x8a9d71cb6571e85f4e7af30ef296d558e6c9d7fe41f09024fae2e2bd8ab52ffb,t,21000,4708117,,5000100,2018-01-30 14:07:22,127
0x43594b6161d463701c0fdddc62aed4c082e8e8123ffc6ea094b5381c2340e5a5,t,21000,4729117,,5000100,2018-01-30 14:07:22,128
0xcfae317f4573ae34d4990cb3a4f375f1ddd7047b536b36c45923bce44210aeac,t,21000,4750117,,5000100,2018-01-30 14:07:22,129
0x340c4d0bd780d8293df1c55ba9ebf7561913c2c43f06ed5f9e748ba98d312e7e,t,21000,4771117,,5000100,2018-01-30 14:07:22,130
0xfd6798dc2428cd75f4c9a96739a150b346f8927d9ff8f9223e782d3dc0a475ed,t,21000,4792117,,5000100,2018-01-30 14:07:22,131
0x86540fe93dadde2c9afa09ba0174229f1bb4142f99d820fa66d84dbb42703a65,t,21000,4813117,,5000100,2018-01-30 14:07:22,132
0x55fb0f94a39195cddf9352fd370356e639965fa1d3addc61a5c5d2deb838d702,t,36756,4849873,,5000100,2018-01-30 14:07:22,133
0xc9c0974c18bee6677e5a70300da0f24ba99a251bf349372dd80f4fdf03ef3f54,t,21000,4870873,,5000100,2018-01-30 14:07:22,134
0xb15f7a5e3181a9ebedd4091db06fb5c7a6b63cc6f01a677fd27e1c10999dc50b,t,92730,4963603,,5000100,2018-01-30 14:07:22,135
0x350f78efd7d7a76be5d51ec1c8c572bedcfbff2cccd7c9ac505774baea2b5836,t,21000,4984603,,5000100,2018-01-30 14:07:22,136
0xa6d14209c6329289ef0b0c908a3c347081ee7f052d4a85f14ca3034c4f3c48d2,t,37524,5022127,,5000100,2018-01-30 14:07:22,137
0xa74baa408fa98764c4e459d77c08862897c62b6465c6d621db5dee837c17cced,t,21000,5043127,,5000100,2018-01-30 14:07:22,138
0xef9ddbcd061f933f0bcf7b1765cd4b6622703064863ca176df645a9d46d89ac2,t,21000,5064127,,5000100,2018-01-30 14:07:22,139
0x9ffee8821e5d5beca13958aa4222627bf8509351e5b8e95689c4475e1babcf30,t,21000,5085127,,5000100,2018-01-30 14:07:22,140
0xf0d3073dfd64d1699c3e1767e5504c08ae5732a5addfc7ffca8187b4c58d9a41,t,21000,5106127,,5000100,2018-01-30 14:07:22,141
0x28ec8f9079f2424332d2419fcf5d8ae542cbf7ba00a991529a5757856c810760,t,36912,5143039,,5000100,2018-01-30 14:07:22,142
0x20f351f722a37f3a61990a22d497c18a5b887fec59db0f84a97a5fef6094597a,t,107662,5250701,,5000100,2018-01-30 14:07:22,143
0xb5674b1928f53818c0e671a1918c31d0890e85b4670cd31254ad5743accc677e,t,21000,5271701,,5000100,2018-01-30 14:07:22,144
0xa495cbef4bb02745e2bebcd3b13a679919b29ad0564cbe6629cd01216b829f29,t,21000,5292701,,5000100,2018-01-30 14:07:22,145
0xfba8373c32646489d24e9382b94720df8da37145747a45cd3522f26f6216734b,t,21000,5313701,,5000100,2018-01-30 14:07:22,146
0x7d5f57f1bfcc1c995ac74cd2379ac0519418008d6f7758eec8e35361da87f310,t,21000,5334701,,5000100,2018-01-30 14:07:22,147
0x6bd0218b5275f9ec0203e574ccf27296bb07c79a51f73e5e5708b03e14ac4081,t,21000,5355701,,5000100,2018-01-30 14:07:22,148
0x8d2b925bf09f9e9c60ca506feb6d8c63fb4139f1a74ad23362ced6864d17bf4e,t,21000,5376701,,5000100,2018-01-30 14:07:22,149
0x1b767cea3267555b4ec4a237c8a1692e7955690be1eedefa989d0d7ca3f67c59,t,21000,5397701,,5000100,2018-01-30 14:07:22,150
0xeccfbe6c5dd7c547a4ae3ec5383bc847355bf258bfced2c180a8c4a35db42980,t,21000,5418701,,5000100,2018-01-30 14:07:22,151
0xeb0f4341f6d6387632e366e89a282414120b71f11f12bc1d4c444e0fdb7ac7bf,t,37524,5456225,,5000100,2018-01-30 14:07:22,152
0xcea1847cf64394c5810cfb6ef6a7c67fb51001044f539d9f6dd1480bddc448ef,t,21000,5477225,,5000100,2018-01-30 14:07:22,153
0xc22358200e550ad377d04fcc793d9dddd02b5682df85a1ab8f0a5ae20d88fa9f,t,21000,5498225,,5000100,2018-01-30 14:07:22,154
0x34bd25b224b895b1832ddc5f47553975bdcfca7784eec69019c88f098746ffc7,f,25000,5523225,,5000100,2018-01-30 14:07:22,155
0xb8297a041e46706158b149de3499c9b5c233008a889d83b4e6259f079c1d7321,t,21000,5544225,,5000100,2018-01-30 14:07:22,156
0xa7bdf1767cd07794c3ef6c1d1b3242dd3bd037cf7bf6ee9064a4fdc3120bafbe,t,21000,5565225,,5000100,2018-01-30 14:07:22,157
0xf39a9a139f86b3877e0df6716df8bb4f8c5757c3f46cb0da2b91a092f2c12011,t,21000,5586225,,5000100,2018-01-30 14:07:22,158
0xeee2d97fb7bfbfd024388068aa4d0cb3c4f4854a32a14d16048ab8b3ed879afe,t,21000,5607225,,5000100,2018-01-30 14:07:22,159
0x6d883366919dbfbb9a4638a038c2ae93956a3c792f4962a45aad85261812c257,t,21000,5628225,,5000100,2018-01-30 14:07:22,160
0x08ea0a6afda233aca383663541d0552b51aa1efe8bef142877d652151468d363,t,21000,5649225,,5000100,2018-01-30 14:07:22,161
0x64318cc8e175017d4b3a10d40ac021d8713df9548183fd9e55921af487a2aea2,t,40669,5689894,,5000100,2018-01-30 14:07:22,162
0x1c20baf74dddc1f305b509a8e9897f80a18c4d6d786347b4d66a498e26bc1418,t,21000,5710894,,5000100,2018-01-30 14:07:22,163
0xd6169970c65fb14cde043db5f03bc36bbe09644b487db4f5396abc63a80a83d5,t,21000,5731894,,5000100,2018-01-30 14:07:22,164
0x99038ce6f437e141e43685b3e6131d922b98f826cb6e2307f49f71fdf7f0f1ee,t,22511,5754405,,5000100,2018-01-30 14:07:22,165
0xbf48d8fc013a680544aa47959bbeaf59c5ba9161485a2217391d1ac9f8e44a3b,t,52460,5806865,,5000100,2018-01-30 14:07:22,166
0x64b857d7904f0414b7a31e2eabf836fcd7c89a6c471a6c5203ed7bef9357a832,t,52524,5859389,,5000100,2018-01-30 14:07:22,167
0x78b618bfdfb0d2460b6f435d14c4bc68c05e8c12b1377436551860aab8b7cdfe,t,21000,5880389,,5000100,2018-01-30 14:07:22,168
0xd2c03bdc013bdd4cd59644b309be159b8faf5f96a247e923378d6669260c2d89,t,21000,5901389,,5000100,2018-01-30 14:07:22,169
0xd15a528ddb58a4b1ef048a319d9b8438efef935f0db2935bae8322a2ddab64e9,t,37886,5939275,,5000100,2018-01-30 14:07:22,170
0xebb296457c739943cd04ff4eb707a56c3d2d95518dd1a18de61d8b05c258de14,t,21000,5960275,,5000100,2018-01-30 14:07:22,171
0x729a46d9ec05fab18bf8d8157b1294e72cf797012330aa0d18dc41c3c7b4e030,t,21000,5981275,,5000100,2018-01-30 14:07:22,172
0x2f3760d6f568d033de61ef1c7ea9dd78071baf19b1634fff2eb36e6dcf4cdb11,t,21000,6002275,,5000100,2018-01-30 14:07:22,173
0x2ca484bdc4472a730a0a1da5c4f517a2411dfaa1ca8bd99eaa5c5854f97f8a59,t,21000,6023275,,5000100,2018-01-30 14:07:22,174
0xcbc83e9034f9ef14bca64bcdd59fae9e0d84fda0d7d7ce882bc039e8d570b35f,t,21000,6044275,,5000100,2018-01-30 14:07:22,175
0x378132a48cafd10372811e5f603cb4aca59cd9c2ee0ad09b5a8994e37ff021df,t,21000,6065275,,5000100,2018-01-30 14:07:22,176
0x69845847b4184d836d81459c4a93d9fabd50527efaa3e9243133a2f896e2f182,t,21000,6086275,,5000100,2018-01-30 14:07:22,177
0xd83a35a4d3767c67723086ec665a4195e6aeace667d984fa0fe9553b33fa7994,t,21000,6107275,,5000100,2018-01-30 14:07:22,178
0xaefedc3f8e5d163d43ee1102753806ea506810e5c6ef53dd11bcc153c6292dae,t,21000,6128275,,5000100,2018-01-30 14:07:22,179
0x9f999d6246b487cea0d84829fe455311563598558d0f94fb96adf15dd93a010c,t,21000,6149275,,5000100,2018-01-30 14:07:22,180
0x46720f8d9ecf6081e9451f12f196b112209976714b4ec7b2b57f4aa6b3101e24,t,21000,6170275,,5000100,2018-01-30 14:07:22,181
0xce0b1136b1498e7663c12ccf4451ef416b473393d76d460abdfc0dfee69f7066,t,21000,6191275,,5000100,2018-01-30 14:07:22,182
0x217bb72a7241e6cc6d37873f79cf48a38252333380316f16a71635cd1af769fe,t,21000,6212275,,5000100,2018-01-30 14:07:22,183
0xd64958f815552bfe74b5d2465d6f01a43f684f068c68e004701c851ad80dcea8,t,21000,6233275,,5000100,2018-01-30 14:07:22,184
0xb7427d11e2d727636efee5ebe5cd894a68221f50c1553215c2add8476adfa9ea,t,21000,6254275,,5000100,2018-01-30 14:07:22,185
0x132be84c785ea6adfaac6d26b423de4d45bfc8213d2cd18e7df8c26954570bcc,t,21000,6275275,,5000100,2018-01-30 14:07:22,186
0x4bac249fe21ccc524369972e8a355f4468176b1cf21bd8cb6272da2d9c52483f,t,21000,6296275,,5000100,2018-01-30 14:07:22,187
0xd4aa69f827ed3fef4b8a5be2bf5c7b42b33a6e6c3fb31554b5e2fc81997d4df0,t,21000,6317275,,5000100,2018-01-30 14:07:22,188
0xe23f19f5371a59b4283c3f65cf56c450753defa1cdcd2d06537ad6a7345973b2,t,21000,6338275,,5000100,2018-01-30 14:07:22,189
0x8b0e87c4460b01d4fca58006993a0dc2b6e728bc9945e234dede695e03d21e0c,f,25200,6363475,,5000100,2018-01-30 14:07:22,190
0xc4bc860aac4d89ee4aa94f47446c209dcbc87c359cd8412a8b26d1d5267cc94e,t,21000,6384475,,5000100,2018-01-30 14:07:22,191
0xa61e8aece302ee6036ccb1cabc06b38e6a1d2eeabe189c82a470260a184f25c8,t,21000,6405475,,5000100,2018-01-30 14:07:22,192
0xddd06642945e90895cef3a61ddbfa36a6b41ca66ef4d1753f745d1e0f7e2f738,t,52148,6457623,,5000100,2018-01-30 14:07:22,193
0x7073e1c317c6c979b91a738190d47cec798d7c930398b356d5ee76094588cd7f,t,76670,6534293,,5000100,2018-01-30 14:07:22,194
0xd9ee4bd96cc2fa6fb5fe0b9ca650afe7dd65769efa14e13335c7d885839db17d,f,21000,6555293,,5000100,2018-01-30 14:07:22,195
0xdfd87caeb4289122aaa3e5c5c511738ebaf2905e27d869eccc3629964d3a039f,t,21000,6576293,,5000100,2018-01-30 14:07:22,196
0xd5a6b0f1f90b426a2aa76a7930c8abb846624257516c0ecbfd87e41496ff8333,t,21000,6597293,,5000100,2018-01-30 14:07:22,197
0xaa4fbb05a7b1e1033404b9bfa346ab68f0d4fde904a46105d25d3d931e7018d9,t,21000,6618293,,5000100,2018-01-30 14:07:22,198
0x7f9821bbab2d858d9416433a1a16c4b7adb308c257da4aa1791a05e85d922b2f,t,94920,6713213,,5000100,2018-01-30 14:07:22,199
0x19d748d7b89631d48475cc3741ea7bfb1ed6c66575e91b3554aaf1483911018b,t,21000,6734213,,5000100,2018-01-30 14:07:22,200
0x443b20e4a69e53749ae4658008480ab97e1e8db779fc40afc3d69eee92e14ee8,t,21000,6755213,,5000100,2018-01-30 14:07:22,201
0x847424f3b25cb4698be44a09701c2ea0c5787085b53c7577a10f84a15e9dc5c9,t,21000,6776213,,5000100,2018-01-30 14:07:22,202
0xdaa435a733130efc5a5cd1f7e55410486994a2e82c8de17380ab0927d6745264,t,21000,6797213,,5000100,2018-01-30 14:07:22,203
0x048558d18a4fa7abfd23a42f6708c36f327e254ea986bbedaad184866f6daae2,t,21000,6818213,,5000100,2018-01-30 14:07:22,204
0x87f99363650afbe724507990f24e5c13d7fcb53a0fe6199a157a715b71512674,t,21000,6839213,,5000100,2018-01-30 14:07:22,205
0x5aeb8eee07233c7c09bf46f4be348639b2844ae2f991b9647b07673f465b88f1,t,21000,6860213,,5000100,2018-01-30 14:07:22,206
0x80e1ccdfbac770893f566e7c406f48f4d62f86ac7c97a0d1f61322fab5b63e1b,t,21000,6881213,,5000100,2018-01-30 14:07:22,207
0xc87e50983ca299e5b072e19d14bd09016eb0ca4b7c7fbcb796d6a059568fc69b,t,21000,6902213,,5000100,2018-01-30 14:07:22,208
0x827ffb148a83ddb67f04afe2d32b2211d580517f9a3bf9488c7f4446737898ac,t,21000,6923213,,5000100,2018-01-30 14:07:22,209
0xfa3e989ac8a09d0687834ca0999407b563edfa214dde23a3b1126e0c2d9a1e23,t,23416,6946629,,5000100,2018-01-30 14:07:22,210
0xd9b3d73a4c348ebd06f28e2bece5e0614ef92a345140441691d9136278bf5e1e,t,37524,6984153,,5000100,2018-01-30 14:07:22,211
0x31af8519b0a8038e0370ad862bcdeae68aa9a772519decf19532eb22ff305200,t,21000,7005153,,5000100,2018-01-30 14:07:22,212
0xae3229052923a4b4fad39b4b64b84a59560aa3fc04d09f7a268c0350982b393f,t,21000,7026153,,5000100,2018-01-30 14:07:22,213
0xe1252d016790876e5daa84ff35bf2d4e941d9bef6e1b452ce360f2045fc7a84e,t,45907,7072060,,5000100,2018-01-30 14:07:22,214
0xa0770305de99303d1e73e8c9c35bec594d5ca87f0c18dbc550529a825497ea0e,t,21000,7093060,,5000100,2018-01-30 14:07:22,215
0xc769015cbab0749fe57610204b0fc26955410b5be9c5a937731f7cdb519d3741,t,21000,7114060,,5000100,2018-01-30 14:07:22,216
0xbcc181a9b1f50f7bef227f0503ab8958a98232fe8a73fc01ceeffb9cd2ef0cc1,t,21000,7135060,,5000100,2018-01-30 14:07:22,217
0xa8ff98f1e48d770ec399622f5e9bff50ba7ed8e99ada81cc86a194430c759e0c,t,21000,7156060,,5000100,2018-01-30 14:07:22,218
0xe3b7baee6c34471cb045860a66ddbad27c63fe1b168ef8f741adb8d1f5dd17ff,t,21000,7177060,,5000100,2018-01-30 14:07:22,219
0x3725a3059867d8c508053e50cdc7071522fd3b1aed56dca6b29837b76e57cf5a,t,21051,7198111,,5000100,2018-01-30 14:07:22,220
0x2451bbd7582205fdebd8409d33230800fa2c886fa00813fef2c2fa1c2c91025f,t,21000,7219111,,5000100,2018-01-30 14:07:22,221
0x372ce7610c80851f5b7e4df43481a558e39d9a2dd5dce092066af224474e7e21,t,21000,7240111,,5000100,2018-01-30 14:07:22,222
0x546030fd59a46789072f443473a1dc4cb3fe5e24497923f028429f8fb032e4d1,t,21000,7261111,,5000100,2018-01-30 14:07:22,223
0x5d79633ae4e25cc7ef4bc5ecce56fc338fe5f2702a359d41240773721ba116b3,t,21000,7282111,,5000100,2018-01-30 14:07:22,224
0x9767e7e1e90fdcc3b6991ac2b4b7f6d7bf6b287c0d793a33c49c48a8d810a0b2,t,21000,7303111,,5000100,2018-01-30 14:07:22,225
0x53e466d2e700aa32ee3c807dbf7b972c7bfc568b3bdac8c51109cdc5ff8b1e92,t,21000,7324111,,5000100,2018-01-30 14:07:22,226
0x142ab86da0ec334015cdac58df96b3476684edee93495cd443130d361bb0721d,t,21000,7345111,,5000100,2018-01-30 14:07:22,227
0xf4f175fd9ae6f8343e7aa93e202a29a68f3e1f8c102d65efcabf88c3351aeb83,t,21000,7366111,,5000100,2018-01-30 14:07:22,228
0x34ae203d0dea047583879566894dacd4c6b980619ecf812cf67ae671f9db1317,t,21000,7387111,,5000100,2018-01-30 14:07:22,229
0x72964a5d7f360857fc6a86e49ec83cd6e9c6c0c8a467b38fdc8567acc0248e2f,t,21000,7408111,,5000100,2018-01-30 14:07:22,230
0xa4a09ac272a554a22c474c44a314d42fbf1e6539e0b7eb8d6001479378aba43c,t,21000,7429111,,5000100,2018-01-30 14:07:22,231
0xe3c6721fb188ccb669b7e7505c2816bbc1ed09acbe84c0edd67efa3cceeca983,t,21000,7450111,,5000100,2018-01-30 14:07:22,232
0xc587108f39f493c648c0fc64fc6e36763061f197eed0c772ba7fe850f6732c2d,t,21000,7471111,,5000100,2018-01-30 14:07:22,233
0x0e60bf0dbc53a3c66d1fb45418be82812ef5b2beafad0e7f034170a541026ce8,t,21000,7492111,,5000100,2018-01-30 14:07:22,234
0x0ffb26d2ee52e2e1a82e7ef541a20dbaef771d7f01e894fde4ad3ea66bde9fb1,t,21000,7513111,,5000100,2018-01-30 14:07:22,235
0x4559497a8422b7213459a7e39118cf1340c35b3b3a1f01e7e5f7028c42eeb60c,t,21000,7534111,,5000100,2018-01-30 14:07:22,236
0xda4350eefb29e221acef4b1f3deb310c6109507e3f25eda81f70baef7fe4db8c,t,21000,7555111,,5000100,2018-01-30 14:07:22,237
0x19c214e1950ac08a9a762995825307752fc74f1d97a3e0a3e98af28a41ff7ada,t,21000,7576111,,5000100,2018-01-30 14:07:22,238
0xee9e1b2f58f044f114699dd0d0775785bd1021c2097a9a1155b3da280496c324,t,21000,7597111,,5000100,2018-01-30 14:07:22,239
0x3fef73bb7e2a75af162e7efe06a85c1597c43010b6c6e31998b08d200d5aba6d,t,21000,7618111,,5000100,2018-01-30 14:07:22,240
0x84c9fc70e9624ce4081f2499ccd745dafac4e855f26f53201d57e5101b9fd156,t,21000,7639111,,5000100,2018-01-30 14:07:22,241
0x721c24e89b063666a194c7a31fe565ae24d2cd04946771badffe9b2bb835558e,t,21000,7660111,,5000100,2018-01-30 14:07:22,242
0x6fe431a29d5934f6b83063984829437f23b8ba84f204bd25e7584dad3f984314,t,21000,7681111,,5000100,2018-01-30 14:07:22,243
0x2d67b48cfccf531de2bd5dcba6b32417042be42264b4f24b5ddcbc190aded4ad,t,21000,7702111,,5000100,2018-01-30 14:07:22,244
0x3ec3a8294cb3d7665491d1113201b61b653eb74260a19e12d06b8d0d783c666a,t,21000,7723111,,5000100,2018-01-30 14:07:22,245
0x28c729e50677bef3ecafda0a0031fb6519aedcda01947e38517b6caac3f88b3c,t,21000,7744111,,5000100,2018-01-30 14:07:22,246
0x6cc05398cf6899eb74cfe5694bee8a7a8e6660e93f77e121cd74f1459d1ee7e4,t,21000,7765111,,5000100,2018-01-30 14:07:22,247
0x0afe563910d5623afc2efc7bef6dda804a6f7e610ab639fad8ab076fd980e110,t,21000,7786111,,5000100,2018-01-30 14:07:22,248
0x86746e2c8ff29fa30b16b1af838d42b0fdc6cba31ed92feb882bf1feb76ae7f6,t,21000,7807111,,5000100,2018-01-30 14:07:22,249
0x4668a1f08fa7ba0ebc868bc94cf231dbaac80244de8d975c11d251e28329afc2,t,21000,7828111,,5000100,2018-01-30 14:07:22,250
0x04f59296fd09bbb74e62f30943fce8ff391c817f7c513fc12fe8faa7be4fca18,t,21000,7849111,,5000100,2018-01-30 14:07:22,251
0x75f32e7838499ad54168736f54c0ac79155aab6fb3328e954866174b00416f70,t,21000,7870111,,5000100,2018-01-30 14:07:22,252
0xb6db278c2b554ce00b57719dfac3436e84c3d259efe9854e4e832e7c8ee8ad97,t,21000,7891111,,5000100,2018-01-30 14:07:22,253
0x92811105f30c1f8484279073f5c549f231f343dffe3f00855110696289313928,t,21000,7912111,,5000100,2018-01-30 14:07:22,254
0x262000c50f48eb18ae3b1e79e85e3245eec1dab2d2cace6ccebe6bd05602d7d9,t,21000,7933111,,5000100,2018-01-30 14:07:22,255
0x05f4d500eba0be692b1a02882800f4dfa3a6fe57672b7819b09a0bf17c1cdf06,t,21000,7954111,,5000100,2018-01-30 14:07:22,256
0x1d6100e9e90e59ee0ae33eb72fdd665bbc9d3fa0b8eae737124c257b5fca01e9,t,21051,7975162,,5000100,2018-01-30 14:07:22,257
0xd37b084735bfe13178847beca12e741e16d1d9063c9b554695e3418ae3f0f9a6,t,21000,7996162,,5000100,2018-01-30 14:07:22,258
